areacode,white,mixed,asian,black,other,total
E01000001,1161,31,121,8,29,1350
E01000002,1165,30,86,4,8,1293
E01000003,996,33,155,35,23,1242
E01000005,471,39,209,65,37,821
E01000006,467,31,641,135,35,1309
E01000007,359,55,349,278,17,1058
E01000008,361,29,266,360,26,1042
E01000009,366,40,847,168,41,1462
E01000010,688,75,982,380,64,2189
E01000011,285,21,806,113,44,1269
E01000012,412,65,505,322,28,1332
E01000013,926,26,109,180,4,1245
E01000014,985,33,64,159,12,1253
E01000015,1122,19,108,295,26,1570
E01000016,924,26,79,175,12,1216
E01000017,875,21,75,205,15,1191
E01000018,885,26,73,180,4,1168
E01000019,619,37,200,140,34,1030
E01000020,945,39,133,223,17,1357
E01000021,696,50,233,207,10,1196
E01000022,661,39,98,158,8,964
E01000023,510,33,186,132,20,881
E01000024,595,22,152,184,17,970
E01000025,893,27,135,157,6,1218
E01000027,956,30,111,139,5,1241
E01000028,698,42,159,219,15,1133
E01000029,908,27,212,147,20,1314
E01000030,961,38,100,220,17,1336
E01000031,699,44,304,180,37,1264
E01000032,853,32,227,135,30,1277
E01000033,789,18,42,142,7,998
E01000034,921,14,48,141,6,1130
E01000035,893,18,112,203,11,1237
E01000036,670,18,170,193,2,1053
E01000037,1198,35,57,126,8,1424
E01000038,1005,14,63,70,5,1157
E01000039,1069,28,68,104,6,1275
E01000040,763,23,204,177,26,1193
E01000041,879,29,79,215,14,1216
E01000042,757,39,232,213,29,1270
E01000043,592,26,263,109,16,1006
E01000044,653,55,335,276,19,1338
E01000045,763,53,106,252,20,1194
E01000046,997,29,68,170,14,1278
E01000048,455,60,148,433,33,1129
E01000049,530,54,177,373,37,1171
E01000050,518,40,451,181,25,1215
E01000051,505,38,234,444,49,1270
E01000052,781,39,389,261,16,1486
E01000053,753,14,86,258,8,1119
E01000054,966,18,70,201,10,1265
E01000055,864,28,97,164,8,1161
E01000056,814,33,77,202,10,1136
E01000057,733,33,63,215,15,1059
E01000058,887,42,132,278,23,1362
E01000059,915,36,41,170,10,1172
E01000060,951,22,78,247,12,1310
E01000061,810,47,55,264,13,1189
E01000062,1021,28,104,309,2,1464
E01000063,933,19,82,157,10,1201
E01000064,1072,26,63,276,5,1442
E01000065,1016,23,72,219,16,1346
E01000066,773,37,482,122,26,1440
E01000067,806,18,503,162,28,1517
E01000068,482,17,648,92,19,1258
E01000069,709,44,505,75,22,1355
E01000070,745,25,659,108,21,1558
E01000071,774,47,658,190,45,1714
E01000072,1016,44,120,249,12,1441
E01000073,896,23,96,153,14,1182
E01000074,867,32,55,168,7,1129
E01000075,1006,37,102,150,5,1300
E01000076,986,34,132,218,13,1383
E01000077,789,17,98,192,8,1104
E01000078,896,28,117,171,9,1221
E01000079,847,20,88,173,7,1135
E01000080,858,35,67,190,9,1159
E01000081,931,24,86,212,17,1270
E01000082,932,28,78,181,12,1231
E01000083,906,37,95,189,16,1243
E01000084,739,19,66,160,6,990
E01000085,917,33,62,205,21,1238
E01000086,757,22,76,192,5,1052
E01000087,716,26,41,212,6,1001
E01000088,799,31,163,361,13,1367
E01000089,816,29,69,287,13,1214
E01000090,650,18,148,284,28,1128
E01000091,676,20,163,286,23,1168
E01000092,888,52,381,548,56,1925
E01000093,643,42,108,310,12,1115
E01000094,346,33,157,378,12,926
E01000095,625,21,135,316,13,1110
E01000096,617,35,125,436,23,1236
E01000097,941,24,156,133,18,1272
E01000098,842,49,209,162,14,1276
E01000099,968,34,139,135,7,1283
E01000100,900,21,123,140,12,1196
E01000101,854,15,104,164,11,1148
E01000102,861,35,81,168,12,1157
E01000103,765,45,93,321,17,1241
E01000104,887,30,74,271,18,1280
E01000105,1154,44,81,298,14,1591
E01000106,990,50,78,341,14,1473
E01000107,977,20,98,176,10,1281
E01000108,904,20,99,194,12,1229
E01000109,813,32,225,189,9,1268
E01000110,676,31,237,158,19,1121
E01000111,923,22,214,208,27,1394
E01000112,796,43,360,246,22,1467
E01000113,703,25,302,209,36,1275
E01000114,1005,30,189,312,13,1549
E01000115,875,14,224,30,59,1202
E01000116,1015,49,192,36,43,1335
E01000117,1203,37,164,38,60,1502
E01000118,1118,71,212,71,40,1512
E01000119,886,46,288,43,91,1354
E01000120,819,32,245,29,66,1191
E01000121,752,62,160,90,52,1116
E01000122,765,35,272,56,45,1173
E01000123,947,48,254,59,41,1349
E01000124,773,48,262,134,62,1279
E01000125,899,89,640,350,128,2106
E01000126,636,76,356,371,105,1544
E01000127,613,46,261,180,43,1143
E01000128,736,40,366,186,49,1377
E01000129,664,61,421,169,66,1381
E01000130,623,43,271,237,42,1216
E01000131,686,39,507,136,64,1432
E01000132,580,56,254,133,49,1072
E01000133,696,34,271,179,35,1215
E01000134,651,44,303,210,45,1253
E01000135,831,59,250,54,99,1293
E01000136,935,48,160,28,69,1240
E01000137,794,67,188,174,95,1318
E01000138,704,33,219,74,121,1151
E01000139,815,36,159,59,112,1181
E01000140,932,50,237,79,101,1399
E01000141,973,72,314,201,149,1709
E01000142,1134,76,320,216,167,1913
E01000143,686,42,167,156,88,1139
E01000144,761,36,351,43,93,1284
E01000145,747,24,218,45,84,1118
E01000146,892,72,300,65,131,1460
E01000147,564,45,716,71,53,1449
E01000148,646,62,488,229,82,1507
E01000150,721,61,621,188,72,1663
E01000151,401,91,206,370,91,1159
E01000152,425,79,179,360,92,1135
E01000153,565,72,206,271,43,1157
E01000154,454,47,203,260,66,1030
E01000155,702,44,514,167,60,1487
E01000156,1155,66,138,85,67,1511
E01000157,960,46,108,69,52,1235
E01000158,779,35,211,95,38,1158
E01000159,1031,43,200,81,37,1392
E01000160,1087,64,344,125,73,1693
E01000161,979,65,294,147,65,1550
E01000162,848,42,281,79,41,1291
E01000163,817,70,150,168,47,1252
E01000164,829,76,183,127,74,1289
E01000165,819,77,387,93,103,1479
E01000166,956,36,159,66,39,1256
E01000167,848,38,79,62,25,1052
E01000168,961,33,212,24,46,1276
E01000169,1029,32,88,47,16,1212
E01000170,1026,48,129,64,21,1288
E01000171,1055,52,155,118,49,1429
E01000172,1074,23,137,46,32,1312
E01000173,1065,43,150,49,37,1344
E01000174,1030,58,156,81,43,1368
E01000175,1001,46,154,35,20,1256
E01000176,860,66,217,120,31,1294
E01000177,1104,37,136,47,33,1357
E01000178,1115,51,147,58,39,1410
E01000179,1057,45,153,64,25,1344
E01000180,952,46,209,77,42,1326
E01000181,1138,63,121,28,51,1401
E01000182,1168,47,138,28,50,1431
E01000183,940,42,128,25,57,1192
E01000184,650,54,152,173,32,1061
E01000185,604,60,218,196,78,1156
E01000186,796,14,312,19,31,1172
E01000187,854,26,229,72,50,1231
E01000188,847,23,313,25,30,1238
E01000189,579,68,289,292,68,1296
E01000190,871,18,214,62,39,1204
E01000191,801,21,296,39,39,1196
E01000192,923,31,344,79,92,1469
E01000193,859,26,350,78,50,1363
E01000194,668,50,407,134,58,1317
E01000195,782,51,208,233,67,1341
E01000196,1059,65,313,81,77,1595
E01000197,961,61,355,66,55,1498
E01000198,963,35,228,86,116,1428
E01000199,956,29,178,42,88,1293
E01000200,1096,27,250,65,122,1560
E01000201,801,40,248,53,88,1230
E01000202,1002,53,222,44,61,1382
E01000203,789,64,307,109,78,1347
E01000204,1030,33,240,50,82,1435
E01000205,910,39,102,41,68,1160
E01000206,948,25,174,35,68,1250
E01000207,1037,36,112,20,41,1246
E01000208,1001,19,154,28,81,1283
E01000209,1167,32,54,12,26,1291
E01000210,925,20,125,34,67,1171
E01000211,1194,62,252,93,105,1706
E01000212,937,20,126,26,29,1138
E01000213,913,18,60,17,42,1050
E01000214,1006,43,238,27,76,1390
E01000215,1017,36,204,69,108,1434
E01000216,998,45,264,30,110,1447
E01000217,950,25,127,57,74,1233
E01000218,944,42,168,57,90,1301
E01000219,856,30,301,43,102,1332
E01000220,1049,41,206,41,99,1436
E01000221,465,55,198,176,62,956
E01000222,653,42,241,134,136,1206
E01000223,588,41,166,141,56,992
E01000224,621,56,278,136,126,1217
E01000225,898,27,111,26,86,1148
E01000226,741,60,304,168,45,1318
E01000227,879,38,377,96,46,1436
E01000228,711,30,242,55,51,1089
E01000229,792,53,203,181,44,1273
E01000230,957,31,339,63,35,1425
E01000231,718,50,375,187,63,1393
E01000232,876,43,376,119,52,1466
E01000233,853,42,332,122,45,1394
E01000234,929,31,218,110,54,1342
E01000235,782,56,213,162,59,1272
E01000236,1054,38,116,29,105,1342
E01000237,1137,54,274,66,140,1671
E01000238,927,39,246,67,128,1407
E01000239,838,74,409,192,112,1625
E01000240,708,68,371,128,80,1355
E01000241,997,42,230,60,106,1435
E01000242,935,31,175,102,65,1308
E01000243,1081,42,336,62,72,1593
E01000244,817,50,402,113,75,1457
E01000245,913,81,286,165,124,1569
E01000246,1039,37,98,43,27,1244
E01000247,1125,37,108,47,45,1362
E01000248,1185,27,81,21,12,1326
E01000249,1082,16,108,16,8,1230
E01000250,1468,46,175,50,62,1801
E01000251,1200,65,163,64,70,1562
E01000252,1052,49,141,56,32,1330
E01000253,1120,22,171,38,35,1386
E01000254,1118,29,73,15,6,1241
E01000255,807,44,200,101,36,1188
E01000256,965,43,247,111,47,1413
E01000257,793,60,278,151,100,1382
E01000258,1021,41,178,55,30,1325
E01000259,1213,77,543,106,74,2013
E01000260,900,66,335,149,78,1528
E01000261,1018,27,141,50,19,1255
E01000262,1041,71,311,159,87,1669
E01000263,924,28,159,30,35,1176
E01000264,814,61,258,99,60,1292
E01000265,1071,57,202,114,46,1490
E01000266,975,16,172,31,44,1238
E01000267,961,44,182,32,26,1245
E01000268,1022,61,144,105,59,1391
E01000269,913,28,172,25,16,1154
E01000270,968,34,142,42,28,1214
E01000271,950,31,159,37,38,1215
E01000272,920,21,139,15,31,1126
E01000273,903,34,223,79,37,1276
E01000274,982,51,278,86,45,1442
E01000275,837,41,397,55,48,1378
E01000276,717,22,379,16,38,1172
E01000277,766,45,328,84,99,1322
E01000278,664,13,390,20,40,1127
E01000279,970,12,153,13,30,1178
E01000280,903,26,166,8,31,1134
E01000281,678,19,122,81,53,953
E01000282,961,50,276,35,40,1362
E01000283,821,17,231,12,31,1112
E01000284,947,47,271,45,63,1373
E01000285,920,28,139,71,32,1190
E01000286,934,41,166,91,30,1262
E01000287,983,23,133,75,37,1251
E01000288,903,39,196,55,22,1215
E01000289,836,68,170,206,42,1322
E01000290,1049,37,137,41,24,1288
E01000291,784,46,155,143,35,1163
E01000292,1012,27,122,35,25,1221
E01000293,1133,41,162,44,33,1413
E01000294,1047,46,143,51,29,1316
E01000295,870,49,393,58,59,1429
E01000296,910,60,363,49,57,1439
E01000297,692,40,346,74,41,1193
E01000298,1002,55,346,48,92,1543
E01000299,858,49,446,74,87,1514
E01000300,880,39,317,52,51,1339
E01000301,730,33,349,26,43,1181
E01000302,879,66,374,78,87,1484
E01000303,729,36,350,31,56,1202
E01000304,931,41,212,65,57,1306
E01000305,562,53,492,146,99,1352
E01000306,532,40,696,87,50,1405
E01000307,629,37,466,140,51,1323
E01000308,621,59,266,188,55,1189
E01000309,761,43,513,104,71,1492
E01000310,1014,56,469,99,92,1730
E01000311,879,27,120,37,52,1115
E01000312,643,56,410,141,50,1300
E01000313,648,59,592,116,95,1510
E01000314,771,47,557,99,65,1539
E01000315,814,62,259,117,51,1303
E01000316,988,85,478,182,103,1836
E01000317,806,53,338,51,85,1333
E01000318,831,35,479,70,65,1480
E01000319,821,35,262,38,33,1189
E01000320,902,36,191,49,35,1213
E01000321,970,43,232,66,89,1400
E01000322,1036,58,229,55,66,1444
E01000323,999,58,400,126,88,1671
E01000324,1029,62,211,63,46,1411
E01000325,1221,10,35,24,3,1293
E01000326,940,11,27,38,6,1022
E01000327,1162,17,64,12,10,1265
E01000328,1138,8,40,20,6,1212
E01000329,963,8,62,34,4,1071
E01000330,1192,15,71,31,4,1313
E01000331,1119,12,73,57,5,1266
E01000332,992,20,142,86,17,1257
E01000333,1167,13,49,91,11,1331
E01000334,1055,20,120,88,15,1298
E01000335,806,33,137,289,24,1289
E01000336,842,36,208,287,38,1411
E01000337,985,40,97,154,10,1286
E01000338,1021,17,159,146,17,1360
E01000339,1160,13,32,22,7,1234
E01000340,1133,9,51,30,4,1227
E01000341,1141,4,43,19,2,1209
E01000342,1219,16,40,13,4,1292
E01000343,1119,15,54,12,4,1204
E01000344,1206,14,29,29,6,1284
E01000345,998,15,51,11,4,1079
E01000346,1190,26,46,18,3,1283
E01000347,1082,22,46,26,16,1192
E01000348,1096,16,56,11,7,1186
E01000349,1213,19,72,33,1,1338
E01000350,1113,18,48,20,6,1205
E01000351,1203,19,64,18,4,1308
E01000352,1131,28,70,30,8,1267
E01000353,1298,18,69,31,7,1423
E01000354,1055,17,100,41,5,1218
E01000355,1150,12,56,35,8,1261
E01000356,1122,10,139,34,5,1310
E01000357,967,7,108,29,19,1130
E01000358,1194,15,100,32,3,1344
E01000359,899,15,84,41,2,1041
E01000360,1181,18,100,26,13,1338
E01000361,1137,9,46,42,3,1237
E01000362,1106,13,67,25,16,1227
E01000363,1045,11,108,33,9,1206
E01000364,1143,19,93,42,6,1303
E01000365,1231,18,83,44,5,1381
E01000366,1099,26,129,22,12,1288
E01000367,1050,15,68,114,4,1251
E01000368,999,17,49,98,4,1167
E01000369,1197,15,33,54,19,1318
E01000370,1183,23,45,39,10,1300
E01000371,1168,9,31,56,3,1267
E01000372,1050,13,116,108,7,1294
E01000373,722,29,49,243,19,1062
E01000374,920,8,59,86,5,1078
E01000375,1030,17,33,63,5,1148
E01000376,1058,7,62,42,8,1177
E01000377,1114,15,35,24,2,1190
E01000378,1533,15,77,78,9,1712
E01000379,1159,12,52,56,6,1285
E01000380,1112,11,28,48,2,1201
E01000381,1157,18,28,27,8,1238
E01000382,1129,9,61,28,12,1239
E01000383,1176,15,33,19,8,1251
E01000384,1339,15,53,18,2,1427
E01000385,1194,21,62,85,13,1375
E01000386,912,35,90,75,10,1122
E01000387,1148,6,67,29,6,1256
E01000388,1073,6,150,37,13,1279
E01000389,1198,9,148,21,5,1381
E01000390,901,24,101,23,26,1075
E01000391,1224,24,53,61,3,1365
E01000392,980,28,136,99,19,1262
E01000393,1119,17,105,56,8,1305
E01000394,1046,19,81,32,9,1187
E01000395,1037,19,96,23,6,1181
E01000396,959,11,107,35,24,1136
E01000398,1084,13,104,55,7,1263
E01000399,1093,19,101,66,14,1293
E01000400,1018,11,149,56,12,1246
E01000401,1097,13,120,75,8,1313
E01000402,980,25,97,97,5,1204
E01000403,1263,50,96,223,17,1649
E01000404,1001,50,116,423,15,1605
E01000405,705,25,65,207,10,1012
E01000406,824,23,143,228,12,1230
E01000407,1027,19,146,65,6,1263
E01000408,726,26,267,196,26,1241
E01000409,1244,11,63,20,10,1348
E01000410,1146,7,56,48,7,1264
E01000411,992,17,67,51,10,1137
E01000412,1136,14,102,64,8,1324
E01000413,922,17,62,34,12,1047
E01000414,1037,27,226,64,26,1380
E01000415,1032,18,126,44,16,1236
E01000416,609,24,187,323,14,1157
E01000417,1088,30,101,124,15,1358
E01000418,925,41,230,278,15,1489
E01000419,1042,18,107,41,2,1210
E01000420,1131,15,94,43,5,1288
E01000421,1082,6,106,21,16,1231
E01000422,586,26,184,421,22,1239
E01000423,1230,17,34,32,9,1322
E01000424,1370,22,67,11,6,1476
E01000425,1342,12,64,13,3,1434
E01000426,1258,14,52,23,8,1355
E01000427,1501,18,59,25,11,1614
E01000428,1303,42,124,64,6,1539
E01000429,857,26,49,253,7,1192
E01000430,879,29,51,329,11,1299
E01000431,857,39,55,259,7,1217
E01000432,995,17,52,162,19,1245
E01000433,1016,34,40,218,5,1313
E01000434,939,18,33,119,6,1115
E01000435,896,9,31,145,4,1085
E01000436,1216,15,100,35,5,1371
E01000437,929,10,76,35,2,1052
E01000438,1087,22,78,63,8,1258
E01000439,901,21,64,60,1,1047
E01000440,1002,14,114,32,6,1168
E01000441,1046,24,78,76,4,1228
E01000442,1117,10,98,52,12,1289
E01000443,957,18,25,12,9,1021
E01000444,1174,12,142,15,5,1348
E01000445,1261,13,80,15,7,1376
E01000446,1184,15,36,7,13,1255
E01000447,1150,18,54,18,8,1248
E01000448,1026,14,36,10,2,1088
E01000449,1170,14,49,17,2,1252
E01000450,1150,15,100,94,13,1372
E01000451,1128,18,105,84,5,1340
E01000452,890,21,117,33,20,1081
E01000453,998,22,73,47,8,1148
E01000454,1075,17,130,36,22,1280
E01000455,1099,13,175,48,15,1350
E01000456,943,12,97,37,9,1098
E01000457,1379,35,97,34,7,1552
E01000458,1147,11,54,20,7,1239
E01000459,1286,35,62,20,4,1407
E01000460,1039,12,64,16,3,1134
E01000461,1233,9,88,25,14,1369
E01000462,1293,18,69,35,10,1425
E01000463,917,12,51,21,2,1003
E01000464,609,26,98,350,10,1093
E01000465,739,26,64,369,11,1209
E01000466,581,42,121,447,11,1202
E01000467,604,64,84,400,24,1176
E01000468,729,75,103,898,22,1827
E01000469,638,30,101,475,11,1255
E01000470,569,38,92,330,18,1047
E01000471,324,47,735,166,37,1309
E01000472,392,22,556,90,58,1118
E01000473,157,25,1266,108,13,1569
E01000474,176,44,1175,163,17,1575
E01000475,348,32,1011,172,46,1609
E01000476,216,27,918,164,28,1353
E01000477,365,33,785,236,59,1478
E01000478,210,37,945,118,32,1342
E01000479,467,45,563,92,192,1359
E01000480,536,32,605,121,148,1442
E01000481,395,48,475,218,97,1233
E01000482,603,85,728,643,124,2183
E01000483,380,52,347,397,117,1293
E01000484,321,29,277,254,53,934
E01000485,379,45,512,149,48,1133
E01000486,511,59,595,55,132,1352
E01000487,537,49,687,149,128,1550
E01000488,585,56,315,162,107,1225
E01000489,724,72,220,138,148,1302
E01000490,948,79,163,128,71,1389
E01000491,894,79,245,168,197,1583
E01000492,684,41,226,95,55,1101
E01000493,805,67,248,149,73,1342
E01000494,855,76,260,160,146,1497
E01000495,894,76,152,191,84,1397
E01000497,665,39,365,243,92,1404
E01000498,324,28,561,212,67,1192
E01000499,528,67,376,207,96,1274
E01000501,570,83,266,359,97,1375
E01000502,508,33,272,157,68,1038
E01000503,863,61,297,245,115,1581
E01000504,899,67,193,183,80,1422
E01000505,585,49,400,199,95,1328
E01000506,602,53,275,300,72,1302
E01000507,614,68,412,157,98,1349
E01000508,541,52,266,552,63,1474
E01000509,433,31,426,213,66,1169
E01000510,557,63,361,196,121,1298
E01000511,541,50,326,212,90,1219
E01000512,923,70,256,131,46,1426
E01000513,513,29,571,123,83,1319
E01000514,520,58,437,112,50,1177
E01000515,489,68,504,206,75,1342
E01000516,593,43,565,108,73,1382
E01000517,459,12,754,42,56,1323
E01000518,497,51,536,152,64,1300
E01000519,507,45,606,195,133,1486
E01000520,615,46,428,140,82,1311
E01000521,505,117,365,561,101,1649
E01000522,573,88,151,528,63,1403
E01000523,834,124,261,627,113,1959
E01000524,661,102,314,653,118,1848
E01000525,638,96,182,519,56,1491
E01000526,455,92,262,794,80,1683
E01000527,605,97,224,580,73,1579
E01000528,246,69,151,608,37,1111
E01000530,864,75,321,228,40,1528
E01000531,937,118,181,362,105,1703
E01000532,756,93,128,327,84,1388
E01000533,798,108,272,516,57,1751
E01000534,745,81,235,285,58,1404
E01000535,941,103,256,367,70,1737
E01000536,445,42,752,47,38,1324
E01000538,478,18,693,38,48,1275
E01000539,516,16,684,43,46,1305
E01000540,433,27,720,46,38,1264
E01000541,335,24,709,63,18,1149
E01000543,309,32,848,77,50,1316
E01000544,506,96,173,479,123,1377
E01000545,1064,98,197,147,92,1598
E01000546,948,72,185,127,62,1394
E01000547,968,68,186,206,61,1489
E01000548,1176,90,173,250,121,1810
E01000549,1127,92,169,159,66,1613
E01000550,810,71,220,406,97,1604
E01000551,532,99,179,658,135,1603
E01000552,332,86,135,667,121,1341
E01000553,898,72,429,215,101,1715
E01000554,893,73,229,199,69,1463
E01000555,712,54,260,106,89,1221
E01000556,788,56,366,225,131,1566
E01000557,883,62,386,141,127,1599
E01000558,863,72,151,124,87,1297
E01000559,778,73,175,163,75,1264
E01000560,1049,86,142,88,46,1411
E01000561,906,71,194,228,99,1498
E01000562,330,28,772,87,57,1274
E01000563,363,36,719,81,57,1256
E01000564,395,51,606,150,42,1244
E01000565,337,24,591,180,51,1183
E01000566,431,26,633,109,62,1261
E01000567,420,30,502,126,27,1105
E01000568,869,46,931,159,54,2059
E01000569,418,27,679,113,54,1291
E01000570,333,37,625,219,34,1248
E01000571,423,52,666,150,96,1387
E01000572,397,40,601,116,24,1178
E01000573,446,51,614,92,59,1262
E01000574,425,36,501,85,28,1075
E01000575,509,48,749,121,74,1501
E01000576,392,40,728,99,111,1370
E01000577,445,70,703,399,129,1746
E01000578,655,71,570,159,91,1546
E01000579,845,83,161,274,47,1410
E01000580,1216,62,122,132,69,1601
E01000581,831,61,116,176,39,1223
E01000582,1114,73,106,116,52,1461
E01000583,1308,93,238,199,91,1929
E01000584,747,81,329,186,43,1386
E01000585,869,72,222,229,69,1461
E01000586,1201,134,300,283,144,2062
E01000587,419,33,837,63,24,1376
E01000588,506,57,692,324,77,1656
E01000589,350,31,1011,131,50,1573
E01000590,593,38,693,94,35,1453
E01000591,378,43,1086,97,92,1696
E01000592,448,27,664,132,67,1338
E01000593,464,47,830,254,72,1667
E01000594,341,27,871,98,15,1352
E01000595,328,59,196,484,105,1172
E01000596,342,60,216,521,77,1216
E01000599,243,31,109,543,57,983
E01000600,398,71,238,703,86,1496
E01000601,281,55,146,444,76,1002
E01000602,264,54,295,464,46,1123
E01000603,331,63,206,418,61,1079
E01000604,311,69,245,595,66,1286
E01000605,399,46,261,459,39,1204
E01000606,374,45,666,211,48,1344
E01000607,410,48,1084,171,50,1763
E01000608,390,53,998,236,90,1767
E01000609,454,44,818,230,71,1617
E01000610,348,38,908,196,51,1541
E01000611,216,33,689,175,47,1160
E01000612,343,23,821,124,29,1340
E01000613,389,34,671,178,57,1329
E01000615,307,46,509,366,56,1284
E01000616,450,63,720,193,35,1461
E01000617,367,30,775,230,56,1458
E01000618,351,35,578,297,28,1289
E01000619,244,36,623,383,47,1333
E01000620,279,29,797,269,64,1438
E01000621,335,56,674,328,51,1444
E01000622,693,59,220,228,60,1260
E01000623,544,32,634,129,75,1414
E01000624,585,47,502,164,53,1351
E01000625,561,35,359,155,110,1220
E01000626,410,61,200,372,69,1112
E01000627,552,56,410,338,87,1443
E01000628,552,65,467,304,66,1454
E01000629,597,29,714,147,76,1563
E01000630,299,60,1037,361,55,1812
E01000631,251,29,1128,117,37,1562
E01000632,134,30,1429,87,48,1728
E01000633,165,26,1354,99,20,1664
E01000634,273,35,1127,327,52,1814
E01000635,383,61,1110,320,85,1959
E01000636,267,41,941,216,41,1506
E01000637,761,72,268,229,50,1380
E01000638,732,88,388,238,76,1522
E01000639,945,93,257,159,54,1508
E01000640,725,104,485,251,114,1679
E01000641,703,116,325,320,52,1516
E01000642,1088,100,322,203,78,1791
E01000643,644,86,320,474,108,1632
E01000644,823,82,379,222,66,1572
E01000645,980,21,114,12,5,1132
E01000646,1173,26,108,44,19,1370
E01000647,1094,20,68,34,13,1229
E01000648,1158,35,86,42,21,1342
E01000649,1350,26,157,62,16,1611
E01000650,1301,20,149,31,26,1527
E01000651,1213,30,71,18,12,1344
E01000652,1187,13,81,34,11,1326
E01000653,1151,25,99,22,18,1315
E01000654,963,12,21,8,1,1005
E01000655,986,13,16,3,6,1024
E01000656,1084,20,12,16,18,1150
E01000657,1225,8,22,19,9,1283
E01000658,1137,6,12,2,1,1158
E01000659,1121,11,10,10,2,1154
E01000661,997,47,69,74,13,1200
E01000662,1188,38,70,79,9,1384
E01000663,1129,30,47,37,15,1258
E01000664,1106,27,62,52,6,1253
E01000665,1298,28,60,44,17,1447
E01000666,1470,11,37,17,7,1542
E01000667,1180,10,82,17,15,1304
E01000668,1138,20,79,37,9,1283
E01000669,1196,35,40,36,0,1307
E01000670,1270,54,171,70,29,1594
E01000671,1210,32,121,56,7,1426
E01000672,1058,39,84,45,23,1249
E01000673,1063,33,73,51,15,1235
E01000674,1103,47,93,68,13,1324
E01000675,1052,58,110,72,32,1324
E01000676,1153,45,128,83,30,1439
E01000677,1160,24,91,75,24,1374
E01000678,1133,21,90,70,23,1337
E01000679,1111,37,56,55,9,1268
E01000680,1279,13,35,3,6,1336
E01000681,1230,22,66,17,15,1350
E01000682,1165,9,42,19,4,1239
E01000683,1117,26,117,27,8,1295
E01000684,1367,18,129,49,15,1578
E01000685,1152,12,44,18,13,1239
E01000686,1164,7,58,22,4,1255
E01000687,1248,15,40,8,3,1314
E01000688,1023,12,53,14,0,1102
E01000689,980,35,76,27,14,1132
E01000690,995,12,75,29,8,1119
E01000691,1050,26,33,28,23,1160
E01000692,1172,23,35,24,10,1264
E01000693,1134,13,129,23,10,1309
E01000694,1179,13,93,26,14,1325
E01000695,1156,17,36,14,5,1228
E01000696,1149,14,76,11,3,1253
E01000697,1249,15,78,12,14,1368
E01000698,853,22,88,34,9,1006
E01000699,782,70,85,196,13,1146
E01000700,1011,39,55,91,5,1201
E01000701,831,48,57,125,17,1078
E01000702,907,45,54,79,5,1090
E01000703,1115,38,62,57,3,1275
E01000704,892,35,52,140,11,1130
E01000705,684,52,78,214,8,1036
E01000706,870,43,49,88,6,1056
E01000707,991,17,27,17,9,1061
E01000708,1065,34,57,67,4,1227
E01000709,1018,27,82,40,14,1181
E01000710,1202,40,86,72,16,1416
E01000711,1344,38,96,70,23,1571
E01000712,1216,40,116,55,21,1448
E01000713,1256,31,72,89,18,1466
E01000714,1407,47,107,64,16,1641
E01000715,1283,30,90,41,15,1459
E01000716,1180,40,64,32,15,1331
E01000717,1261,41,61,50,15,1428
E01000718,1195,68,124,179,39,1605
E01000719,1226,28,45,132,8,1439
E01000720,974,43,34,121,16,1188
E01000721,763,29,53,103,8,956
E01000722,1167,22,52,46,4,1291
E01000723,1042,7,14,23,0,1086
E01000724,1004,30,39,167,5,1245
E01000725,1156,18,36,58,1,1269
E01000726,988,11,38,33,8,1078
E01000727,1174,21,49,31,5,1280
E01000728,1058,29,36,50,14,1187
E01000729,1148,36,52,86,14,1336
E01000730,1037,42,32,99,3,1213
E01000731,906,28,42,55,6,1037
E01000732,1066,15,63,35,8,1187
E01000733,1153,19,35,48,15,1270
E01000734,938,19,36,43,3,1039
E01000735,997,21,48,55,1,1122
E01000736,1090,29,34,35,12,1200
E01000737,944,15,65,56,4,1084
E01000738,1080,15,38,59,13,1205
E01000739,955,18,28,106,7,1114
E01000740,787,85,108,364,28,1372
E01000741,884,90,73,265,10,1322
E01000742,1133,111,69,305,28,1646
E01000743,904,95,64,317,26,1406
E01000744,756,53,81,281,17,1188
E01000745,977,75,102,267,16,1437
E01000746,1131,99,92,197,10,1529
E01000747,1422,28,21,19,7,1497
E01000748,1321,15,15,8,6,1365
E01000749,1274,9,22,6,1,1312
E01000750,1127,23,34,22,8,1214
E01000751,1350,19,153,34,17,1573
E01000752,1286,10,28,15,3,1342
E01000753,1400,9,44,15,10,1478
E01000754,1224,19,84,10,10,1347
E01000755,1127,16,46,13,15,1217
E01000756,1132,19,84,14,9,1258
E01000757,1197,15,39,2,2,1255
E01000758,1117,12,68,19,6,1222
E01000759,1163,12,21,11,14,1221
E01000760,1155,24,26,18,5,1228
E01000761,1147,19,22,25,3,1216
E01000762,1174,33,112,24,22,1365
E01000763,1072,8,47,15,5,1147
E01000764,1152,18,42,63,4,1279
E01000765,1286,17,23,24,10,1360
E01000766,1281,21,35,14,6,1357
E01000767,1195,23,39,15,2,1274
E01000768,1189,19,43,16,4,1271
E01000769,978,27,44,89,9,1147
E01000770,1119,26,51,22,13,1231
E01000771,1101,52,94,36,22,1305
E01000772,1154,23,57,34,11,1279
E01000773,1085,28,45,34,9,1201
E01000774,984,29,73,66,12,1164
E01000775,1428,52,113,107,32,1732
E01000777,1053,38,43,73,12,1219
E01000778,1039,40,71,68,10,1228
E01000779,875,28,103,54,8,1068
E01000780,945,28,67,114,15,1169
E01000781,906,31,35,92,8,1072
E01000782,888,29,51,119,7,1094
E01000783,956,26,35,77,16,1110
E01000784,1046,20,58,32,6,1162
E01000785,935,18,48,71,2,1074
E01000786,1169,14,29,19,12,1243
E01000787,1102,14,37,36,1,1190
E01000788,1067,19,78,65,13,1242
E01000789,965,33,57,114,5,1174
E01000790,1357,43,181,47,19,1647
E01000791,1124,9,46,28,6,1213
E01000792,797,15,40,66,8,926
E01000793,1257,24,43,6,11,1341
E01000794,1218,16,39,16,14,1303
E01000795,1013,25,27,31,2,1098
E01000796,638,67,73,382,34,1194
E01000797,1088,53,48,62,22,1273
E01000798,713,67,68,288,17,1153
E01000799,900,46,116,248,10,1320
E01000800,778,69,84,318,20,1269
E01000801,838,61,74,156,14,1143
E01000802,970,57,94,244,22,1387
E01000803,924,77,65,195,23,1284
E01000804,884,34,85,142,18,1163
E01000805,928,59,61,164,19,1231
E01000806,778,76,100,333,18,1305
E01000807,1112,18,56,19,6,1211
E01000808,1162,10,75,14,7,1268
E01000809,1172,10,23,24,5,1234
E01000810,1140,19,60,10,5,1234
E01000811,1000,18,57,6,5,1086
E01000812,1151,17,87,16,8,1279
E01000813,1205,14,70,19,5,1313
E01000814,1154,19,99,15,3,1290
E01000815,1144,12,44,21,11,1232
E01000816,940,20,93,127,20,1200
E01000818,999,20,75,82,11,1187
E01000819,1014,48,83,142,27,1314
E01000820,999,27,63,43,20,1152
E01000822,1114,46,59,86,17,1322
E01000823,1219,27,61,36,14,1357
E01000824,819,28,41,47,16,951
E01000825,1134,29,82,45,20,1310
E01000826,1131,14,77,27,34,1283
E01000827,1182,27,135,39,27,1410
E01000828,1139,24,109,44,8,1324
E01000829,1156,40,96,54,29,1375
E01000830,1062,24,89,30,22,1227
E01000831,1221,32,87,23,22,1385
E01000832,1055,20,80,31,9,1195
E01000833,995,19,63,21,2,1100
E01000834,946,24,39,23,4,1036
E01000835,1157,23,57,35,0,1272
E01000836,986,36,39,22,10,1093
E01000837,1064,28,62,41,17,1212
E01000838,1095,30,43,24,7,1199
E01000839,1108,24,41,28,3,1204
E01000840,1273,15,27,29,6,1350
E01000841,1173,16,56,16,7,1268
E01000842,1025,43,117,32,40,1257
E01000843,1023,61,174,76,36,1370
E01000844,1147,47,224,22,43,1483
E01000845,998,36,149,49,24,1256
E01000846,706,62,152,163,43,1126
E01000847,787,55,242,124,50,1258
E01000848,1089,33,148,22,72,1364
E01000849,1060,59,175,34,44,1372
E01000850,1040,74,367,67,64,1612
E01000851,1402,92,586,82,85,2247
E01000852,906,61,467,54,56,1544
E01000853,887,72,272,121,31,1383
E01000854,720,52,557,156,131,1616
E01000855,1234,49,299,64,67,1713
E01000856,825,58,258,114,39,1294
E01000857,990,40,113,32,26,1201
E01000858,946,85,220,186,66,1503
E01000859,1168,61,76,23,19,1347
E01000860,959,34,81,42,28,1144
E01000861,1028,57,183,86,30,1384
E01000862,1217,42,102,37,67,1465
E01000863,1044,39,136,91,26,1336
E01000864,1024,48,118,97,44,1331
E01000865,1028,44,235,43,18,1368
E01000866,1271,93,145,139,69,1717
E01000867,846,62,257,95,41,1301
E01000868,538,64,168,255,24,1049
E01000869,1372,108,158,127,40,1805
E01000870,1120,76,95,109,24,1424
E01000871,994,54,167,53,84,1352
E01000872,1155,82,251,118,62,1668
E01000873,1136,37,97,64,52,1386
E01000874,1025,45,157,30,75,1332
E01000875,1029,72,191,97,64,1453
E01000876,909,66,175,197,80,1427
E01000877,1078,51,126,45,56,1356
E01000878,1011,62,246,56,57,1432
E01000879,1006,27,115,26,46,1220
E01000880,933,41,165,26,47,1212
E01000881,907,41,225,28,32,1233
E01000882,1043,32,135,14,45,1269
E01000883,747,40,284,26,47,1144
E01000884,923,30,116,29,34,1132
E01000885,948,47,134,15,53,1197
E01000886,982,60,73,32,26,1173
E01000887,1003,53,124,28,56,1264
E01000888,1012,64,113,56,34,1279
E01000889,865,72,177,137,53,1304
E01000890,858,65,163,167,68,1321
E01000891,779,48,187,170,50,1234
E01000892,1161,56,168,63,33,1481
E01000893,1152,49,68,10,22,1301
E01000894,960,24,103,12,31,1130
E01000895,1153,48,113,34,31,1379
E01000896,1197,30,105,34,25,1391
E01000897,1032,46,153,14,40,1285
E01000898,922,70,307,102,71,1472
E01000899,1179,30,86,19,26,1340
E01000900,1135,47,115,130,53,1480
E01000901,816,76,335,177,70,1474
E01000902,646,65,173,156,62,1102
E01000903,945,49,162,59,32,1247
E01000904,1235,91,201,161,51,1739
E01000905,903,62,277,237,53,1532
E01000906,1094,56,127,56,47,1380
E01000907,881,53,96,74,31,1135
E01000908,976,82,83,97,51,1289
E01000909,1175,56,64,36,39,1370
E01000910,1052,63,52,36,18,1221
E01000911,1023,35,79,70,34,1241
E01000912,1059,52,66,113,39,1329
E01000913,1268,45,77,16,12,1418
E01000914,1131,56,319,73,47,1626
E01000915,683,47,374,89,41,1234
E01000916,1041,60,281,112,66,1560
E01000917,848,62,347,178,55,1490
E01000918,1242,79,393,101,71,1886
E01000919,1099,66,487,108,90,1850
E01000920,1210,73,279,91,49,1702
E01000921,1346,93,128,89,36,1692
E01000922,1010,73,92,114,33,1322
E01000923,1016,60,95,70,23,1264
E01000924,1164,61,112,70,29,1436
E01000925,706,40,191,211,25,1173
E01000926,930,58,321,87,141,1537
E01000927,1182,58,135,79,42,1496
E01000928,1073,70,116,76,42,1377
E01000929,746,53,194,174,93,1260
E01000930,1016,64,168,172,166,1586
E01000931,987,76,175,224,127,1589
E01000932,1196,65,213,117,79,1670
E01000933,1123,67,153,67,82,1492
E01000934,712,48,302,175,73,1310
E01000935,609,49,126,204,59,1047
E01000936,803,60,416,202,44,1525
E01000937,747,53,439,72,50,1361
E01000938,702,70,378,157,83,1390
E01000939,366,45,394,108,34,947
E01000940,512,54,260,73,40,939
E01000941,528,35,284,111,42,1000
E01000942,1236,86,561,64,59,2006
E01000943,630,34,208,46,39,957
E01000944,840,82,436,116,153,1627
E01000945,775,73,520,122,63,1553
E01000946,870,40,235,85,72,1302
E01000947,1162,80,280,180,63,1765
E01000948,1128,63,150,97,50,1488
E01000949,851,47,267,119,38,1322
E01000950,471,36,403,127,63,1100
E01000951,628,48,352,123,67,1218
E01000952,793,64,323,169,54,1403
E01000953,703,43,386,163,54,1349
E01000954,619,55,267,194,59,1194
E01000955,727,59,264,137,66,1253
E01000956,561,56,377,140,53,1187
E01000957,957,59,196,170,53,1435
E01000958,1076,121,360,187,119,1863
E01000959,845,50,283,153,45,1376
E01000960,938,55,342,65,74,1474
E01000961,711,33,288,128,68,1228
E01000962,1047,41,212,33,43,1376
E01000963,870,45,489,81,141,1626
E01000964,991,50,158,65,45,1309
E01000965,966,45,188,63,53,1315
E01000966,1093,33,129,13,28,1296
E01000967,874,38,155,39,43,1149
E01000968,1029,56,151,63,37,1336
E01000969,1360,64,256,48,63,1791
E01000970,1119,49,119,38,37,1362
E01000971,1001,45,130,26,35,1237
E01000972,1020,87,279,219,71,1676
E01000973,1089,90,267,146,62,1654
E01000974,969,79,172,191,80,1491
E01000975,787,75,320,130,32,1344
E01000976,829,85,342,214,42,1512
E01000977,854,93,256,245,31,1479
E01000978,933,73,286,193,26,1511
E01000979,854,65,347,126,31,1423
E01000980,623,57,139,261,10,1090
E01000981,797,71,134,241,15,1258
E01000982,815,62,176,195,17,1265
E01000983,913,84,176,189,19,1381
E01000984,805,107,270,250,34,1466
E01000985,849,46,141,126,21,1183
E01000986,945,68,200,172,22,1407
E01000987,851,53,145,132,11,1192
E01000989,966,49,146,148,14,1323
E01000990,667,55,95,213,26,1056
E01000991,1057,37,166,123,11,1394
E01000992,780,76,171,385,23,1435
E01000993,916,55,133,170,15,1289
E01000994,395,68,326,415,19,1223
E01000995,324,51,473,367,32,1247
E01000996,263,62,295,382,9,1011
E01000997,334,45,354,320,33,1086
E01000998,362,90,286,455,34,1227
E01000999,237,43,494,289,19,1082
E01001000,258,40,327,337,30,992
E01001001,303,47,167,371,21,909
E01001002,271,60,293,405,6,1035
E01001003,400,58,221,423,32,1134
E01001004,491,92,347,549,40,1519
E01001005,285,27,599,268,31,1210
E01001006,452,61,278,265,18,1074
E01001007,388,35,717,280,48,1468
E01001008,492,54,354,246,34,1180
E01001009,310,57,576,356,29,1328
E01001010,575,57,223,229,13,1097
E01001011,401,89,566,332,52,1440
E01001012,428,91,535,390,47,1491
E01001013,575,101,353,419,93,1541
E01001014,925,145,479,428,41,2018
E01001015,915,37,63,83,3,1101
E01001016,1086,55,115,78,27,1361
E01001017,1181,27,81,34,6,1329
E01001018,1177,23,34,29,5,1268
E01001019,1105,33,63,47,8,1256
E01001020,1132,40,77,65,12,1326
E01001021,875,49,35,66,13,1038
E01001022,1074,28,69,40,5,1216
E01001023,765,55,149,91,15,1075
E01001024,919,37,97,66,5,1124
E01001025,879,23,79,39,6,1026
E01001026,1199,40,49,49,8,1345
E01001027,983,34,126,52,17,1212
E01001028,851,45,360,60,23,1339
E01001029,945,35,242,90,18,1330
E01001030,761,40,215,91,12,1119
E01001031,912,42,152,50,19,1175
E01001032,962,18,137,32,13,1162
E01001033,874,53,217,117,22,1283
E01001034,921,59,125,120,16,1241
E01001035,996,54,250,181,30,1511
E01001036,906,44,238,73,19,1280
E01001037,763,65,103,134,17,1082
E01001038,1062,74,201,168,30,1535
E01001039,945,31,163,64,7,1210
E01001040,1019,61,127,114,33,1354
E01001041,857,72,117,175,30,1251
E01001042,862,105,198,236,47,1448
E01001043,1136,113,440,347,57,2093
E01001044,980,43,418,122,29,1592
E01001045,973,59,343,181,19,1575
E01001046,653,29,656,50,39,1427
E01001047,956,65,207,171,33,1432
E01001048,628,94,456,295,53,1526
E01001049,632,29,433,86,20,1200
E01001050,772,37,419,106,28,1362
E01001051,758,59,29,234,15,1095
E01001052,641,54,28,230,8,961
E01001053,889,25,45,134,8,1101
E01001054,930,46,36,246,14,1272
E01001055,968,34,44,173,5,1224
E01001056,745,66,63,259,13,1146
E01001057,644,80,77,295,13,1109
E01001058,857,24,76,71,8,1036
E01001059,985,40,58,57,15,1155
E01001060,1035,40,69,91,6,1241
E01001061,948,44,79,117,16,1204
E01001062,970,44,196,110,12,1332
E01001063,979,41,149,97,7,1273
E01001064,976,26,250,64,9,1325
E01001065,1011,23,61,59,10,1164
E01001066,631,35,75,203,22,966
E01001067,970,37,205,64,21,1297
E01001068,1221,60,92,106,17,1496
E01001069,882,15,144,53,9,1103
E01001070,1025,52,131,138,15,1361
E01001071,1238,52,78,73,14,1455
E01001072,1046,20,113,24,16,1219
E01001073,911,49,154,70,8,1192
E01001074,1106,84,174,138,32,1534
E01001075,997,40,94,64,7,1202
E01001076,899,53,61,139,11,1163
E01001077,961,18,46,80,8,1113
E01001078,795,31,42,149,13,1030
E01001079,1008,29,27,169,6,1239
E01001080,905,50,46,202,22,1225
E01001081,860,35,46,109,8,1058
E01001082,969,28,28,151,10,1186
E01001083,562,48,419,239,22,1290
E01001084,813,54,386,204,30,1487
E01001085,465,57,396,325,33,1276
E01001086,532,96,373,398,29,1428
E01001087,665,85,583,422,56,1811
E01001088,452,56,319,413,37,1277
E01001089,591,88,380,328,33,1420
E01001090,703,101,445,453,39,1741
E01001091,543,47,407,261,25,1283
E01001092,1007,47,283,108,20,1465
E01001093,826,56,275,139,47,1343
E01001094,870,25,329,39,22,1285
E01001095,790,43,155,153,20,1161
E01001096,907,51,183,91,9,1241
E01001097,1250,96,253,143,43,1785
E01001098,920,44,141,57,10,1172
E01001099,860,56,123,80,20,1139
E01001100,903,25,127,104,14,1173
E01001101,973,20,105,38,9,1145
E01001102,1007,30,145,42,11,1235
E01001103,1147,34,114,39,13,1347
E01001104,1077,31,143,62,19,1332
E01001105,1145,39,57,73,6,1320
E01001106,988,33,84,51,12,1168
E01001107,1026,38,213,63,13,1353
E01001108,1147,35,132,48,16,1378
E01001109,720,92,261,435,33,1541
E01001110,539,88,277,437,23,1364
E01001111,451,88,177,483,24,1223
E01001112,548,104,104,515,33,1304
E01001113,556,112,140,522,27,1357
E01001114,379,55,157,390,27,1008
E01001115,418,53,364,369,53,1257
E01001116,389,69,194,347,22,1021
E01001117,633,127,713,602,53,2128
E01001118,550,93,312,455,33,1443
E01001119,1107,13,48,40,10,1218
E01001120,821,18,95,86,6,1026
E01001121,968,18,125,23,14,1148
E01001122,919,33,226,102,6,1286
E01001123,1027,26,128,74,13,1268
E01001124,1154,33,120,39,5,1351
E01001125,1029,26,216,79,15,1365
E01001126,1011,34,73,49,7,1174
E01001127,1061,26,134,92,12,1325
E01001128,656,36,128,282,23,1125
E01001129,981,25,106,68,12,1192
E01001130,482,55,146,400,20,1103
E01001131,1012,36,92,97,17,1254
E01001132,1030,28,140,76,20,1294
E01001133,1053,37,157,80,11,1338
E01001134,1020,56,174,80,19,1349
E01001135,1021,42,184,100,20,1367
E01001136,715,94,188,473,40,1510
E01001137,984,77,141,240,16,1458
E01001138,881,69,106,193,12,1261
E01001139,617,67,141,420,33,1278
E01001140,802,90,88,289,29,1298
E01001141,462,56,81,345,12,956
E01001142,617,45,99,417,3,1181
E01001143,680,85,124,572,23,1484
E01001144,568,106,134,481,20,1309
E01001145,506,104,166,471,18,1265
E01001146,408,83,153,591,12,1247
E01001147,428,73,194,436,21,1152
E01001148,482,62,145,519,22,1230
E01001149,510,53,94,472,23,1152
E01001150,572,70,118,459,21,1240
E01001151,493,91,174,427,24,1209
E01001152,399,72,225,511,20,1227
E01001153,383,73,187,568,32,1243
E01001154,518,68,220,569,37,1412
E01001155,362,71,258,552,45,1288
E01001156,789,72,143,320,21,1345
E01001157,600,46,324,357,26,1353
E01001158,670,82,96,330,13,1191
E01001159,793,79,240,306,31,1449
E01001160,523,62,566,337,50,1538
E01001161,515,84,315,448,33,1395
E01001162,771,85,112,313,39,1320
E01001163,901,92,151,347,40,1531
E01001164,1103,89,152,214,26,1584
E01001165,772,66,181,251,34,1304
E01001166,863,80,173,244,42,1402
E01001167,937,94,327,296,46,1700
E01001168,871,78,204,217,31,1401
E01001169,754,54,197,221,14,1240
E01001170,1074,87,236,233,51,1681
E01001171,754,53,248,234,19,1308
E01001172,773,58,165,225,35,1256
E01001173,1165,100,329,330,57,1981
E01001174,261,45,545,345,30,1226
E01001175,302,69,371,409,25,1176
E01001176,266,67,623,390,34,1380
E01001177,340,61,455,318,21,1195
E01001178,304,54,265,328,40,991
E01001179,339,39,484,268,21,1151
E01001180,358,64,471,315,40,1248
E01001181,432,76,397,406,43,1354
E01001182,304,37,428,304,19,1092
E01001183,212,68,533,384,32,1229
E01001184,251,42,380,374,19,1066
E01001185,800,85,122,259,26,1292
E01001186,656,96,130,459,31,1372
E01001187,796,103,198,364,27,1488
E01001188,618,80,150,501,16,1365
E01001189,484,56,119,263,13,935
E01001190,529,80,97,441,20,1167
E01001191,555,88,137,543,56,1379
E01001192,593,80,81,455,7,1216
E01001193,532,117,178,408,15,1250
E01001194,652,63,85,377,19,1196
E01001195,778,36,343,106,206,1469
E01001196,761,80,195,254,117,1407
E01001197,840,46,286,98,84,1354
E01001198,859,54,103,117,51,1184
E01001199,880,55,161,164,95,1355
E01001200,873,43,157,96,76,1245
E01001201,951,60,140,83,41,1275
E01001202,948,62,271,209,143,1633
E01001203,977,61,163,150,121,1472
E01001204,897,46,201,65,77,1286
E01001205,686,49,197,186,80,1198
E01001206,450,62,209,350,93,1164
E01001207,977,39,164,81,58,1319
E01001208,803,26,115,35,48,1027
E01001209,1086,21,123,28,55,1313
E01001210,612,61,293,217,115,1298
E01001211,1044,34,183,41,75,1377
E01001212,1036,39,203,49,89,1416
E01001213,147,27,1131,108,69,1482
E01001214,127,10,1137,67,102,1443
E01001215,152,31,1053,105,63,1404
E01001216,174,19,896,105,59,1253
E01001217,360,21,668,125,43,1217
E01001218,521,40,550,263,82,1456
E01001219,338,52,590,416,83,1479
E01001220,254,37,416,296,58,1061
E01001221,1212,86,304,45,69,1716
E01001222,1297,86,360,136,126,2005
E01001223,996,28,215,38,37,1314
E01001224,1063,33,123,22,39,1280
E01001225,1066,42,262,68,82,1520
E01001226,927,44,214,66,60,1311
E01001227,905,33,207,35,51,1231
E01001228,1153,59,259,74,66,1611
E01001229,853,59,127,119,57,1215
E01001230,974,47,132,99,34,1286
E01001231,1031,35,344,41,126,1577
E01001232,873,49,199,89,51,1261
E01001233,867,38,186,81,38,1210
E01001234,822,56,216,73,49,1216
E01001235,1002,40,239,64,56,1401
E01001236,956,46,207,102,34,1345
E01001237,1100,34,164,39,37,1374
E01001238,1145,131,528,342,279,2425
E01001239,586,72,190,303,85,1236
E01001240,708,57,244,177,127,1313
E01001241,688,59,199,95,194,1235
E01001242,642,38,146,116,183,1125
E01001243,692,40,209,191,163,1295
E01001244,992,78,464,346,170,2050
E01001245,1080,59,241,139,65,1584
E01001246,597,45,114,230,69,1055
E01001247,1024,90,365,166,142,1787
E01001248,869,48,220,106,60,1303
E01001249,1020,79,368,275,124,1866
E01001250,1074,63,246,218,91,1692
E01001251,988,32,179,98,37,1334
E01001252,1017,58,265,136,63,1539
E01001253,990,46,154,93,34,1317
E01001254,1086,52,104,78,30,1350
E01001255,896,45,202,112,19,1274
E01001257,587,70,292,242,60,1251
E01001258,668,33,432,146,72,1351
E01001259,540,24,452,93,54,1163
E01001260,716,29,556,105,125,1531
E01001261,841,44,581,201,99,1766
E01001262,625,40,294,216,59,1234
E01001263,604,51,355,212,59,1281
E01001264,686,41,302,148,76,1253
E01001265,731,45,346,136,56,1314
E01001266,765,39,454,117,130,1505
E01001267,799,46,373,228,79,1525
E01001268,860,32,286,84,94,1356
E01001269,796,42,455,170,79,1542
E01001270,734,38,353,175,69,1369
E01001271,717,24,437,183,57,1418
E01001272,660,40,401,131,80,1312
E01001273,728,39,423,33,106,1329
E01001274,539,37,469,40,124,1209
E01001275,1138,43,249,112,73,1615
E01001276,812,31,296,105,191,1435
E01001277,842,66,416,58,155,1537
E01001278,827,35,451,77,207,1597
E01001279,883,21,181,22,89,1196
E01001280,908,40,287,53,148,1436
E01001281,1017,29,138,28,43,1255
E01001282,751,48,202,141,66,1208
E01001283,771,42,213,134,102,1262
E01001284,879,33,207,90,46,1255
E01001285,827,66,181,156,61,1291
E01001286,839,45,191,129,52,1256
E01001287,488,44,197,258,69,1056
E01001288,825,48,138,93,44,1148
E01001289,732,32,141,103,30,1038
E01001290,1126,40,188,94,51,1499
E01001291,365,25,676,130,86,1282
E01001292,412,52,675,147,92,1378
E01001293,209,15,823,133,83,1263
E01001294,169,22,1163,72,100,1526
E01001295,188,23,1074,93,73,1451
E01001296,192,18,794,87,87,1178
E01001297,164,16,1107,68,82,1437
E01001298,271,31,1068,121,84,1575
E01001299,1111,44,216,65,28,1464
E01001300,1026,37,162,50,27,1302
E01001301,1138,53,254,87,37,1569
E01001302,993,39,174,69,16,1291
E01001303,1072,35,131,37,36,1311
E01001304,1043,37,157,64,37,1338
E01001305,1053,17,204,59,42,1375
E01001306,1079,35,148,34,26,1322
E01001307,759,37,485,155,67,1503
E01001308,668,38,783,125,85,1699
E01001309,674,38,501,174,52,1439
E01001310,658,44,429,231,51,1413
E01001311,876,37,384,200,59,1556
E01001312,615,21,650,112,72,1470
E01001313,517,18,646,148,55,1384
E01001314,638,27,428,119,52,1264
E01001315,484,43,391,183,24,1125
E01001316,521,25,350,226,52,1174
E01001317,736,46,370,189,64,1405
E01001318,715,42,328,177,72,1334
E01001319,626,23,321,135,61,1166
E01001320,567,26,182,219,66,1060
E01001321,884,54,359,212,75,1584
E01001322,766,35,393,129,32,1355
E01001323,706,29,458,160,58,1411
E01001324,577,41,330,183,62,1193
E01001325,766,50,265,203,38,1322
E01001326,662,52,283,225,55,1277
E01001327,712,58,352,168,104,1394
E01001328,577,51,297,246,94,1265
E01001329,681,48,326,171,87,1313
E01001330,566,41,315,218,63,1203
E01001331,496,49,257,277,76,1155
E01001332,486,42,298,254,55,1135
E01001333,178,22,1061,171,65,1497
E01001334,150,38,702,237,83,1210
E01001335,370,34,960,46,91,1501
E01001336,351,20,731,62,114,1278
E01001337,472,46,395,208,58,1179
E01001338,232,14,1048,155,126,1575
E01001339,302,40,683,252,69,1346
E01001340,650,82,337,408,75,1552
E01001341,472,26,608,128,123,1357
E01001342,568,29,648,86,139,1470
E01001343,547,52,453,80,87,1219
E01001344,913,56,442,152,162,1725
E01001345,449,50,643,104,60,1306
E01001346,881,38,296,92,176,1483
E01001347,706,33,303,124,99,1265
E01001348,744,37,276,86,146,1289
E01001349,559,22,267,188,102,1138
E01001350,880,37,183,47,76,1223
E01001351,1060,73,284,175,77,1669
E01001352,877,39,191,51,83,1241
E01001353,890,52,170,169,78,1359
E01001354,1139,43,240,75,62,1559
E01001355,979,56,175,142,63,1415
E01001356,585,67,234,412,126,1424
E01001357,417,23,132,204,49,825
E01001358,413,42,230,328,103,1116
E01001359,56,25,1440,83,90,1694
E01001360,58,16,1368,49,70,1561
E01001361,110,10,1092,114,67,1393
E01001362,136,13,1299,75,60,1583
E01001363,77,13,1043,93,49,1275
E01001364,157,26,967,150,41,1341
E01001365,99,27,1502,77,40,1745
E01001366,121,23,1093,141,102,1480
E01001367,136,23,1017,131,83,1390
E01001368,105,21,1004,116,82,1328
E01001369,151,28,1088,118,91,1476
E01001370,176,23,1193,100,85,1577
E01001371,161,33,1089,184,79,1546
E01001372,119,14,992,164,86,1375
E01001373,94,21,862,130,45,1152
E01001374,1159,43,129,111,38,1480
E01001375,1194,19,100,16,14,1343
E01001376,933,41,174,132,54,1334
E01001377,1197,38,91,47,33,1406
E01001379,1185,39,90,21,17,1352
E01001380,1205,41,140,70,18,1474
E01001381,1039,51,125,103,94,1412
E01001382,951,27,141,47,36,1202
E01001383,1005,42,290,105,50,1492
E01001384,1021,56,207,60,37,1381
E01001385,1069,49,182,39,27,1366
E01001386,1197,37,126,55,22,1437
E01001387,1025,31,160,50,47,1313
E01001388,876,41,183,157,58,1315
E01001389,981,30,282,80,57,1430
E01001390,1104,81,331,98,56,1670
E01001391,905,52,141,181,63,1342
E01001392,1015,53,316,84,54,1522
E01001393,1128,96,325,170,68,1787
E01001394,793,45,232,161,132,1363
E01001395,697,54,176,169,103,1199
E01001396,822,36,166,90,85,1199
E01001397,859,55,353,162,117,1546
E01001398,938,26,70,76,19,1129
E01001399,879,28,125,99,47,1178
E01001400,1033,35,116,72,29,1285
E01001401,788,35,98,83,34,1038
E01001402,1150,41,205,64,72,1532
E01001403,919,43,145,141,50,1298
E01001404,754,38,178,146,53,1169
E01001405,1240,45,77,71,61,1494
E01001406,956,50,77,151,57,1291
E01001407,1040,41,62,95,34,1272
E01001408,1133,33,58,67,18,1309
E01001409,922,62,174,224,51,1433
E01001410,858,52,88,234,63,1295
E01001411,1193,49,91,47,22,1402
E01001412,1236,30,67,86,42,1461
E01001413,1237,21,31,32,11,1332
E01001414,872,59,100,120,53,1204
E01001415,1052,24,152,59,51,1338
E01001416,1057,36,247,42,42,1424
E01001417,1297,40,188,69,38,1632
E01001418,1036,32,162,75,74,1379
E01001419,1229,56,277,65,53,1680
E01001420,937,49,161,67,42,1256
E01001421,978,57,207,90,47,1379
E01001422,1022,32,178,56,37,1325
E01001423,625,59,224,321,100,1329
E01001424,355,34,110,314,58,871
E01001425,537,61,180,436,88,1302
E01001426,604,59,189,401,91,1344
E01001427,483,57,139,506,94,1279
E01001428,600,59,190,309,86,1244
E01001429,705,112,203,672,90,1782
E01001430,457,73,148,496,72,1246
E01001431,511,70,123,330,87,1121
E01001432,521,83,189,532,85,1410
E01001433,889,55,81,224,43,1292
E01001434,782,43,81,173,104,1183
E01001435,699,45,105,211,52,1112
E01001436,908,61,107,259,70,1405
E01001437,962,83,174,419,105,1743
E01001438,740,64,84,298,59,1245
E01001439,866,65,133,290,80,1434
E01001440,730,69,122,247,95,1263
E01001441,711,41,56,266,68,1142
E01001442,715,54,74,254,45,1142
E01001444,888,69,69,247,48,1321
E01001445,954,91,138,402,96,1681
E01001446,950,41,69,244,70,1374
E01001447,942,45,116,292,79,1474
E01001448,750,56,95,368,85,1354
E01001449,740,35,67,261,58,1161
E01001450,1241,43,93,137,61,1575
E01001451,1164,26,80,58,21,1349
E01001452,875,24,118,35,41,1093
E01001453,1125,28,131,55,37,1376
E01001454,1106,24,107,45,36,1318
E01001455,992,31,93,102,35,1253
E01001456,925,18,77,42,20,1082
E01001457,1213,27,102,53,30,1425
E01001458,575,84,135,410,83,1287
E01001459,660,53,166,295,106,1280
E01001460,498,75,159,414,76,1222
E01001461,587,52,158,396,80,1273
E01001462,403,63,143,328,84,1021
E01001463,642,42,212,241,81,1218
E01001464,605,42,122,184,51,1004
E01001465,642,41,187,215,101,1186
E01001466,634,54,183,298,102,1271
E01001467,625,65,227,355,95,1367
E01001468,829,46,120,101,31,1127
E01001469,1046,38,112,72,37,1305
E01001470,1121,33,84,33,38,1309
E01001471,1240,38,137,62,44,1521
E01001472,1208,42,84,54,24,1412
E01001473,960,36,105,74,41,1216
E01001474,1299,44,114,56,24,1537
E01001475,1054,22,218,31,55,1380
E01001476,701,55,141,284,90,1271
E01001477,703,51,150,332,94,1330
E01001478,738,58,134,205,54,1189
E01001479,621,47,149,382,112,1311
E01001480,682,56,153,240,89,1220
E01001481,651,33,192,339,69,1284
E01001482,587,55,181,450,101,1374
E01001483,398,58,89,263,100,908
E01001484,691,35,112,161,53,1052
E01001485,604,72,169,383,91,1319
E01001486,689,89,169,472,101,1520
E01001487,589,64,195,469,82,1399
E01001488,609,70,173,460,52,1364
E01001489,666,45,186,340,93,1330
E01001491,578,59,188,502,125,1452
E01001492,640,75,201,431,102,1449
E01001493,1010,38,157,143,79,1427
E01001494,748,52,203,134,88,1225
E01001495,1124,59,115,102,42,1442
E01001496,900,52,188,140,98,1378
E01001497,762,30,157,134,65,1148
E01001498,1071,71,217,121,122,1602
E01001499,784,41,275,145,103,1348
E01001500,813,51,164,83,106,1217
E01001501,996,61,199,183,79,1518
E01001502,731,65,204,360,93,1453
E01001503,775,40,218,280,73,1386
E01001504,660,42,147,228,85,1162
E01001505,642,49,274,254,81,1300
E01001506,504,40,179,362,65,1150
E01001507,669,43,211,396,97,1416
E01001508,658,62,239,409,93,1461
E01001509,586,61,235,325,91,1298
E01001510,435,66,144,268,68,981
E01001511,915,57,169,121,42,1304
E01001512,1093,56,96,103,42,1390
E01001513,914,50,145,163,33,1305
E01001514,991,63,94,170,55,1373
E01001515,786,75,130,314,93,1398
E01001516,884,59,139,227,60,1369
E01001517,798,49,102,268,115,1332
E01001518,1030,46,136,139,60,1411
E01001519,1351,81,427,117,110,2086
E01001520,966,48,222,68,57,1361
E01001521,1063,54,240,41,57,1455
E01001522,984,58,182,94,69,1387
E01001523,1125,31,156,53,54,1419
E01001524,747,42,238,121,70,1218
E01001525,1114,38,185,85,62,1484
E01001526,1027,27,171,51,45,1321
E01001527,938,63,179,90,46,1316
E01001528,624,76,216,171,42,1129
E01001529,796,49,224,148,53,1270
E01001530,634,43,280,58,43,1058
E01001531,963,54,108,38,52,1215
E01001532,1132,63,146,58,46,1445
E01001533,985,20,178,40,62,1285
E01001534,866,22,308,91,61,1348
E01001535,849,37,250,49,39,1224
E01001536,1254,44,54,56,17,1425
E01001537,1137,46,55,111,20,1369
E01001538,1142,27,50,65,23,1307
E01001539,1131,35,59,78,27,1330
E01001540,1206,40,109,70,18,1443
E01001541,1029,32,42,40,34,1177
E01001542,964,46,80,110,25,1225
E01001543,1066,46,89,74,32,1307
E01001544,1109,21,87,58,41,1316
E01001545,852,55,105,240,60,1312
E01001546,943,54,57,243,51,1348
E01001547,894,37,112,248,69,1360
E01001548,854,56,83,283,62,1338
E01001549,776,63,107,328,100,1374
E01001550,832,64,96,163,45,1200
E01001551,953,62,60,218,51,1344
E01001552,1019,46,78,245,45,1433
E01001553,594,58,144,262,88,1146
E01001554,571,90,129,418,115,1323
E01001555,506,88,232,434,83,1343
E01001556,770,37,188,178,86,1259
E01001557,500,41,163,376,66,1146
E01001558,405,72,172,340,123,1112
E01001559,672,73,157,552,89,1543
E01001560,642,42,230,206,122,1242
E01001562,478,62,169,441,144,1294
E01001563,987,62,116,88,76,1329
E01001564,1094,42,90,50,50,1326
E01001565,965,55,166,80,86,1352
E01001566,1145,54,119,61,52,1431
E01001567,1085,35,96,42,18,1276
E01001568,1020,18,141,50,70,1299
E01001569,1164,57,100,73,66,1460
E01001570,1070,54,139,129,69,1461
E01001571,727,43,187,272,27,1256
E01001572,829,33,106,296,17,1281
E01001573,659,49,205,221,22,1156
E01001574,781,55,101,309,23,1269
E01001575,661,36,77,401,13,1188
E01001576,729,43,58,378,25,1233
E01001577,739,42,90,421,28,1320
E01001578,859,47,141,486,36,1569
E01001579,744,26,104,329,12,1215
E01001580,1224,38,98,52,15,1427
E01001581,1198,36,105,91,26,1456
E01001582,933,29,95,94,26,1177
E01001583,1217,32,61,60,6,1376
E01001584,1167,31,58,40,8,1304
E01001585,1034,30,80,47,19,1210
E01001586,1005,45,63,112,16,1241
E01001587,1346,46,89,83,24,1588
E01001588,951,46,194,153,16,1360
E01001589,883,45,205,144,27,1304
E01001590,956,67,271,123,28,1445
E01001591,932,57,204,316,28,1537
E01001592,1054,45,163,111,15,1388
E01001593,1170,32,69,65,13,1349
E01001594,771,67,196,350,24,1408
E01001595,827,49,262,288,30,1456
E01001596,1092,21,100,45,32,1290
E01001597,998,43,110,93,36,1280
E01001598,1075,18,100,112,40,1345
E01001599,1139,24,84,86,28,1361
E01001600,1080,23,86,83,20,1292
E01001601,1139,15,68,59,17,1298
E01001602,1262,29,43,94,27,1455
E01001603,1115,31,40,110,14,1310
E01001604,1018,28,92,19,13,1170
E01001605,1166,16,62,37,7,1288
E01001606,1171,24,63,23,12,1293
E01001607,1084,20,56,26,7,1193
E01001608,1109,19,34,21,3,1186
E01001609,1159,29,64,68,10,1330
E01001610,1195,27,86,49,9,1366
E01001611,1227,30,48,45,13,1363
E01001613,1146,26,76,68,21,1337
E01001614,1112,10,71,20,13,1226
E01001615,1034,39,109,88,24,1294
E01001617,1196,25,79,41,14,1355
E01001618,1112,20,60,43,17,1252
E01001619,1301,33,108,69,7,1518
E01001620,941,22,119,119,17,1218
E01001621,1031,35,60,67,13,1206
E01001623,1023,35,112,129,29,1328
E01001624,1102,20,53,69,10,1254
E01001625,1055,21,61,105,17,1259
E01001629,856,68,225,472,16,1637
E01001631,621,62,290,489,42,1504
E01001632,523,67,818,405,29,1842
E01001633,634,52,170,325,26,1207
E01001634,723,39,122,344,25,1253
E01001635,735,46,240,232,63,1316
E01001636,582,47,437,266,64,1396
E01001637,709,60,304,271,30,1374
E01001638,879,66,173,367,28,1513
E01001640,1077,100,256,369,51,1853
E01001641,1129,52,113,145,28,1467
E01001642,1280,35,48,72,5,1440
E01001644,1437,61,181,169,30,1878
E01001645,961,38,118,208,38,1363
E01001646,1388,121,255,393,25,2182
E01001647,795,42,205,139,25,1206
E01001648,1007,63,177,143,25,1415
E01001649,941,22,73,141,25,1202
E01001650,955,20,220,146,26,1367
E01001651,884,56,160,221,28,1349
E01001652,1000,37,154,101,18,1310
E01001653,973,38,55,83,7,1156
E01001654,888,31,43,143,33,1138
E01001655,931,33,35,112,9,1120
E01001656,894,22,42,73,11,1042
E01001657,1010,24,78,91,19,1222
E01001658,979,26,105,123,22,1255
E01001659,781,45,191,145,38,1200
E01001660,863,39,119,156,36,1213
E01001661,957,25,85,88,42,1197
E01001662,1187,60,65,46,17,1375
E01001664,1291,53,166,68,20,1598
E01001665,1199,58,156,107,34,1554
E01001666,649,35,331,167,33,1215
E01001667,839,53,187,179,17,1275
E01001668,1425,38,109,194,31,1797
E01001669,858,48,132,349,27,1414
E01001671,876,43,101,178,13,1211
E01001672,516,39,621,347,25,1548
E01001673,523,37,613,303,43,1519
E01001674,614,44,473,322,36,1489
E01001675,485,36,705,313,33,1572
E01001676,616,44,226,376,24,1286
E01001677,653,73,385,347,26,1484
E01001678,920,45,151,205,12,1333
E01001679,746,39,73,171,16,1045
E01001680,1017,32,119,85,28,1281
E01001681,679,43,99,135,6,962
E01001682,821,35,60,125,26,1067
E01001683,732,44,193,177,50,1196
E01001684,776,28,121,196,18,1139
E01001685,850,24,150,168,41,1233
E01001686,884,64,130,294,18,1390
E01001687,482,33,122,259,23,919
E01001688,823,57,152,752,30,1814
E01001690,804,51,42,506,36,1439
E01001692,560,30,45,352,10,997
E01001693,507,37,70,471,10,1095
E01001694,625,48,45,505,20,1243
E01001695,561,61,326,317,20,1285
E01001696,361,49,172,375,28,985
E01001697,649,59,387,421,28,1544
E01001698,558,70,146,484,16,1274
E01001699,885,53,107,361,46,1452
E01001700,596,60,437,347,43,1483
E01001701,695,36,78,220,25,1054
E01001702,415,37,214,397,32,1095
E01001703,397,50,227,623,24,1321
E01001704,745,49,236,234,33,1297
E01001705,689,66,166,469,20,1410
E01001706,504,50,209,253,11,1027
E01001708,937,43,106,140,14,1240
E01001709,520,42,128,210,16,916
E01001710,540,45,177,400,31,1193
E01001711,599,43,205,265,22,1134
E01001712,867,59,201,426,35,1588
E01001713,547,57,154,418,13,1189
E01001714,640,63,140,283,79,1205
E01001715,869,71,88,128,50,1206
E01001716,689,53,138,192,50,1122
E01001717,596,30,146,118,61,951
E01001718,1245,85,165,82,50,1627
E01001719,524,62,85,218,70,959
E01001720,1198,90,108,111,45,1552
E01001722,724,98,162,462,81,1527
E01001723,918,69,292,160,88,1527
E01001724,1246,86,275,179,66,1852
E01001725,717,42,145,210,97,1211
E01001726,388,45,148,293,82,956
E01001727,767,45,203,187,79,1281
E01001728,700,35,134,272,97,1238
E01001729,576,111,166,611,48,1512
E01001730,566,98,161,486,102,1413
E01001731,974,118,186,487,64,1829
E01001732,486,75,128,516,61,1266
E01001733,879,87,159,300,40,1465
E01001734,887,101,132,376,46,1542
E01001735,778,74,83,325,40,1300
E01001736,915,81,80,222,50,1348
E01001737,1090,85,127,159,52,1513
E01001738,1082,70,61,166,75,1454
E01001739,1330,77,84,222,35,1748
E01001740,543,65,131,361,103,1203
E01001741,890,42,98,100,54,1184
E01001742,881,89,142,301,64,1477
E01001744,941,52,99,392,81,1565
E01001745,876,93,154,564,80,1767
E01001746,413,68,129,448,90,1148
E01001747,1196,101,150,316,112,1875
E01001748,1296,108,196,345,68,2013
E01001749,1061,47,84,210,46,1448
E01001750,985,76,165,256,83,1565
E01001751,1158,77,57,61,19,1372
E01001752,1278,97,195,369,48,1987
E01001753,489,78,103,467,89,1226
E01001754,1228,110,198,365,69,1970
E01001755,739,89,132,354,79,1393
E01001756,1483,117,121,170,42,1933
E01001757,329,86,245,584,53,1297
E01001758,717,90,192,499,116,1614
E01001759,807,99,103,412,79,1500
E01001760,806,108,137,359,75,1485
E01001761,831,96,160,398,46,1531
E01001762,1041,93,109,250,56,1549
E01001763,800,62,110,353,39,1364
E01001764,752,73,178,305,64,1372
E01001765,451,94,172,501,64,1282
E01001767,719,79,191,265,36,1290
E01001768,925,61,200,281,66,1533
E01001769,754,86,141,301,57,1339
E01001770,612,96,180,437,69,1394
E01001772,328,52,107,295,38,820
E01001773,879,96,225,398,83,1681
E01001774,1074,69,176,297,70,1686
E01001775,662,73,212,352,104,1403
E01001776,614,57,120,345,78,1214
E01001777,1165,103,193,392,78,1931
E01001779,1112,118,237,377,118,1962
E01001780,867,129,139,319,80,1534
E01001781,777,74,145,304,65,1365
E01001782,1345,116,196,220,95,1972
E01001783,686,76,175,472,114,1523
E01001784,1086,88,306,369,94,1943
E01001785,655,65,126,308,49,1203
E01001786,392,60,96,698,60,1306
E01001787,485,54,83,458,70,1150
E01001788,438,72,125,457,58,1150
E01001789,767,64,145,365,38,1379
E01001790,265,55,99,460,60,939
E01001791,473,100,136,376,50,1135
E01001792,712,49,327,298,45,1431
E01001793,754,56,194,344,40,1388
E01001794,913,71,320,258,34,1596
E01001795,722,60,177,222,31,1212
E01001796,725,101,179,312,62,1379
E01001798,515,103,230,395,86,1329
E01001799,752,36,59,95,67,1009
E01001800,623,39,67,257,103,1089
E01001801,808,49,74,157,68,1156
E01001802,612,35,84,136,85,952
E01001803,1090,83,68,96,64,1401
E01001804,735,47,74,98,60,1014
E01001805,743,45,88,107,36,1019
E01001806,837,73,69,239,51,1269
E01001807,801,70,94,286,79,1330
E01001808,906,30,50,66,109,1161
E01001809,867,45,77,151,146,1286
E01001811,544,58,153,342,88,1185
E01001812,777,67,59,185,100,1188
E01001813,442,58,147,262,78,987
E01001814,726,57,110,166,106,1165
E01001815,669,81,192,437,32,1411
E01001816,847,72,64,290,31,1304
E01001819,920,73,97,211,35,1336
E01001820,595,59,104,383,47,1188
E01001821,578,82,83,353,72,1168
E01001822,533,76,169,391,118,1287
E01001823,653,58,78,205,126,1120
E01001824,559,68,67,226,79,999
E01001825,728,20,26,66,93,933
E01001826,693,54,67,211,119,1144
E01001827,662,68,113,376,80,1299
E01001828,572,92,147,580,97,1488
E01001829,1104,55,114,126,29,1428
E01001830,897,121,119,421,91,1649
E01001831,960,78,155,220,48,1461
E01001832,818,71,254,201,44,1388
E01001833,1003,105,194,387,63,1752
E01001834,1090,101,148,306,75,1720
E01001835,684,40,139,159,39,1061
E01001836,993,57,71,289,56,1466
E01001837,1007,48,94,91,9,1249
E01001838,466,61,165,480,83,1255
E01001839,1243,122,162,296,70,1893
E01001840,651,48,155,399,38,1291
E01001841,856,54,56,168,21,1155
E01001842,566,89,129,380,47,1211
E01001843,570,57,91,225,37,980
E01001844,1147,72,136,240,47,1642
E01001845,621,64,87,388,56,1216
E01001846,471,42,91,337,29,970
E01001847,484,52,92,237,25,890
E01001848,805,53,57,355,32,1302
E01001849,1003,99,177,464,103,1846
E01001850,436,70,132,558,53,1249
E01001851,1093,49,56,81,26,1305
E01001852,1222,72,151,104,92,1641
E01001853,1020,50,95,74,39,1278
E01001854,1121,74,147,131,53,1526
E01001855,1194,47,115,77,53,1486
E01001856,891,56,124,189,92,1352
E01001857,709,67,113,264,100,1253
E01001858,1030,92,185,168,72,1547
E01001859,1297,81,186,325,109,1998
E01001860,848,83,194,256,84,1465
E01001861,724,63,117,258,69,1231
E01001862,917,90,110,255,106,1478
E01001863,960,34,80,141,42,1257
E01001864,956,53,97,163,66,1335
E01001865,1016,70,152,101,72,1411
E01001866,917,48,184,72,176,1397
E01001867,723,59,263,60,138,1243
E01001868,642,59,134,183,79,1097
E01001869,884,28,81,41,42,1076
E01001870,1115,63,360,106,126,1770
E01001871,911,69,199,61,221,1461
E01001872,990,87,204,80,92,1453
E01001873,874,64,111,96,65,1210
E01001874,1087,101,223,275,97,1783
E01001875,840,55,174,248,100,1417
E01001876,805,101,332,350,171,1759
E01001877,549,54,155,263,71,1092
E01001878,739,80,118,233,86,1256
E01001879,956,61,88,132,44,1281
E01001880,1006,39,121,82,57,1305
E01001881,1155,39,114,63,38,1409
E01001882,1231,49,149,73,58,1560
E01001883,969,58,158,90,62,1337
E01001884,1136,59,184,149,81,1609
E01001885,493,57,110,243,107,1010
E01001886,900,59,131,170,47,1307
E01001887,940,49,151,130,59,1329
E01001888,1130,48,135,49,40,1402
E01001889,954,27,134,82,35,1232
E01001890,960,53,379,148,83,1623
E01001891,1353,54,275,85,90,1857
E01001892,778,56,72,166,59,1131
E01001893,657,58,89,141,58,1003
E01001894,784,44,99,177,36,1140
E01001895,941,74,99,141,61,1316
E01001896,868,77,161,175,73,1354
E01001897,894,37,79,88,41,1139
E01001898,949,63,165,117,87,1381
E01001899,762,80,90,155,81,1168
E01001900,1036,54,146,190,93,1519
E01001901,1107,53,72,47,38,1317
E01001902,1234,46,102,96,48,1526
E01001903,963,50,115,144,102,1374
E01001904,1155,28,86,59,26,1354
E01001905,1238,43,89,53,20,1443
E01001906,1074,44,90,43,29,1280
E01001907,895,24,77,32,24,1052
E01001908,1076,62,212,84,72,1506
E01001909,1183,64,136,130,62,1575
E01001910,997,58,176,93,71,1395
E01001911,748,71,161,270,125,1375
E01001912,640,52,194,242,132,1260
E01001913,1232,51,97,22,40,1442
E01001914,1080,69,211,115,104,1579
E01001915,1009,23,61,29,33,1155
E01001916,1110,22,44,9,25,1210
E01001917,1054,33,75,51,44,1257
E01001918,1012,39,82,63,41,1237
E01001919,1066,40,51,35,60,1252
E01001920,1006,58,94,113,71,1342
E01001921,1085,36,71,67,29,1288
E01001922,1102,30,64,42,57,1295
E01001923,995,43,90,69,56,1253
E01001924,1084,37,68,16,43,1248
E01001925,1062,27,83,34,31,1237
E01001926,1059,37,74,16,13,1199
E01001927,989,65,97,23,17,1191
E01001928,971,70,91,171,58,1361
E01001929,887,37,44,36,25,1029
E01001930,1153,59,132,145,92,1581
E01001931,787,46,141,110,109,1193
E01001932,1024,28,126,105,121,1404
E01001933,845,44,92,92,52,1125
E01001934,932,61,119,139,63,1314
E01001935,1426,55,101,133,55,1770
E01001937,1264,50,101,69,41,1525
E01001938,857,55,80,159,44,1195
E01001939,1386,92,227,178,69,1952
E01001940,814,89,124,239,86,1352
E01001941,1026,70,203,142,73,1514
E01001942,1071,69,205,200,77,1622
E01001943,1098,83,221,204,108,1714
E01001944,564,83,116,490,92,1345
E01001945,1046,61,124,155,74,1460
E01001946,934,64,117,198,54,1367
E01001947,619,65,95,251,73,1103
E01001948,1371,48,88,87,60,1654
E01001949,1148,35,49,29,23,1284
E01001950,1115,37,59,31,29,1271
E01001951,1102,51,90,85,46,1374
E01001952,1196,48,112,64,55,1475
E01001953,889,46,95,89,56,1175
E01001954,805,57,116,198,54,1230
E01001955,727,79,121,337,105,1369
E01001956,877,60,124,148,72,1281
E01001957,470,62,165,433,90,1220
E01001958,424,57,147,469,112,1209
E01001959,742,79,149,224,148,1342
E01001960,1129,71,151,164,85,1600
E01001961,416,60,135,401,92,1104
E01001962,972,55,112,127,35,1301
E01001963,1163,42,74,66,31,1376
E01001964,1002,64,113,92,30,1301
E01001965,1066,42,53,67,28,1256
E01001966,1002,44,71,52,26,1195
E01001967,1115,50,63,43,41,1312
E01001968,1227,61,88,68,61,1505
E01001969,1042,69,185,210,69,1575
E01001970,818,64,221,376,67,1546
E01001971,835,99,171,367,81,1553
E01001972,895,61,119,228,58,1361
E01001973,1232,80,212,213,71,1808
E01001974,1264,73,259,180,95,1871
E01001975,986,59,151,175,77,1448
E01001976,578,49,120,443,49,1239
E01001977,548,71,136,375,57,1187
E01001978,618,97,168,520,88,1491
E01001979,714,53,220,501,172,1660
E01001980,743,77,196,436,74,1526
E01001981,637,83,165,424,90,1399
E01001982,718,59,134,460,52,1423
E01001983,730,63,153,302,57,1305
E01001984,1105,58,93,73,43,1372
E01001985,1224,38,66,43,11,1382
E01001986,1128,56,43,71,47,1345
E01001987,1325,48,94,39,37,1543
E01001988,1260,57,76,55,34,1482
E01001989,1157,52,81,89,34,1413
E01001990,1549,65,131,59,88,1892
E01001991,1151,52,76,48,25,1352
E01001992,1170,29,104,20,29,1352
E01001993,1118,28,56,12,19,1233
E01001994,1160,61,175,63,42,1501
E01001995,1260,98,148,190,66,1762
E01001996,1121,36,63,46,24,1290
E01001997,1124,61,77,39,40,1341
E01001998,1256,72,258,149,69,1804
E01001999,1175,87,186,182,94,1724
E01002000,1034,66,118,153,46,1417
E01002001,1076,63,125,118,83,1465
E01002002,1080,82,154,179,64,1559
E01002003,1046,83,225,263,111,1728
E01002004,1076,78,234,165,62,1615
E01002005,1225,69,102,44,34,1474
E01002006,1170,44,88,58,45,1405
E01002007,1244,38,75,53,16,1426
E01002008,1049,31,103,38,43,1264
E01002009,1262,47,91,33,35,1468
E01002010,1082,51,79,99,47,1358
E01002011,1137,46,118,103,46,1450
E01002013,943,39,72,64,6,1124
E01002014,1111,65,109,116,45,1446
E01002015,850,66,109,181,30,1236
E01002016,1161,78,110,193,59,1601
E01002017,1079,67,91,200,83,1520
E01002018,845,39,73,120,29,1106
E01002019,951,40,50,24,19,1084
E01002020,1040,54,53,113,33,1293
E01002021,1044,37,50,60,18,1209
E01002022,1473,46,75,57,44,1695
E01002023,1032,29,52,51,19,1183
E01002024,876,29,59,62,25,1051
E01002025,1162,37,68,38,36,1341
E01002026,613,74,144,357,71,1259
E01002027,787,53,196,207,25,1268
E01002028,914,72,189,224,64,1463
E01002029,791,71,185,293,75,1415
E01002030,819,62,186,201,91,1359
E01002031,1030,63,260,206,82,1641
E01002032,825,71,186,254,80,1416
E01002033,848,57,228,245,78,1456
E01002034,520,89,121,550,68,1348
E01002036,476,64,97,494,64,1195
E01002037,573,77,140,508,90,1388
E01002038,621,69,80,380,65,1215
E01002039,490,50,86,445,54,1125
E01002040,626,80,125,615,60,1506
E01002041,615,62,98,548,90,1413
E01002042,774,64,144,197,67,1246
E01002043,922,93,216,276,76,1583
E01002044,1015,75,181,140,91,1502
E01002045,826,81,223,468,126,1724
E01002046,672,58,145,425,58,1358
E01002047,1019,77,191,115,65,1467
E01002048,950,63,246,252,104,1615
E01002049,719,77,182,399,95,1472
E01002050,699,37,114,175,111,1136
E01002051,724,75,113,323,98,1333
E01002052,741,39,76,170,146,1172
E01002053,671,98,144,389,65,1367
E01002054,627,71,108,401,79,1286
E01002055,715,49,90,103,81,1038
E01002056,960,79,103,371,83,1596
E01002057,789,40,109,276,65,1279
E01002058,947,55,175,181,85,1443
E01002059,988,74,62,163,40,1327
E01002060,1204,54,53,101,34,1446
E01002061,1178,56,68,90,38,1430
E01002062,1214,79,111,126,59,1589
E01002063,983,46,69,157,57,1312
E01002064,829,41,96,214,56,1236
E01002065,1136,72,98,158,40,1504
E01002066,550,84,128,495,113,1370
E01002067,713,68,132,365,73,1351
E01002068,838,60,142,442,61,1543
E01002069,859,79,215,380,101,1634
E01002070,927,77,223,299,72,1598
E01002071,508,57,145,381,114,1205
E01002072,775,62,165,437,99,1538
E01002073,721,87,142,337,77,1364
E01002074,626,56,97,628,129,1536
E01002075,624,58,171,410,72,1335
E01002076,646,66,212,434,80,1438
E01002077,785,59,164,421,107,1536
E01002078,813,98,166,534,92,1703
E01002079,608,66,153,323,84,1234
E01002080,569,80,275,342,51,1317
E01002081,612,74,190,420,107,1403
E01002082,388,42,83,507,82,1102
E01002083,772,35,243,144,60,1254
E01002084,880,60,186,151,66,1343
E01002085,1053,90,252,246,101,1742
E01002086,686,71,125,354,87,1323
E01002087,846,79,171,198,59,1353
E01002088,1010,51,200,185,81,1527
E01002089,353,56,47,559,73,1088
E01002090,650,59,161,272,76,1218
E01002091,733,68,96,349,97,1343
E01002092,540,62,105,449,86,1242
E01002093,736,60,126,321,72,1315
E01002094,555,67,115,297,88,1122
E01002095,583,65,132,300,85,1165
E01002096,669,65,117,285,62,1198
E01002097,574,69,123,281,100,1147
E01002098,803,54,127,115,44,1143
E01002099,827,84,204,384,82,1581
E01002100,802,82,288,231,79,1482
E01002101,1019,90,171,206,97,1583
E01002102,991,63,195,216,103,1568
E01002103,887,66,248,221,81,1503
E01002104,644,48,208,191,61,1152
E01002105,1103,73,291,196,54,1717
E01002106,737,56,684,106,54,1637
E01002107,551,34,679,64,30,1358
E01002108,522,14,772,66,35,1409
E01002109,917,41,426,40,47,1471
E01002110,593,18,721,38,19,1389
E01002111,633,41,822,136,37,1669
E01002112,894,17,559,52,31,1553
E01002113,758,23,380,70,22,1253
E01002114,1034,30,489,97,43,1693
E01002115,591,37,506,72,13,1219
E01002116,882,21,426,46,52,1427
E01002117,637,21,753,107,76,1594
E01002118,810,44,422,118,48,1442
E01002119,549,36,551,167,47,1350
E01002120,454,36,331,175,40,1036
E01002121,493,37,720,101,43,1394
E01002122,558,33,652,108,29,1380
E01002123,578,26,655,124,45,1428
E01002124,327,17,881,82,27,1334
E01002125,425,25,773,100,44,1367
E01002126,937,75,1118,137,89,2356
E01002127,613,35,679,58,53,1438
E01002128,923,44,538,141,49,1695
E01002129,874,55,582,155,35,1701
E01002130,727,57,819,148,78,1829
E01002131,542,44,532,155,38,1311
E01002132,930,69,534,81,44,1658
E01002133,644,76,613,230,77,1640
E01002134,640,28,443,49,43,1203
E01002135,691,42,557,135,38,1463
E01002136,632,42,515,124,45,1358
E01002137,956,36,170,35,11,1208
E01002138,387,48,593,123,35,1186
E01002139,545,35,313,132,54,1079
E01002140,749,42,394,150,20,1355
E01002141,867,30,434,83,49,1463
E01002142,773,34,521,91,35,1454
E01002143,568,33,444,110,33,1188
E01002144,783,28,386,74,30,1301
E01002145,790,31,342,91,36,1290
E01002146,734,28,369,29,14,1174
E01002147,723,10,427,18,17,1195
E01002148,669,22,390,64,32,1177
E01002149,617,13,457,10,11,1108
E01002150,971,40,437,75,26,1549
E01002151,659,38,265,140,40,1142
E01002152,840,30,437,28,15,1350
E01002153,685,24,647,52,20,1428
E01002154,807,52,606,120,39,1624
E01002155,827,28,440,25,33,1353
E01002156,715,20,448,51,27,1261
E01002157,518,50,695,118,24,1405
E01002158,597,18,512,39,21,1187
E01002159,671,51,686,85,41,1534
E01002160,699,75,573,167,37,1551
E01002161,575,50,787,128,56,1596
E01002162,720,56,492,139,51,1458
E01002163,588,36,563,112,22,1321
E01002164,834,49,378,108,38,1407
E01002165,375,16,911,77,24,1403
E01002166,312,17,927,76,15,1347
E01002167,387,20,810,76,34,1327
E01002168,419,41,580,98,30,1168
E01002169,350,34,858,77,31,1350
E01002170,314,27,632,57,45,1075
E01002171,369,18,868,100,26,1381
E01002172,457,35,606,112,21,1231
E01002173,418,18,894,104,18,1452
E01002174,322,15,899,53,22,1311
E01002175,301,13,827,49,22,1212
E01002176,397,37,888,133,31,1486
E01002177,395,19,655,69,14,1152
E01002178,390,37,801,83,17,1328
E01002179,626,74,761,240,72,1773
E01002180,648,56,642,222,48,1616
E01002181,698,47,622,126,23,1516
E01002182,654,41,767,111,84,1657
E01002183,618,32,783,207,56,1696
E01002184,633,57,576,173,25,1464
E01002185,598,35,370,148,27,1178
E01002186,879,37,354,72,26,1368
E01002187,911,24,502,71,19,1527
E01002188,1111,27,188,16,16,1358
E01002189,1009,34,275,33,20,1371
E01002190,857,18,490,22,21,1408
E01002191,716,34,682,53,22,1507
E01002192,858,26,332,18,17,1251
E01002193,910,42,337,81,10,1380
E01002194,1025,30,292,27,16,1390
E01002195,776,26,434,27,21,1284
E01002196,898,20,441,26,11,1396
E01002197,398,17,662,43,14,1134
E01002198,349,21,972,65,17,1424
E01002199,312,24,790,71,13,1210
E01002200,375,25,857,63,44,1364
E01002201,282,24,1010,79,26,1421
E01002202,455,38,882,122,63,1560
E01002203,353,19,830,96,33,1331
E01002204,429,32,805,70,39,1375
E01002206,352,28,635,67,25,1107
E01002207,481,26,709,76,35,1327
E01002208,609,14,419,32,19,1093
E01002209,550,20,674,53,34,1331
E01002210,421,32,760,54,22,1289
E01002211,481,49,458,174,23,1185
E01002212,474,39,655,140,37,1345
E01002213,810,74,1057,225,50,2216
E01002214,544,22,658,126,34,1384
E01002215,574,42,401,148,31,1196
E01002216,370,28,784,64,21,1267
E01002217,374,45,399,249,31,1098
E01002218,502,44,608,104,30,1288
E01002219,431,27,824,97,23,1402
E01002220,510,42,498,153,42,1245
E01002221,469,47,608,104,36,1264
E01002222,448,34,563,160,34,1239
E01002223,470,46,737,123,42,1418
E01002224,504,43,378,185,33,1143
E01002225,1069,15,248,26,28,1386
E01002226,1125,44,560,76,72,1877
E01002227,802,46,371,159,78,1456
E01002228,817,25,591,109,63,1605
E01002229,922,28,367,96,41,1454
E01002230,866,33,523,53,28,1503
E01002231,633,36,540,194,46,1449
E01002232,713,49,588,161,51,1562
E01002233,612,61,604,217,87,1581
E01002234,532,44,456,242,52,1326
E01002235,536,30,572,196,76,1410
E01002236,489,52,610,192,54,1397
E01002237,711,53,395,140,31,1330
E01002238,705,36,556,77,36,1410
E01002239,701,18,524,92,20,1355
E01002240,790,41,438,119,24,1412
E01002241,446,47,601,109,47,1250
E01002242,564,29,802,70,45,1510
E01002243,1168,41,122,113,15,1459
E01002244,1132,30,83,90,9,1344
E01002245,1127,14,57,60,7,1265
E01002246,1116,25,111,111,19,1382
E01002247,1073,29,148,140,9,1399
E01002248,903,29,103,57,9,1101
E01002249,1085,28,249,127,18,1507
E01002250,1004,23,91,115,16,1249
E01002251,906,19,72,90,13,1100
E01002252,1226,6,18,6,5,1261
E01002253,1242,12,42,6,3,1305
E01002254,1256,11,44,13,7,1331
E01002255,1149,16,48,14,5,1232
E01002256,1185,15,21,10,5,1236
E01002257,1319,7,46,13,3,1388
E01002258,1341,8,24,13,3,1389
E01002259,1171,10,32,9,5,1227
E01002260,1025,17,133,89,2,1266
E01002261,1103,20,113,71,6,1313
E01002262,1154,17,72,75,1,1319
E01002263,1199,13,49,76,1,1338
E01002264,1091,16,24,52,2,1185
E01002265,1138,19,48,26,5,1236
E01002266,1123,7,56,42,2,1230
E01002267,1215,22,39,66,3,1345
E01002268,962,12,72,42,10,1098
E01002269,1324,13,70,34,3,1444
E01002270,977,14,384,44,15,1434
E01002271,939,14,246,44,23,1266
E01002272,1028,11,25,32,5,1101
E01002273,988,16,122,32,7,1165
E01002274,1234,16,74,15,8,1347
E01002275,959,10,166,22,12,1169
E01002276,1410,19,41,69,7,1546
E01002277,1134,8,29,40,2,1213
E01002278,1089,11,34,50,9,1193
E01002279,1090,15,21,74,5,1205
E01002280,946,27,36,120,7,1136
E01002281,1127,21,25,55,5,1233
E01002282,1037,23,34,81,6,1181
E01002283,999,16,27,108,5,1155
E01002284,1220,21,50,122,3,1416
E01002285,1034,11,20,12,3,1080
E01002286,1268,5,28,32,1,1334
E01002287,1198,19,50,36,0,1303
E01002288,1180,10,69,16,2,1277
E01002289,1215,21,34,22,2,1294
E01002290,1212,9,33,34,8,1296
E01002291,1289,13,72,20,5,1399
E01002292,1167,11,36,28,3,1245
E01002293,1176,30,63,43,2,1314
E01002294,1193,21,32,24,4,1274
E01002295,1202,9,64,25,4,1304
E01002296,1303,14,61,25,5,1408
E01002297,1029,25,38,73,12,1177
E01002298,1176,21,38,35,3,1273
E01002299,1200,8,53,65,10,1336
E01002300,1238,16,60,33,10,1357
E01002301,1200,18,53,44,0,1315
E01002302,1142,9,43,46,0,1240
E01002303,1373,32,52,108,5,1570
E01002304,1102,17,29,29,1,1178
E01002305,1083,14,46,65,6,1214
E01002306,984,16,61,88,6,1155
E01002307,1169,22,26,51,6,1274
E01002308,1142,17,59,59,12,1289
E01002309,1041,14,66,117,8,1246
E01002310,1202,8,38,95,9,1352
E01002311,1115,26,38,97,6,1282
E01002312,1055,5,18,44,2,1124
E01002313,1055,19,36,70,3,1183
E01002314,1067,25,26,110,7,1235
E01002315,995,21,47,107,14,1184
E01002316,982,39,24,155,8,1208
E01002317,1160,13,60,23,9,1265
E01002318,1243,7,69,17,2,1338
E01002319,1175,17,58,59,5,1314
E01002320,1128,10,36,25,8,1207
E01002321,1214,20,91,26,4,1355
E01002322,1444,24,69,55,9,1601
E01002323,1227,22,39,62,2,1352
E01002324,1163,9,27,26,11,1236
E01002325,1282,11,25,35,5,1358
E01002326,1099,23,32,46,4,1204
E01002327,1087,7,51,48,4,1197
E01002328,1191,10,91,47,6,1345
E01002329,1137,24,67,47,9,1284
E01002330,1180,22,79,73,23,1377
E01002331,1188,12,52,54,9,1315
E01002332,1232,14,20,53,8,1327
E01002333,1042,7,23,27,4,1103
E01002334,1316,24,53,25,1,1419
E01002335,1151,5,48,13,2,1219
E01002336,1159,17,32,22,3,1233
E01002337,1000,11,71,12,12,1106
E01002338,975,12,67,35,4,1093
E01002339,1202,17,40,45,5,1309
E01002340,980,11,48,42,6,1087
E01002341,1115,6,38,14,8,1181
E01002342,989,21,98,143,6,1257
E01002343,1303,11,42,48,8,1412
E01002344,1107,15,51,75,13,1261
E01002345,1011,37,72,131,6,1257
E01002346,984,27,47,121,3,1182
E01002347,907,30,108,81,11,1137
E01002348,1230,11,42,24,2,1309
E01002349,1242,9,13,27,5,1296
E01002350,1052,40,124,56,10,1282
E01002351,1139,21,70,38,2,1270
E01002352,1169,26,71,58,17,1341
E01002353,1365,36,180,67,7,1655
E01002354,1037,8,49,30,8,1132
E01002355,1091,13,37,30,2,1173
E01002356,1320,56,185,147,16,1724
E01002358,1218,21,123,86,4,1452
E01002359,1031,8,19,16,10,1084
E01002360,1208,17,14,15,3,1257
E01002361,1333,20,50,29,7,1439
E01002362,1181,12,51,14,8,1266
E01002363,1240,11,38,20,3,1312
E01002364,1176,10,16,7,7,1216
E01002365,989,18,34,54,3,1098
E01002366,1065,14,49,40,11,1179
E01002367,1222,12,37,17,8,1296
E01002368,945,29,33,175,17,1199
E01002369,1247,25,79,150,10,1511
E01002370,1335,32,49,132,9,1557
E01002371,1194,19,44,66,6,1329
E01002372,1165,12,21,84,8,1290
E01002373,1148,16,44,66,3,1277
E01002374,1062,15,39,96,13,1225
E01002375,1139,22,47,98,1,1307
E01002376,1069,12,65,22,4,1172
E01002377,1155,22,101,42,5,1325
E01002378,1238,21,32,33,2,1326
E01002379,1059,31,103,28,22,1243
E01002380,1569,31,63,63,5,1731
E01002381,1163,16,74,18,4,1275
E01002382,1333,20,96,13,5,1467
E01002383,1175,13,66,47,10,1311
E01002384,1200,12,50,12,2,1276
E01002385,1281,6,12,9,5,1313
E01002386,1426,20,47,35,5,1533
E01002387,1268,9,22,13,1,1313
E01002388,1321,7,32,12,5,1377
E01002389,1291,7,15,2,0,1315
E01002390,1114,7,32,6,11,1170
E01002391,1337,6,30,10,0,1383
E01002392,686,23,228,175,39,1151
E01002393,718,53,420,235,49,1475
E01002394,443,27,596,81,62,1209
E01002395,355,30,536,127,48,1096
E01002396,374,22,732,126,84,1338
E01002397,277,37,792,136,50,1292
E01002398,324,18,863,105,75,1385
E01002399,310,22,740,94,66,1232
E01002400,767,26,363,154,54,1364
E01002401,634,42,413,189,41,1319
E01002402,500,26,413,133,61,1133
E01002403,487,39,521,200,39,1286
E01002404,676,40,392,156,59,1323
E01002405,784,34,480,157,39,1494
E01002406,608,36,674,199,70,1587
E01002407,453,54,937,268,63,1775
E01002408,801,37,253,112,34,1237
E01002409,887,54,309,108,31,1389
E01002410,902,27,365,70,27,1391
E01002411,1076,39,170,92,26,1403
E01002412,1141,48,474,138,112,1913
E01002413,914,19,171,73,25,1202
E01002414,1697,119,826,394,121,3157
E01002415,1152,33,123,38,11,1357
E01002416,1168,14,130,42,16,1370
E01002417,1047,22,188,21,23,1301
E01002418,1082,38,185,38,26,1369
E01002419,989,18,186,23,14,1230
E01002420,1032,26,165,36,6,1265
E01002421,1125,17,168,39,13,1362
E01002422,678,39,269,87,28,1101
E01002423,858,24,312,85,26,1305
E01002424,674,36,364,83,47,1204
E01002425,786,26,354,172,72,1410
E01002426,636,36,478,106,40,1296
E01002427,744,33,343,78,22,1220
E01002428,793,28,212,75,47,1155
E01002429,682,24,193,138,16,1053
E01002430,1077,19,101,11,6,1214
E01002431,855,24,203,27,18,1127
E01002432,1082,23,183,27,13,1328
E01002433,1169,32,206,34,38,1479
E01002434,962,7,105,9,15,1098
E01002435,981,15,142,6,35,1179
E01002436,1068,24,179,21,6,1298
E01002437,1019,12,215,11,3,1260
E01002438,958,21,62,16,9,1066
E01002439,1087,10,119,37,7,1260
E01002440,1074,12,46,28,3,1163
E01002441,1085,31,100,33,19,1268
E01002442,1100,17,49,25,27,1218
E01002443,429,24,707,54,55,1269
E01002444,842,56,478,154,70,1600
E01002445,736,20,219,112,32,1119
E01002446,860,36,302,52,30,1280
E01002447,739,62,392,101,82,1376
E01002448,834,54,534,106,39,1567
E01002449,645,55,592,94,62,1448
E01002450,795,28,205,43,8,1079
E01002451,833,26,240,36,29,1164
E01002452,814,23,294,53,27,1211
E01002453,961,25,246,53,39,1324
E01002454,973,37,186,65,40,1301
E01002455,834,40,334,136,27,1371
E01002456,932,33,236,53,21,1275
E01002457,694,42,326,106,30,1198
E01002458,993,21,163,5,7,1189
E01002459,1188,13,97,13,18,1329
E01002460,964,9,130,10,11,1124
E01002461,769,13,327,39,58,1206
E01002462,875,24,198,7,12,1116
E01002463,965,19,240,12,26,1262
E01002464,1048,15,111,30,21,1225
E01002465,1009,23,147,26,19,1224
E01002466,1173,28,59,37,11,1308
E01002467,1075,24,104,29,6,1238
E01002468,1160,21,116,34,13,1344
E01002469,1160,20,127,17,7,1331
E01002470,1139,40,177,23,18,1397
E01002471,1075,29,145,27,8,1284
E01002472,989,29,297,41,10,1366
E01002473,832,24,433,26,14,1329
E01002474,899,27,275,19,8,1228
E01002475,908,28,272,31,18,1257
E01002476,749,22,484,29,25,1309
E01002477,667,30,325,20,15,1057
E01002478,961,30,227,33,15,1266
E01002479,968,41,289,45,16,1359
E01002480,1044,25,336,26,13,1444
E01002481,910,37,278,26,36,1287
E01002482,826,32,428,28,16,1330
E01002483,897,28,406,49,25,1405
E01002484,889,38,193,30,19,1169
E01002485,958,35,327,60,20,1400
E01002486,684,44,606,164,69,1567
E01002487,464,27,654,163,65,1373
E01002488,539,18,624,84,35,1300
E01002489,315,35,890,95,52,1387
E01002490,551,42,805,113,57,1568
E01002491,432,26,548,134,52,1192
E01002492,325,31,739,71,54,1220
E01002493,505,25,495,186,60,1271
E01002494,1016,41,191,51,42,1341
E01002495,1443,42,265,74,27,1851
E01002496,1073,39,205,89,30,1436
E01002497,1018,33,253,97,32,1433
E01002498,866,33,184,39,13,1135
E01002499,978,35,259,72,17,1361
E01002501,508,28,575,130,68,1309
E01002502,659,32,394,111,43,1239
E01002503,521,26,603,110,45,1305
E01002504,849,53,502,164,32,1600
E01002505,560,40,426,187,64,1277
E01002506,361,35,697,229,41,1363
E01002507,359,20,703,136,52,1270
E01002508,594,41,604,155,77,1471
E01002509,836,11,272,33,23,1175
E01002511,889,42,177,64,31,1203
E01002512,1105,33,274,29,38,1479
E01002513,880,9,214,35,20,1158
E01002514,1181,34,285,46,29,1575
E01002515,979,34,181,83,29,1306
E01002516,729,16,352,36,51,1184
E01002518,847,31,193,46,28,1145
E01002519,1006,20,168,57,25,1276
E01002520,878,40,216,69,37,1240
E01002521,1023,34,220,116,55,1448
E01002523,790,78,392,61,27,1348
E01002525,1055,31,193,52,19,1350
E01002526,940,41,293,101,22,1397
E01002527,949,19,160,72,34,1234
E01002528,891,23,287,74,25,1300
E01002529,908,50,411,171,64,1604
E01002530,861,28,157,95,20,1161
E01002531,1049,35,225,29,15,1353
E01002532,1086,61,337,151,66,1701
E01002533,963,29,73,33,23,1121
E01002534,1031,24,82,18,18,1173
E01002535,1203,32,240,21,42,1538
E01002536,917,29,145,44,16,1151
E01002537,889,22,189,24,23,1147
E01002538,1150,23,131,13,14,1331
E01002539,1111,33,84,19,8,1255
E01002540,618,50,352,189,38,1247
E01002541,889,43,406,109,69,1516
E01002542,535,38,489,258,63,1383
E01002543,594,33,403,167,43,1240
E01002544,420,42,638,110,78,1288
E01002545,418,58,343,168,46,1033
E01002546,259,31,743,103,61,1197
E01002547,224,38,725,125,63,1175
E01002548,966,22,181,68,11,1248
E01002549,941,31,309,95,34,1410
E01002550,1022,40,207,103,64,1436
E01002551,1017,30,333,75,50,1505
E01002552,830,27,251,63,26,1197
E01002553,929,33,205,72,50,1289
E01002554,1205,86,435,185,83,1994
E01002555,811,41,587,49,36,1524
E01002556,840,23,323,77,34,1297
E01002557,1042,30,298,65,23,1458
E01002558,1031,37,279,108,33,1488
E01002559,1185,60,341,125,22,1733
E01002560,1003,31,292,59,18,1403
E01002561,680,26,142,87,39,974
E01002562,813,48,149,92,39,1141
E01002563,968,47,273,67,36,1391
E01002564,1022,53,202,141,50,1468
E01002565,1891,107,264,199,61,2522
E01002566,973,91,264,240,100,1668
E01002567,1184,52,127,58,41,1462
E01002568,1342,93,364,253,78,2130
E01002569,1279,41,92,55,34,1501
E01002570,1185,30,117,49,46,1427
E01002571,928,18,80,25,35,1086
E01002572,937,46,87,141,66,1277
E01002573,1132,23,87,45,18,1305
E01002574,1055,47,115,14,43,1274
E01002575,1169,34,115,35,43,1396
E01002576,1035,48,124,103,45,1355
E01002577,1049,51,125,50,43,1318
E01002578,976,42,130,21,36,1205
E01002579,1252,44,104,32,34,1466
E01002580,907,40,99,75,31,1152
E01002581,1298,55,124,45,40,1562
E01002582,1155,40,77,37,11,1320
E01002583,277,33,897,72,59,1338
E01002584,233,22,985,35,53,1328
E01002585,398,27,756,90,52,1323
E01002586,246,22,1003,37,71,1379
E01002587,383,21,1004,92,47,1547
E01002588,662,44,313,194,59,1272
E01002589,442,62,792,167,44,1507
E01002590,1029,37,290,80,33,1469
E01002591,1022,32,252,49,32,1387
E01002592,974,38,427,100,38,1577
E01002593,1145,37,479,76,46,1783
E01002594,772,66,578,64,42,1522
E01002595,1004,37,361,80,34,1516
E01002596,949,66,270,200,43,1528
E01002598,978,59,237,95,22,1391
E01002599,876,29,178,79,32,1194
E01002600,889,15,163,80,7,1154
E01002601,917,38,208,68,18,1249
E01002602,1024,19,66,33,20,1162
E01002603,914,37,307,98,44,1400
E01002604,746,30,236,163,24,1199
E01002605,1007,38,244,83,42,1414
E01002606,862,35,211,117,22,1247
E01002607,978,68,264,105,47,1462
E01002608,926,44,205,85,33,1293
E01002609,1110,41,174,47,29,1401
E01002610,891,34,168,63,41,1197
E01002611,1005,42,270,60,24,1401
E01002612,913,30,264,77,40,1324
E01002613,916,32,358,53,33,1392
E01002614,1030,32,273,55,25,1415
E01002615,712,43,268,96,25,1144
E01002616,896,21,119,51,12,1099
E01002617,1070,26,148,45,9,1298
E01002618,297,27,1018,17,79,1438
E01002619,318,46,1104,53,70,1591
E01002620,468,42,685,99,69,1363
E01002621,401,25,874,80,58,1438
E01002622,317,28,957,42,51,1395
E01002623,293,20,840,71,77,1301
E01002624,337,29,744,44,47,1201
E01002625,225,17,983,40,93,1358
E01002626,335,27,821,63,95,1341
E01002627,359,46,626,151,101,1283
E01002628,422,33,991,51,81,1578
E01002629,440,46,969,103,86,1644
E01002630,349,26,829,64,92,1360
E01002631,242,35,821,57,89,1244
E01002632,338,24,960,60,68,1450
E01002633,508,39,504,142,45,1238
E01002634,444,39,547,141,41,1212
E01002635,277,10,1000,58,66,1411
E01002636,363,24,1094,66,68,1615
E01002637,178,18,813,184,96,1289
E01002638,364,28,802,116,56,1366
E01002639,374,15,949,23,65,1426
E01002640,280,20,1107,43,65,1515
E01002641,502,32,930,54,59,1577
E01002642,428,48,1016,64,63,1619
E01002643,863,62,770,109,57,1861
E01002645,679,40,797,118,63,1697
E01002646,420,43,874,107,54,1498
E01002647,489,43,878,121,80,1611
E01002648,647,38,1262,88,89,2124
E01002649,602,41,712,91,43,1489
E01002650,391,42,1092,122,90,1737
E01002651,312,46,941,69,59,1427
E01002652,375,31,929,64,38,1437
E01002653,499,34,818,58,71,1480
E01002654,751,46,524,58,57,1436
E01002655,820,44,578,49,36,1527
E01002656,778,29,220,30,26,1083
E01002657,862,44,487,43,39,1475
E01002658,835,29,156,44,18,1082
E01002659,686,37,316,59,24,1122
E01002660,295,31,1005,41,83,1455
E01002661,220,17,1204,42,89,1572
E01002662,429,29,1188,32,39,1717
E01002663,502,51,952,114,51,1670
E01002664,460,35,826,87,38,1446
E01002665,347,26,808,71,37,1289
E01002666,354,16,847,57,27,1301
E01002667,981,38,171,64,32,1286
E01002668,1200,45,274,87,32,1638
E01002669,974,56,176,93,62,1361
E01002670,1050,31,219,64,42,1406
E01002671,1117,29,99,52,26,1323
E01002672,677,44,302,200,45,1268
E01002673,491,58,315,216,61,1141
E01002674,590,30,669,48,56,1393
E01002675,1014,44,680,92,101,1931
E01002676,458,36,879,26,57,1456
E01002677,800,38,318,80,44,1280
E01002678,675,39,701,44,66,1525
E01002679,769,38,542,25,98,1472
E01002680,844,45,574,59,83,1605
E01002681,957,68,358,145,72,1600
E01002682,1228,68,387,103,53,1839
E01002683,1385,75,390,94,64,2008
E01002684,1435,68,294,130,76,2003
E01002686,1014,37,175,141,49,1416
E01002687,1221,55,141,35,27,1479
E01002689,1023,40,117,88,30,1298
E01002690,1009,26,81,35,41,1192
E01002691,937,42,229,50,81,1339
E01002692,1123,74,191,62,71,1521
E01002693,1200,38,141,51,47,1477
E01002694,716,69,178,170,47,1180
E01002695,1106,60,179,92,35,1472
E01002696,1352,58,109,63,14,1596
E01002697,933,70,440,217,98,1758
E01002698,1414,87,119,123,42,1785
E01002699,1133,47,83,53,19,1335
E01002700,1115,30,70,25,19,1259
E01002701,934,42,173,145,59,1353
E01002702,1013,62,267,210,64,1616
E01002703,889,78,171,171,53,1362
E01002704,1286,96,167,257,67,1873
E01002706,1221,63,145,143,64,1636
E01002707,1130,55,202,114,51,1552
E01002708,1155,74,247,167,59,1702
E01002709,978,70,228,166,50,1492
E01002710,844,47,201,185,50,1327
E01002711,1150,110,248,151,68,1727
E01002712,1054,119,177,209,38,1597
E01002713,958,68,61,182,33,1302
E01002714,1213,50,105,62,27,1457
E01002715,704,46,159,206,58,1173
E01002716,1252,143,143,232,86,1856
E01002717,852,35,97,80,24,1088
E01002718,1233,70,74,77,29,1483
E01002719,1074,54,77,50,21,1276
E01002720,1112,91,153,303,94,1753
E01002721,1167,67,59,95,34,1422
E01002722,852,52,60,101,36,1101
E01002723,908,41,155,133,47,1284
E01002724,1391,70,274,69,36,1840
E01002725,835,46,173,127,48,1229
E01002726,1054,63,138,133,38,1426
E01002727,1147,41,129,85,30,1432
E01002728,896,65,331,144,55,1491
E01002729,1113,60,81,110,18,1382
E01002730,1113,76,184,151,51,1575
E01002731,1517,113,218,207,108,2163
E01002732,801,88,200,359,64,1512
E01002733,918,55,119,94,36,1222
E01002734,613,99,101,329,72,1214
E01002735,891,94,148,225,38,1396
E01002736,649,50,125,310,66,1200
E01002737,833,85,115,334,65,1432
E01002738,1180,64,82,124,34,1484
E01002739,1264,60,89,86,40,1539
E01002740,1269,71,92,72,12,1516
E01002741,836,33,66,205,54,1194
E01002742,1086,62,71,84,20,1323
E01002743,975,75,93,170,39,1352
E01002744,1006,47,63,94,36,1246
E01002745,1024,64,66,72,32,1258
E01002747,1072,65,119,109,28,1393
E01002748,679,62,162,235,47,1185
E01002749,703,51,96,126,33,1009
E01002751,782,74,167,336,87,1446
E01002752,848,58,111,152,51,1220
E01002753,801,76,84,200,37,1198
E01002754,1002,53,67,81,24,1227
E01002755,723,63,67,172,47,1072
E01002756,833,62,62,136,30,1123
E01002757,777,48,97,144,47,1113
E01002758,723,73,109,253,57,1215
E01002759,1110,71,88,97,19,1385
E01002760,725,76,103,232,55,1191
E01002762,1353,77,144,113,49,1736
E01002763,913,57,156,110,44,1280
E01002764,1070,79,103,153,50,1455
E01002765,1258,115,263,297,102,2035
E01002766,882,77,206,242,65,1472
E01002767,1201,88,152,217,70,1728
E01002768,1057,69,98,107,37,1368
E01002769,1329,71,225,95,49,1769
E01002770,967,62,131,150,22,1332
E01002771,867,82,80,144,35,1208
E01002772,1131,63,122,192,51,1559
E01002773,733,74,102,180,58,1147
E01002774,1312,105,128,189,57,1791
E01002775,1018,54,70,78,46,1266
E01002776,980,82,82,142,55,1341
E01002777,1140,69,65,141,34,1449
E01002778,749,80,97,287,94,1307
E01002779,1237,68,142,109,54,1610
E01002780,999,85,89,158,35,1366
E01002781,725,57,58,209,54,1103
E01002782,615,67,93,289,53,1117
E01002783,939,64,66,169,35,1273
E01002784,985,85,110,232,38,1450
E01002785,1236,79,101,116,45,1577
E01002786,997,66,133,221,44,1461
E01002787,941,91,125,206,60,1423
E01002788,1301,85,97,95,36,1614
E01002789,1366,66,66,75,17,1590
E01002790,878,55,81,150,45,1209
E01002791,1162,49,61,54,26,1352
E01002792,1279,94,103,94,32,1602
E01002793,1254,60,125,131,65,1635
E01002794,1239,65,133,82,34,1553
E01002795,1172,107,167,191,57,1694
E01002796,732,40,75,55,27,929
E01002797,1146,101,144,151,68,1610
E01002798,1462,56,84,88,36,1726
E01002799,1100,53,106,175,42,1476
E01002800,512,27,81,125,47,792
E01002801,1146,46,82,79,23,1376
E01002802,1089,39,87,39,20,1274
E01002803,1373,90,213,84,56,1816
E01002804,802,56,113,303,64,1338
E01002805,1017,64,101,163,38,1383
E01002806,1013,62,68,181,17,1341
E01002807,931,77,127,238,51,1424
E01002808,1217,61,136,159,44,1617
E01002809,889,78,168,162,45,1342
E01002810,844,76,94,242,57,1313
E01002811,767,75,62,241,49,1194
E01002812,1066,60,321,54,126,1627
E01002813,1166,63,155,20,61,1465
E01002814,828,89,327,89,291,1624
E01002815,812,55,210,15,143,1235
E01002816,901,33,171,10,69,1184
E01002817,1007,50,132,20,120,1329
E01002818,1293,51,214,43,183,1784
E01002819,1086,51,154,19,74,1384
E01002820,808,38,138,17,71,1072
E01002821,943,28,170,18,63,1222
E01002822,829,24,97,3,40,993
E01002823,851,56,113,55,67,1142
E01002824,1011,47,103,27,63,1251
E01002825,1168,49,190,74,116,1597
E01002826,1082,44,141,16,79,1362
E01002827,1271,54,160,17,44,1546
E01002828,927,48,85,29,58,1147
E01002829,864,92,107,159,66,1288
E01002830,983,95,152,225,79,1534
E01002831,1098,105,116,236,123,1678
E01002832,973,82,108,167,111,1441
E01002833,1028,51,96,50,30,1255
E01002834,873,39,178,32,71,1193
E01002835,996,42,201,27,59,1325
E01002836,950,56,155,19,44,1224
E01002837,1003,37,87,12,35,1174
E01002838,1132,34,254,18,43,1481
E01002839,899,68,224,87,140,1418
E01002840,799,70,119,82,88,1158
E01002841,893,62,89,85,56,1185
E01002842,467,65,190,107,142,971
E01002843,629,73,106,127,81,1016
E01002844,990,32,89,26,60,1197
E01002845,931,36,110,61,58,1196
E01002846,803,65,170,60,92,1190
E01002847,1052,54,215,37,69,1427
E01002848,933,74,203,72,104,1386
E01002849,960,51,174,41,83,1309
E01002850,731,64,316,47,109,1267
E01002851,860,59,275,120,167,1481
E01002852,707,83,182,329,193,1494
E01002853,447,46,58,195,143,889
E01002854,441,49,71,196,113,870
E01002855,659,113,111,332,216,1431
E01002856,1036,131,73,205,87,1532
E01002857,452,74,120,249,158,1053
E01002858,714,52,152,79,124,1121
E01002859,1140,57,109,10,84,1400
E01002860,1123,37,67,14,53,1294
E01002861,1025,33,88,24,68,1238
E01002862,919,79,192,70,108,1368
E01002863,1023,32,119,16,74,1264
E01002864,774,39,160,26,165,1164
E01002865,776,32,144,12,113,1077
E01002866,973,67,189,92,130,1451
E01002867,979,69,237,105,261,1651
E01002868,1084,43,140,23,83,1373
E01002869,928,65,108,54,117,1272
E01002870,725,63,58,198,107,1151
E01002871,1163,46,85,24,53,1371
E01002872,847,69,78,99,99,1192
E01002873,878,36,74,57,54,1099
E01002874,889,56,70,92,63,1170
E01002875,967,57,79,39,34,1176
E01002876,1104,84,56,115,44,1403
E01002877,693,61,137,213,188,1292
E01002878,979,86,106,147,85,1403
E01002879,625,73,127,264,136,1225
E01002880,468,59,182,309,185,1203
E01002881,676,51,82,161,117,1087
E01002882,920,37,64,64,30,1115
E01002883,1244,54,128,54,91,1571
E01002884,926,52,182,42,59,1261
E01002885,1062,70,150,46,63,1391
E01002886,1053,41,116,44,47,1301
E01002887,913,32,199,18,88,1250
E01002888,1203,55,454,43,134,1889
E01002889,822,34,159,25,76,1116
E01002890,1107,25,169,20,63,1384
E01002891,868,49,152,38,108,1215
E01002892,1070,86,259,47,116,1578
E01002893,1232,64,160,55,60,1571
E01002894,953,39,140,43,60,1235
E01002895,985,15,56,18,26,1100
E01002896,1242,54,122,17,54,1489
E01002897,938,34,88,21,81,1162
E01002898,1063,49,106,23,50,1291
E01002899,968,45,76,45,60,1194
E01002900,1048,33,79,19,37,1216
E01002901,1007,15,60,11,36,1129
E01002902,1259,39,109,44,74,1525
E01002903,1115,34,69,12,26,1256
E01002904,446,70,78,213,119,926
E01002905,748,84,115,203,98,1248
E01002906,947,73,115,150,103,1388
E01002907,574,77,77,151,112,991
E01002908,874,52,73,79,62,1140
E01002909,1394,112,130,154,80,1870
E01002910,998,33,83,26,64,1204
E01002911,1165,37,63,25,67,1357
E01002912,1223,42,118,46,56,1485
E01002913,1187,40,195,65,111,1598
E01002914,1167,23,110,10,39,1349
E01002915,774,19,253,26,23,1095
E01002916,887,24,237,15,27,1190
E01002917,885,25,182,11,20,1123
E01002918,908,25,324,27,22,1306
E01002919,819,29,385,84,34,1351
E01002920,1044,21,144,15,28,1252
E01002921,1079,40,212,29,34,1394
E01002922,1191,29,114,12,16,1362
E01002923,1032,49,180,65,18,1344
E01002924,1039,21,95,13,19,1187
E01002925,1171,29,117,27,30,1374
E01002926,1009,29,103,25,13,1179
E01002927,901,28,276,28,29,1262
E01002928,903,30,351,21,22,1327
E01002929,1008,41,212,17,27,1305
E01002930,931,33,355,41,31,1391
E01002931,966,53,351,21,24,1415
E01002932,868,48,270,76,58,1320
E01002933,1269,49,151,30,25,1524
E01002934,1150,23,148,18,25,1364
E01002935,1155,46,243,24,41,1509
E01002937,1089,38,113,25,19,1284
E01002938,1241,35,124,26,31,1457
E01002939,1013,34,126,35,18,1226
E01002940,1042,15,114,23,17,1211
E01002941,1111,15,101,19,9,1255
E01002942,1013,10,62,14,9,1108
E01002943,968,23,84,19,8,1102
E01002944,879,17,97,28,16,1037
E01002945,1141,15,70,16,6,1248
E01002946,1118,27,65,10,9,1229
E01002947,1179,22,69,8,15,1293
E01002948,1377,44,143,46,35,1645
E01002949,1251,19,122,19,31,1442
E01002950,1141,15,66,27,10,1259
E01002951,970,24,141,17,77,1229
E01002952,822,28,266,21,75,1212
E01002953,657,50,284,30,37,1058
E01002954,731,38,205,37,74,1085
E01002955,728,32,229,41,119,1149
E01002956,921,42,246,53,100,1362
E01002957,755,49,328,99,82,1313
E01002958,1069,24,178,14,20,1305
E01002959,724,20,312,31,38,1125
E01002960,792,42,372,23,53,1282
E01002961,965,31,308,15,54,1373
E01002962,793,23,303,26,39,1184
E01002963,978,29,339,25,39,1410
E01002964,1490,55,242,95,53,1935
E01002965,1558,70,296,59,100,2083
E01002966,1341,46,105,28,20,1540
E01002967,1375,57,145,29,36,1642
E01002968,1635,81,438,77,115,2346
E01002969,794,65,302,134,73,1368
E01002970,919,32,229,56,33,1269
E01002971,1152,38,138,53,29,1410
E01002972,1178,54,227,49,69,1577
E01002973,687,32,252,56,38,1065
E01002974,1105,55,233,70,58,1521
E01002975,595,27,414,22,33,1091
E01002976,1063,20,156,23,25,1287
E01002977,906,15,292,38,44,1295
E01002978,1110,24,270,20,61,1485
E01002979,991,23,184,12,40,1250
E01002980,742,20,335,17,35,1149
E01002981,707,16,443,28,41,1235
E01002982,797,22,299,23,55,1196
E01002983,952,24,302,16,51,1345
E01002984,757,29,298,22,35,1141
E01002985,611,22,585,30,36,1284
E01002986,682,18,294,12,27,1033
E01002987,1219,39,190,69,34,1551
E01002988,1272,72,221,104,31,1700
E01002989,1354,40,135,18,25,1572
E01002990,1242,41,187,20,36,1526
E01002991,1142,40,152,24,26,1384
E01002992,1198,81,201,82,27,1589
E01002993,1152,34,130,24,29,1369
E01002994,1060,29,129,38,23,1279
E01002995,1015,38,157,16,22,1248
E01002996,1015,21,114,27,10,1187
E01002997,1016,24,117,16,19,1192
E01002998,943,25,130,48,29,1175
E01002999,986,31,171,42,32,1262
E01003000,897,30,260,26,30,1243
E01003001,936,27,422,24,38,1447
E01003002,1169,52,173,36,33,1463
E01003003,909,35,273,28,18,1263
E01003004,953,37,174,41,29,1234
E01003005,1001,18,123,23,6,1171
E01003006,953,23,143,12,46,1177
E01003007,952,33,120,9,23,1137
E01003008,878,28,107,14,18,1045
E01003009,1221,43,138,27,30,1459
E01003010,1039,18,84,7,18,1166
E01003011,1174,49,102,20,52,1397
E01003013,816,75,517,64,40,1512
E01003014,985,56,123,164,37,1365
E01003015,690,118,92,352,49,1301
E01003016,661,71,371,130,41,1274
E01003017,1037,70,153,179,18,1457
E01003018,1370,119,77,246,27,1839
E01003019,1347,91,69,311,37,1855
E01003020,942,88,79,353,34,1496
E01003021,952,106,81,453,35,1627
E01003022,1000,79,76,293,34,1482
E01003023,1334,155,115,392,42,2038
E01003024,602,89,79,557,49,1376
E01003025,906,107,106,488,34,1641
E01003026,1105,32,75,82,9,1303
E01003027,960,25,52,38,3,1078
E01003028,956,48,57,112,9,1182
E01003029,1242,81,72,182,17,1594
E01003030,1336,63,76,72,11,1558
E01003031,993,77,96,234,20,1420
E01003032,986,75,89,314,34,1498
E01003033,942,45,71,128,27,1213
E01003034,1062,65,68,219,20,1434
E01003035,1098,59,59,182,27,1425
E01003036,975,49,67,244,19,1354
E01003037,698,76,53,301,26,1154
E01003038,1103,56,61,88,3,1311
E01003039,1476,86,93,81,28,1764
E01003040,855,44,53,120,17,1089
E01003041,805,82,87,321,36,1331
E01003042,694,43,39,129,15,920
E01003043,891,104,54,355,18,1422
E01003044,249,59,29,622,22,981
E01003045,440,131,78,750,73,1472
E01003046,438,82,36,679,30,1265
E01003047,702,78,122,415,36,1353
E01003048,402,91,46,689,51,1279
E01003049,559,85,78,500,50,1272
E01003050,929,107,78,329,17,1460
E01003051,572,100,87,490,42,1291
E01003052,459,103,87,691,30,1370
E01003053,1178,75,79,227,24,1583
E01003054,1407,73,63,139,22,1704
E01003055,893,92,84,287,25,1381
E01003056,1192,100,86,332,27,1737
E01003057,789,86,73,420,37,1405
E01003058,1241,105,77,311,28,1762
E01003059,581,77,107,480,49,1294
E01003060,488,67,97,530,44,1226
E01003061,577,104,67,254,50,1052
E01003062,989,88,62,225,20,1384
E01003063,613,70,56,339,29,1107
E01003064,898,87,55,171,15,1226
E01003065,536,85,50,412,24,1107
E01003066,708,90,70,437,22,1327
E01003067,806,45,60,244,17,1172
E01003068,686,80,50,317,23,1156
E01003069,663,49,33,241,14,1000
E01003070,530,103,55,433,28,1149
E01003071,1400,122,110,301,20,1953
E01003072,1179,64,64,137,18,1462
E01003073,738,89,36,424,39,1326
E01003074,1304,121,53,416,46,1940
E01003075,452,76,85,551,54,1218
E01003076,962,98,176,311,67,1614
E01003077,903,108,115,336,48,1510
E01003078,975,67,105,132,30,1309
E01003079,738,94,111,419,27,1389
E01003080,826,82,76,271,24,1279
E01003081,771,81,124,399,29,1404
E01003082,594,93,59,353,30,1129
E01003083,726,59,104,308,16,1213
E01003084,829,88,80,252,15,1264
E01003085,886,86,91,261,32,1356
E01003086,528,100,55,451,22,1156
E01003087,543,67,74,425,32,1141
E01003088,909,99,88,384,32,1512
E01003089,696,90,127,467,77,1457
E01003090,1496,119,132,289,35,2071
E01003091,792,91,118,280,32,1313
E01003092,773,77,115,416,44,1425
E01003093,769,146,116,660,69,1760
E01003094,895,77,71,294,21,1358
E01003095,1161,77,71,207,24,1540
E01003096,1436,106,97,268,28,1935
E01003097,826,74,115,337,48,1400
E01003098,857,56,73,267,22,1275
E01003099,840,87,89,249,42,1307
E01003100,1435,109,82,118,54,1798
E01003101,810,84,75,270,36,1275
E01003102,1139,83,143,175,39,1579
E01003104,972,76,112,205,52,1417
E01003105,754,88,124,358,44,1368
E01003106,1121,77,79,306,30,1613
E01003107,1242,82,107,204,34,1669
E01003108,712,87,76,337,32,1244
E01003109,1102,101,159,413,83,1858
E01003110,1238,80,100,178,24,1620
E01003111,523,65,117,461,41,1207
E01003112,699,76,124,330,44,1273
E01003113,1039,120,135,313,25,1632
E01003114,978,65,144,279,34,1500
E01003115,758,68,99,337,31,1293
E01003116,818,45,239,193,10,1305
E01003117,1107,99,152,239,40,1637
E01003118,1003,81,215,140,23,1462
E01003119,1091,84,151,211,36,1573
E01003120,1049,83,127,366,44,1669
E01003121,536,104,58,512,28,1238
E01003122,984,78,112,316,63,1553
E01003123,1004,70,57,140,17,1288
E01003124,791,69,84,232,34,1210
E01003125,577,73,103,470,67,1290
E01003126,713,55,61,359,32,1220
E01003127,983,89,60,310,31,1473
E01003128,658,77,50,380,35,1200
E01003129,1079,92,121,253,44,1589
E01003130,976,77,139,224,38,1454
E01003131,884,46,85,154,20,1189
E01003132,602,72,46,429,38,1187
E01003133,971,118,61,211,32,1393
E01003134,830,78,88,233,25,1254
E01003135,914,82,95,276,28,1395
E01003136,833,84,65,290,23,1295
E01003137,604,92,93,324,54,1167
E01003138,1088,37,68,106,17,1316
E01003139,596,54,264,281,18,1213
E01003140,497,46,240,345,18,1146
E01003141,686,84,177,390,16,1353
E01003142,450,66,269,240,34,1059
E01003143,437,53,247,391,13,1141
E01003144,833,55,146,206,20,1260
E01003145,884,90,182,253,27,1436
E01003146,569,51,155,382,13,1170
E01003147,869,93,209,370,54,1595
E01003148,937,63,78,305,25,1408
E01003149,939,104,177,213,25,1458
E01003150,822,75,88,335,26,1346
E01003151,702,85,132,453,40,1412
E01003152,967,84,154,326,53,1584
E01003153,1324,92,162,228,48,1854
E01003154,791,72,116,450,29,1458
E01003155,977,79,162,246,41,1505
E01003156,969,56,61,185,7,1278
E01003157,909,46,103,146,13,1217
E01003158,1229,38,28,68,12,1375
E01003159,634,75,56,352,49,1166
E01003160,420,83,62,477,52,1094
E01003161,714,44,89,135,22,1004
E01003162,605,94,86,683,92,1560
E01003163,833,50,148,176,37,1244
E01003164,1032,143,105,363,48,1691
E01003165,851,61,117,214,21,1264
E01003166,1187,92,136,340,67,1822
E01003167,1043,57,85,132,19,1336
E01003168,781,76,33,321,17,1228
E01003169,1229,143,98,448,40,1958
E01003170,1161,44,99,155,10,1469
E01003171,923,78,63,375,27,1466
E01003172,785,127,73,496,42,1523
E01003173,881,105,72,276,35,1369
E01003174,542,94,78,720,53,1487
E01003175,498,73,73,503,43,1190
E01003176,693,113,64,484,35,1389
E01003177,838,99,72,337,25,1371
E01003178,1000,97,47,264,16,1424
E01003179,461,85,56,565,69,1236
E01003180,721,82,68,356,36,1263
E01003181,697,82,90,322,45,1236
E01003182,781,100,77,467,48,1473
E01003183,636,84,97,400,27,1244
E01003184,361,65,50,496,37,1009
E01003185,895,88,72,289,61,1405
E01003186,1145,86,100,287,35,1653
E01003187,400,102,75,636,36,1249
E01003188,405,70,67,489,32,1063
E01003189,687,42,81,347,37,1194
E01003190,607,91,85,508,45,1336
E01003191,619,69,50,340,23,1101
E01003192,669,56,93,408,11,1237
E01003193,763,47,54,361,15,1240
E01003194,685,60,85,431,51,1312
E01003195,603,39,87,434,23,1186
E01003196,701,54,77,349,39,1220
E01003197,680,52,115,368,17,1232
E01003198,949,39,50,135,12,1185
E01003199,1129,52,123,98,18,1420
E01003200,1144,34,88,30,31,1327
E01003201,881,72,85,235,37,1310
E01003202,1148,45,95,41,10,1339
E01003203,1011,53,134,276,30,1504
E01003204,805,37,73,161,33,1109
E01003205,361,78,125,397,27,988
E01003206,998,45,86,89,58,1276
E01003207,528,53,121,384,33,1119
E01003209,863,125,126,485,73,1672
E01003210,1009,74,111,283,20,1497
E01003211,956,67,67,216,19,1325
E01003212,1027,95,98,440,51,1711
E01003213,1121,98,131,272,21,1643
E01003214,819,96,76,398,29,1418
E01003215,1004,95,268,295,25,1687
E01003216,726,74,149,488,45,1482
E01003217,568,71,137,456,31,1263
E01003218,589,45,97,392,32,1155
E01003219,592,58,137,489,41,1317
E01003220,648,76,89,392,50,1255
E01003221,746,96,187,481,19,1529
E01003222,603,55,107,488,16,1269
E01003223,690,54,170,420,37,1371
E01003224,610,75,116,475,31,1307
E01003225,805,53,93,244,28,1223
E01003226,992,69,136,218,17,1432
E01003227,946,73,79,233,27,1358
E01003228,928,49,56,184,21,1238
E01003229,739,64,97,327,22,1249
E01003230,859,107,91,445,21,1523
E01003231,730,87,89,343,37,1286
E01003232,858,56,136,263,37,1350
E01003233,831,58,149,299,23,1360
E01003235,705,44,48,186,31,1014
E01003236,760,64,55,211,59,1149
E01003237,747,43,99,182,24,1095
E01003238,658,47,58,238,18,1019
E01003239,625,51,57,277,38,1048
E01003240,877,65,85,297,23,1347
E01003241,684,53,123,358,35,1253
E01003243,624,50,112,248,21,1055
E01003244,384,32,131,522,30,1099
E01003245,447,56,158,368,36,1065
E01003246,457,57,183,413,26,1136
E01003247,935,75,263,179,47,1499
E01003248,539,59,200,386,41,1225
E01003249,849,93,205,412,41,1600
E01003250,685,67,244,410,21,1427
E01003251,513,70,265,539,63,1450
E01003252,269,52,240,476,46,1083
E01003253,563,46,172,369,17,1167
E01003254,915,41,81,120,20,1177
E01003255,1120,71,147,232,33,1603
E01003256,1031,119,143,344,36,1673
E01003257,894,75,80,262,14,1325
E01003258,475,58,96,412,27,1068
E01003259,922,67,78,230,24,1321
E01003260,897,57,153,180,31,1318
E01003261,829,47,74,207,13,1170
E01003262,727,38,89,193,15,1062
E01003263,881,48,106,206,43,1284
E01003264,889,55,85,224,45,1298
E01003265,696,67,60,310,31,1164
E01003266,862,44,63,346,31,1346
E01003267,839,33,80,204,27,1183
E01003268,899,44,115,256,57,1371
E01003269,850,52,127,185,28,1242
E01003270,895,54,121,224,42,1336
E01003271,1019,42,127,138,47,1373
E01003272,1097,80,134,265,71,1647
E01003273,774,217,324,349,35,1699
E01003274,817,89,140,301,30,1377
E01003275,693,56,165,381,46,1341
E01003276,873,82,123,340,24,1442
E01003277,923,82,67,324,21,1417
E01003278,826,92,168,453,62,1601
E01003279,874,59,113,260,25,1331
E01003280,708,40,185,290,19,1242
E01003281,846,47,124,183,11,1211
E01003282,1224,129,215,357,121,2046
E01003283,1372,48,82,139,16,1657
E01003284,963,65,108,263,28,1427
E01003285,956,41,174,150,22,1343
E01003286,840,45,115,279,15,1294
E01003287,1201,50,116,154,18,1539
E01003288,763,84,212,375,45,1479
E01003290,745,102,114,443,48,1452
E01003291,537,62,108,421,33,1161
E01003292,734,51,161,330,27,1303
E01003293,623,64,130,383,12,1212
E01003295,710,66,113,415,41,1345
E01003296,912,67,340,338,49,1706
E01003297,566,74,105,410,27,1182
E01003298,308,47,170,437,19,981
E01003299,655,65,114,362,76,1272
E01003300,367,51,145,468,15,1046
E01003301,878,103,278,474,57,1790
E01003302,426,63,166,507,31,1193
E01003303,552,59,232,390,34,1267
E01003304,737,96,255,432,55,1575
E01003305,601,52,75,338,28,1094
E01003307,756,54,81,305,17,1213
E01003308,839,98,83,355,48,1423
E01003309,646,60,80,347,21,1154
E01003310,765,79,92,304,35,1275
E01003311,823,68,98,245,24,1258
E01003312,939,74,95,262,50,1420
E01003313,617,52,87,342,28,1126
E01003314,826,61,70,294,30,1281
E01003315,652,42,109,234,17,1054
E01003316,777,62,104,223,17,1183
E01003317,771,91,113,441,22,1438
E01003318,603,79,166,460,30,1338
E01003319,598,76,173,489,60,1396
E01003320,493,82,78,475,25,1153
E01003321,773,86,100,534,30,1523
E01003322,551,62,113,384,33,1143
E01003323,534,55,107,460,37,1193
E01003324,450,43,127,518,22,1160
E01003325,560,81,108,485,51,1285
E01003326,776,61,66,279,14,1196
E01003327,955,133,180,209,9,1486
E01003328,944,69,105,264,36,1418
E01003329,821,77,88,230,24,1240
E01003330,684,64,72,293,18,1131
E01003331,693,59,79,274,21,1126
E01003332,721,67,75,297,26,1186
E01003333,771,74,86,270,23,1224
E01003334,843,47,128,318,35,1371
E01003335,625,66,71,295,23,1080
E01003336,375,62,78,472,24,1011
E01003337,397,58,74,553,25,1107
E01003338,516,68,199,567,57,1407
E01003339,798,70,98,371,95,1432
E01003340,1214,82,97,222,63,1678
E01003341,882,76,75,147,36,1216
E01003342,772,77,105,322,63,1339
E01003343,714,67,92,197,36,1106
E01003344,819,76,129,350,81,1455
E01003345,817,64,143,353,80,1457
E01003346,649,49,91,348,16,1153
E01003347,498,63,117,431,44,1153
E01003348,660,63,129,276,17,1145
E01003349,648,44,67,208,30,997
E01003350,553,51,81,290,42,1017
E01003351,685,46,46,275,17,1069
E01003352,769,59,145,405,26,1404
E01003353,795,48,161,319,37,1360
E01003354,617,44,125,464,26,1276
E01003355,1095,60,164,26,26,1371
E01003356,1080,60,213,32,31,1416
E01003357,889,46,272,172,48,1427
E01003358,1213,62,242,34,39,1590
E01003359,1095,50,197,83,50,1475
E01003360,1139,38,177,41,25,1420
E01003361,944,46,255,70,21,1336
E01003362,903,25,146,25,14,1113
E01003363,1003,44,192,46,15,1300
E01003364,1112,37,161,72,17,1399
E01003365,860,29,261,23,11,1184
E01003366,984,50,167,59,17,1277
E01003367,1288,63,602,134,30,2117
E01003368,666,44,385,206,29,1330
E01003369,988,75,252,113,28,1456
E01003370,1131,86,343,123,29,1712
E01003371,897,71,263,113,15,1359
E01003372,713,57,226,199,23,1218
E01003373,528,59,204,237,23,1051
E01003374,680,45,158,226,27,1136
E01003375,884,49,202,161,25,1321
E01003376,734,55,232,213,16,1250
E01003377,567,48,231,276,15,1137
E01003378,828,59,236,352,34,1509
E01003379,720,49,293,301,32,1395
E01003380,1130,41,145,26,20,1362
E01003381,1101,30,123,16,21,1291
E01003382,1072,46,125,23,13,1279
E01003383,1027,60,173,21,27,1308
E01003384,1036,60,142,20,6,1264
E01003385,1037,54,109,22,20,1242
E01003386,649,69,499,357,46,1620
E01003387,634,46,217,320,24,1241
E01003388,561,58,259,276,21,1175
E01003389,650,56,363,262,37,1368
E01003390,488,51,274,338,41,1192
E01003391,471,62,114,320,15,982
E01003392,472,43,340,176,33,1064
E01003393,733,40,300,160,33,1266
E01003394,724,49,540,256,28,1597
E01003395,471,43,371,302,17,1204
E01003396,556,35,457,239,29,1316
E01003397,544,51,410,239,22,1266
E01003398,540,62,425,314,35,1376
E01003399,957,31,163,31,18,1200
E01003400,1019,47,165,28,22,1281
E01003401,872,31,198,20,16,1137
E01003402,963,50,223,26,37,1299
E01003403,1120,26,143,10,31,1330
E01003404,1195,42,213,20,19,1489
E01003405,695,60,328,231,35,1349
E01003406,646,57,246,231,38,1218
E01003407,875,54,374,124,45,1472
E01003408,1122,65,259,90,36,1572
E01003409,597,38,447,196,36,1314
E01003410,678,49,285,205,45,1262
E01003411,719,70,214,302,41,1346
E01003412,551,70,269,340,26,1256
E01003413,638,91,313,395,33,1470
E01003414,473,58,402,323,28,1284
E01003415,533,51,298,355,39,1276
E01003416,652,42,240,269,20,1223
E01003417,1070,27,137,37,12,1283
E01003418,993,26,91,71,8,1189
E01003419,1061,34,166,73,19,1353
E01003420,863,23,126,41,21,1074
E01003421,1007,32,225,43,8,1315
E01003422,903,26,142,48,13,1132
E01003423,1038,32,121,19,20,1230
E01003424,1022,23,139,27,7,1218
E01003425,861,38,186,30,20,1135
E01003426,813,38,457,45,50,1403
E01003427,789,47,524,36,55,1451
E01003428,984,41,108,39,26,1198
E01003429,606,36,141,325,19,1127
E01003430,403,59,79,488,15,1044
E01003431,498,41,154,394,21,1108
E01003432,520,59,178,327,12,1096
E01003433,495,51,180,450,24,1200
E01003434,562,52,223,310,31,1178
E01003435,605,43,156,241,8,1053
E01003436,845,44,204,99,17,1209
E01003437,994,53,370,101,20,1538
E01003438,914,26,267,87,13,1307
E01003439,692,41,296,71,28,1128
E01003440,801,33,214,147,24,1219
E01003441,831,51,290,240,37,1449
E01003442,1123,32,168,32,29,1384
E01003443,1083,27,64,10,13,1197
E01003444,1087,23,92,19,13,1234
E01003445,1072,40,198,20,23,1353
E01003446,1129,52,198,46,21,1446
E01003447,922,35,192,78,30,1257
E01003448,877,38,270,87,34,1306
E01003449,812,58,396,88,20,1374
E01003450,886,32,161,110,22,1211
E01003451,1066,20,223,75,11,1395
E01003452,1114,31,261,140,28,1574
E01003453,858,25,333,62,27,1305
E01003454,930,32,148,32,18,1160
E01003455,1051,56,144,72,26,1349
E01003456,1050,50,161,52,23,1336
E01003457,1062,38,121,16,9,1246
E01003458,1064,28,178,34,20,1324
E01003459,1279,87,201,124,33,1724
E01003460,1113,29,64,20,15,1241
E01003461,1148,36,100,13,17,1314
E01003462,999,29,116,9,24,1177
E01003463,753,15,188,11,23,990
E01003464,850,22,193,12,50,1127
E01003465,859,27,101,2,31,1020
E01003466,1006,36,198,34,20,1294
E01003467,1038,28,170,41,20,1297
E01003468,1101,34,144,32,28,1339
E01003469,681,40,464,42,31,1258
E01003470,863,32,432,23,31,1381
E01003471,992,46,150,60,29,1277
E01003472,861,24,108,9,13,1015
E01003473,872,22,176,20,22,1112
E01003474,948,18,79,12,21,1078
E01003475,1527,70,321,116,35,2069
E01003476,819,24,138,66,31,1078
E01003477,1000,38,142,20,17,1217
E01003478,1060,51,118,10,15,1254
E01003479,709,26,172,203,30,1140
E01003480,938,69,429,292,69,1797
E01003481,726,45,231,246,26,1274
E01003482,917,75,590,410,83,2075
E01003483,413,42,417,237,31,1140
E01003484,606,38,326,214,55,1239
E01003485,631,40,313,174,33,1191
E01003486,344,40,239,305,18,946
E01003487,407,33,329,215,25,1009
E01003488,320,46,594,345,91,1396
E01003489,256,35,760,199,48,1298
E01003490,226,22,868,188,58,1362
E01003491,207,35,1197,146,53,1638
E01003492,331,41,873,200,40,1485
E01003493,451,30,965,248,84,1778
E01003494,504,43,680,182,71,1480
E01003495,678,42,560,211,68,1559
E01003496,423,60,276,362,47,1168
E01003497,780,68,173,274,55,1350
E01003498,618,50,285,353,36,1342
E01003499,741,67,384,430,54,1676
E01003500,774,61,242,427,38,1542
E01003501,680,70,382,405,37,1574
E01003502,601,47,315,459,34,1456
E01003503,512,68,232,466,24,1302
E01003506,561,68,153,316,35,1133
E01003507,795,75,350,374,53,1647
E01003508,553,40,270,274,42,1179
E01003509,943,53,169,270,67,1502
E01003511,426,46,118,315,27,932
E01003512,773,47,178,352,53,1403
E01003513,638,58,236,228,33,1193
E01003514,681,45,132,242,29,1129
E01003515,648,66,186,416,35,1351
E01003516,620,82,196,417,58,1373
E01003517,613,44,189,373,45,1264
E01003518,626,46,272,262,30,1236
E01003519,532,31,279,350,44,1236
E01003520,218,13,1244,97,54,1626
E01003521,326,56,1329,94,40,1845
E01003522,211,27,1027,122,38,1425
E01003523,415,29,815,228,69,1556
E01003524,266,32,1060,164,65,1587
E01003525,223,34,1050,164,64,1535
E01003526,282,21,913,184,58,1458
E01003527,515,54,530,158,54,1311
E01003528,135,19,578,198,62,992
E01003529,126,28,1629,115,31,1929
E01003530,119,22,1191,66,49,1447
E01003531,176,19,1249,99,46,1589
E01003532,139,15,1290,116,54,1614
E01003533,201,21,1071,137,35,1465
E01003534,203,27,1356,175,36,1797
E01003535,492,46,350,334,51,1273
E01003536,469,59,461,284,45,1318
E01003537,597,60,619,203,60,1539
E01003538,509,52,531,368,61,1521
E01003539,571,48,574,315,85,1593
E01003540,566,54,371,290,34,1315
E01003541,541,44,422,269,38,1314
E01003542,471,49,503,281,60,1364
E01003543,811,82,578,377,93,1941
E01003544,569,75,394,425,52,1515
E01003545,494,50,347,394,27,1312
E01003546,333,39,533,444,67,1416
E01003547,758,72,407,256,52,1545
E01003548,883,66,491,392,108,1940
E01003549,741,63,483,382,72,1741
E01003550,456,49,486,337,61,1389
E01003551,528,57,504,309,86,1484
E01003552,400,29,557,262,75,1323
E01003553,603,74,430,349,48,1504
E01003554,764,57,453,257,58,1589
E01003555,354,34,885,163,45,1481
E01003556,491,46,639,323,47,1546
E01003557,480,43,677,351,64,1615
E01003558,286,40,698,234,21,1279
E01003559,1084,91,527,377,92,2171
E01003560,139,15,1070,142,33,1399
E01003561,128,32,1122,164,28,1474
E01003562,168,23,1414,158,31,1794
E01003563,239,17,1044,193,51,1544
E01003564,219,26,1447,161,41,1894
E01003565,131,33,1142,113,21,1440
E01003566,151,22,1036,137,39,1385
E01003567,173,23,988,206,29,1419
E01003568,196,16,1410,167,50,1839
E01003569,137,41,1232,133,20,1563
E01003570,254,41,1066,196,63,1620
E01003571,147,30,1397,175,26,1775
E01003572,168,30,947,167,39,1351
E01003573,165,25,1252,179,46,1667
E01003574,362,31,1413,263,53,2122
E01003575,204,47,694,216,47,1208
E01003576,306,45,677,321,50,1399
E01003577,318,62,480,394,57,1311
E01003578,316,35,779,243,47,1420
E01003579,211,22,926,189,28,1376
E01003580,297,49,546,323,64,1279
E01003581,207,32,870,249,39,1397
E01003582,274,46,596,220,32,1168
E01003583,329,36,822,229,38,1454
E01003584,521,62,742,239,40,1604
E01003585,130,8,912,144,45,1239
E01003586,252,29,913,184,36,1414
E01003587,402,44,1022,338,61,1867
E01003588,121,21,1040,144,29,1355
E01003589,257,28,935,135,45,1400
E01003590,416,56,422,287,26,1207
E01003591,326,48,910,290,57,1631
E01003592,397,38,678,232,78,1423
E01003593,414,63,350,334,31,1192
E01003594,418,44,529,266,75,1332
E01003595,429,57,418,266,45,1215
E01003596,426,39,647,222,40,1374
E01003597,262,29,716,209,58,1274
E01003598,385,65,451,435,43,1379
E01003599,312,40,664,196,23,1235
E01003600,487,52,481,341,34,1395
E01003601,637,50,439,398,38,1562
E01003602,553,52,529,387,42,1563
E01003603,547,38,502,274,64,1425
E01003604,695,67,456,418,59,1695
E01003605,434,32,750,333,51,1600
E01003606,487,52,707,320,65,1631
E01003607,461,57,416,263,52,1249
E01003608,682,58,458,287,75,1560
E01003609,1049,78,461,426,58,2072
E01003611,452,79,175,512,38,1256
E01003615,631,75,415,337,36,1494
E01003616,576,54,374,335,64,1403
E01003617,1033,94,681,472,70,2350
E01003618,950,62,512,266,92,1882
E01003619,836,92,527,431,58,1944
E01003621,235,41,725,123,90,1214
E01003622,263,21,643,212,34,1173
E01003623,333,26,618,218,42,1237
E01003624,378,38,484,210,51,1161
E01003625,271,39,805,107,52,1274
E01003626,165,27,936,72,44,1244
E01003627,181,20,955,90,30,1276
E01003628,213,19,918,77,41,1268
E01003629,160,21,956,64,51,1252
E01003630,560,62,440,446,46,1554
E01003631,597,67,377,333,95,1469
E01003632,695,92,599,342,60,1788
E01003633,428,58,337,510,49,1382
E01003634,510,60,454,347,37,1408
E01003635,760,57,499,248,57,1621
E01003636,578,74,376,404,56,1488
E01003637,612,43,500,291,36,1482
E01003638,731,25,440,97,14,1307
E01003639,708,33,479,103,47,1370
E01003640,692,38,473,124,34,1361
E01003641,457,23,651,122,50,1303
E01003642,525,37,549,116,34,1261
E01003643,663,22,614,76,41,1416
E01003644,407,23,686,65,31,1212
E01003645,734,53,965,155,61,1968
E01003646,441,31,775,102,42,1391
E01003647,417,30,881,69,25,1422
E01003648,729,24,395,41,25,1214
E01003649,544,17,612,77,49,1299
E01003650,619,17,450,80,28,1194
E01003651,408,23,672,56,40,1199
E01003652,485,29,584,53,45,1196
E01003653,394,28,619,69,27,1137
E01003654,842,34,227,95,27,1225
E01003655,989,31,170,48,5,1243
E01003656,950,40,138,80,9,1217
E01003657,1366,42,176,90,14,1688
E01003658,819,51,216,153,34,1273
E01003659,894,52,207,107,23,1283
E01003660,1173,35,120,55,11,1394
E01003661,728,34,506,226,28,1522
E01003662,656,52,458,225,31,1422
E01003663,872,34,346,148,22,1422
E01003664,692,35,330,208,41,1306
E01003665,613,42,379,151,29,1214
E01003666,724,62,454,319,29,1588
E01003668,1071,31,210,42,28,1382
E01003669,1010,40,112,45,17,1224
E01003670,907,24,170,64,9,1174
E01003671,964,28,163,51,11,1217
E01003672,833,60,159,72,32,1156
E01003673,1110,55,230,50,11,1456
E01003674,1298,60,341,74,34,1807
E01003675,379,13,797,40,20,1249
E01003676,331,18,875,58,25,1307
E01003677,464,17,676,44,38,1239
E01003678,438,21,680,69,28,1236
E01003679,472,12,758,49,23,1314
E01003680,429,24,699,51,32,1235
E01003681,622,25,686,85,41,1459
E01003682,353,28,816,58,47,1302
E01003683,314,16,990,120,40,1480
E01003684,274,25,769,126,50,1244
E01003685,192,13,992,106,57,1360
E01003686,196,30,987,151,53,1417
E01003688,189,23,1015,108,37,1372
E01003689,192,26,831,78,57,1184
E01003690,565,23,730,73,38,1429
E01003691,233,33,652,133,31,1082
E01003692,373,25,693,103,27,1221
E01003693,306,36,748,98,51,1239
E01003694,293,17,794,75,5,1184
E01003695,307,31,714,123,50,1225
E01003696,459,20,869,95,65,1508
E01003697,296,18,835,82,38,1269
E01003698,820,25,196,50,14,1105
E01003699,893,20,155,62,15,1145
E01003700,1132,38,457,112,41,1780
E01003701,746,19,492,95,32,1384
E01003702,979,19,206,88,25,1317
E01003703,1402,49,348,115,36,1950
E01003704,899,42,248,86,41,1316
E01003705,1032,26,517,91,28,1694
E01003706,742,22,357,66,18,1205
E01003707,539,14,365,113,35,1066
E01003708,658,37,230,156,41,1122
E01003709,766,21,380,93,32,1292
E01003710,570,28,554,53,37,1242
E01003711,888,22,400,84,73,1467
E01003712,586,29,264,141,20,1040
E01003713,291,29,811,141,60,1332
E01003714,330,22,998,174,52,1576
E01003715,304,44,973,145,59,1525
E01003716,443,29,688,107,41,1308
E01003718,353,23,762,147,83,1368
E01003719,387,47,925,139,47,1545
E01003720,1115,31,170,114,8,1438
E01003721,847,40,256,120,22,1285
E01003722,1063,32,153,108,21,1377
E01003723,1017,45,146,100,20,1328
E01003724,769,25,176,63,18,1051
E01003725,878,27,114,95,14,1128
E01003726,824,37,146,123,14,1144
E01003727,988,29,110,73,17,1217
E01003728,321,38,1191,215,61,1826
E01003729,183,15,929,119,48,1294
E01003730,134,13,861,128,40,1176
E01003731,226,39,642,125,41,1073
E01003732,317,38,431,290,32,1108
E01003733,261,30,805,165,44,1305
E01003734,278,25,796,139,55,1293
E01003735,340,68,762,332,39,1541
E01003736,171,34,708,189,24,1126
E01003737,452,32,801,59,49,1393
E01003738,551,34,852,153,29,1619
E01003739,456,39,894,150,51,1590
E01003740,434,34,915,123,63,1569
E01003741,687,21,570,102,18,1398
E01003742,366,34,870,157,62,1489
E01003743,275,23,833,151,15,1297
E01003744,965,8,133,39,8,1153
E01003745,898,8,210,13,7,1136
E01003746,1100,25,97,29,10,1261
E01003747,849,24,155,25,2,1055
E01003748,1052,16,153,44,19,1284
E01003749,1035,32,210,43,26,1346
E01003750,1175,32,137,42,32,1418
E01003751,500,36,796,99,38,1469
E01003752,587,58,1171,155,27,1998
E01003753,378,23,925,118,42,1486
E01003754,328,20,767,89,58,1262
E01003755,331,35,936,87,70,1459
E01003756,395,40,951,132,75,1593
E01003757,440,46,757,166,35,1444
E01003758,380,67,995,288,54,1784
E01003759,872,19,218,44,26,1179
E01003760,887,38,258,162,41,1386
E01003761,586,53,213,291,41,1184
E01003762,1025,50,103,87,22,1287
E01003763,810,39,410,154,25,1438
E01003764,1188,48,228,75,39,1578
E01003765,943,40,196,51,22,1252
E01003766,295,23,950,131,54,1453
E01003767,280,29,900,143,50,1402
E01003768,294,35,832,142,80,1383
E01003769,273,45,786,139,54,1297
E01003770,751,66,862,224,73,1976
E01003771,345,56,832,133,44,1410
E01003772,343,33,778,109,50,1313
E01003773,461,33,597,153,14,1258
E01003774,1170,44,214,46,24,1498
E01003775,890,30,414,51,40,1425
E01003776,1075,62,161,118,14,1430
E01003777,1191,37,259,47,21,1555
E01003778,1185,44,273,51,30,1583
E01003779,1055,38,164,61,11,1329
E01003780,746,30,397,34,9,1216
E01003781,411,34,718,112,28,1303
E01003782,225,33,918,87,27,1290
E01003783,445,53,974,200,54,1726
E01003784,264,29,871,122,50,1336
E01003785,366,43,843,121,50,1423
E01003786,393,25,554,96,23,1091
E01003787,298,23,724,94,21,1160
E01003788,358,27,876,84,55,1400
E01003789,885,26,266,31,14,1222
E01003790,805,47,163,87,12,1114
E01003791,945,34,161,63,23,1226
E01003792,889,31,139,58,12,1129
E01003793,875,55,184,130,28,1272
E01003794,816,31,212,61,12,1132
E01003795,690,22,165,42,18,937
E01003796,911,43,199,98,23,1274
E01003797,1021,19,39,7,22,1108
E01003798,1102,33,40,13,37,1225
E01003799,1158,24,55,10,18,1265
E01003800,1042,33,71,27,48,1221
E01003801,924,34,87,9,35,1089
E01003802,869,27,152,12,39,1099
E01003803,966,34,114,41,36,1191
E01003804,1201,33,102,16,18,1370
E01003805,1133,26,60,5,14,1238
E01003806,1062,17,36,3,14,1132
E01003807,1350,30,58,12,34,1484
E01003808,1303,21,45,16,29,1414
E01003809,1238,21,54,11,16,1340
E01003810,1118,25,52,10,15,1220
E01003811,1115,13,33,10,5,1176
E01003812,1289,29,95,19,12,1444
E01003813,1228,22,34,19,9,1312
E01003814,1301,19,67,14,21,1422
E01003815,1222,42,101,24,27,1416
E01003816,1135,37,67,7,22,1268
E01003817,1379,25,143,62,43,1652
E01003818,1017,43,97,23,66,1246
E01003819,1125,28,103,39,35,1330
E01003820,1309,42,113,28,27,1519
E01003821,1152,33,108,18,18,1329
E01003822,1029,13,87,12,8,1149
E01003823,1269,29,96,14,21,1429
E01003824,1163,17,102,5,7,1294
E01003825,1257,30,64,10,18,1379
E01003826,1247,36,91,24,18,1416
E01003827,1248,37,71,20,11,1387
E01003828,1145,14,70,11,9,1249
E01003829,1103,37,120,42,27,1329
E01003830,1194,45,138,29,17,1423
E01003831,1064,34,109,38,24,1269
E01003832,969,36,123,23,10,1161
E01003833,990,30,95,16,18,1149
E01003834,1315,32,84,28,37,1496
E01003835,1051,17,53,2,5,1128
E01003836,1053,24,58,29,14,1178
E01003837,1298,31,81,19,16,1445
E01003838,1238,23,84,20,20,1385
E01003839,1324,40,86,29,21,1500
E01003840,681,41,444,56,26,1248
E01003841,934,50,356,122,26,1488
E01003842,1133,29,123,22,22,1329
E01003843,1101,35,388,38,45,1607
E01003844,1015,19,146,14,14,1208
E01003845,1084,24,207,12,26,1353
E01003846,1185,33,86,3,15,1322
E01003847,1209,23,116,7,34,1389
E01003848,1283,37,99,25,21,1465
E01003849,1103,20,91,12,17,1243
E01003851,1201,19,68,4,16,1308
E01003852,978,28,61,8,46,1121
E01003853,1069,38,52,19,19,1197
E01003854,1032,33,51,14,13,1143
E01003855,1202,36,93,38,29,1398
E01003856,1154,45,55,21,13,1288
E01003857,1230,35,58,15,21,1359
E01003858,1189,20,28,5,10,1252
E01003859,1075,31,77,11,28,1222
E01003860,1280,33,97,23,21,1454
E01003861,1278,38,96,37,27,1476
E01003862,904,39,127,26,27,1123
E01003863,989,33,90,19,21,1152
E01003864,1034,43,112,18,11,1218
E01003865,835,35,110,17,20,1017
E01003866,1106,24,40,16,9,1195
E01003867,950,33,162,19,33,1197
E01003868,1072,25,63,3,6,1169
E01003869,1182,24,114,15,12,1347
E01003870,1287,25,79,12,25,1428
E01003871,1081,40,53,17,33,1224
E01003872,1052,33,65,6,16,1172
E01003873,1202,38,97,12,24,1373
E01003874,1172,47,55,13,18,1305
E01003875,1043,37,116,16,46,1258
E01003876,1276,28,85,10,33,1432
E01003877,1120,27,53,5,11,1216
E01003878,984,40,95,9,21,1149
E01003879,1108,42,62,33,51,1296
E01003880,1024,27,67,2,17,1137
E01003881,1468,52,65,26,8,1619
E01003882,1289,30,68,12,23,1422
E01003883,1366,28,50,12,18,1474
E01003884,1201,24,46,22,12,1305
E01003885,1084,23,53,10,15,1185
E01003886,1176,27,71,12,17,1303
E01003887,1312,21,40,10,9,1392
E01003888,1368,59,90,27,22,1566
E01003889,1376,18,53,6,8,1461
E01003890,1100,26,51,8,15,1200
E01003891,1353,29,53,11,6,1452
E01003892,1445,41,107,12,37,1642
E01003893,1243,22,72,13,7,1357
E01003894,1210,34,69,13,8,1334
E01003895,1262,35,54,15,11,1377
E01003896,1281,24,89,13,8,1415
E01003897,1333,31,84,22,20,1490
E01003898,1128,23,47,8,12,1218
E01003899,970,31,79,12,16,1108
E01003900,979,33,154,23,33,1222
E01003901,1094,21,74,26,19,1234
E01003902,818,35,109,26,12,1000
E01003903,1003,29,161,33,25,1251
E01003904,1053,26,81,26,15,1201
E01003905,937,23,161,12,22,1155
E01003906,1105,20,142,25,24,1316
E01003907,968,32,246,38,36,1320
E01003908,1106,31,257,30,29,1453
E01003909,1058,39,150,30,10,1287
E01003910,1169,24,90,11,41,1335
E01003911,629,77,144,569,69,1488
E01003912,289,77,68,649,53,1136
E01003913,1071,54,132,255,51,1563
E01003914,991,71,115,319,37,1533
E01003915,682,71,119,635,65,1572
E01003916,946,106,134,526,101,1813
E01003917,807,53,123,436,60,1479
E01003918,465,65,110,544,45,1229
E01003919,812,77,126,394,49,1458
E01003920,512,52,109,636,56,1365
E01003921,569,52,113,412,68,1214
E01003922,664,56,113,615,57,1505
E01003923,834,70,104,376,52,1436
E01003924,462,83,122,730,95,1492
E01003925,490,56,66,385,38,1035
E01003926,465,48,105,450,45,1113
E01003927,1603,91,213,219,41,2167
E01003929,1400,82,178,220,48,1928
E01003930,861,74,193,169,50,1347
E01003932,683,74,205,379,27,1368
E01003933,931,75,301,210,45,1562
E01003934,878,72,151,149,20,1270
E01003935,675,60,332,112,31,1210
E01003936,1191,83,360,81,31,1746
E01003937,837,79,273,166,46,1401
E01003938,791,67,206,365,56,1485
E01003939,948,75,334,234,36,1627
E01003940,515,53,155,378,43,1144
E01003941,1124,49,219,248,60,1700
E01003942,638,77,240,330,59,1344
E01003943,414,55,210,337,42,1058
E01003945,991,40,132,179,26,1368
E01003946,952,47,126,220,21,1366
E01003947,547,55,44,406,48,1100
E01003948,967,59,81,163,22,1292
E01003949,1177,54,110,180,25,1546
E01003950,845,63,92,456,43,1499
E01003951,902,41,188,89,11,1231
E01003952,1015,43,86,196,18,1358
E01003953,1286,77,136,262,37,1798
E01003954,926,63,72,216,18,1295
E01003955,1099,82,92,245,33,1551
E01003956,997,76,53,230,11,1367
E01003957,1080,54,79,194,28,1435
E01003958,1022,42,81,194,19,1358
E01003960,1013,85,176,241,43,1558
E01003961,824,72,129,521,92,1638
E01003963,522,52,192,440,55,1261
E01003964,794,97,146,429,98,1564
E01003966,773,93,175,452,79,1572
E01003967,480,43,131,548,95,1297
E01003968,309,51,133,531,45,1069
E01003969,965,87,142,274,91,1559
E01003970,486,40,113,464,31,1134
E01003971,389,61,119,608,63,1240
E01003972,665,54,112,420,40,1291
E01003973,755,54,99,347,44,1299
E01003974,364,30,119,414,39,966
E01003975,700,77,89,306,58,1230
E01003976,1071,70,164,265,64,1634
E01003977,956,69,76,250,54,1405
E01003978,1025,64,183,221,62,1555
E01003979,974,64,190,266,51,1545
E01003980,1066,78,176,313,49,1682
E01003981,902,69,266,224,44,1505
E01003983,477,83,101,746,65,1472
E01003984,795,107,125,588,69,1684
E01003986,569,37,91,234,34,965
E01003987,877,41,119,338,40,1415
E01003988,688,73,121,720,102,1704
E01003989,479,51,76,713,77,1396
E01003990,541,71,137,769,73,1591
E01003991,580,34,104,277,28,1023
E01003992,564,58,74,384,52,1132
E01003993,486,61,89,571,62,1269
E01003994,705,99,128,290,54,1276
E01003995,714,50,56,288,39,1147
E01003997,584,66,71,234,45,1000
E01003998,872,52,58,158,36,1176
E01003999,692,67,98,259,49,1165
E01004000,740,125,79,564,40,1548
E01004001,617,67,78,519,47,1328
E01004002,866,77,64,276,23,1306
E01004003,535,74,99,600,58,1366
E01004004,1069,118,136,682,52,2057
E01004005,651,101,122,762,67,1703
E01004006,855,90,99,554,42,1640
E01004007,244,37,80,532,40,933
E01004008,509,79,186,812,66,1652
E01004010,407,79,107,496,84,1173
E01004011,334,63,138,916,53,1504
E01004012,713,118,159,814,76,1880
E01004013,359,60,162,612,52,1245
E01004014,434,62,91,736,54,1377
E01004015,938,49,65,181,24,1257
E01004016,1215,62,103,396,30,1806
E01004017,1002,42,47,152,17,1260
E01004018,1196,65,56,180,36,1533
E01004019,931,109,108,621,27,1796
E01004020,600,56,83,522,29,1290
E01004021,1425,73,75,224,36,1833
E01004022,1457,99,244,247,66,2113
E01004023,889,54,121,177,39,1280
E01004024,993,48,108,301,69,1519
E01004027,1165,85,185,288,76,1799
E01004028,856,47,122,273,37,1335
E01004029,1012,56,381,106,56,1611
E01004030,937,51,119,154,37,1298
E01004031,1031,65,327,213,68,1704
E01004032,952,49,422,54,43,1520
E01004033,757,44,157,259,34,1251
E01004034,816,41,94,212,43,1206
E01004035,804,60,102,262,52,1280
E01004036,826,66,190,370,52,1504
E01004037,939,62,133,348,85,1567
E01004038,1005,99,214,379,72,1769
E01004039,717,74,213,210,74,1288
E01004040,528,93,88,561,62,1332
E01004041,712,55,111,337,82,1297
E01004042,1075,50,74,207,37,1443
E01004043,972,38,49,102,17,1178
E01004044,601,33,107,294,42,1077
E01004045,347,75,85,559,34,1100
E01004046,886,68,81,262,35,1332
E01004047,490,65,130,430,73,1188
E01004048,820,63,111,249,30,1273
E01004049,608,61,218,387,49,1323
E01004050,974,53,50,130,52,1259
E01004051,897,51,95,114,14,1171
E01004052,1049,64,119,218,47,1497
E01004053,1224,76,253,39,53,1645
E01004054,1097,45,242,57,36,1477
E01004055,801,20,66,141,15,1043
E01004056,1318,66,227,153,52,1816
E01004057,897,45,176,140,19,1277
E01004058,1180,42,282,48,29,1581
E01004059,917,37,386,45,21,1406
E01004060,965,79,206,261,44,1555
E01004061,993,78,94,289,36,1490
E01004062,843,75,186,434,30,1568
E01004063,1063,82,78,412,40,1675
E01004064,794,69,98,499,53,1513
E01004065,866,48,48,255,31,1248
E01004066,883,83,124,520,52,1662
E01004067,571,54,214,802,73,1714
E01004068,716,69,124,662,36,1607
E01004069,899,36,94,24,14,1067
E01004070,1259,63,78,142,19,1561
E01004071,921,44,79,209,15,1268
E01004072,1092,51,85,93,14,1335
E01004073,1229,40,84,115,13,1481
E01004074,1157,48,100,77,20,1402
E01004075,1199,25,76,33,11,1344
E01004076,872,34,120,121,10,1157
E01004077,993,20,141,84,11,1249
E01004078,1057,33,62,98,13,1263
E01004079,954,14,86,62,5,1121
E01004080,829,25,157,78,9,1098
E01004081,922,39,120,72,4,1157
E01004082,849,19,182,62,19,1131
E01004083,807,46,88,104,25,1070
E01004084,926,21,229,40,12,1228
E01004085,929,18,268,85,7,1307
E01004086,852,48,296,76,10,1282
E01004087,909,22,225,36,21,1213
E01004088,1038,69,77,105,8,1297
E01004089,664,33,77,126,19,919
E01004090,668,33,108,85,12,906
E01004091,947,24,86,12,6,1075
E01004092,952,21,195,34,27,1229
E01004093,941,15,228,24,21,1229
E01004094,1136,20,123,31,24,1334
E01004095,1040,28,174,25,13,1280
E01004096,932,52,130,78,15,1207
E01004097,1162,20,98,42,16,1338
E01004098,879,30,54,28,6,997
E01004099,1056,33,30,43,15,1177
E01004100,973,33,55,32,8,1101
E01004101,980,33,63,30,4,1110
E01004102,994,19,62,19,10,1104
E01004103,1077,46,117,44,14,1298
E01004104,1093,27,71,24,7,1222
E01004105,1213,27,139,36,6,1421
E01004106,1083,14,133,24,4,1258
E01004107,992,25,88,64,12,1181
E01004108,1094,17,146,50,15,1322
E01004109,1080,33,61,92,12,1278
E01004110,1219,43,181,39,13,1495
E01004111,970,18,142,13,12,1155
E01004112,1164,24,105,15,5,1313
E01004114,1103,21,231,32,25,1412
E01004115,1114,27,193,29,11,1374
E01004116,1196,17,105,18,11,1347
E01004117,1045,15,73,12,9,1154
E01004118,1107,29,157,21,32,1346
E01004119,1018,20,98,14,7,1157
E01004120,1129,14,103,17,5,1268
E01004121,1013,30,180,23,25,1271
E01004122,968,19,106,9,22,1124
E01004123,1117,54,279,143,34,1627
E01004124,1073,36,178,71,17,1375
E01004125,962,28,117,67,25,1199
E01004126,888,36,93,69,8,1094
E01004127,994,30,108,72,28,1232
E01004128,869,34,123,113,21,1160
E01004129,1037,42,206,75,14,1374
E01004130,1031,20,157,72,12,1292
E01004131,1039,19,154,51,12,1275
E01004132,987,20,115,15,11,1148
E01004133,978,17,131,16,9,1151
E01004134,889,36,202,38,14,1179
E01004135,964,22,147,46,14,1193
E01004136,986,21,202,33,27,1269
E01004137,996,30,145,49,27,1247
E01004138,1010,35,126,50,13,1234
E01004139,904,31,117,49,12,1113
E01004140,868,50,186,109,40,1253
E01004141,1000,29,133,90,18,1270
E01004142,1248,57,222,110,36,1673
E01004143,945,35,117,35,9,1141
E01004144,1047,52,175,63,11,1348
E01004145,1338,29,210,82,21,1680
E01004146,1077,38,143,60,12,1330
E01004147,1104,20,140,29,4,1297
E01004148,922,43,152,58,16,1191
E01004149,1191,42,104,62,25,1424
E01004150,1059,41,149,76,40,1365
E01004151,1166,42,165,53,32,1458
E01004152,1057,43,179,61,26,1366
E01004153,1019,43,235,52,78,1427
E01004154,995,19,113,26,19,1172
E01004155,1099,24,176,56,28,1383
E01004156,1063,34,259,60,24,1440
E01004157,848,19,141,2,10,1020
E01004158,992,40,149,47,18,1246
E01004159,1033,33,121,39,14,1240
E01004160,997,42,154,49,12,1254
E01004161,958,27,94,34,23,1136
E01004162,946,40,229,49,32,1296
E01004163,1072,25,85,58,4,1244
E01004164,1111,26,59,31,7,1234
E01004165,1128,20,109,75,13,1345
E01004166,1037,45,83,35,7,1207
E01004167,793,39,81,88,21,1022
E01004168,1131,18,75,31,13,1268
E01004169,688,35,56,62,18,859
E01004170,1156,42,164,52,10,1424
E01004171,932,34,152,60,15,1193
E01004172,971,47,117,76,14,1225
E01004173,958,17,71,46,22,1114
E01004174,960,51,106,39,5,1161
E01004175,1115,32,68,59,15,1289
E01004176,961,29,71,54,8,1123
E01004177,1206,42,112,102,18,1480
E01004178,1276,68,178,88,22,1632
E01004179,1026,27,129,54,15,1251
E01004180,1198,33,143,53,7,1434
E01004181,1107,30,146,87,16,1386
E01004182,954,32,105,56,13,1160
E01004183,1011,38,140,95,10,1294
E01004184,907,36,99,83,17,1142
E01004185,771,51,107,134,15,1078
E01004186,1042,46,121,138,12,1359
E01004187,1038,28,77,81,6,1230
E01004188,995,46,123,99,20,1283
E01004189,1101,47,181,96,20,1445
E01004190,970,29,103,12,21,1135
E01004191,1116,14,161,35,14,1340
E01004192,1236,31,182,29,35,1513
E01004193,1393,48,179,37,36,1693
E01004194,938,28,101,20,6,1093
E01004195,1002,46,174,20,37,1279
E01004196,952,27,161,19,20,1179
E01004197,1094,94,513,150,55,1906
E01004198,630,55,440,99,18,1242
E01004199,482,21,565,87,17,1172
E01004200,949,75,294,46,35,1399
E01004201,819,40,267,78,41,1245
E01004202,829,62,428,68,40,1427
E01004203,983,66,334,41,42,1466
E01004204,659,31,431,123,43,1287
E01004205,401,27,1021,99,32,1580
E01004206,378,33,651,92,30,1184
E01004207,533,44,475,78,21,1151
E01004208,932,88,620,61,45,1746
E01004209,325,24,552,68,16,985
E01004211,840,72,326,71,32,1341
E01004212,751,44,549,92,47,1483
E01004214,603,46,427,113,19,1208
E01004215,1187,75,731,151,62,2206
E01004216,858,42,386,42,35,1363
E01004217,961,33,371,53,11,1429
E01004218,1009,52,307,53,40,1461
E01004219,579,48,887,187,54,1755
E01004221,999,42,417,77,26,1561
E01004222,1176,81,381,261,33,1932
E01004223,1106,69,269,207,24,1675
E01004224,1006,71,363,161,32,1633
E01004225,1548,88,225,76,29,1966
E01004226,782,42,348,123,25,1320
E01004228,1237,67,159,75,26,1564
E01004229,619,36,426,88,22,1191
E01004230,1095,56,367,158,27,1703
E01004231,584,60,531,112,27,1314
E01004232,1044,44,285,58,16,1447
E01004233,799,38,410,119,21,1387
E01004234,1439,70,206,106,20,1841
E01004235,284,31,506,126,31,978
E01004236,307,30,707,136,22,1202
E01004237,426,33,300,102,38,899
E01004238,645,54,1063,241,65,2068
E01004239,457,36,531,164,22,1210
E01004240,495,56,550,136,32,1269
E01004241,420,40,545,151,19,1175
E01004242,694,53,777,234,50,1808
E01004243,540,36,530,147,19,1272
E01004244,633,38,496,197,28,1392
E01004245,272,29,562,124,22,1009
E01004246,860,46,488,114,32,1540
E01004247,648,35,603,133,38,1457
E01004248,325,29,398,130,14,896
E01004249,617,35,579,207,41,1479
E01004250,772,53,633,195,35,1688
E01004251,679,50,721,108,24,1582
E01004252,958,64,824,197,46,2089
E01004253,832,72,619,157,33,1713
E01004254,1309,33,430,62,58,1892
E01004255,475,33,609,108,25,1250
E01004256,542,33,609,83,32,1299
E01004257,537,42,596,130,11,1316
E01004258,865,46,289,68,16,1284
E01004259,993,76,288,68,46,1471
E01004260,684,51,489,83,55,1362
E01004261,1007,71,914,136,59,2187
E01004262,750,44,603,73,36,1506
E01004263,653,31,314,71,29,1098
E01004264,268,25,725,84,22,1124
E01004266,876,39,266,56,20,1257
E01004267,807,48,420,143,37,1455
E01004268,498,37,596,173,40,1344
E01004269,718,49,620,146,37,1570
E01004270,1118,52,544,132,46,1892
E01004271,371,31,542,142,12,1098
E01004272,343,33,901,150,16,1443
E01004273,303,29,828,185,16,1361
E01004274,602,46,741,101,36,1526
E01004275,1096,50,300,51,24,1521
E01004276,1325,49,393,39,45,1851
E01004277,916,48,448,22,46,1480
E01004280,761,34,501,122,55,1473
E01004281,936,43,491,30,31,1531
E01004283,826,56,817,98,40,1837
E01004284,698,53,836,146,33,1766
E01004285,412,39,1024,111,19,1605
E01004286,750,43,834,98,26,1751
E01004287,686,52,758,95,71,1662
E01004288,434,28,593,85,13,1153
E01004289,676,38,613,93,57,1477
E01004290,712,52,277,54,41,1136
E01004291,1326,42,227,29,44,1668
E01004292,1164,64,277,26,36,1567
E01004293,1508,41,306,36,34,1925
E01004294,1010,63,396,64,33,1566
E01004295,305,26,648,76,15,1070
E01004296,694,39,475,62,23,1293
E01004297,1275,31,244,48,28,1626
E01004298,452,44,679,87,28,1290
E01004300,422,31,465,90,21,1029
E01004301,314,19,581,48,13,975
E01004302,335,28,914,97,32,1406
E01004303,982,45,627,166,24,1844
E01004304,434,36,857,92,56,1475
E01004305,641,41,660,90,40,1472
E01004306,773,47,617,62,39,1538
E01004307,1428,72,420,60,67,2047
E01004308,535,34,583,33,18,1203
E01004309,1003,81,1090,157,55,2386
E01004310,756,48,795,75,28,1702
E01004311,740,34,337,87,17,1215
E01004312,577,52,518,106,35,1288
E01004313,898,49,480,99,52,1578
E01004314,751,43,111,21,13,939
E01004315,893,59,368,88,30,1438
E01004316,492,28,348,50,18,936
E01004317,1531,108,601,98,44,2382
E01004318,590,63,292,141,54,1140
E01004319,386,40,953,68,23,1470
E01004321,485,25,889,73,32,1504
E01004322,477,26,456,61,37,1057
E01004323,555,35,539,31,30,1190
E01004324,393,18,693,54,22,1180
E01004325,1256,80,751,57,50,2194
E01004326,576,36,463,62,43,1180
E01004327,467,48,185,240,42,982
E01004328,755,61,255,342,73,1486
E01004329,670,42,364,411,36,1523
E01004330,785,42,257,360,33,1477
E01004331,621,70,303,410,38,1442
E01004332,685,57,335,309,62,1448
E01004333,617,70,309,266,58,1320
E01004334,485,56,202,324,61,1128
E01004335,426,51,280,467,44,1268
E01004336,508,64,566,294,48,1480
E01004337,750,46,401,273,51,1521
E01004338,693,51,441,268,45,1498
E01004339,692,46,278,242,141,1399
E01004340,654,66,273,404,63,1460
E01004341,574,50,237,436,64,1361
E01004342,832,55,396,262,125,1670
E01004343,968,52,168,197,34,1419
E01004344,610,70,259,344,58,1341
E01004345,737,71,249,325,52,1434
E01004346,807,45,166,170,42,1230
E01004347,1002,63,208,227,52,1552
E01004348,1070,79,385,416,93,2043
E01004349,909,41,66,98,15,1129
E01004350,1251,29,64,97,24,1465
E01004351,1155,21,37,65,26,1304
E01004352,1485,35,44,47,23,1634
E01004353,1400,28,49,34,18,1529
E01004354,1257,37,55,53,7,1409
E01004355,993,46,92,123,23,1277
E01004356,1004,41,122,94,39,1300
E01004357,937,28,115,130,30,1240
E01004358,1175,39,71,74,24,1383
E01004359,1140,37,79,80,14,1350
E01004360,898,20,98,50,35,1101
E01004361,888,31,53,79,31,1082
E01004362,880,42,185,182,57,1346
E01004363,618,37,411,159,46,1271
E01004364,503,36,448,273,56,1316
E01004365,531,41,903,250,127,1852
E01004366,798,64,386,232,69,1549
E01004367,505,34,484,210,41,1274
E01004368,750,42,484,224,60,1560
E01004369,719,49,340,194,56,1358
E01004370,723,50,299,288,57,1417
E01004371,746,50,327,239,59,1421
E01004372,906,48,191,257,36,1438
E01004373,655,61,422,243,54,1435
E01004374,769,47,429,245,59,1549
E01004375,745,48,451,191,69,1504
E01004376,679,57,705,184,76,1701
E01004377,883,47,206,216,31,1383
E01004378,888,61,203,228,43,1423
E01004379,896,38,96,90,15,1135
E01004380,965,46,97,75,20,1203
E01004381,1075,43,165,110,19,1412
E01004382,553,45,105,205,36,944
E01004383,999,39,101,93,42,1274
E01004384,1024,48,103,191,40,1406
E01004385,850,39,85,100,28,1102
E01004386,1193,33,65,61,22,1374
E01004387,1046,21,57,57,21,1202
E01004388,1031,19,81,74,25,1230
E01004389,1050,28,82,79,30,1269
E01004390,1003,37,52,112,27,1231
E01004391,939,54,260,167,67,1487
E01004392,925,69,591,173,89,1847
E01004393,1041,44,231,445,290,2051
E01004394,709,53,373,234,58,1427
E01004395,783,23,248,138,41,1233
E01004396,774,40,434,120,49,1417
E01004397,869,61,638,261,80,1909
E01004398,793,69,338,243,55,1498
E01004399,570,42,288,317,41,1258
E01004400,725,44,198,289,66,1322
E01004401,927,54,279,308,74,1642
E01004402,678,49,274,303,53,1357
E01004403,749,45,223,277,44,1338
E01004404,784,61,286,331,87,1549
E01004405,587,55,378,209,46,1275
E01004406,728,62,404,218,68,1480
E01004407,439,81,153,434,35,1142
E01004408,800,31,318,177,39,1365
E01004409,822,53,318,134,55,1382
E01004410,943,73,187,237,67,1507
E01004411,699,51,451,160,82,1443
E01004412,938,46,239,128,35,1386
E01004413,961,35,93,132,27,1248
E01004414,1001,38,111,114,25,1289
E01004415,942,36,110,125,38,1251
E01004416,1079,31,83,128,28,1349
E01004417,980,50,135,148,50,1363
E01004418,869,56,160,163,42,1290
E01004419,802,37,208,176,59,1282
E01004420,582,47,640,358,91,1718
E01004421,441,32,774,295,72,1614
E01004422,589,36,286,286,65,1262
E01004423,578,51,439,367,97,1532
E01004424,444,59,403,360,81,1347
E01004425,746,82,243,397,84,1552
E01004426,513,40,387,357,45,1342
E01004427,764,53,274,388,81,1560
E01004428,507,46,222,415,71,1261
E01004429,617,64,340,345,38,1404
E01004430,828,67,589,294,91,1869
E01004432,580,28,324,310,64,1306
E01004434,595,68,424,392,79,1558
E01004435,688,65,336,342,75,1506
E01004436,765,36,385,165,69,1420
E01004437,890,69,316,234,63,1572
E01004438,968,59,488,169,90,1774
E01004439,699,53,345,225,38,1360
E01004440,955,84,447,250,49,1785
E01004441,826,41,331,122,52,1372
E01004442,889,73,296,164,59,1481
E01004443,494,47,713,147,47,1448
E01004444,937,68,435,336,119,1895
E01004445,658,46,471,170,59,1404
E01004446,763,49,376,200,85,1473
E01004447,683,35,512,229,44,1503
E01004448,787,57,203,265,84,1396
E01004449,494,71,440,294,59,1358
E01004450,1021,38,97,128,31,1315
E01004451,1045,56,110,158,40,1409
E01004452,957,55,117,145,35,1309
E01004453,812,50,176,218,45,1301
E01004454,900,39,163,170,61,1333
E01004455,640,42,242,219,42,1185
E01004456,586,40,134,385,27,1172
E01004457,762,49,367,246,69,1493
E01004458,760,42,418,184,69,1473
E01004459,501,37,248,268,50,1104
E01004460,799,69,356,240,61,1525
E01004461,871,53,478,205,81,1688
E01004462,598,42,501,235,50,1426
E01004463,1147,62,146,184,47,1586
E01004464,534,59,230,287,47,1157
E01004465,666,41,214,196,38,1155
E01004466,841,51,240,150,24,1306
E01004467,790,54,308,362,105,1619
E01004468,836,44,228,193,25,1326
E01004469,551,66,267,250,68,1202
E01004470,627,51,202,257,48,1185
E01004471,685,37,228,292,61,1303
E01004472,1222,43,125,85,11,1486
E01004473,1180,50,144,89,16,1479
E01004474,1307,61,144,151,30,1693
E01004475,918,43,116,127,14,1218
E01004476,1139,53,172,94,21,1479
E01004477,1153,19,73,18,5,1268
E01004478,952,34,89,48,12,1135
E01004479,1070,21,57,47,10,1205
E01004480,1153,34,179,89,19,1474
E01004481,1068,64,241,97,28,1498
E01004482,903,37,246,126,22,1334
E01004483,1275,66,288,160,29,1818
E01004484,1047,54,95,119,23,1338
E01004485,1078,62,154,121,13,1428
E01004486,1083,47,107,82,11,1330
E01004487,1013,44,89,150,17,1313
E01004488,934,55,117,124,11,1241
E01004489,885,46,93,102,15,1141
E01004490,1071,38,75,51,15,1250
E01004491,1055,58,388,279,50,1830
E01004492,1067,52,178,149,21,1467
E01004493,1222,36,120,114,22,1514
E01004494,1060,65,134,141,25,1425
E01004495,671,50,197,277,25,1220
E01004496,1489,60,141,70,29,1789
E01004497,947,37,69,87,13,1153
E01004498,1279,37,106,56,11,1489
E01004499,1128,33,121,61,22,1365
E01004500,1237,52,124,43,38,1494
E01004501,1071,42,102,88,38,1341
E01004502,1109,55,136,24,14,1338
E01004503,1192,52,109,57,35,1445
E01004504,922,36,187,34,17,1196
E01004505,1163,45,143,37,75,1463
E01004506,1419,62,149,44,37,1711
E01004507,1373,48,162,51,41,1675
E01004508,1475,62,121,129,24,1811
E01004509,1592,61,204,96,71,2024
E01004510,1366,64,106,170,18,1724
E01004511,1284,59,103,33,7,1486
E01004512,998,29,86,61,12,1186
E01004513,1107,71,172,169,37,1556
E01004514,1279,38,62,81,21,1481
E01004515,1062,68,112,228,23,1493
E01004516,927,67,230,150,14,1388
E01004517,940,90,172,321,44,1567
E01004518,892,47,191,190,28,1348
E01004519,740,71,314,218,15,1358
E01004520,531,46,276,169,10,1032
E01004521,854,60,203,347,46,1510
E01004522,737,38,192,254,33,1254
E01004523,912,44,187,142,17,1302
E01004524,755,58,205,287,22,1327
E01004525,753,52,517,182,42,1546
E01004526,774,60,337,174,30,1375
E01004527,695,40,389,171,27,1322
E01004528,622,53,264,237,39,1215
E01004529,1128,73,333,175,33,1742
E01004530,983,67,335,183,33,1601
E01004531,706,80,353,195,15,1349
E01004532,840,63,142,164,17,1226
E01004533,669,49,217,143,28,1106
E01004534,1408,51,83,78,17,1637
E01004535,473,66,147,524,53,1263
E01004536,1138,96,153,326,39,1752
E01004537,833,75,157,425,32,1522
E01004538,994,77,168,352,37,1628
E01004539,775,88,151,471,53,1538
E01004540,1286,81,90,239,37,1733
E01004541,698,71,131,444,29,1373
E01004542,1098,31,51,94,8,1282
E01004543,1234,28,61,69,20,1412
E01004544,966,21,93,113,20,1213
E01004545,1251,43,120,50,14,1478
E01004546,1041,36,112,87,7,1283
E01004547,787,45,116,195,25,1168
E01004548,1414,68,242,111,21,1856
E01004549,1010,62,172,127,16,1387
E01004550,977,44,66,103,31,1221
E01004551,1169,77,121,192,24,1583
E01004552,1585,62,96,65,18,1826
E01004553,1224,31,63,90,15,1423
E01004554,1124,44,65,51,6,1290
E01004555,1111,35,49,37,12,1244
E01004556,1055,29,39,43,8,1174
E01004557,1056,35,51,68,18,1228
E01004558,1139,35,55,73,7,1309
E01004559,906,20,33,48,12,1019
E01004560,1389,45,98,142,41,1715
E01004562,815,93,142,384,50,1484
E01004563,909,105,166,371,50,1601
E01004564,1272,70,45,178,37,1602
E01004565,1235,53,56,114,24,1482
E01004566,1203,39,53,46,38,1379
E01004567,869,99,233,527,67,1795
E01004568,977,66,126,188,33,1390
E01004569,1475,99,216,200,57,2047
E01004570,952,155,148,221,53,1529
E01004571,988,51,144,160,50,1393
E01004572,1016,29,116,140,51,1352
E01004573,966,56,203,90,36,1351
E01004574,781,69,142,250,59,1301
E01004575,1140,78,152,158,44,1572
E01004576,911,38,116,115,40,1220
E01004577,1402,49,79,124,32,1686
E01004579,1068,35,72,137,36,1348
E01004580,1375,71,136,190,39,1811
E01004581,1297,53,118,119,39,1626
E01004582,1415,88,137,98,77,1815
E01004583,1295,53,105,109,60,1622
E01004584,620,81,101,451,23,1276
E01004585,1404,62,90,73,32,1661
E01004586,1425,45,59,99,14,1642
E01004587,1254,58,82,69,22,1485
E01004588,1445,50,77,88,41,1701
E01004589,1291,37,39,64,17,1448
E01004590,1150,51,76,176,14,1467
E01004591,1131,66,91,230,37,1555
E01004592,1147,52,59,120,22,1400
E01004593,1231,46,189,61,41,1568
E01004594,1065,26,150,22,14,1277
E01004595,1249,43,141,43,18,1494
E01004596,1079,29,135,28,13,1284
E01004597,1162,26,138,99,23,1448
E01004598,1340,43,92,51,24,1550
E01004599,1008,32,75,23,6,1144
E01004600,835,71,221,440,46,1613
E01004601,1398,57,260,122,33,1870
E01004602,1230,39,106,36,6,1417
E01004604,1188,23,27,8,11,1257
E01004605,1231,34,89,60,16,1430
E01004606,1310,22,71,9,18,1430
E01004607,1265,34,64,20,15,1398
E01004608,1279,57,66,55,26,1483
E01004609,1647,39,175,30,34,1925
E01004610,713,51,616,194,50,1624
E01004611,745,38,373,124,30,1310
E01004612,576,32,602,163,36,1409
E01004613,636,59,359,231,35,1320
E01004614,973,58,403,233,87,1754
E01004615,755,68,209,311,26,1369
E01004616,983,97,452,238,68,1838
E01004617,708,75,387,217,38,1425
E01004618,771,34,362,95,20,1282
E01004619,942,29,35,50,7,1063
E01004620,1090,37,87,101,13,1328
E01004621,1158,46,89,68,8,1369
E01004622,1454,137,165,297,44,2097
E01004623,1158,40,84,87,7,1376
E01004624,1116,44,59,100,7,1326
E01004625,979,8,30,14,8,1039
E01004626,1227,50,141,87,20,1525
E01004627,1096,31,55,83,9,1274
E01004628,1387,50,302,165,37,1941
E01004629,994,50,180,40,32,1296
E01004630,824,59,206,200,43,1332
E01004631,923,30,182,70,48,1253
E01004632,985,37,142,36,15,1215
E01004633,752,72,181,207,40,1252
E01004634,984,32,123,85,44,1268
E01004635,1051,43,154,57,44,1349
E01004636,875,52,154,72,34,1187
E01004637,916,40,144,84,34,1218
E01004638,1018,27,61,18,8,1132
E01004639,1240,32,130,45,31,1478
E01004640,1296,43,92,40,27,1498
E01004641,1315,51,124,75,44,1609
E01004642,1224,68,95,89,43,1519
E01004643,1136,80,187,157,69,1629
E01004644,1312,53,109,89,46,1609
E01004645,1132,62,143,260,47,1644
E01004646,857,28,212,35,96,1228
E01004647,843,30,205,41,114,1233
E01004648,1381,63,257,57,221,1979
E01004649,794,26,368,63,171,1422
E01004650,1190,46,261,45,123,1665
E01004651,1053,49,431,46,180,1759
E01004652,968,78,312,66,229,1653
E01004653,1230,58,114,58,83,1543
E01004654,1509,88,239,68,116,2020
E01004656,1237,87,262,105,170,1861
E01004657,996,38,140,18,144,1336
E01004658,767,49,258,46,260,1380
E01004659,1067,60,333,57,138,1655
E01004660,961,58,319,57,159,1554
E01004661,985,74,258,88,246,1651
E01004662,1176,69,273,37,145,1700
E01004663,1019,53,157,59,152,1440
E01004665,659,46,152,107,142,1106
E01004666,634,40,136,64,59,933
E01004667,845,54,138,68,60,1165
E01004668,865,31,129,58,67,1150
E01004669,864,74,173,119,123,1353
E01004670,528,97,553,304,456,1938
E01004674,792,91,254,310,218,1665
E01004675,1001,104,223,256,286,1870
E01004676,854,68,142,173,141,1378
E01004677,982,79,176,252,88,1577
E01004678,911,82,182,240,187,1602
E01004679,893,89,173,312,201,1668
E01004680,901,39,172,19,143,1274
E01004681,1226,101,359,47,189,1922
E01004682,906,80,254,44,149,1433
E01004683,985,67,217,30,144,1443
E01004684,575,67,273,68,375,1358
E01004686,524,48,212,43,464,1291
E01004687,1196,24,95,25,81,1421
E01004688,1056,65,572,31,134,1858
E01004689,765,34,98,34,89,1020
E01004690,955,29,102,31,50,1167
E01004691,960,51,166,32,146,1355
E01004692,784,45,288,47,222,1386
E01004693,888,45,145,43,92,1213
E01004694,1130,66,239,46,133,1614
E01004695,779,47,205,47,107,1185
E01004696,741,69,174,95,217,1296
E01004697,967,58,171,31,135,1362
E01004698,932,73,220,41,134,1400
E01004699,1437,93,263,57,205,2055
E01004700,1099,77,181,49,134,1540
E01004701,951,53,150,30,194,1378
E01004702,875,99,349,234,430,1987
E01004703,1350,64,227,66,171,1878
E01004705,939,26,142,30,86,1223
E01004706,1081,57,136,46,68,1388
E01004707,1210,49,168,42,129,1598
E01004708,943,68,138,132,116,1397
E01004709,876,61,165,81,207,1390
E01004710,639,51,190,145,219,1244
E01004711,826,43,187,91,220,1367
E01004712,1103,59,241,25,119,1547
E01004713,1344,63,117,47,89,1660
E01004714,1387,56,226,60,209,1938
E01004715,1041,68,328,116,98,1651
E01004716,963,42,192,21,66,1284
E01004717,1132,45,146,10,69,1402
E01004718,799,71,222,389,114,1595
E01004719,929,68,139,229,93,1458
E01004720,957,88,153,235,108,1541
E01004721,818,76,223,302,178,1597
E01004722,564,123,371,483,281,1822
E01004723,962,100,154,392,207,1815
E01004724,962,48,299,37,140,1486
E01004725,628,56,281,98,251,1314
E01004726,895,44,320,54,190,1503
E01004727,978,68,515,54,189,1804
E01004728,842,49,205,78,169,1343
E01004729,821,55,242,85,167,1370
E01004730,882,42,303,28,146,1401
E01004731,1244,46,218,65,53,1626
E01004732,849,54,127,127,100,1257
E01004733,1331,81,187,57,87,1743
E01004734,1203,62,444,60,84,1853
E01004735,1302,61,231,91,49,1734
E01004736,1287,39,258,35,45,1664
E01004737,874,32,81,60,68,1115
E01004738,1005,30,90,41,42,1208
E01004739,1107,25,125,22,18,1297
E01004740,907,42,160,106,78,1293
E01004741,856,34,109,60,39,1098
E01004742,1092,35,74,38,31,1270
E01004743,706,36,208,115,70,1135
E01004744,870,40,107,86,46,1149
E01004745,1461,51,191,77,63,1843
E01004746,812,55,183,72,75,1197
E01004747,1437,64,229,110,99,1939
E01004748,1038,33,128,50,29,1278
E01004749,1629,72,273,61,91,2126
E01004750,1113,38,232,76,98,1557
E01004751,1340,45,98,55,35,1573
E01004752,1124,48,110,88,78,1448
E01004753,1345,73,103,78,62,1661
E01004754,647,57,127,226,197,1254
E01004755,821,94,299,240,332,1786
E01004756,972,65,176,131,163,1507
E01004757,653,53,187,158,159,1210
E01004760,853,61,144,151,135,1344
E01004761,1203,66,275,51,191,1786
E01004762,1237,47,295,66,209,1854
E01004763,1428,121,373,66,75,2063
E01004765,1284,69,253,103,128,1837
E01004766,1183,17,118,15,1,1334
E01004767,1172,19,203,8,3,1405
E01004768,1217,12,40,4,5,1278
E01004769,1207,11,57,1,2,1278
E01004770,1043,8,148,2,5,1206
E01004771,1202,10,83,6,3,1304
E01004772,1183,21,59,18,11,1292
E01004773,1296,15,238,22,15,1586
E01004774,1178,24,124,11,3,1340
E01004775,1214,11,46,9,5,1285
E01004776,1416,10,28,4,2,1460
E01004777,1246,18,13,4,3,1284
E01004778,1001,9,6,1,0,1017
E01004779,1163,10,17,2,1,1193
E01004780,1599,12,18,2,4,1635
E01004781,1327,23,110,12,5,1477
E01004782,911,4,7,0,0,922
E01004783,1248,3,1,5,0,1257
E01004784,1025,8,12,3,1,1049
E01004785,1123,11,30,5,6,1175
E01004786,1189,8,10,6,1,1214
E01004787,1172,10,17,14,3,1216
E01004788,1152,8,10,3,0,1173
E01004789,1180,6,1,1,1,1189
E01004790,1171,7,12,5,1,1196
E01004791,1035,7,6,1,0,1049
E01004792,1236,7,11,1,2,1257
E01004793,1193,14,20,31,1,1259
E01004794,1146,18,24,67,2,1257
E01004795,1237,12,8,8,7,1272
E01004796,1182,16,29,2,0,1229
E01004797,919,10,31,16,11,987
E01004798,1224,10,38,7,0,1279
E01004799,1090,6,39,5,2,1142
E01004800,1016,10,56,9,0,1091
E01004801,1113,30,31,23,1,1198
E01004802,1196,46,34,50,6,1332
E01004803,1320,9,14,2,2,1347
E01004804,1205,4,11,1,4,1225
E01004805,1315,14,17,2,4,1352
E01004806,1236,6,8,6,2,1258
E01004807,1109,5,20,2,2,1138
E01004808,1328,5,17,1,3,1354
E01004809,1444,20,6,2,3,1475
E01004810,1250,8,18,4,0,1280
E01004811,622,24,430,37,15,1128
E01004812,663,16,569,62,23,1333
E01004813,632,25,375,39,16,1087
E01004814,764,27,259,25,13,1088
E01004815,653,17,446,36,14,1166
E01004816,700,11,425,16,6,1158
E01004817,961,22,287,29,18,1317
E01004818,850,23,353,58,19,1303
E01004819,1009,19,203,67,7,1305
E01004820,604,24,473,57,19,1177
E01004822,513,26,644,25,18,1226
E01004823,987,32,304,37,27,1387
E01004824,188,15,999,27,9,1238
E01004825,400,26,714,21,34,1195
E01004826,687,19,402,31,9,1148
E01004827,770,21,302,57,31,1181
E01004828,583,26,565,50,23,1247
E01004829,271,14,687,36,15,1023
E01004830,1057,18,150,13,10,1248
E01004831,998,14,269,6,10,1297
E01004832,992,15,157,19,7,1190
E01004833,1091,13,134,8,8,1254
E01004834,714,27,399,20,7,1167
E01004835,876,12,327,6,10,1231
E01004836,934,3,285,2,8,1232
E01004837,980,13,316,14,4,1327
E01004838,866,22,287,45,16,1236
E01004839,1310,30,168,25,11,1544
E01004840,1266,10,77,8,4,1365
E01004841,1116,21,25,41,7,1210
E01004842,1298,12,65,6,3,1384
E01004843,1121,14,90,8,2,1235
E01004844,1101,12,192,8,10,1323
E01004845,1126,17,224,14,3,1384
E01004846,532,20,345,28,18,943
E01004847,620,25,597,82,42,1366
E01004848,1008,30,281,72,33,1424
E01004849,177,38,894,98,41,1248
E01004850,587,30,538,96,78,1329
E01004851,416,34,691,58,27,1226
E01004852,161,13,924,47,12,1157
E01004853,275,18,719,42,28,1082
E01004854,125,13,923,25,28,1114
E01004855,1035,30,85,10,8,1168
E01004856,888,3,185,12,13,1101
E01004857,925,10,200,6,12,1153
E01004858,1220,14,65,7,4,1310
E01004859,1143,20,36,10,7,1216
E01004860,1188,10,24,7,2,1231
E01004861,1073,22,75,17,3,1190
E01004862,952,15,28,11,7,1013
E01004863,1123,23,30,4,11,1191
E01004864,1196,32,41,8,3,1280
E01004865,863,15,201,5,8,1092
E01004866,881,20,306,73,22,1302
E01004867,883,18,248,3,8,1160
E01004868,898,14,361,35,12,1320
E01004869,1078,24,207,20,3,1332
E01004870,810,28,620,49,30,1537
E01004871,463,15,616,44,26,1164
E01004872,1079,16,95,9,6,1205
E01004873,1084,15,145,24,11,1279
E01004874,1257,18,49,18,8,1350
E01004875,1195,12,65,11,0,1283
E01004876,1333,11,68,27,10,1449
E01004877,815,38,352,50,17,1272
E01004878,697,14,408,18,5,1142
E01004879,642,26,282,39,14,1003
E01004880,906,9,150,13,1,1079
E01004881,1214,6,0,4,4,1228
E01004882,1081,15,9,5,0,1110
E01004883,1159,7,8,4,4,1182
E01004884,1266,6,11,2,0,1285
E01004885,1021,9,67,6,0,1103
E01004886,1066,1,26,7,3,1103
E01004887,1138,13,10,4,1,1166
E01004888,1050,4,12,3,1,1070
E01004889,1111,5,11,4,3,1134
E01004890,1164,7,9,4,2,1186
E01004891,1335,11,12,7,4,1369
E01004892,1276,6,24,2,5,1313
E01004893,1212,5,40,3,1,1261
E01004894,1454,22,23,1,2,1502
E01004895,1058,12,6,3,3,1082
E01004896,1135,14,12,11,1,1173
E01004897,815,12,72,7,3,909
E01004899,1017,17,171,9,11,1225
E01004900,886,20,289,11,5,1211
E01004901,1473,10,33,4,0,1520
E01004902,1317,9,32,15,3,1376
E01004903,1087,9,26,7,5,1134
E01004904,1220,16,16,8,5,1265
E01004905,1225,16,21,11,3,1276
E01004906,1324,18,26,14,2,1384
E01004907,973,14,11,6,4,1008
E01004908,1052,4,30,3,4,1093
E01004909,1090,10,9,3,4,1116
E01004910,1651,22,33,10,6,1722
E01004911,1241,15,20,8,3,1287
E01004912,1195,11,46,5,3,1260
E01004913,1390,14,45,5,10,1464
E01004914,985,8,18,5,1,1017
E01004915,1104,5,19,2,3,1133
E01004916,1132,10,21,4,4,1171
E01004917,1543,18,27,13,5,1606
E01004918,1036,12,21,3,0,1072
E01004919,1193,7,33,6,4,1243
E01004920,1210,10,21,10,6,1257
E01004921,1227,14,57,10,5,1313
E01004922,1181,15,129,22,12,1359
E01004923,1008,25,208,24,10,1275
E01004924,1203,14,26,9,2,1254
E01004925,1200,12,56,6,2,1276
E01004926,909,14,18,14,5,960
E01004927,1496,32,56,41,11,1636
E01004928,1086,18,21,7,8,1140
E01004929,1441,20,62,26,12,1561
E01004930,1236,13,25,4,0,1278
E01004931,1241,15,23,14,2,1295
E01004932,1140,29,78,14,4,1265
E01004933,1047,4,19,2,0,1072
E01004934,1091,11,27,6,1,1136
E01004935,1312,18,37,5,2,1374
E01004936,1644,23,28,5,1,1701
E01004937,1174,16,25,3,2,1220
E01004938,1103,14,19,1,2,1139
E01004939,1208,11,12,4,5,1240
E01004940,1163,8,17,8,3,1199
E01004941,1246,28,49,59,5,1387
E01004942,983,22,32,42,12,1091
E01004943,1049,37,91,46,14,1237
E01004944,1144,20,76,40,6,1286
E01004945,1269,4,26,6,1,1306
E01004946,1212,32,9,23,15,1291
E01004947,1070,9,62,9,6,1156
E01004948,1383,21,88,23,10,1525
E01004949,1160,6,25,3,0,1194
E01004950,1201,13,32,2,1,1249
E01004951,1263,6,67,6,4,1346
E01004952,1200,6,32,0,5,1243
E01004953,1174,7,39,0,5,1225
E01004954,1156,5,55,13,13,1242
E01004955,946,6,75,7,3,1037
E01004956,1158,8,40,8,25,1239
E01004957,1218,25,86,21,15,1365
E01004958,1022,11,100,11,6,1150
E01004959,1091,36,118,24,18,1287
E01004960,931,16,43,50,12,1052
E01004961,1153,27,22,8,5,1215
E01004962,1267,16,32,4,2,1321
E01004963,1221,10,16,4,1,1252
E01004964,1386,21,68,7,6,1488
E01004965,963,8,36,6,5,1018
E01004966,1255,27,34,26,7,1349
E01004967,926,7,109,5,0,1047
E01004968,1246,5,23,3,5,1282
E01004969,1191,15,26,18,17,1267
E01004970,1105,16,120,19,22,1282
E01004971,1121,12,102,5,6,1246
E01004972,999,16,66,18,14,1113
E01004973,1160,23,64,17,9,1273
E01004974,1068,22,65,10,16,1181
E01004975,1154,23,61,21,9,1268
E01004976,1096,16,104,22,2,1240
E01004977,1387,16,47,6,7,1463
E01004978,1095,23,187,10,9,1324
E01004979,804,28,305,29,17,1183
E01004980,811,12,184,19,10,1036
E01004981,1190,7,9,3,3,1212
E01004982,1183,10,17,5,2,1217
E01004983,853,30,148,24,12,1067
E01004984,1012,7,60,2,22,1103
E01004985,1067,7,95,9,22,1200
E01004986,1249,27,58,17,8,1359
E01004987,966,10,24,7,5,1012
E01004988,1111,9,32,7,12,1171
E01004989,1069,9,76,12,14,1180
E01004990,1152,13,18,6,1,1190
E01004991,1048,14,36,8,5,1111
E01004992,1064,23,54,10,5,1156
E01004993,1005,11,51,2,4,1073
E01004994,933,17,45,5,13,1013
E01004995,1255,7,28,5,6,1301
E01004996,1113,15,32,10,5,1175
E01004997,1181,8,38,2,5,1234
E01004998,1208,2,15,2,2,1229
E01004999,1114,10,25,2,1,1152
E01005000,1187,7,20,7,2,1223
E01005001,1005,5,37,7,8,1062
E01005002,1229,19,41,5,0,1294
E01005003,1114,10,18,7,2,1151
E01005004,1188,14,24,12,4,1242
E01005005,1163,3,6,2,0,1174
E01005006,1223,4,25,6,3,1261
E01005007,1234,8,30,10,8,1290
E01005008,1316,24,77,13,18,1448
E01005009,1082,22,68,13,3,1188
E01005010,1231,7,16,9,4,1267
E01005011,1073,8,20,4,8,1113
E01005012,1237,14,49,18,13,1331
E01005013,1592,17,94,26,10,1739
E01005014,1229,10,17,5,3,1264
E01005015,1207,7,13,1,0,1228
E01005016,1242,9,10,2,3,1266
E01005017,1300,15,15,9,1,1340
E01005018,1195,6,6,8,1,1216
E01005019,1177,13,15,2,1,1208
E01005020,1112,4,11,2,1,1130
E01005021,828,5,138,3,1,975
E01005022,1236,18,23,4,0,1281
E01005023,1081,6,3,1,0,1091
E01005024,478,18,507,8,16,1027
E01005025,1163,6,88,8,7,1272
E01005026,469,19,674,28,2,1192
E01005027,996,36,357,16,13,1418
E01005028,1035,25,291,22,30,1403
E01005029,900,15,437,16,16,1384
E01005030,1085,9,144,15,7,1260
E01005031,1042,8,71,21,8,1150
E01005032,960,21,50,33,9,1073
E01005033,1052,19,102,5,19,1197
E01005034,1149,14,46,12,3,1224
E01005035,1076,28,24,5,3,1136
E01005036,1404,25,111,23,28,1591
E01005037,1107,14,54,17,5,1197
E01005038,922,27,98,22,5,1074
E01005039,1108,15,34,20,12,1189
E01005040,1008,35,300,29,45,1417
E01005041,891,15,239,17,25,1187
E01005042,1170,15,105,12,29,1331
E01005043,917,13,151,10,40,1131
E01005044,825,21,114,7,32,999
E01005045,1143,19,83,22,9,1276
E01005046,1203,7,7,0,1,1218
E01005047,1222,5,5,4,2,1238
E01005048,1395,3,12,6,1,1417
E01005049,1360,17,9,4,1,1391
E01005050,1521,12,21,5,1,1560
E01005051,1247,9,18,2,3,1279
E01005052,1188,3,10,1,0,1202
E01005053,1187,8,23,4,1,1223
E01005054,1201,19,24,0,12,1256
E01005055,1116,16,78,4,4,1218
E01005056,1035,7,52,1,9,1104
E01005057,1143,15,26,5,4,1193
E01005058,1003,15,67,8,0,1093
E01005059,1088,31,227,13,7,1366
E01005060,1207,22,112,12,3,1356
E01005061,538,72,197,356,43,1206
E01005062,1004,108,971,260,152,2495
E01005063,436,65,257,282,55,1095
E01005065,704,98,390,342,134,1668
E01005066,655,52,546,179,84,1516
E01005067,701,45,69,162,25,1002
E01005068,1124,27,38,33,9,1231
E01005069,1110,23,50,16,13,1212
E01005070,1105,32,78,73,25,1313
E01005071,1104,24,45,42,11,1226
E01005072,1180,50,68,32,8,1338
E01005073,1071,33,79,24,15,1222
E01005074,1020,44,57,48,5,1174
E01005075,969,35,37,29,10,1080
E01005076,1208,47,77,15,19,1366
E01005077,786,60,101,125,49,1121
E01005078,1123,29,136,21,35,1344
E01005079,1017,42,133,37,25,1254
E01005081,924,102,103,156,53,1338
E01005082,963,65,112,63,25,1228
E01005083,1290,58,126,25,39,1538
E01005084,1351,63,116,64,34,1628
E01005085,941,32,56,73,19,1121
E01005086,1116,31,93,67,18,1325
E01005087,1287,45,44,101,17,1494
E01005088,1059,36,37,68,8,1208
E01005089,1152,40,115,57,27,1391
E01005090,1077,39,30,60,25,1231
E01005091,1299,35,162,71,11,1578
E01005092,950,17,62,182,15,1226
E01005093,1005,32,75,137,13,1262
E01005094,904,25,51,114,12,1106
E01005097,933,53,44,169,10,1209
E01005098,1130,22,34,30,11,1227
E01005099,1058,27,92,117,10,1304
E01005100,1136,16,45,34,4,1235
E01005101,1182,17,42,61,15,1317
E01005102,1103,11,3,9,3,1129
E01005103,1229,26,39,47,2,1343
E01005104,1038,42,80,144,29,1333
E01005105,857,51,374,191,34,1507
E01005106,973,51,157,213,11,1405
E01005107,885,60,64,244,14,1267
E01005108,1300,60,114,357,14,1845
E01005111,1032,23,23,26,12,1116
E01005112,1084,37,65,62,12,1260
E01005113,1146,36,33,45,8,1268
E01005114,1345,19,123,24,16,1527
E01005115,1239,48,108,50,21,1466
E01005116,1468,31,96,40,11,1646
E01005117,1292,67,85,69,22,1535
E01005118,695,13,387,27,34,1156
E01005119,888,45,164,35,31,1163
E01005120,893,41,365,37,32,1368
E01005121,808,42,217,46,48,1161
E01005122,951,27,198,69,20,1265
E01005123,874,68,199,47,56,1244
E01005124,990,64,181,64,34,1333
E01005125,947,55,169,49,25,1245
E01005126,1204,46,341,41,31,1663
E01005128,863,35,644,37,104,1683
E01005129,798,35,131,135,16,1115
E01005130,878,46,118,132,37,1211
E01005132,856,36,74,127,6,1099
E01005133,898,27,97,66,21,1109
E01005135,1009,30,66,81,26,1212
E01005136,1181,26,21,22,6,1256
E01005138,1084,25,47,121,6,1283
E01005139,1190,20,72,60,3,1345
E01005140,1848,57,153,82,52,2192
E01005141,1222,29,19,74,15,1359
E01005142,453,80,512,210,92,1347
E01005143,240,28,1317,153,62,1800
E01005145,312,41,1287,122,154,1916
E01005146,684,48,809,115,79,1735
E01005147,643,110,567,307,99,1726
E01005149,173,18,947,42,50,1230
E01005150,1489,51,113,27,34,1714
E01005151,1099,34,116,26,6,1281
E01005152,1042,34,68,25,12,1181
E01005153,1293,36,48,22,11,1410
E01005154,1136,49,71,49,36,1341
E01005155,1135,23,28,11,7,1204
E01005156,1115,37,65,21,3,1241
E01005157,1136,27,43,20,6,1232
E01005158,1013,55,136,48,19,1271
E01005159,1095,23,150,36,18,1322
E01005160,869,31,405,29,41,1375
E01005161,903,18,204,38,21,1184
E01005162,912,25,323,40,42,1342
E01005163,826,35,336,47,44,1288
E01005164,652,62,322,100,68,1204
E01005165,905,61,506,111,81,1664
E01005166,549,37,634,104,71,1395
E01005167,387,43,703,103,113,1349
E01005168,894,16,136,26,7,1079
E01005169,974,26,126,33,13,1172
E01005170,847,31,229,32,55,1194
E01005171,996,42,298,37,66,1439
E01005172,1171,38,102,21,52,1384
E01005173,1154,29,101,12,23,1319
E01005174,1113,19,100,20,9,1261
E01005175,1154,26,84,29,23,1316
E01005176,1462,46,70,24,24,1626
E01005177,1024,21,53,18,28,1144
E01005178,982,78,264,147,92,1563
E01005179,1001,78,539,136,100,1854
E01005180,943,91,237,97,62,1430
E01005181,747,64,679,75,89,1654
E01005182,537,69,300,209,51,1166
E01005183,794,87,226,173,73,1353
E01005184,1382,59,280,64,112,1897
E01005185,3348,160,315,83,63,3969
E01005186,1172,47,284,290,20,1813
E01005187,1011,37,93,225,22,1388
E01005188,1144,34,57,109,4,1348
E01005189,1096,34,54,151,12,1347
E01005190,1204,40,67,201,14,1526
E01005191,1052,32,50,140,15,1289
E01005192,1031,30,88,102,13,1264
E01005193,1146,36,85,125,18,1410
E01005194,667,38,926,164,69,1864
E01005195,993,52,147,200,20,1412
E01005196,1004,70,133,367,22,1596
E01005197,942,41,90,127,12,1212
E01005198,722,51,171,158,29,1131
E01005199,831,45,592,157,25,1650
E01005200,957,68,250,96,20,1391
E01005201,732,61,241,325,45,1404
E01005202,1063,29,80,136,2,1310
E01005203,1022,63,147,184,39,1455
E01005205,1234,40,116,149,9,1548
E01005206,1105,34,146,74,12,1371
E01005207,1069,56,122,229,47,1523
E01005208,1051,109,361,309,130,1960
E01005209,1150,110,601,422,113,2396
E01005210,1417,132,1163,233,112,3057
E01005212,1344,96,244,182,71,1937
E01005213,1106,107,172,366,88,1839
E01005214,1157,102,296,289,86,1930
E01005215,809,51,452,100,87,1499
E01005216,831,34,233,66,32,1196
E01005217,914,40,437,56,34,1481
E01005218,928,44,402,41,22,1437
E01005219,1000,72,447,104,63,1686
E01005220,857,41,361,103,40,1402
E01005221,800,56,606,129,59,1650
E01005222,1022,93,313,131,46,1605
E01005223,829,16,60,81,12,998
E01005224,845,45,133,290,9,1322
E01005225,1270,25,42,126,21,1484
E01005226,981,24,66,160,12,1243
E01005227,975,35,84,162,15,1271
E01005228,950,49,51,165,18,1233
E01005229,1238,22,12,16,8,1296
E01005230,917,78,520,182,91,1788
E01005231,1572,88,532,216,89,2497
E01005232,522,52,623,153,47,1397
E01005233,464,49,920,169,45,1647
E01005234,268,46,974,148,29,1465
E01005235,641,66,380,170,52,1309
E01005236,674,68,722,126,76,1666
E01005237,227,40,1060,107,28,1462
E01005238,232,36,983,165,33,1449
E01005239,378,61,319,336,66,1160
E01005240,635,116,279,653,133,1816
E01005241,1182,80,327,200,105,1894
E01005242,683,110,509,431,148,1881
E01005243,499,123,197,849,99,1767
E01005244,1127,133,629,473,170,2532
E01005245,380,111,172,878,78,1619
E01005246,284,87,172,713,92,1348
E01005247,1163,10,26,20,3,1222
E01005248,991,19,121,53,11,1195
E01005249,1297,36,92,70,7,1502
E01005250,1162,37,36,135,4,1374
E01005251,1068,23,27,70,9,1197
E01005252,1348,19,26,53,4,1450
E01005253,1101,20,18,58,5,1202
E01005254,1291,11,14,12,1,1329
E01005255,1060,30,35,114,22,1261
E01005256,1227,58,81,159,15,1540
E01005257,1106,57,64,110,6,1343
E01005258,1296,19,42,31,11,1399
E01005259,1090,31,49,64,14,1248
E01005260,1114,21,51,23,19,1228
E01005261,1026,49,31,66,2,1174
E01005262,1224,34,96,67,30,1451
E01005263,1247,44,49,26,28,1394
E01005264,1063,28,59,42,8,1200
E01005265,1118,23,42,41,45,1269
E01005266,1329,36,77,52,12,1506
E01005267,1170,14,76,21,12,1293
E01005268,1600,36,90,40,21,1787
E01005269,1065,22,107,26,15,1235
E01005270,996,77,140,92,67,1372
E01005271,1675,58,143,42,82,2000
E01005272,956,87,136,129,39,1347
E01005273,1183,86,104,40,31,1444
E01005274,1209,73,103,56,65,1506
E01005275,1358,38,112,29,35,1572
E01005276,1229,43,95,45,26,1438
E01005277,1244,38,153,26,29,1490
E01005278,1013,55,405,61,37,1571
E01005279,984,81,312,110,83,1570
E01005280,482,32,701,113,43,1371
E01005281,1774,85,234,54,48,2195
E01005282,691,43,572,63,51,1420
E01005283,1217,62,102,36,17,1434
E01005284,1758,113,1107,152,163,3293
E01005285,337,30,354,216,94,1031
E01005286,1264,75,466,69,96,1970
E01005287,562,43,807,130,39,1581
E01005288,690,71,477,143,77,1458
E01005289,996,41,53,20,10,1120
E01005290,1081,47,41,13,12,1194
E01005291,1077,18,30,31,10,1166
E01005292,1050,23,41,49,9,1172
E01005293,914,13,38,7,11,983
E01005294,1155,27,73,11,6,1272
E01005295,1673,47,223,44,49,2036
E01005296,864,38,321,91,57,1371
E01005297,925,94,568,212,75,1874
E01005298,647,44,495,137,37,1360
E01005299,538,15,567,101,49,1270
E01005300,492,24,622,33,53,1224
E01005301,836,36,343,36,33,1284
E01005302,1071,57,212,201,56,1597
E01005304,1384,61,137,37,36,1655
E01005305,1055,36,357,25,38,1511
E01005306,1103,31,125,13,28,1300
E01005307,1483,59,156,34,38,1770
E01005308,1032,64,175,42,52,1365
E01005309,1809,98,204,68,65,2244
E01005310,1423,79,109,44,22,1677
E01005311,1158,58,258,50,48,1572
E01005312,1466,82,131,42,33,1754
E01005313,1048,33,46,26,11,1164
E01005314,1120,41,45,20,3,1229
E01005315,1065,23,49,51,9,1197
E01005316,1161,48,44,53,9,1315
E01005317,1193,44,55,43,3,1338
E01005318,1322,34,67,37,8,1468
E01005319,1482,25,61,46,27,1641
E01005320,728,29,545,26,6,1334
E01005321,586,16,513,58,7,1180
E01005322,752,17,142,18,8,937
E01005323,1036,20,18,16,0,1090
E01005324,1076,13,19,9,2,1119
E01005325,680,6,12,8,2,708
E01005326,275,12,1766,27,10,2090
E01005327,1421,14,108,8,0,1551
E01005328,950,17,137,18,0,1122
E01005329,1184,2,56,12,1,1255
E01005330,1260,9,28,5,0,1302
E01005331,1099,8,78,17,5,1207
E01005332,1561,31,150,42,3,1787
E01005333,1027,3,56,6,0,1092
E01005334,1088,18,47,5,1,1159
E01005335,1044,10,46,6,0,1106
E01005336,1243,5,55,3,0,1306
E01005337,735,24,537,15,4,1315
E01005338,963,20,315,12,0,1310
E01005339,1173,12,26,5,1,1217
E01005340,954,21,113,5,2,1095
E01005341,1106,18,23,14,2,1163
E01005342,963,15,91,12,2,1083
E01005343,982,21,37,8,4,1052
E01005344,1011,28,84,12,2,1137
E01005345,1173,20,47,9,2,1251
E01005346,1217,3,13,10,1,1244
E01005347,1002,8,32,6,2,1050
E01005348,697,35,345,60,15,1152
E01005349,62,12,1379,10,7,1470
E01005350,911,64,461,129,27,1592
E01005351,216,7,986,21,1,1231
E01005352,334,9,608,27,2,980
E01005353,398,22,827,97,13,1357
E01005354,547,11,647,19,4,1228
E01005355,1112,14,66,10,3,1205
E01005356,1008,9,49,5,1,1072
E01005357,1212,8,2,1,0,1223
E01005358,1298,10,10,2,1,1321
E01005359,1371,8,9,2,1,1391
E01005360,1151,14,10,2,1,1178
E01005361,1370,10,46,5,4,1435
E01005362,1167,14,23,1,1,1206
E01005363,1173,14,41,10,1,1239
E01005364,1380,5,5,2,0,1392
E01005365,1177,6,24,5,3,1215
E01005366,1208,15,9,12,3,1247
E01005367,1157,7,25,2,1,1192
E01005368,1164,15,21,11,3,1214
E01005369,1089,26,47,31,3,1196
E01005370,1127,14,18,20,2,1181
E01005371,992,14,21,11,2,1040
E01005372,902,12,19,6,4,943
E01005373,979,5,5,6,1,996
E01005374,1109,14,15,6,7,1151
E01005375,1233,7,9,1,0,1250
E01005376,877,10,50,26,0,963
E01005377,925,8,30,10,2,975
E01005378,1104,16,72,17,2,1211
E01005379,829,13,9,7,0,858
E01005380,1004,6,29,10,0,1049
E01005381,842,21,263,16,1,1143
E01005382,1049,25,50,8,0,1132
E01005383,953,27,372,33,5,1390
E01005386,961,27,27,30,4,1049
E01005387,1171,9,0,7,1,1188
E01005388,1107,7,8,3,1,1126
E01005389,1207,27,18,27,1,1280
E01005390,1169,10,4,8,1,1192
E01005391,1269,6,12,4,4,1295
E01005392,1240,8,6,5,2,1261
E01005393,1060,8,12,6,0,1086
E01005394,1277,4,13,2,1,1297
E01005395,1163,4,14,2,0,1183
E01005396,1176,11,27,3,4,1221
E01005397,1178,13,16,4,1,1212
E01005398,1233,10,39,8,2,1292
E01005399,1321,5,32,8,0,1366
E01005400,1222,14,16,6,3,1261
E01005401,1265,12,54,7,3,1341
E01005402,1053,16,128,9,6,1212
E01005403,1245,19,37,6,2,1309
E01005406,1155,9,13,5,1,1183
E01005407,1392,14,10,5,2,1423
E01005408,1421,12,17,4,2,1456
E01005409,1293,7,28,0,3,1331
E01005410,1243,6,8,2,0,1259
E01005411,1281,5,15,5,2,1308
E01005412,1395,10,12,4,3,1424
E01005413,1285,15,20,2,2,1324
E01005414,1052,3,5,2,4,1066
E01005415,916,9,16,5,1,947
E01005416,1098,9,37,5,1,1150
E01005417,1264,6,12,2,0,1284
E01005418,1200,8,8,8,1,1225
E01005419,1201,9,16,7,0,1233
E01005420,1340,10,14,4,1,1369
E01005421,1269,30,7,18,3,1327
E01005422,925,31,6,31,1,994
E01005427,53,7,1191,26,2,1279
E01005428,315,18,812,25,3,1173
E01005429,118,21,1026,16,5,1186
E01005430,414,20,1129,24,16,1603
E01005431,1127,27,154,23,2,1333
E01005432,950,40,61,55,3,1109
E01005433,910,33,82,56,7,1088
E01005434,644,27,339,32,16,1058
E01005435,197,16,1037,11,13,1274
E01005436,597,9,631,5,4,1246
E01005437,366,10,910,20,4,1310
E01005438,1305,18,400,30,3,1756
E01005439,1159,9,73,9,3,1253
E01005440,1100,17,11,11,1,1140
E01005441,1303,8,10,3,2,1326
E01005442,1174,5,3,0,1,1183
E01005443,1096,11,28,3,0,1138
E01005444,1158,6,39,7,2,1212
E01005445,1131,11,47,10,1,1200
E01005446,1096,3,20,9,0,1128
E01005447,1121,15,154,7,1,1298
E01005448,1037,20,77,20,5,1159
E01005449,923,14,36,16,2,991
E01005450,688,25,438,28,7,1186
E01005451,678,13,286,17,6,1000
E01005452,1109,6,2,6,0,1123
E01005453,1042,11,8,3,1,1065
E01005454,1150,10,5,7,1,1173
E01005455,1193,22,33,5,0,1253
E01005456,1201,17,19,15,3,1255
E01005459,185,6,704,14,4,913
E01005460,665,25,864,30,16,1600
E01005461,192,9,1435,4,6,1646
E01005462,529,12,774,18,8,1341
E01005463,230,8,510,36,5,789
E01005464,1062,27,117,23,4,1233
E01005465,1308,11,47,9,2,1377
E01005466,1563,32,72,71,1,1739
E01005467,1196,21,56,37,2,1312
E01005468,1166,10,73,14,2,1265
E01005469,1262,16,122,14,2,1416
E01005470,254,14,946,20,10,1244
E01005471,518,32,596,14,6,1166
E01005472,949,10,172,12,4,1147
E01005473,460,33,601,13,8,1115
E01005474,911,15,116,9,0,1051
E01005475,523,17,671,7,9,1227
E01005476,1231,8,54,2,1,1296
E01005477,1217,29,86,12,14,1358
E01005478,1198,6,80,5,3,1292
E01005479,1334,19,54,10,3,1420
E01005480,1217,23,110,7,1,1358
E01005481,1035,12,303,14,5,1369
E01005482,1266,35,287,105,38,1731
E01005483,857,24,484,60,51,1476
E01005484,620,61,729,141,55,1606
E01005485,284,19,1294,12,9,1618
E01005486,535,19,511,9,15,1089
E01005487,533,18,677,12,11,1251
E01005488,1053,13,97,0,3,1166
E01005489,898,4,56,4,1,963
E01005490,1054,41,102,25,1,1223
E01005491,1111,16,77,1,0,1205
E01005492,1101,10,152,8,4,1275
E01005493,1167,11,165,4,1,1348
E01005494,1115,19,220,9,7,1370
E01005495,1062,12,268,4,3,1349
E01005496,932,9,71,15,2,1029
E01005497,1119,14,38,25,6,1202
E01005498,1065,15,46,10,0,1136
E01005499,1205,14,18,4,2,1243
E01005500,1289,8,16,3,4,1320
E01005501,1269,11,27,10,2,1319
E01005502,1209,7,19,1,6,1242
E01005503,1051,6,34,0,0,1091
E01005504,1138,11,33,8,0,1190
E01005505,1341,17,7,7,1,1373
E01005506,1263,6,22,6,6,1303
E01005507,1237,13,15,3,1,1269
E01005508,1421,12,69,14,5,1521
E01005509,1409,14,21,38,10,1492
E01005510,899,3,12,0,1,915
E01005511,993,8,14,6,1,1022
E01005512,1259,14,13,14,2,1302
E01005513,998,13,12,8,3,1034
E01005514,1155,12,12,16,2,1197
E01005515,1215,21,10,7,5,1258
E01005516,1109,6,17,3,0,1135
E01005517,1272,6,8,2,2,1290
E01005518,1138,12,9,1,0,1160
E01005519,1185,8,7,1,1,1202
E01005520,1389,10,11,6,3,1419
E01005521,1191,8,9,1,3,1212
E01005522,1092,5,8,3,2,1110
E01005523,1507,10,19,8,2,1546
E01005524,1164,21,22,10,2,1219
E01005525,1204,27,20,44,7,1302
E01005526,1137,17,68,28,1,1251
E01005527,1114,18,15,28,5,1180
E01005528,1159,7,11,20,6,1203
E01005529,1241,21,9,28,0,1299
E01005530,1173,14,27,4,5,1223
E01005531,892,13,27,3,1,936
E01005532,1030,19,37,31,1,1118
E01005533,1355,12,14,13,2,1396
E01005534,1151,15,19,13,2,1200
E01005535,1269,15,23,12,2,1321
E01005536,1176,25,10,25,6,1242
E01005537,1128,6,3,6,0,1143
E01005538,1076,13,15,6,2,1112
E01005539,1086,9,16,28,2,1141
E01005540,1062,23,12,9,0,1106
E01005541,1228,18,21,9,2,1278
E01005542,1029,8,23,13,0,1073
E01005543,1077,14,11,6,1,1109
E01005544,1218,5,14,6,0,1243
E01005545,942,5,36,18,6,1007
E01005546,1009,14,14,17,4,1058
E01005547,1103,15,19,16,8,1161
E01005548,1031,8,14,26,4,1083
E01005549,1200,9,45,7,3,1264
E01005550,1166,3,20,6,7,1202
E01005551,1204,22,46,22,13,1307
E01005552,1365,30,42,39,4,1480
E01005553,1380,32,31,26,5,1474
E01005554,1027,18,32,8,4,1089
E01005555,1065,10,10,4,2,1091
E01005556,1215,15,19,1,0,1250
E01005557,979,9,18,0,0,1006
E01005558,1295,20,9,7,3,1334
E01005559,1182,12,11,2,1,1208
E01005560,1282,11,13,1,3,1310
E01005561,1102,13,6,3,1,1125
E01005562,1205,17,8,3,1,1234
E01005563,740,23,515,13,11,1302
E01005564,403,20,907,22,10,1362
E01005565,947,19,164,12,7,1149
E01005566,1159,22,334,12,6,1533
E01005567,1092,11,54,1,3,1161
E01005568,598,26,476,64,11,1175
E01005569,825,19,335,36,2,1217
E01005570,1058,3,25,4,6,1096
E01005571,1232,12,36,1,6,1287
E01005572,1179,6,133,0,0,1318
E01005573,1101,14,86,3,3,1207
E01005574,1151,9,216,3,7,1386
E01005575,1157,10,193,4,5,1369
E01005576,895,11,314,8,14,1242
E01005577,1169,4,64,2,2,1241
E01005578,571,25,413,10,5,1024
E01005579,644,17,393,17,3,1074
E01005580,744,16,400,9,2,1171
E01005581,564,12,533,5,3,1117
E01005583,171,13,1038,6,8,1236
E01005585,470,14,523,3,5,1015
E01005586,949,5,156,8,2,1120
E01005587,1013,10,98,4,2,1127
E01005588,1112,6,41,5,5,1169
E01005589,1099,21,103,6,2,1231
E01005590,601,22,523,25,15,1186
E01005591,1097,16,66,4,0,1183
E01005592,986,27,191,15,4,1223
E01005593,1013,25,58,19,0,1115
E01005594,1144,4,38,1,1,1188
E01005595,1116,21,55,9,3,1204
E01005596,1364,10,131,5,0,1510
E01005597,1240,3,15,4,1,1263
E01005598,1270,10,25,7,0,1312
E01005599,1131,27,83,40,38,1319
E01005600,1022,14,51,31,11,1129
E01005601,1119,7,57,20,28,1231
E01005602,1034,18,29,19,27,1127
E01005603,1073,18,63,40,4,1198
E01005604,1188,8,17,17,4,1234
E01005605,1086,5,24,21,10,1146
E01005609,1173,41,90,125,19,1448
E01005610,901,17,32,25,21,996
E01005611,1349,50,97,80,18,1594
E01005612,1208,24,85,157,19,1493
E01005613,1114,66,191,216,60,1647
E01005614,840,18,82,74,23,1037
E01005615,1257,38,132,113,27,1567
E01005616,1152,7,9,10,0,1178
E01005617,1205,0,11,2,0,1218
E01005618,1111,8,14,3,0,1136
E01005619,1018,6,12,6,3,1045
E01005620,1810,27,79,13,23,1952
E01005621,1255,14,36,14,6,1325
E01005622,1118,18,27,16,3,1182
E01005623,1017,6,31,9,4,1067
E01005624,1143,13,33,46,5,1240
E01005625,1061,7,29,7,0,1104
E01005626,1051,7,41,7,2,1108
E01005627,911,13,31,8,0,963
E01005628,1217,21,137,36,8,1419
E01005629,1063,10,25,6,11,1115
E01005630,1103,9,61,17,6,1196
E01005631,1279,21,36,25,31,1392
E01005632,1270,26,192,36,127,1651
E01005633,1059,16,44,7,9,1135
E01005634,1162,9,25,4,2,1202
E01005635,1230,18,98,19,11,1376
E01005636,1222,13,55,13,18,1321
E01005637,1024,15,43,4,7,1093
E01005638,1113,20,80,22,13,1248
E01005639,1005,14,7,18,2,1046
E01005640,999,12,15,12,3,1041
E01005641,1130,10,14,8,0,1162
E01005642,922,11,33,2,3,971
E01005643,1170,4,9,14,4,1201
E01005644,1179,10,30,3,4,1226
E01005645,1211,4,9,3,1,1228
E01005646,916,8,61,7,33,1025
E01005647,1136,10,36,16,95,1293
E01005648,1313,28,93,37,46,1517
E01005649,1151,9,43,20,33,1256
E01005650,976,22,34,42,17,1091
E01005651,1061,27,43,44,54,1229
E01005652,991,18,21,30,5,1065
E01005653,1009,25,45,70,6,1155
E01005654,1109,28,44,37,5,1223
E01005655,769,37,100,180,27,1113
E01005656,1072,13,38,39,9,1171
E01005657,1145,9,19,28,3,1204
E01005658,967,18,20,56,10,1071
E01005659,1119,8,8,14,1,1150
E01005660,1063,7,13,17,1,1101
E01005661,1223,12,48,27,2,1312
E01005662,999,15,10,42,6,1072
E01005663,1032,9,14,18,2,1075
E01005664,999,21,13,49,0,1082
E01005665,1036,9,8,16,0,1069
E01005667,1245,24,49,106,18,1442
E01005670,1247,28,49,37,3,1364
E01005671,1163,15,24,16,3,1221
E01005672,1047,4,56,13,1,1121
E01005673,1095,12,27,22,1,1157
E01005674,1173,9,20,2,2,1206
E01005675,1923,70,114,58,11,2176
E01005676,1096,7,5,5,1,1114
E01005677,1202,11,29,17,4,1263
E01005678,1098,25,27,31,5,1186
E01005679,1071,23,21,31,4,1150
E01005680,1054,23,43,44,9,1173
E01005681,1224,29,166,58,25,1502
E01005682,1076,46,55,141,25,1343
E01005683,1129,24,24,60,10,1247
E01005686,1072,11,38,32,7,1160
E01005687,1343,12,32,6,1,1394
E01005688,1163,11,39,28,3,1244
E01005689,906,13,56,38,2,1015
E01005690,1251,5,16,7,1,1280
E01005691,1247,6,16,5,2,1276
E01005692,1060,6,19,21,6,1112
E01005693,1138,7,9,6,1,1161
E01005694,1288,9,32,6,5,1340
E01005695,1190,14,51,2,2,1259
E01005696,1177,15,13,23,8,1236
E01005697,1241,8,15,6,0,1270
E01005698,1220,12,19,46,10,1307
E01005699,1208,7,8,4,1,1228
E01005700,1174,8,56,12,7,1257
E01005701,1254,11,27,8,6,1306
E01005702,1621,20,48,17,4,1710
E01005703,1143,16,15,15,0,1189
E01005704,1078,7,15,2,3,1105
E01005705,1441,13,25,8,10,1497
E01005706,1109,9,14,15,5,1152
E01005707,1242,16,17,28,4,1307
E01005708,1149,15,35,20,5,1224
E01005709,1004,12,17,24,3,1060
E01005710,1199,6,15,10,0,1230
E01005711,1195,8,39,1,7,1250
E01005712,1288,10,25,15,5,1343
E01005713,1187,6,13,5,2,1213
E01005714,1124,3,17,7,1,1152
E01005715,1320,13,28,5,6,1372
E01005716,1330,18,50,13,9,1420
E01005717,1026,13,111,4,6,1160
E01005718,1410,18,18,6,3,1455
E01005719,1298,23,117,74,21,1533
E01005720,1664,40,90,106,21,1921
E01005721,1188,13,34,32,4,1271
E01005722,1176,29,92,44,13,1354
E01005723,1041,18,38,43,3,1143
E01005724,1213,7,55,6,10,1291
E01005725,924,17,26,29,12,1008
E01005726,1138,8,13,9,6,1174
E01005727,1051,18,25,14,10,1118
E01005728,1094,2,9,3,1,1109
E01005729,970,32,25,38,6,1071
E01005730,1256,17,26,15,2,1316
E01005731,1061,24,23,37,2,1147
E01005732,922,6,17,11,3,959
E01005733,1005,3,21,4,4,1037
E01005734,1099,13,23,6,1,1142
E01005735,1094,14,19,5,4,1136
E01005736,1167,12,11,4,1,1195
E01005737,1150,10,55,5,4,1224
E01005738,1411,13,45,0,8,1477
E01005739,1121,7,61,4,3,1196
E01005740,1248,18,27,1,7,1301
E01005741,1298,17,47,5,3,1370
E01005742,1242,12,20,3,3,1280
E01005743,1119,4,10,1,1,1135
E01005744,1167,7,19,4,0,1197
E01005745,1136,14,7,5,3,1165
E01005746,1220,10,4,7,5,1246
E01005747,1174,4,10,1,2,1191
E01005748,1303,6,6,2,0,1317
E01005749,1330,11,18,7,1,1367
E01005750,1305,10,14,0,0,1329
E01005751,1030,4,15,2,0,1051
E01005752,1098,15,12,10,1,1136
E01005753,1160,24,22,15,3,1224
E01005754,1361,14,23,19,1,1418
E01005755,1119,20,12,20,8,1179
E01005756,1120,16,21,16,5,1178
E01005757,1167,16,34,14,2,1233
E01005758,1553,25,48,18,7,1651
E01005759,1244,19,49,17,2,1331
E01005760,1263,18,122,19,8,1430
E01005761,963,16,66,13,4,1062
E01005762,1101,11,39,11,2,1164
E01005763,1134,20,83,18,3,1258
E01005764,1276,14,19,4,2,1315
E01005765,1084,12,14,3,2,1115
E01005766,1034,14,141,19,9,1217
E01005767,989,16,225,10,31,1271
E01005768,1072,19,194,12,19,1316
E01005769,1062,24,40,8,10,1144
E01005770,1030,17,91,5,18,1161
E01005771,944,17,77,15,20,1073
E01005772,901,16,218,4,36,1175
E01005773,1046,16,124,3,19,1208
E01005774,1070,7,65,4,9,1155
E01005775,1103,19,100,10,18,1250
E01005776,911,17,286,13,41,1268
E01005777,1124,15,79,14,5,1237
E01005778,1171,17,27,9,6,1230
E01005779,1072,15,33,11,7,1138
E01005780,1016,11,75,13,8,1123
E01005781,1167,24,43,13,6,1253
E01005782,979,10,43,15,3,1050
E01005783,1178,15,59,0,17,1269
E01005784,978,4,140,14,20,1156
E01005785,1174,14,43,5,9,1245
E01005786,1195,5,60,4,11,1275
E01005787,991,10,58,4,6,1069
E01005788,1099,17,73,7,12,1208
E01005789,1163,16,51,5,11,1246
E01005790,839,11,95,11,15,971
E01005791,1206,13,30,2,3,1254
E01005792,1159,6,33,3,10,1211
E01005793,1117,6,53,6,11,1193
E01005794,977,14,44,4,1,1040
E01005795,1016,2,29,1,7,1055
E01005796,932,5,54,9,11,1011
E01005797,1090,15,24,9,1,1139
E01005798,1273,23,43,16,9,1364
E01005799,1119,19,79,18,2,1237
E01005800,1247,15,43,11,4,1320
E01005801,1113,13,56,9,12,1203
E01005802,1175,16,8,8,10,1217
E01005803,1174,12,23,2,1,1212
E01005804,927,10,20,4,4,965
E01005805,1235,7,12,5,1,1260
E01005806,966,10,16,1,0,993
E01005807,1266,10,33,2,5,1316
E01005808,992,14,58,9,9,1082
E01005809,895,15,83,6,6,1005
E01005810,1208,17,84,4,12,1325
E01005811,1120,6,42,4,10,1182
E01005812,915,7,84,8,11,1025
E01005813,1133,8,53,4,11,1209
E01005814,1084,10,25,2,5,1126
E01005815,1127,5,16,6,4,1158
E01005816,1161,16,45,10,3,1235
E01005817,1012,13,59,13,2,1099
E01005818,958,11,51,8,0,1028
E01005819,1197,12,59,14,13,1295
E01005820,1146,10,34,3,2,1195
E01005821,1143,11,51,4,3,1212
E01005822,1192,23,56,15,1,1287
E01005823,1218,15,34,12,7,1286
E01005824,1167,11,11,10,2,1201
E01005825,1205,21,38,4,3,1271
E01005826,1053,8,19,9,4,1093
E01005827,1172,6,24,4,6,1212
E01005828,924,13,12,10,2,961
E01005829,914,9,16,13,2,954
E01005830,1178,15,39,8,4,1244
E01005831,1166,10,61,3,3,1243
E01005832,1171,11,23,1,7,1213
E01005833,820,4,44,2,3,873
E01005834,1131,9,37,11,9,1197
E01005835,1118,3,20,2,12,1155
E01005836,1483,7,29,1,2,1522
E01005837,1233,9,30,3,10,1285
E01005838,1325,14,34,14,4,1391
E01005839,1064,5,23,0,6,1098
E01005840,1199,11,34,12,8,1264
E01005841,1173,16,40,6,1,1236
E01005842,1290,13,11,6,6,1326
E01005843,1243,2,21,3,6,1275
E01005844,888,17,308,11,14,1238
E01005845,1084,17,201,9,9,1320
E01005846,1044,15,218,5,21,1303
E01005847,1105,10,136,11,15,1277
E01005848,1260,13,223,14,21,1531
E01005849,1166,16,113,2,5,1302
E01005850,1287,21,114,7,3,1432
E01005851,1007,6,233,6,13,1265
E01005852,978,25,254,9,33,1299
E01005853,1025,14,140,21,11,1211
E01005854,1280,27,27,10,5,1349
E01005855,1052,13,131,5,11,1212
E01005856,1105,28,143,14,8,1298
E01005857,693,35,428,18,47,1221
E01005858,1266,20,50,6,15,1357
E01005859,1133,16,36,9,1,1195
E01005860,1082,10,54,10,7,1163
E01005861,1236,9,27,13,2,1287
E01005862,1153,22,51,16,6,1248
E01005863,1376,17,44,16,4,1457
E01005864,1144,16,41,9,10,1220
E01005865,1076,20,112,6,19,1233
E01005866,1253,14,135,25,9,1436
E01005867,1152,12,44,2,7,1217
E01005868,944,11,196,7,15,1173
E01005869,1082,12,106,23,7,1230
E01005870,1070,13,14,6,0,1103
E01005871,1050,11,7,0,1,1069
E01005872,1292,17,21,10,7,1347
E01005873,1158,6,5,3,3,1175
E01005874,1342,18,29,15,2,1406
E01005875,1249,6,13,4,2,1274
E01005876,1171,9,36,0,1,1217
E01005877,1053,9,29,7,3,1101
E01005878,1103,7,20,1,2,1133
E01005879,1044,8,20,5,1,1078
E01005880,1215,7,5,2,2,1231
E01005881,1034,4,16,1,1,1056
E01005882,1130,9,20,7,2,1168
E01005883,1260,7,4,6,1,1278
E01005884,1203,7,21,1,1,1233
E01005885,1140,3,17,4,1,1165
E01005886,1093,18,32,19,1,1163
E01005887,995,20,43,22,9,1089
E01005888,1118,12,22,13,2,1167
E01005889,1166,11,18,10,2,1207
E01005890,975,24,48,40,10,1097
E01005891,1087,14,8,8,1,1118
E01005892,1016,12,9,10,7,1054
E01005893,1350,19,17,5,4,1395
E01005894,1064,19,19,12,0,1114
E01005895,894,6,10,3,0,913
E01005896,1257,26,27,20,6,1336
E01005897,1118,6,14,6,0,1144
E01005898,1303,14,12,3,2,1334
E01005899,1312,14,24,0,1,1351
E01005900,1275,12,19,2,0,1308
E01005901,1191,2,11,2,1,1207
E01005902,1241,14,12,6,0,1273
E01005903,1217,2,10,4,0,1233
E01005904,1164,7,8,3,1,1183
E01005905,1050,20,10,4,2,1086
E01005906,1248,11,12,3,1,1275
E01005907,1094,3,13,5,3,1118
E01005908,1223,3,3,1,0,1230
E01005909,1276,6,5,3,2,1292
E01005910,1223,4,17,5,1,1250
E01005911,1129,1,3,5,3,1141
E01005912,1142,5,6,2,0,1155
E01005913,1193,6,10,2,0,1211
E01005914,1124,15,28,8,4,1179
E01005915,1187,14,10,8,1,1220
E01005916,1198,25,48,8,6,1285
E01005917,1192,25,71,36,7,1331
E01005918,1187,25,39,31,7,1289
E01005919,1131,14,45,10,5,1205
E01005920,1205,21,39,24,4,1293
E01005921,1092,21,32,5,3,1153
E01005922,1110,7,49,7,1,1174
E01005923,1223,5,44,2,1,1275
E01005924,1035,11,27,1,2,1076
E01005925,1129,6,37,2,3,1177
E01005926,994,2,24,0,4,1024
E01005927,967,18,61,9,4,1059
E01005928,1134,15,50,15,16,1230
E01005929,1055,7,74,11,11,1158
E01005930,1179,5,69,4,6,1263
E01005931,1157,4,22,4,7,1194
E01005932,1058,14,50,9,1,1132
E01005933,965,13,75,14,3,1070
E01005934,1119,12,37,6,7,1181
E01005935,1071,7,69,15,0,1162
E01005936,1150,6,78,14,0,1248
E01005937,1114,11,68,5,1,1199
E01005938,1168,11,113,12,6,1310
E01005939,757,6,339,5,6,1113
E01005940,942,6,280,11,1,1240
E01005941,891,17,383,14,8,1313
E01005942,1241,12,71,12,2,1338
E01005943,1368,13,103,3,0,1487
E01005944,972,22,189,14,6,1203
E01005945,1209,18,169,19,8,1423
E01005946,1100,11,199,14,0,1324
E01005947,967,15,242,25,2,1251
E01005948,1024,29,380,25,2,1460
E01005949,1080,15,197,4,8,1304
E01005950,485,14,781,25,5,1310
E01005951,1100,14,104,20,2,1240
E01005952,1434,30,245,62,7,1778
E01005953,1102,12,370,23,4,1511
E01005954,1219,8,83,7,0,1317
E01005955,1121,16,215,11,3,1366
E01005956,1057,6,142,7,1,1213
E01005957,944,12,194,5,10,1165
E01005958,1095,7,38,8,1,1149
E01005959,1073,17,201,9,0,1300
E01005960,1104,19,145,15,10,1293
E01005961,1110,12,49,8,7,1186
E01005962,1098,6,75,6,1,1186
E01005963,951,6,21,5,0,983
E01005964,1223,16,19,11,3,1272
E01005965,1130,10,13,9,1,1163
E01005966,1003,18,25,8,0,1054
E01005967,1072,14,31,23,0,1140
E01005968,1178,8,21,5,1,1213
E01005969,1075,4,79,0,0,1158
E01005970,1213,8,46,5,0,1272
E01005971,1098,9,27,10,2,1146
E01005972,1260,18,27,12,4,1321
E01005973,1170,4,9,7,2,1192
E01005974,1220,9,33,14,1,1277
E01005975,1196,5,46,12,0,1259
E01005976,1156,5,14,6,4,1185
E01005977,1225,13,15,8,2,1263
E01005978,1086,10,7,4,0,1107
E01005979,1358,11,6,6,0,1381
E01005980,1125,2,30,7,1,1165
E01005981,1212,15,27,13,0,1267
E01005982,1043,15,14,14,1,1087
E01005983,1309,7,21,14,0,1351
E01005984,1163,21,17,18,2,1221
E01005985,1259,17,14,6,0,1296
E01005986,961,11,14,6,0,992
E01005987,1279,9,27,6,2,1323
E01005988,1241,9,32,4,3,1289
E01005989,1027,7,4,6,0,1044
E01005990,1106,12,10,9,2,1139
E01005991,1121,20,28,10,5,1184
E01005992,1007,16,22,8,0,1053
E01005993,1124,7,32,12,1,1176
E01005994,1102,19,14,12,1,1148
E01005995,1089,6,66,5,1,1167
E01005996,1425,15,50,12,3,1505
E01005997,1189,6,13,7,0,1215
E01005998,1264,26,38,28,3,1359
E01005999,1338,24,58,48,7,1475
E01006000,1299,11,36,15,2,1363
E01006001,1183,20,22,20,7,1252
E01006002,1075,9,12,3,2,1101
E01006003,1108,9,49,16,1,1183
E01006004,1227,12,16,8,1,1264
E01006005,1057,12,4,12,2,1087
E01006006,1186,10,18,13,1,1228
E01006007,1182,10,10,5,1,1208
E01006008,1104,7,23,1,0,1135
E01006009,1046,0,78,2,2,1128
E01006010,1058,7,21,5,0,1091
E01006011,1217,7,29,6,3,1262
E01006012,1387,6,89,5,7,1494
E01006013,1017,2,33,6,1,1059
E01006014,932,6,24,3,1,966
E01006015,1060,7,59,5,3,1134
E01006016,1371,19,36,39,2,1467
E01006017,1090,17,19,3,0,1129
E01006018,1125,4,26,4,2,1161
E01006019,1258,6,10,11,1,1286
E01006020,1208,7,16,6,4,1241
E01006021,1094,10,12,1,2,1119
E01006022,1291,7,93,3,0,1394
E01006023,1246,11,24,6,3,1290
E01006024,1412,12,30,3,2,1459
E01006025,1042,7,7,13,2,1071
E01006026,1251,11,18,5,4,1289
E01006027,1044,10,9,3,4,1070
E01006028,1280,14,113,4,1,1412
E01006029,961,22,337,17,4,1341
E01006030,1393,6,40,14,2,1455
E01006031,1027,13,115,9,0,1164
E01006032,974,1,32,7,0,1014
E01006033,1062,10,30,1,0,1103
E01006034,1581,19,30,4,2,1636
E01006035,1525,24,46,18,4,1617
E01006036,1343,17,89,15,1,1465
E01006037,1211,6,14,2,1,1234
E01006038,1288,7,28,3,4,1330
E01006039,592,7,422,10,2,1033
E01006040,695,13,530,17,1,1256
E01006041,968,12,220,1,5,1206
E01006042,1336,14,10,3,0,1363
E01006043,1082,7,68,1,1,1159
E01006044,1143,3,18,1,0,1165
E01006045,1063,6,10,0,3,1082
E01006046,1194,7,24,5,0,1230
E01006047,1061,4,10,4,0,1079
E01006048,1273,5,9,4,0,1291
E01006049,1278,7,9,4,1,1299
E01006050,1261,16,20,15,3,1315
E01006051,1329,10,10,1,2,1352
E01006052,1154,14,7,21,2,1198
E01006053,1507,8,5,4,0,1524
E01006054,1276,14,35,2,0,1327
E01006055,1132,8,4,6,0,1150
E01006056,858,9,9,4,0,880
E01006057,1193,7,15,7,1,1223
E01006058,1545,14,32,6,4,1601
E01006059,1112,9,16,7,1,1145
E01006060,1054,13,46,7,1,1121
E01006061,1727,11,51,11,3,1803
E01006062,1641,6,23,3,3,1676
E01006063,1173,10,12,1,1,1197
E01006064,1212,13,37,5,1,1268
E01006065,905,6,33,24,2,970
E01006066,1075,11,52,9,0,1147
E01006067,1402,6,55,4,5,1472
E01006068,1321,1,29,2,0,1353
E01006069,1200,13,23,3,1,1240
E01006070,1163,6,17,3,0,1189
E01006071,1280,5,81,5,3,1374
E01006072,1341,9,59,3,0,1412
E01006073,1296,10,25,1,0,1332
E01006074,1191,13,48,5,3,1260
E01006075,1451,22,81,15,8,1577
E01006076,1291,17,61,11,14,1394
E01006077,1263,19,34,14,8,1338
E01006078,1478,23,35,16,18,1570
E01006079,1455,13,119,11,18,1616
E01006080,1390,24,52,15,1,1482
E01006081,1001,15,73,4,17,1110
E01006082,1213,14,62,7,5,1301
E01006083,1008,10,33,0,5,1056
E01006084,1250,13,34,6,5,1308
E01006085,1168,14,46,6,7,1241
E01006086,1246,12,62,8,6,1334
E01006087,1114,16,80,6,17,1233
E01006088,1176,11,15,6,5,1213
E01006089,1126,18,55,15,6,1220
E01006090,1565,25,34,11,6,1641
E01006091,1514,33,217,21,15,1800
E01006092,909,32,32,10,5,988
E01006093,1193,9,48,3,4,1257
E01006094,1096,9,76,14,8,1203
E01006095,1186,18,90,27,8,1329
E01006096,1094,5,52,13,8,1172
E01006097,1318,23,109,29,8,1487
E01006098,975,9,53,3,2,1042
E01006099,1006,8,38,5,24,1081
E01006100,1141,7,57,11,9,1225
E01006101,1087,11,77,7,6,1188
E01006102,991,17,41,21,10,1080
E01006103,1151,20,70,9,13,1263
E01006104,1356,15,14,14,3,1402
E01006105,1243,27,17,19,1,1307
E01006106,1117,15,9,17,0,1158
E01006107,1236,16,16,17,2,1287
E01006108,1070,21,13,39,3,1146
E01006109,483,73,191,341,49,1137
E01006110,519,56,467,253,39,1334
E01006111,417,75,415,222,52,1181
E01006112,368,52,577,258,23,1278
E01006113,318,42,633,149,26,1168
E01006114,557,59,507,133,24,1280
E01006115,573,42,399,218,41,1273
E01006116,1022,7,19,8,0,1056
E01006117,1267,17,36,21,5,1346
E01006118,1118,16,28,11,0,1173
E01006119,1212,21,43,46,9,1331
E01006120,1147,11,15,0,6,1179
E01006121,1160,19,31,21,4,1235
E01006122,1272,9,15,15,4,1315
E01006123,1276,14,50,12,5,1357
E01006124,1194,7,17,4,2,1224
E01006125,1185,9,18,17,4,1233
E01006126,1278,15,11,14,1,1319
E01006127,1240,14,22,6,0,1282
E01006128,1358,13,30,13,4,1418
E01006129,1086,13,21,18,0,1138
E01006130,1409,11,24,9,0,1453
E01006131,1208,20,22,4,1,1255
E01006132,1226,8,16,6,11,1267
E01006133,1260,7,10,1,0,1278
E01006134,1038,13,135,3,12,1201
E01006135,1152,18,105,10,22,1307
E01006136,1043,18,154,11,14,1240
E01006137,803,19,259,9,38,1128
E01006138,1260,20,128,5,29,1442
E01006139,1225,6,64,10,4,1309
E01006140,1143,26,82,4,4,1259
E01006141,818,35,218,115,20,1206
E01006142,1062,24,168,79,22,1355
E01006143,1116,20,171,46,5,1358
E01006144,1001,33,51,63,8,1156
E01006145,854,51,289,119,31,1344
E01006146,850,47,370,161,18,1446
E01006147,1062,6,27,10,3,1108
E01006148,1267,15,56,11,23,1372
E01006149,1137,5,31,6,3,1182
E01006150,1196,12,36,16,3,1263
E01006151,1092,6,105,6,15,1224
E01006152,1131,3,147,24,29,1334
E01006153,1138,12,95,21,33,1299
E01006154,1099,23,50,9,6,1187
E01006155,1215,19,31,27,3,1295
E01006156,1091,28,45,72,10,1246
E01006157,997,29,126,68,14,1234
E01006158,1118,19,112,59,3,1311
E01006159,1120,31,100,48,9,1308
E01006160,1330,21,136,22,14,1523
E01006161,1437,28,130,20,3,1618
E01006162,1222,9,66,11,11,1319
E01006163,1369,26,52,8,7,1462
E01006164,1316,14,43,6,0,1379
E01006165,1438,32,93,8,5,1576
E01006166,1167,20,48,12,32,1279
E01006167,1118,43,64,46,13,1284
E01006168,1197,43,42,78,8,1368
E01006169,1292,10,18,9,8,1337
E01006170,1217,11,13,19,2,1262
E01006171,1295,30,45,6,11,1387
E01006172,1241,9,41,11,3,1305
E01006173,1169,3,41,20,4,1237
E01006174,1341,16,69,9,5,1440
E01006175,1187,13,43,14,22,1279
E01006176,1335,15,54,19,31,1454
E01006177,1105,26,46,22,6,1205
E01006178,1377,16,63,17,18,1491
E01006179,1286,26,75,67,10,1464
E01006180,1277,37,114,54,6,1488
E01006181,1028,28,189,61,12,1318
E01006182,1017,24,114,82,8,1245
E01006183,1054,34,156,65,20,1329
E01006184,1172,24,88,42,13,1339
E01006185,921,73,282,311,41,1628
E01006186,1058,61,171,147,25,1462
E01006187,1615,77,145,161,29,2027
E01006188,489,46,463,118,49,1165
E01006189,1362,71,169,101,12,1715
E01006190,1319,13,38,3,2,1375
E01006191,1273,8,38,12,1,1332
E01006192,1189,5,29,3,6,1232
E01006193,1145,15,38,8,3,1209
E01006194,1607,23,140,13,8,1791
E01006195,1340,9,41,11,6,1407
E01006196,1369,10,34,6,5,1424
E01006197,1087,20,66,16,0,1189
E01006198,1227,10,30,19,2,1288
E01006199,1229,21,19,15,1,1285
E01006200,1172,15,25,13,6,1231
E01006201,1119,31,35,14,3,1202
E01006202,1045,20,29,27,6,1127
E01006203,1123,12,9,5,4,1153
E01006204,1209,13,75,12,16,1325
E01006205,1036,10,52,4,1,1103
E01006206,1301,21,95,22,10,1449
E01006207,1230,13,28,23,10,1304
E01006208,1135,29,47,19,12,1242
E01006209,1198,5,33,10,9,1255
E01006210,1165,24,95,10,10,1304
E01006211,1177,9,15,2,6,1209
E01006212,1145,3,2,0,1,1151
E01006213,1189,10,21,17,6,1243
E01006214,1039,2,8,16,2,1067
E01006215,1326,10,7,10,3,1356
E01006216,1648,11,17,16,4,1696
E01006217,1743,10,24,5,4,1786
E01006218,1524,10,36,8,3,1581
E01006219,1048,3,4,0,2,1057
E01006220,1456,4,3,5,0,1468
E01006221,1322,5,4,5,0,1336
E01006222,1243,3,4,4,2,1256
E01006223,1299,6,8,3,1,1317
E01006224,1113,4,7,1,1,1126
E01006225,1276,7,1,0,1,1285
E01006226,1419,2,8,2,2,1433
E01006227,1229,6,5,3,1,1244
E01006228,1296,6,22,7,2,1333
E01006229,1264,3,30,5,11,1313
E01006230,1149,1,24,3,11,1188
E01006231,1204,5,25,0,3,1237
E01006232,1522,7,12,3,0,1544
E01006233,1188,4,28,2,5,1227
E01006234,1028,5,10,1,0,1044
E01006235,1183,4,10,1,1,1199
E01006236,1260,3,5,6,1,1275
E01006237,1183,7,11,6,1,1208
E01006238,1223,5,12,7,2,1249
E01006239,1563,5,26,26,3,1623
E01006240,1113,8,12,19,5,1157
E01006241,1438,14,26,25,6,1509
E01006242,1373,11,7,1,0,1392
E01006243,1628,9,25,5,2,1669
E01006244,1308,6,14,5,1,1334
E01006245,1880,14,42,7,6,1949
E01006246,1280,10,14,4,7,1315
E01006247,1098,4,7,4,0,1113
E01006248,1204,9,24,22,1,1260
E01006249,1183,9,16,11,4,1223
E01006250,1266,8,12,4,2,1292
E01006251,1189,9,10,1,8,1217
E01006252,1214,3,4,0,2,1223
E01006253,1242,2,14,7,1,1266
E01006254,1149,14,15,6,2,1186
E01006255,1255,10,7,2,4,1278
E01006256,1134,8,11,8,2,1163
E01006257,1042,7,18,2,2,1071
E01006258,1352,10,8,12,2,1384
E01006259,1077,2,10,1,0,1090
E01006260,1187,6,8,1,0,1202
E01006261,1269,3,4,1,1,1278
E01006262,1185,3,13,0,3,1204
E01006263,1319,2,2,1,1,1325
E01006264,1144,2,4,1,0,1151
E01006265,1177,1,12,1,0,1191
E01006266,1208,5,2,1,2,1218
E01006267,1329,1,3,3,4,1340
E01006268,1394,10,6,2,1,1413
E01006269,1304,5,12,8,0,1329
E01006270,1234,1,0,5,0,1240
E01006271,1468,6,11,5,0,1490
E01006272,1331,7,16,1,2,1357
E01006273,1204,7,6,3,6,1226
E01006274,1153,5,9,3,2,1172
E01006275,1162,8,4,3,1,1178
E01006276,1704,8,10,8,9,1739
E01006277,1345,4,7,3,1,1360
E01006278,1300,7,11,2,3,1323
E01006279,1271,3,9,4,3,1290
E01006280,1165,6,3,3,1,1178
E01006281,1411,3,12,14,2,1442
E01006282,1327,13,17,10,2,1369
E01006283,1139,7,22,7,4,1179
E01006284,1190,5,5,11,0,1211
E01006285,1507,7,5,1,2,1522
E01006286,1312,4,1,2,2,1321
E01006287,1000,6,11,4,0,1021
E01006288,1299,11,28,20,6,1364
E01006289,1350,13,9,18,6,1396
E01006290,1160,3,15,3,1,1182
E01006291,1161,7,20,2,1,1191
E01006292,1296,7,9,11,0,1323
E01006293,1272,5,3,13,4,1297
E01006294,1513,14,20,8,3,1558
E01006295,1285,4,2,18,5,1314
E01006296,1157,5,15,5,4,1186
E01006297,1239,9,8,21,1,1278
E01006298,1067,10,26,12,5,1120
E01006299,1499,10,16,8,4,1537
E01006300,1147,7,12,4,2,1172
E01006301,1124,1,1,0,1,1127
E01006302,1253,15,20,5,2,1295
E01006303,1155,4,7,2,3,1171
E01006304,1177,4,20,1,1,1203
E01006305,1308,9,17,16,0,1350
E01006306,1274,20,17,14,12,1337
E01006307,1143,5,7,6,1,1162
E01006308,1274,5,15,3,0,1297
E01006309,1221,6,8,3,7,1245
E01006310,1145,12,9,6,0,1172
E01006311,1187,11,16,8,1,1223
E01006312,1236,8,6,2,2,1254
E01006313,864,0,0,4,1,869
E01006314,1416,6,5,1,1,1429
E01006315,1021,2,6,6,3,1038
E01006316,1245,7,10,1,2,1265
E01006317,1249,4,4,1,0,1258
E01006318,1224,6,5,0,0,1235
E01006319,1004,6,23,8,2,1043
E01006320,1134,10,16,2,0,1162
E01006321,1370,4,9,2,2,1387
E01006322,1202,7,10,4,1,1224
E01006323,1158,2,9,1,3,1173
E01006324,1064,3,4,3,1,1075
E01006325,1225,13,24,5,1,1268
E01006326,1133,16,13,5,4,1171
E01006327,1115,11,5,21,0,1152
E01006328,1073,8,68,13,8,1170
E01006329,1053,24,15,10,3,1105
E01006330,1321,12,27,8,2,1370
E01006331,1273,3,17,0,4,1297
E01006332,1660,9,20,10,3,1702
E01006333,1326,20,80,21,5,1452
E01006334,1291,6,37,21,14,1369
E01006335,1294,6,32,10,1,1343
E01006336,1205,10,10,12,4,1241
E01006337,1210,9,7,5,2,1233
E01006338,1230,10,22,13,4,1279
E01006339,1178,9,4,2,0,1193
E01006340,1133,6,5,4,1,1149
E01006341,1299,7,10,1,6,1323
E01006342,1255,5,4,4,2,1270
E01006343,1258,9,33,7,7,1314
E01006344,1132,3,16,5,0,1156
E01006345,1280,4,12,3,0,1299
E01006346,1701,7,13,7,1,1729
E01006347,1282,5,11,0,4,1302
E01006348,1336,2,12,2,2,1354
E01006349,1437,17,41,5,9,1509
E01006350,1313,15,20,11,5,1364
E01006351,1478,14,24,30,7,1553
E01006352,1365,2,14,2,7,1390
E01006353,1289,6,7,4,1,1307
E01006354,1267,6,20,3,1,1297
E01006355,1259,10,10,0,1,1280
E01006356,1131,3,8,4,0,1146
E01006357,1264,5,13,4,3,1289
E01006358,1443,10,9,5,3,1470
E01006359,1156,5,7,9,1,1178
E01006360,1221,16,8,8,19,1272
E01006361,1157,14,8,9,6,1194
E01006362,1469,2,9,1,0,1481
E01006363,1338,2,2,1,0,1343
E01006364,1431,5,17,3,10,1466
E01006365,1649,5,18,9,2,1683
E01006366,1431,10,3,1,1,1446
E01006367,1333,4,5,0,0,1342
E01006368,1329,4,7,1,0,1341
E01006369,1360,17,31,17,19,1444
E01006370,1222,28,101,18,10,1379
E01006371,1223,10,28,2,3,1266
E01006372,1373,9,39,8,2,1431
E01006373,1239,10,20,1,3,1273
E01006374,1264,5,9,3,3,1284
E01006375,1225,7,36,19,9,1296
E01006376,1221,15,10,17,3,1266
E01006377,1311,8,13,9,2,1343
E01006378,1139,8,3,8,2,1160
E01006379,1245,14,14,7,4,1284
E01006380,1290,14,16,5,4,1329
E01006381,1402,10,36,20,6,1474
E01006382,1136,9,14,3,1,1163
E01006383,1292,12,13,3,7,1327
E01006384,1154,4,8,1,0,1167
E01006385,1214,18,21,6,2,1261
E01006386,1330,16,17,15,11,1389
E01006387,1059,6,1,1,2,1069
E01006388,1375,10,1,2,3,1391
E01006389,1073,5,4,2,1,1085
E01006390,1293,4,10,1,0,1308
E01006391,1326,1,10,3,0,1340
E01006392,1053,8,24,25,3,1113
E01006393,1209,9,6,3,1,1228
E01006394,1327,0,2,2,0,1331
E01006395,1842,6,15,1,1,1865
E01006396,1209,4,0,1,2,1216
E01006397,958,5,3,1,0,967
E01006398,891,3,3,1,0,898
E01006399,1249,7,15,3,1,1275
E01006400,1033,3,12,6,1,1055
E01006401,1181,5,6,1,0,1193
E01006402,996,0,1,3,2,1002
E01006403,1391,1,13,2,0,1407
E01006404,1277,5,18,6,1,1307
E01006405,1146,11,10,2,2,1171
E01006406,1223,3,7,8,6,1247
E01006407,1225,7,13,0,0,1245
E01006408,1220,3,7,3,3,1236
E01006409,1186,2,10,1,1,1200
E01006410,1155,6,3,0,1,1165
E01006411,1200,10,20,27,12,1269
E01006412,1138,16,6,5,3,1168
E01006413,1176,8,5,10,0,1199
E01006414,1089,11,7,5,3,1115
E01006415,1563,19,12,7,2,1603
E01006416,1139,19,1,0,2,1161
E01006417,1074,10,3,0,0,1087
E01006418,1059,10,1,0,0,1070
E01006419,1139,12,21,14,4,1190
E01006420,1529,11,43,3,3,1589
E01006421,906,5,27,3,2,943
E01006422,1066,13,3,2,7,1091
E01006423,1120,10,13,4,3,1150
E01006424,1648,9,18,7,5,1687
E01006425,1051,17,35,5,2,1110
E01006426,956,30,11,4,1,1002
E01006427,1189,10,14,13,7,1233
E01006428,1109,24,21,9,7,1170
E01006429,850,22,5,7,0,884
E01006430,1095,12,11,3,0,1121
E01006431,1315,24,14,15,2,1370
E01006432,1155,19,19,18,1,1212
E01006433,1150,14,18,6,5,1193
E01006434,1163,4,0,6,0,1173
E01006435,1237,12,1,1,0,1251
E01006436,1168,12,5,0,0,1185
E01006437,1103,14,1,4,0,1122
E01006438,987,10,18,3,5,1023
E01006439,1301,11,4,4,1,1321
E01006440,1105,13,4,2,1,1125
E01006441,1835,26,9,19,2,1891
E01006442,995,3,1,7,0,1006
E01006443,1104,11,2,3,3,1123
E01006444,1032,14,12,5,2,1065
E01006445,1003,15,5,2,0,1025
E01006446,1070,6,5,1,1,1083
E01006447,1106,10,6,2,1,1125
E01006448,1254,19,2,2,1,1278
E01006449,1214,17,3,1,7,1242
E01006450,1081,9,5,0,3,1098
E01006451,1166,12,6,0,0,1184
E01006452,1179,9,11,7,1,1207
E01006453,899,11,4,4,0,918
E01006454,1056,4,1,1,1,1063
E01006455,1284,11,4,13,1,1313
E01006456,1316,7,2,1,0,1326
E01006457,1065,8,5,0,0,1078
E01006458,1131,9,5,4,1,1150
E01006459,1250,11,38,6,2,1307
E01006460,1161,15,15,0,5,1196
E01006461,1170,10,27,4,0,1211
E01006462,1185,13,10,1,2,1211
E01006463,1510,18,20,6,1,1555
E01006464,1380,6,7,2,2,1397
E01006465,1278,16,51,10,5,1360
E01006466,1277,9,14,2,3,1305
E01006467,962,8,10,3,0,983
E01006470,1092,7,4,4,0,1107
E01006471,1234,7,5,2,0,1248
E01006472,1308,11,2,1,2,1324
E01006473,1039,4,2,9,0,1054
E01006474,1250,17,2,4,0,1273
E01006475,1301,7,3,1,6,1318
E01006476,1194,5,15,1,1,1216
E01006477,1099,8,5,2,0,1114
E01006478,1103,5,3,0,0,1111
E01006479,1111,8,4,4,2,1129
E01006480,1083,8,8,5,1,1105
E01006481,1111,5,2,0,0,1118
E01006482,1168,4,7,0,5,1184
E01006483,1065,7,5,1,0,1078
E01006484,1074,11,16,3,1,1105
E01006485,1197,14,10,6,1,1228
E01006486,981,4,5,1,0,991
E01006487,1258,13,9,4,4,1288
E01006488,1426,21,9,1,3,1460
E01006489,1174,7,5,0,1,1187
E01006490,1966,21,11,12,3,2013
E01006491,1475,14,3,7,0,1499
E01006492,1094,7,2,3,0,1106
E01006493,812,14,1,3,0,830
E01006494,1015,14,8,2,0,1039
E01006495,1303,14,7,3,0,1327
E01006496,1113,5,15,4,0,1137
E01006497,906,1,12,3,0,922
E01006498,1177,14,30,3,2,1226
E01006499,1205,7,69,6,12,1299
E01006500,900,7,3,3,0,913
E01006501,1025,9,16,3,0,1053
E01006502,1476,5,18,3,0,1502
E01006503,1064,8,1,4,3,1080
E01006504,1009,23,10,4,2,1048
E01006505,1298,13,14,2,0,1327
E01006506,1054,10,12,1,1,1078
E01006507,1102,12,4,5,1,1124
E01006508,1074,7,2,0,1,1084
E01006509,1256,5,4,5,5,1275
E01006510,972,11,14,6,4,1007
E01006512,685,77,639,101,181,1683
E01006513,2104,67,543,61,113,2888
E01006514,1586,103,181,90,43,2003
E01006515,702,69,168,36,48,1023
E01006518,1197,72,54,71,31,1425
E01006519,1008,11,24,6,6,1055
E01006520,1443,53,45,41,34,1616
E01006521,1333,40,45,37,36,1491
E01006522,1379,96,52,45,30,1602
E01006523,1223,46,29,36,18,1352
E01006524,2062,44,149,30,15,2300
E01006525,984,19,30,8,8,1049
E01006526,1146,21,19,15,16,1217
E01006527,1181,33,18,6,9,1247
E01006528,1112,28,40,46,13,1239
E01006529,1020,14,22,8,16,1080
E01006530,1183,13,21,3,2,1222
E01006531,1256,9,7,20,0,1292
E01006532,1173,7,84,6,10,1280
E01006533,1137,14,49,1,4,1205
E01006534,1129,25,79,22,16,1271
E01006535,1340,30,18,11,2,1401
E01006536,1463,34,25,11,12,1545
E01006537,1725,29,73,13,7,1847
E01006538,1081,7,11,1,1,1101
E01006539,1150,14,54,10,9,1237
E01006540,1081,26,30,41,40,1218
E01006541,1323,13,8,2,4,1350
E01006542,1117,14,4,10,4,1149
E01006543,1040,7,2,4,0,1053
E01006544,1274,12,14,3,1,1304
E01006545,1132,14,19,5,4,1174
E01006546,977,7,13,14,5,1016
E01006547,1095,21,36,24,21,1197
E01006548,1225,16,30,40,17,1328
E01006549,1162,92,79,119,84,1536
E01006550,1319,61,73,32,14,1499
E01006551,1296,57,63,55,14,1485
E01006552,698,120,137,170,327,1452
E01006553,1501,75,81,27,21,1705
E01006554,1349,60,73,26,22,1530
E01006556,809,115,179,263,229,1595
E01006557,1628,69,129,58,31,1915
E01006558,1089,10,25,5,2,1131
E01006560,1483,27,22,31,13,1576
E01006562,1100,23,32,23,7,1185
E01006563,1301,30,28,35,14,1408
E01006564,1408,19,35,10,5,1477
E01006565,1225,15,31,0,4,1275
E01006566,1169,16,23,22,4,1234
E01006567,1371,12,37,11,8,1439
E01006568,1259,15,13,15,4,1306
E01006569,1181,17,3,8,5,1214
E01006570,1174,14,24,7,2,1221
E01006571,1182,5,9,13,1,1210
E01006572,881,12,9,6,1,909
E01006573,1160,13,34,12,4,1223
E01006574,1042,22,14,10,6,1094
E01006575,1027,15,26,9,10,1087
E01006576,1351,9,23,4,7,1394
E01006577,1175,21,28,9,3,1236
E01006578,1064,7,30,6,1,1108
E01006579,1246,25,34,2,10,1317
E01006580,1047,8,48,5,3,1111
E01006581,1213,10,31,9,1,1264
E01006582,1244,11,38,12,4,1309
E01006583,1455,11,32,17,9,1524
E01006584,1129,2,8,7,1,1147
E01006585,1059,19,33,21,4,1136
E01006586,1448,49,63,27,19,1606
E01006587,1207,56,57,10,24,1354
E01006588,1287,36,36,20,23,1402
E01006589,1139,36,48,8,3,1234
E01006590,1349,33,46,19,10,1457
E01006591,1257,38,44,19,16,1374
E01006592,1255,28,27,13,4,1327
E01006593,1209,48,33,25,9,1324
E01006594,1070,16,81,5,19,1191
E01006595,1390,24,41,17,4,1476
E01006596,1102,30,67,8,21,1228
E01006597,1312,20,43,9,11,1395
E01006598,1011,4,10,9,4,1038
E01006599,792,1,8,12,1,814
E01006600,1151,14,3,0,5,1173
E01006603,1147,11,11,7,1,1177
E01006604,1111,5,6,7,1,1130
E01006605,1243,10,11,5,1,1270
E01006606,1235,8,12,10,2,1267
E01006607,1215,6,1,2,3,1227
E01006608,989,1,6,2,0,998
E01006609,1020,11,16,4,9,1060
E01006610,1107,12,7,10,5,1141
E01006611,1032,5,9,9,0,1055
E01006612,1191,10,3,7,3,1214
E01006613,1134,9,6,1,2,1152
E01006614,1057,4,15,5,3,1084
E01006615,1039,10,18,3,1,1071
E01006616,1155,10,5,3,12,1185
E01006617,1185,6,15,2,8,1216
E01006618,1371,12,1,2,5,1391
E01006619,1307,7,8,4,13,1339
E01006620,1169,5,11,7,5,1197
E01006621,1180,5,43,9,12,1249
E01006622,1222,8,8,0,0,1238
E01006623,1141,8,65,6,3,1223
E01006624,1216,9,47,22,0,1294
E01006625,1147,6,17,1,0,1171
E01006626,1205,9,23,5,4,1246
E01006627,1108,11,15,14,4,1152
E01006628,1426,62,82,53,9,1632
E01006629,1021,30,33,27,5,1116
E01006630,894,37,33,37,28,1029
E01006632,1297,31,37,43,57,1465
E01006633,1109,22,6,7,7,1151
E01006637,1047,15,45,46,8,1161
E01006638,864,13,33,20,4,934
E01006639,1128,10,32,6,1,1177
E01006640,1428,11,38,9,10,1496
E01006641,1078,11,151,18,9,1267
E01006642,970,12,21,10,1,1014
E01006643,1278,21,36,17,5,1357
E01006644,1574,20,28,18,3,1643
E01006645,1126,10,10,15,0,1161
E01006646,1457,34,73,31,38,1633
E01006647,1017,28,7,16,3,1071
E01006648,1703,47,83,30,32,1895
E01006651,1197,15,26,6,4,1248
E01006652,1171,6,28,0,6,1211
E01006653,1169,6,35,1,0,1211
E01006654,1192,5,38,1,0,1236
E01006655,1276,8,85,17,24,1410
E01006656,1209,2,5,2,3,1221
E01006657,951,7,16,1,3,978
E01006658,1031,9,15,6,6,1067
E01006659,1462,26,52,31,3,1574
E01006660,1037,6,77,6,10,1136
E01006661,1297,7,16,29,1,1350
E01006662,1362,9,45,21,2,1439
E01006663,868,4,17,5,2,896
E01006664,1317,18,43,25,3,1406
E01006665,1177,9,27,5,1,1219
E01006666,1071,8,56,13,8,1156
E01006667,1153,17,23,5,7,1205
E01006668,1104,16,28,6,9,1163
E01006669,1042,11,58,17,14,1142
E01006670,1140,8,54,6,2,1210
E01006671,995,16,81,13,0,1105
E01006672,1377,21,27,13,7,1445
E01006673,718,182,187,265,159,1511
E01006674,530,131,105,308,281,1355
E01006675,1228,112,108,144,110,1702
E01006676,719,113,149,187,115,1283
E01006677,420,96,52,107,78,753
E01006678,1425,115,50,93,91,1774
E01006679,456,191,151,485,295,1578
E01006680,1243,12,51,2,2,1310
E01006681,1239,24,66,9,4,1342
E01006682,1035,7,19,7,0,1068
E01006683,1199,17,23,6,9,1254
E01006684,1703,23,62,5,3,1796
E01006685,1212,17,25,9,1,1264
E01006686,1144,15,24,9,4,1196
E01006687,1500,35,79,52,3,1669
E01006688,1234,18,16,14,4,1286
E01006689,1294,26,20,18,7,1365
E01006690,1058,47,56,103,31,1295
E01006691,821,38,107,150,47,1163
E01006692,1482,39,75,107,45,1748
E01006693,1207,24,63,25,18,1337
E01006694,1068,47,74,272,20,1481
E01006695,1200,44,60,187,58,1549
E01006696,1076,32,131,115,18,1372
E01006697,1120,38,104,128,67,1457
E01006698,1288,11,14,7,4,1324
E01006699,1244,6,3,17,5,1275
E01006700,1121,10,24,13,9,1177
E01006701,1127,9,18,8,12,1174
E01006702,1198,16,31,19,13,1277
E01006703,1258,14,14,30,3,1319
E01006705,1115,6,11,18,7,1157
E01006706,1048,13,11,13,1,1086
E01006707,1020,21,11,13,2,1067
E01006708,1394,18,4,13,2,1431
E01006709,1181,18,9,3,0,1211
E01006710,1157,15,5,14,0,1191
E01006711,1116,21,34,26,28,1225
E01006712,985,13,40,1,6,1045
E01006713,1067,10,28,5,3,1113
E01006716,1132,33,61,18,19,1263
E01006717,1108,17,19,15,14,1173
E01006718,1238,15,17,12,14,1296
E01006719,1176,14,12,1,6,1209
E01006720,1146,92,164,162,99,1663
E01006721,1137,62,67,62,48,1376
E01006722,1253,55,166,72,45,1591
E01006723,1390,72,128,80,31,1701
E01006724,1436,56,99,60,20,1671
E01006725,1132,52,52,31,17,1284
E01006726,1056,65,92,80,32,1325
E01006727,1096,38,38,33,10,1215
E01006728,1149,58,62,42,17,1328
E01006729,991,7,3,15,2,1018
E01006730,1016,12,10,8,2,1048
E01006731,908,3,17,9,3,940
E01006732,1136,14,12,8,7,1177
E01006734,1010,12,12,14,10,1058
E01006735,986,11,21,12,0,1030
E01006736,1126,12,8,20,1,1167
E01006737,1118,10,5,16,3,1152
E01006738,1163,4,5,10,1,1183
E01006739,1270,29,17,21,5,1342
E01006740,958,5,22,9,24,1018
E01006741,1434,18,5,12,1,1470
E01006742,1112,22,7,6,5,1152
E01006743,1619,25,50,24,9,1727
E01006744,1163,26,9,3,8,1209
E01006745,1431,44,35,9,1,1520
E01006746,1100,33,120,53,11,1317
E01006747,2153,86,940,177,66,3422
E01006748,1360,39,257,65,47,1768
E01006751,1363,101,506,143,101,2214
E01006752,561,40,118,74,46,839
E01006753,1147,19,8,10,0,1184
E01006754,1279,22,0,15,1,1317
E01006755,1134,26,11,22,8,1201
E01006756,1281,21,21,21,4,1348
E01006757,1053,26,7,6,3,1095
E01006758,1095,29,13,19,1,1157
E01006759,814,21,17,30,20,902
E01006760,1244,36,38,53,55,1426
E01006761,1266,31,59,9,9,1374
E01006762,1306,12,18,3,6,1345
E01006763,1122,11,14,8,4,1159
E01006764,1109,24,38,27,16,1214
E01006765,1156,16,9,6,5,1192
E01006766,883,15,24,35,12,969
E01006767,1264,18,25,65,16,1388
E01006768,1050,22,40,16,31,1159
E01006769,1012,18,4,7,18,1059
E01006770,767,20,13,5,3,808
E01006771,1137,16,11,5,3,1172
E01006772,869,11,26,11,1,918
E01006773,1097,15,16,6,4,1138
E01006774,1027,17,106,18,2,1170
E01006775,1047,24,13,6,2,1092
E01006776,1384,11,20,15,3,1433
E01006778,1731,32,41,53,7,1864
E01006779,1545,19,4,6,17,1591
E01006780,1177,5,7,4,3,1196
E01006781,1210,3,10,0,0,1223
E01006782,1232,14,20,4,10,1280
E01006783,1178,10,21,3,1,1213
E01006784,1052,12,9,5,10,1088
E01006785,1374,14,16,28,6,1438
E01006786,1439,8,3,1,7,1458
E01006787,1830,39,74,54,39,2036
E01006788,1359,11,23,8,3,1404
E01006790,1228,16,5,17,10,1276
E01006791,1339,8,15,31,18,1411
E01006792,1099,17,20,6,11,1153
E01006793,1172,19,42,5,15,1253
E01006794,1262,14,53,8,12,1349
E01006795,1140,13,25,1,4,1183
E01006796,1171,15,91,6,21,1304
E01006797,1210,17,8,7,5,1247
E01006798,1156,11,41,7,0,1215
E01006799,1603,20,21,4,12,1660
E01006800,1152,15,64,9,6,1246
E01006801,1160,10,29,2,1,1202
E01006802,1398,5,8,1,2,1414
E01006803,1217,5,7,1,4,1234
E01006804,1326,12,1,0,0,1339
E01006805,1198,5,10,2,1,1216
E01006806,1269,4,6,1,1,1281
E01006807,1164,2,7,1,2,1176
E01006808,1111,4,1,0,1,1117
E01006809,1256,2,0,2,0,1260
E01006810,1072,1,4,0,1,1078
E01006811,1141,2,5,0,2,1150
E01006812,1048,2,23,0,5,1078
E01006813,1225,7,13,3,1,1249
E01006814,1280,3,9,0,1,1293
E01006815,1049,6,8,0,1,1064
E01006816,1247,10,11,5,0,1273
E01006817,1030,10,16,1,1,1058
E01006818,1086,2,3,0,0,1091
E01006819,1192,6,4,1,1,1204
E01006820,1104,5,3,2,0,1114
E01006821,1095,3,6,1,0,1105
E01006822,1110,2,6,1,1,1120
E01006823,1103,2,1,4,1,1111
E01006824,1007,1,5,0,1,1014
E01006825,1244,2,3,2,1,1252
E01006826,1131,4,11,1,0,1147
E01006827,1197,10,30,0,3,1240
E01006828,1770,9,33,5,2,1819
E01006829,1039,4,20,3,2,1068
E01006830,996,4,8,1,0,1009
E01006831,1176,4,8,4,1,1193
E01006832,1270,9,7,5,2,1293
E01006833,1338,6,10,3,3,1360
E01006834,1017,8,6,2,1,1034
E01006835,1170,3,7,1,1,1182
E01006836,1153,1,12,2,0,1168
E01006837,1216,3,7,3,1,1230
E01006838,1194,4,14,0,3,1215
E01006839,1136,4,7,3,1,1151
E01006840,1259,1,16,3,0,1279
E01006841,1327,4,0,3,2,1336
E01006842,1204,1,7,4,4,1220
E01006843,1003,1,1,0,1,1006
E01006844,1262,14,1,1,1,1279
E01006845,1210,3,9,2,0,1224
E01006846,1214,3,4,0,0,1221
E01006847,1255,9,18,2,1,1285
E01006848,1184,6,7,1,2,1200
E01006849,1123,2,4,0,1,1130
E01006850,1227,2,7,0,2,1238
E01006851,1092,2,3,0,1,1098
E01006852,1111,5,0,0,0,1116
E01006853,1139,1,3,1,2,1146
E01006854,1181,4,1,2,2,1190
E01006855,1172,4,13,2,1,1192
E01006856,1077,5,16,7,2,1107
E01006857,1184,14,6,0,1,1205
E01006858,1107,1,12,4,2,1126
E01006859,1324,13,20,5,1,1363
E01006860,1129,9,10,0,1,1149
E01006861,1144,19,21,3,1,1188
E01006862,1066,5,11,1,2,1085
E01006863,1310,7,19,2,1,1339
E01006864,1505,11,20,2,2,1540
E01006865,1381,8,7,3,1,1400
E01006866,1162,7,8,1,2,1180
E01006867,1554,8,28,5,8,1603
E01006868,1133,10,23,0,0,1166
E01006869,1165,9,11,6,1,1192
E01006870,1077,7,35,2,2,1123
E01006871,1198,8,10,3,1,1220
E01006872,1192,11,31,3,3,1240
E01006873,950,3,21,2,0,976
E01006874,924,9,6,1,3,943
E01006875,987,6,11,0,1,1005
E01006876,1223,6,10,1,0,1240
E01006877,1246,11,3,0,1,1261
E01006878,1140,2,3,0,2,1147
E01006879,1157,7,11,2,1,1178
E01006880,1174,4,7,3,6,1194
E01006881,1176,10,13,2,4,1205
E01006882,1006,2,5,2,1,1016
E01006883,1112,4,11,0,0,1127
E01006884,1156,5,7,1,1,1170
E01006885,1085,7,4,3,4,1103
E01006886,1128,3,2,1,2,1136
E01006887,1115,1,9,1,1,1127
E01006888,1017,7,22,0,1,1047
E01006889,1145,11,39,2,2,1199
E01006890,1208,8,9,1,2,1228
E01006891,1126,7,27,0,3,1163
E01006892,1024,5,7,0,0,1036
E01006893,1124,3,21,2,4,1154
E01006894,1139,4,14,0,2,1159
E01006895,1195,12,52,0,3,1262
E01006896,1332,4,2,0,1,1339
E01006897,1275,6,7,1,0,1289
E01006898,1348,6,2,1,1,1358
E01006899,1505,6,24,1,2,1538
E01006900,2051,7,19,5,2,2084
E01006901,1065,5,5,0,0,1075
E01006903,1225,6,7,3,0,1241
E01006904,1326,7,13,2,4,1352
E01006905,1074,4,8,0,0,1086
E01006906,1193,10,10,6,5,1224
E01006907,1259,6,15,2,4,1286
E01006908,1036,3,6,2,1,1048
E01006909,883,5,3,2,3,896
E01006910,1349,9,10,4,0,1372
E01006911,1296,4,1,0,0,1301
E01006912,1089,10,23,1,5,1128
E01006913,1014,3,10,1,0,1028
E01006914,1026,2,6,1,0,1035
E01006915,1299,0,4,2,3,1308
E01006916,1278,9,13,1,1,1302
E01006917,1340,1,11,0,0,1352
E01006918,1013,3,4,0,0,1020
E01006919,1151,5,6,1,0,1163
E01006920,1290,13,11,0,0,1314
E01006921,1145,6,5,0,0,1156
E01006922,1243,4,10,3,0,1260
E01006923,1286,1,12,0,1,1300
E01006924,1130,8,12,1,3,1154
E01006925,1186,11,11,1,1,1210
E01006926,1394,1,17,5,3,1420
E01006927,1360,10,9,3,1,1383
E01006928,1162,8,13,6,3,1192
E01006929,1229,7,7,3,3,1249
E01006930,1141,10,7,2,0,1160
E01006931,1235,7,7,4,5,1258
E01006932,1219,11,9,3,3,1245
E01006933,1106,5,7,2,7,1127
E01006934,1193,10,21,0,3,1227
E01006935,1327,6,10,5,7,1355
E01006936,1270,15,46,4,13,1348
E01006937,1023,3,6,1,0,1033
E01006938,1028,9,43,9,6,1095
E01006939,1194,6,12,0,3,1215
E01006940,1169,14,30,4,2,1219
E01006941,1323,14,17,0,3,1357
E01006942,1187,7,3,1,2,1200
E01006943,1022,2,7,2,5,1038
E01006944,1521,14,14,5,8,1562
E01006945,1392,21,20,9,7,1449
E01006946,1209,3,3,1,2,1218
E01006947,1173,9,19,0,6,1207
E01006948,1106,13,13,8,0,1140
E01006949,1274,5,5,3,0,1287
E01006950,1333,22,21,13,9,1398
E01006951,1287,8,30,6,6,1337
E01006952,1080,6,10,4,24,1124
E01006953,1125,13,17,3,16,1174
E01006954,1260,11,9,0,3,1283
E01006955,1270,10,22,14,1,1317
E01006956,1228,14,16,6,5,1269
E01006957,1327,12,20,5,3,1367
E01006958,1179,23,12,4,9,1227
E01006959,1283,8,19,6,3,1319
E01006960,960,7,4,0,0,971
E01006961,1195,7,13,8,2,1225
E01006962,1152,6,13,1,0,1172
E01006963,1065,10,22,12,3,1112
E01006964,1113,14,34,2,5,1168
E01006965,1124,8,5,0,1,1138
E01006966,1200,5,6,1,0,1212
E01006967,1250,10,8,6,2,1276
E01006968,1441,41,58,17,30,1587
E01006969,1137,15,42,9,3,1206
E01006970,1273,20,51,5,6,1355
E01006971,1428,7,22,2,9,1468
E01006972,1475,12,2,7,6,1502
E01006973,1351,20,50,4,3,1428
E01006974,1346,7,11,0,2,1366
E01006976,1151,6,8,0,0,1165
E01006977,1365,11,5,3,9,1393
E01006978,1133,15,11,1,0,1160
E01006979,1075,14,2,4,4,1099
E01006980,1097,11,13,2,2,1125
E01006981,1144,5,7,0,3,1159
E01006982,1090,4,11,3,0,1108
E01006983,1296,14,1,1,1,1313
E01006984,902,13,6,3,4,928
E01006985,1182,5,9,2,3,1201
E01006986,1108,5,9,1,2,1125
E01006987,1042,5,17,2,1,1067
E01006988,1170,1,3,0,1,1175
E01006989,1153,4,4,3,1,1165
E01006990,1018,5,1,2,1,1027
E01006991,1250,4,4,1,0,1259
E01006992,941,5,5,1,2,954
E01006993,1224,4,11,6,1,1246
E01006994,1160,12,27,9,16,1224
E01006995,1010,16,27,11,6,1070
E01006996,1238,18,36,7,4,1303
E01006997,1160,8,22,0,6,1196
E01006998,1246,12,27,9,3,1297
E01006999,1239,22,62,6,6,1335
E01007000,971,13,19,6,1,1010
E01007001,1208,7,5,12,12,1244
E01007002,1070,11,33,13,2,1129
E01007003,944,8,6,1,0,959
E01007004,1082,12,13,7,1,1115
E01007005,957,20,9,5,4,995
E01007006,1059,10,8,6,2,1085
E01007007,970,9,14,1,10,1004
E01007008,961,7,25,3,29,1025
E01007009,1091,11,10,1,7,1120
E01007010,821,3,13,5,4,846
E01007011,1157,20,4,4,0,1185
E01007012,1049,0,7,2,1,1059
E01007013,1080,8,11,4,11,1114
E01007014,1301,7,5,0,0,1313
E01007016,1378,10,9,8,0,1405
E01007017,1208,7,3,7,1,1226
E01007019,983,9,16,0,3,1011
E01007020,1131,9,5,1,1,1147
E01007021,1143,5,5,1,0,1154
E01007022,1158,10,7,1,0,1176
E01007023,1136,2,12,3,3,1156
E01007024,965,7,4,0,1,977
E01007025,1111,4,13,2,1,1131
E01007026,940,5,4,1,5,955
E01007027,1784,13,12,1,1,1811
E01007028,1090,9,5,4,3,1111
E01007029,1110,6,3,0,0,1119
E01007030,1162,11,4,7,0,1184
E01007031,1158,13,6,2,0,1179
E01007032,1063,11,6,5,3,1088
E01007033,1216,5,3,1,4,1229
E01007034,1146,3,8,0,5,1162
E01007035,1200,5,5,0,1,1211
E01007036,1030,5,10,0,2,1047
E01007037,1297,2,3,0,0,1302
E01007038,1227,9,14,2,2,1254
E01007039,996,9,10,0,0,1015
E01007040,1809,17,9,10,3,1848
E01007041,1155,6,6,4,0,1171
E01007042,1068,2,0,2,1,1073
E01007043,1236,8,2,1,0,1247
E01007044,1211,1,0,1,0,1213
E01007045,1041,5,5,0,0,1051
E01007046,1293,2,10,1,1,1307
E01007047,1162,5,5,2,0,1174
E01007048,1171,8,8,8,5,1200
E01007049,1234,8,7,4,0,1253
E01007050,1082,4,2,0,0,1088
E01007051,934,7,7,0,2,950
E01007052,1041,4,5,0,2,1052
E01007053,1132,5,6,5,0,1148
E01007054,1154,11,4,2,0,1171
E01007055,1074,8,16,10,0,1108
E01007056,1233,7,20,7,4,1271
E01007057,1220,5,12,0,2,1239
E01007058,1142,4,27,0,0,1173
E01007059,1148,7,21,2,5,1183
E01007060,1140,8,14,5,10,1177
E01007061,1121,9,5,5,0,1140
E01007062,1136,5,12,5,0,1158
E01007063,1206,7,6,0,0,1219
E01007064,1018,13,5,3,3,1042
E01007065,1078,5,4,1,0,1088
E01007066,1251,3,17,1,1,1273
E01007067,1163,11,10,8,1,1193
E01007068,1047,5,12,0,0,1064
E01007069,1204,5,1,1,1,1212
E01007070,1253,7,9,0,1,1270
E01007071,1061,1,3,0,0,1065
E01007072,1274,2,8,3,3,1290
E01007073,1110,1,1,1,0,1113
E01007074,1199,8,17,2,1,1227
E01007075,1126,3,7,5,0,1141
E01007076,1167,5,6,3,1,1182
E01007077,1170,9,20,2,4,1205
E01007078,1281,9,17,2,0,1309
E01007079,1285,5,10,1,0,1301
E01007080,1161,7,10,4,4,1186
E01007081,1280,4,5,1,1,1291
E01007082,1173,8,4,1,0,1186
E01007083,978,8,5,1,0,992
E01007084,1128,4,3,2,2,1139
E01007085,1049,5,2,3,1,1060
E01007086,1054,7,1,2,0,1064
E01007087,1089,13,0,1,0,1103
E01007088,1051,5,8,1,0,1065
E01007089,1107,2,6,3,2,1120
E01007090,922,4,2,1,1,930
E01007091,1090,2,0,1,0,1093
E01007092,905,4,4,0,1,914
E01007095,1348,4,1,0,0,1353
E01007096,1158,1,5,1,0,1165
E01007097,1287,7,14,0,1,1309
E01007098,1207,8,5,4,0,1224
E01007099,1318,12,7,4,1,1342
E01007100,1155,0,6,4,2,1167
E01007101,1245,4,15,0,1,1265
E01007102,1161,11,18,2,3,1195
E01007103,1208,10,8,0,1,1227
E01007104,1109,13,8,3,3,1136
E01007105,1287,16,1,5,1,1310
E01007106,1184,7,6,1,2,1200
E01007107,1096,5,3,0,1,1105
E01007108,1239,11,13,6,1,1270
E01007109,1198,8,14,1,2,1223
E01007110,1319,10,17,1,0,1347
E01007111,1261,3,10,2,0,1276
E01007112,1200,10,11,5,1,1227
E01007113,1113,7,19,2,0,1141
E01007114,1084,14,29,3,5,1135
E01007115,1247,7,16,0,2,1272
E01007116,1260,5,20,2,1,1288
E01007117,1297,6,7,4,0,1314
E01007118,1211,7,16,5,3,1242
E01007119,1106,13,24,2,1,1146
E01007120,981,13,14,4,1,1013
E01007121,1097,10,10,4,1,1122
E01007122,1028,14,10,4,1,1057
E01007123,1185,13,29,2,0,1229
E01007124,1088,6,1,1,1,1097
E01007125,1285,12,28,4,1,1330
E01007126,1525,25,28,6,6,1590
E01007127,1103,11,28,1,1,1144
E01007128,1195,20,120,10,2,1347
E01007129,1195,17,17,3,3,1235
E01007130,1088,12,206,3,3,1312
E01007131,1151,9,26,1,3,1190
E01007133,912,12,7,1,2,934
E01007135,1287,5,9,0,1,1302
E01007136,1286,4,2,4,0,1296
E01007137,1318,5,12,5,0,1340
E01007138,1273,11,8,3,0,1295
E01007139,1195,12,16,0,4,1227
E01007140,1319,8,17,4,1,1349
E01007141,1354,7,14,1,3,1379
E01007142,1550,11,22,4,3,1590
E01007143,1297,4,14,3,2,1320
E01007144,1176,9,8,2,3,1198
E01007145,1129,3,22,0,3,1157
E01007146,1313,9,10,1,12,1345
E01007147,1146,8,14,8,2,1178
E01007148,1418,0,5,0,3,1426
E01007149,1257,3,7,0,0,1267
E01007150,1205,4,7,1,0,1217
E01007151,1236,8,9,2,2,1257
E01007152,1335,6,18,2,1,1362
E01007153,1253,2,8,4,1,1268
E01007154,1237,6,19,7,1,1270
E01007155,1563,12,39,3,8,1625
E01007156,1278,9,22,2,3,1314
E01007157,1204,5,5,7,0,1221
E01007158,1257,9,23,5,0,1294
E01007159,1397,24,81,3,7,1512
E01007160,1387,11,25,2,3,1428
E01007161,1236,7,23,1,0,1267
E01007162,1069,10,19,0,1,1099
E01007163,1744,13,80,0,1,1838
E01007164,1360,4,14,1,0,1379
E01007165,1125,6,6,2,0,1139
E01007166,1235,7,6,0,1,1249
E01007167,1163,7,6,3,2,1181
E01007168,1331,9,7,3,1,1351
E01007169,1409,9,12,3,0,1433
E01007170,1245,7,15,2,0,1269
E01007171,1254,4,3,2,1,1264
E01007172,1189,4,11,0,0,1204
E01007173,1248,7,15,2,1,1273
E01007174,1228,5,19,0,1,1253
E01007175,1446,14,24,3,0,1487
E01007176,1281,9,15,5,1,1311
E01007177,1209,15,26,0,0,1250
E01007178,1256,17,20,2,3,1298
E01007179,1002,7,19,4,0,1032
E01007180,1272,9,17,4,3,1305
E01007181,1147,14,18,5,0,1184
E01007182,1299,6,8,3,2,1318
E01007183,1039,11,6,1,1,1058
E01007184,1223,9,10,0,0,1242
E01007185,1215,12,18,2,2,1249
E01007186,1245,9,30,5,0,1289
E01007187,1280,6,7,1,1,1295
E01007188,1193,5,22,0,2,1222
E01007189,1363,8,11,3,2,1387
E01007190,1205,4,12,3,4,1228
E01007191,1082,8,14,3,6,1113
E01007192,1086,4,18,2,2,1112
E01007193,1386,11,25,2,0,1424
E01007194,1212,5,37,1,5,1260
E01007195,1327,5,4,0,1,1337
E01007196,1316,19,9,2,6,1352
E01007197,1300,6,18,2,5,1331
E01007198,1368,17,18,2,4,1409
E01007199,1269,1,5,0,1,1276
E01007200,1408,8,7,2,0,1425
E01007201,1170,6,12,2,0,1190
E01007202,1128,3,3,2,9,1145
E01007203,1629,14,14,9,2,1668
E01007204,1120,15,14,1,1,1151
E01007205,1188,12,3,3,0,1206
E01007206,1391,9,51,1,3,1455
E01007207,1079,8,12,2,2,1103
E01007208,1383,6,12,0,0,1401
E01007209,1069,8,16,2,0,1095
E01007210,1502,9,27,4,0,1542
E01007211,975,6,10,2,0,993
E01007212,1191,10,12,3,3,1219
E01007213,1281,9,18,0,0,1308
E01007214,1216,3,32,3,0,1254
E01007215,1226,17,10,7,3,1263
E01007216,1181,12,8,3,1,1205
E01007217,1266,12,15,7,0,1300
E01007218,1141,12,15,3,0,1171
E01007219,1202,5,20,3,2,1232
E01007220,912,8,29,5,1,955
E01007221,1215,7,14,1,0,1237
E01007222,1290,12,12,2,5,1321
E01007223,1060,2,20,5,4,1091
E01007224,1203,0,15,3,3,1224
E01007225,1500,7,18,1,1,1527
E01007226,1375,7,6,0,0,1388
E01007227,1184,9,8,1,0,1202
E01007228,1152,5,17,4,0,1178
E01007229,1264,16,15,5,3,1303
E01007230,1009,6,8,2,2,1027
E01007231,1303,13,11,3,0,1330
E01007232,1241,6,13,9,3,1272
E01007233,1392,19,14,3,1,1429
E01007234,1228,24,20,7,6,1285
E01007235,1200,8,3,0,0,1211
E01007236,1103,7,10,0,7,1127
E01007237,1293,11,21,2,1,1328
E01007238,1282,17,19,4,0,1322
E01007239,1315,16,23,1,6,1361
E01007240,1365,15,14,3,4,1401
E01007241,1245,9,56,0,0,1310
E01007242,1413,13,30,2,2,1460
E01007243,1364,14,6,3,1,1388
E01007244,1515,18,24,14,3,1574
E01007245,1261,7,22,1,2,1293
E01007246,1232,14,33,4,0,1283
E01007247,1353,9,31,1,1,1395
E01007248,1207,11,31,3,2,1254
E01007249,998,9,24,5,1,1037
E01007250,1154,8,4,3,3,1172
E01007251,960,12,28,10,3,1013
E01007252,1257,2,12,3,0,1274
E01007253,1245,9,25,1,6,1286
E01007254,1248,10,26,0,9,1293
E01007255,1239,8,9,2,0,1258
E01007256,1350,4,19,1,2,1376
E01007257,1005,7,11,2,2,1027
E01007258,1194,5,12,1,2,1214
E01007259,998,10,11,1,1,1021
E01007260,1251,6,12,0,9,1278
E01007261,1178,2,6,2,0,1188
E01007262,1219,6,27,1,3,1256
E01007263,1169,6,4,0,4,1183
E01007264,1183,3,35,0,3,1224
E01007265,1059,6,9,2,1,1077
E01007266,1235,7,9,1,4,1256
E01007267,1201,5,11,0,7,1224
E01007268,1113,4,8,1,3,1129
E01007269,1337,16,18,10,3,1384
E01007270,1306,6,25,1,2,1340
E01007271,1243,15,21,6,5,1290
E01007272,1113,9,12,1,1,1136
E01007273,987,5,11,7,7,1017
E01007274,986,9,7,1,0,1003
E01007275,1184,16,16,2,0,1218
E01007276,1159,14,15,3,0,1191
E01007277,1095,18,26,0,1,1140
E01007278,1053,16,26,9,2,1106
E01007279,1350,8,12,0,1,1371
E01007280,1416,2,10,2,1,1431
E01007281,1069,10,26,1,2,1108
E01007282,1115,11,14,2,6,1148
E01007283,1027,19,15,2,4,1067
E01007284,1380,2,5,5,2,1394
E01007285,1237,6,5,2,1,1251
E01007286,1170,6,11,1,1,1189
E01007287,1609,9,6,1,1,1626
E01007288,1320,9,9,1,1,1340
E01007289,1116,3,19,0,2,1140
E01007290,1322,6,30,5,1,1364
E01007291,1282,14,60,8,3,1367
E01007292,1041,17,23,7,3,1091
E01007293,1064,6,21,4,1,1096
E01007294,1062,5,17,3,2,1089
E01007295,865,11,20,9,1,906
E01007296,1265,13,25,1,4,1308
E01007297,1139,2,13,1,0,1155
E01007298,1284,5,16,0,1,1306
E01007299,1116,2,2,1,0,1121
E01007300,1418,10,30,2,7,1467
E01007301,1315,5,30,5,1,1356
E01007302,1159,3,37,0,2,1201
E01007303,1158,3,7,1,2,1171
E01007304,1188,11,15,3,0,1217
E01007305,1349,8,19,1,4,1381
E01007306,1321,5,7,4,2,1339
E01007307,1434,16,18,4,1,1473
E01007308,1281,11,5,3,1,1301
E01007309,1260,7,11,0,3,1281
E01007310,1138,8,8,6,0,1160
E01007311,1259,3,8,1,3,1274
E01007312,1225,7,15,4,0,1251
E01007313,1298,7,29,0,0,1334
E01007314,1186,5,11,9,1,1212
E01007315,1229,6,7,0,3,1245
E01007316,1263,6,6,1,0,1276
E01007317,1179,6,1,8,1,1195
E01007318,1145,12,14,28,1,1200
E01007319,1225,3,3,0,1,1232
E01007320,1215,3,2,15,0,1235
E01007321,1242,5,6,3,0,1256
E01007322,1641,9,29,11,5,1695
E01007323,1116,8,2,9,0,1135
E01007324,1330,11,0,7,1,1349
E01007325,1178,7,14,4,4,1207
E01007326,1219,5,6,10,2,1242
E01007327,1414,5,2,1,1,1423
E01007328,1492,7,5,8,2,1514
E01007329,1230,7,5,1,0,1243
E01007330,1386,12,5,3,1,1407
E01007331,1528,7,3,0,5,1543
E01007332,1799,9,13,11,7,1839
E01007333,983,5,3,2,1,994
E01007334,1123,9,3,8,0,1143
E01007335,1247,2,2,6,0,1257
E01007336,1242,9,24,31,11,1317
E01007337,1401,9,12,19,11,1452
E01007338,1314,6,11,22,5,1358
E01007339,1129,5,31,42,14,1221
E01007340,1277,19,17,6,10,1329
E01007341,933,8,3,13,2,959
E01007342,1121,4,2,1,1,1129
E01007343,1134,5,1,1,0,1141
E01007344,1639,14,12,8,1,1674
E01007345,1274,6,4,6,0,1290
E01007346,1243,7,14,5,0,1269
E01007347,1264,4,12,5,1,1286
E01007348,1175,3,1,6,0,1185
E01007349,1215,7,1,2,0,1225
E01007350,1022,7,5,1,1,1036
E01007351,1154,3,2,1,0,1160
E01007352,1123,5,8,0,0,1136
E01007353,1245,5,16,8,0,1274
E01007354,1359,12,6,1,1,1379
E01007355,1167,3,15,1,3,1189
E01007356,1143,6,7,3,2,1161
E01007357,1133,8,9,1,0,1151
E01007358,1178,6,8,8,3,1203
E01007359,1190,3,10,2,5,1210
E01007360,1302,1,3,2,3,1311
E01007361,1332,12,10,1,3,1358
E01007362,1328,8,14,2,3,1355
E01007363,1310,3,10,4,10,1337
E01007364,1121,2,1,0,1,1125
E01007365,949,2,4,2,0,957
E01007366,1623,7,0,3,2,1635
E01007367,923,4,0,0,0,927
E01007368,1294,9,3,16,4,1326
E01007369,1149,15,5,6,2,1177
E01007370,1112,5,2,4,0,1123
E01007371,1518,9,16,4,4,1551
E01007372,953,3,6,0,1,963
E01007373,1218,7,11,3,0,1239
E01007374,1242,2,2,2,0,1248
E01007375,1380,6,5,1,6,1398
E01007376,1098,9,0,9,1,1117
E01007377,832,7,3,3,1,846
E01007378,1237,5,2,8,1,1253
E01007379,1331,5,9,2,1,1348
E01007380,1438,4,20,9,5,1476
E01007381,1252,6,21,1,4,1284
E01007382,1214,7,14,0,4,1239
E01007383,1062,7,14,4,0,1087
E01007384,1348,1,7,0,0,1356
E01007385,1220,4,7,2,2,1235
E01007386,1462,3,4,0,0,1469
E01007387,1158,5,11,4,0,1178
E01007388,1300,8,5,8,4,1325
E01007389,1251,12,3,1,1,1268
E01007390,1248,11,7,1,0,1267
E01007391,1186,11,8,8,2,1215
E01007392,1200,6,7,3,1,1217
E01007393,1443,9,12,5,2,1471
E01007394,1099,3,5,4,3,1114
E01007395,1522,6,3,9,2,1542
E01007396,1281,11,1,5,0,1298
E01007397,1212,5,3,7,4,1231
E01007398,1417,0,4,0,1,1422
E01007399,1645,6,2,5,1,1659
E01007400,1618,2,12,2,1,1635
E01007402,1232,4,9,6,5,1256
E01007403,1183,11,3,12,0,1209
E01007404,1140,3,1,2,1,1147
E01007405,1209,2,6,2,1,1220
E01007406,1388,7,11,2,1,1409
E01007408,1199,11,16,9,0,1235
E01007409,1184,9,14,7,4,1218
E01007410,1356,11,14,13,6,1400
E01007411,876,8,9,3,1,897
E01007413,974,2,21,12,2,1011
E01007414,1278,11,3,9,2,1303
E01007415,1208,14,10,2,0,1234
E01007416,918,2,9,17,3,949
E01007417,1217,9,24,17,14,1281
E01007418,1088,4,7,0,0,1099
E01007419,1371,6,1,1,6,1385
E01007420,1180,7,3,1,5,1196
E01007421,1144,6,7,7,0,1164
E01007422,1234,3,7,2,0,1246
E01007423,1346,7,6,3,3,1365
E01007424,1350,3,6,7,1,1367
E01007425,1231,3,8,3,2,1247
E01007426,1288,6,8,2,0,1304
E01007427,1243,9,12,3,3,1270
E01007428,1195,2,7,4,1,1209
E01007429,1221,4,9,1,0,1235
E01007430,1728,7,10,3,2,1750
E01007431,1117,6,4,0,2,1129
E01007432,1142,4,4,0,1,1151
E01007433,1291,6,6,2,0,1305
E01007434,1509,3,6,4,5,1527
E01007435,1272,2,2,3,1,1280
E01007436,1041,3,2,0,3,1049
E01007437,1179,7,7,3,2,1198
E01007438,1280,2,10,3,4,1299
E01007439,1032,1,1,0,0,1034
E01007440,1184,9,7,1,0,1201
E01007441,1175,6,39,24,19,1263
E01007442,1159,2,41,4,5,1211
E01007443,1487,25,47,72,13,1644
E01007444,1282,8,40,0,13,1343
E01007445,1183,10,15,4,3,1215
E01007446,1114,4,27,8,3,1156
E01007447,1223,2,3,3,0,1231
E01007448,1272,12,12,7,4,1307
E01007449,1442,15,11,8,0,1476
E01007450,1259,8,16,7,0,1290
E01007451,1348,10,7,3,0,1368
E01007452,1213,6,5,2,1,1227
E01007453,1184,4,3,4,0,1195
E01007455,1166,6,0,5,0,1177
E01007456,1419,8,5,2,1,1435
E01007457,1267,18,8,0,0,1293
E01007458,1187,7,9,2,1,1206
E01007459,1351,7,1,3,1,1363
E01007460,1180,3,6,17,2,1208
E01007461,1295,9,15,14,2,1335
E01007462,1178,13,19,6,5,1221
E01007463,1360,2,14,12,4,1392
E01007464,1152,2,7,4,0,1165
E01007465,1148,8,8,7,1,1172
E01007466,1212,4,6,6,1,1229
E01007467,1218,2,8,8,2,1238
E01007468,1155,4,2,0,1,1162
E01007469,1057,7,7,1,1,1073
E01007470,1064,6,1,2,1,1074
E01007471,1261,6,5,5,1,1278
E01007472,1221,6,9,5,3,1244
E01007473,1149,4,4,2,3,1162
E01007474,1061,6,4,1,0,1072
E01007475,1229,10,13,2,1,1255
E01007476,1161,16,21,5,7,1210
E01007477,1165,2,15,3,0,1185
E01007478,1249,1,10,4,3,1267
E01007479,1270,6,5,3,1,1285
E01007480,1135,3,12,11,0,1161
E01007482,1110,11,11,6,0,1138
E01007483,1155,6,3,4,4,1172
E01007484,1203,14,5,4,0,1226
E01007485,1133,11,7,5,1,1157
E01007486,1170,5,7,6,0,1188
E01007487,1308,5,4,2,0,1319
E01007488,1406,12,23,3,0,1444
E01007489,1382,4,16,1,1,1404
E01007490,1253,4,14,3,2,1276
E01007491,1241,11,9,5,1,1267
E01007492,1183,13,6,0,1,1203
E01007493,1444,7,5,0,2,1458
E01007494,1184,14,34,10,3,1245
E01007495,1327,21,45,35,4,1432
E01007496,1073,28,30,25,6,1162
E01007497,1002,6,13,21,1,1043
E01007498,1161,17,37,28,2,1245
E01007499,1140,7,17,11,1,1176
E01007500,979,8,24,14,3,1028
E01007501,1212,4,29,3,1,1249
E01007502,2046,9,54,40,8,2157
E01007503,1321,7,12,7,0,1347
E01007504,1209,11,12,5,1,1238
E01007505,1383,13,7,9,0,1412
E01007506,1106,8,6,0,0,1120
E01007507,945,9,20,7,0,981
E01007508,1195,17,9,16,2,1239
E01007509,1333,11,12,12,6,1374
E01007510,1267,11,11,5,0,1294
E01007511,1162,13,10,12,3,1200
E01007512,1306,9,20,5,1,1341
E01007513,1124,13,16,11,4,1168
E01007514,1129,13,23,23,2,1190
E01007515,1239,7,9,11,2,1268
E01007516,1088,6,5,7,2,1108
E01007517,1172,9,20,19,7,1227
E01007518,1190,5,14,3,0,1212
E01007519,1013,11,4,5,0,1033
E01007520,1117,9,70,4,7,1207
E01007521,1160,15,60,6,1,1242
E01007522,1238,12,29,6,6,1291
E01007523,1149,7,104,4,8,1272
E01007524,1240,7,97,8,12,1364
E01007525,1193,7,23,6,9,1238
E01007526,1241,8,105,11,3,1368
E01007527,1686,20,167,21,14,1908
E01007528,1068,6,20,5,11,1110
E01007529,1467,39,120,64,43,1733
E01007530,682,24,171,29,17,923
E01007531,1208,17,57,29,19,1330
E01007532,1085,48,175,80,88,1476
E01007533,1095,8,51,17,10,1181
E01007534,1445,25,66,37,11,1584
E01007535,1147,14,71,17,10,1259
E01007536,1599,11,20,6,1,1637
E01007537,1379,4,4,1,3,1391
E01007538,1188,2,4,3,1,1198
E01007539,1091,10,2,7,1,1111
E01007540,1286,4,2,5,1,1298
E01007541,1233,11,3,2,1,1250
E01007542,1354,11,14,9,3,1391
E01007543,1239,9,4,1,1,1254
E01007544,1325,5,7,2,3,1342
E01007545,1157,11,15,7,1,1191
E01007546,1114,6,16,9,0,1145
E01007547,1159,14,5,5,1,1184
E01007548,795,1,4,6,1,807
E01007549,1173,5,4,4,6,1192
E01007550,1359,5,9,2,0,1375
E01007551,1368,7,4,4,0,1383
E01007552,1139,6,20,2,1,1168
E01007553,1423,4,18,3,3,1451
E01007554,1270,4,24,4,0,1302
E01007555,1143,5,5,4,1,1158
E01007556,1031,8,9,0,0,1048
E01007557,2063,133,235,141,21,2593
E01007558,1196,1,3,3,2,1205
E01007559,976,10,29,19,1,1035
E01007560,1275,5,4,7,4,1295
E01007561,1193,5,6,2,2,1208
E01007562,1099,7,12,2,0,1120
E01007563,1014,7,14,2,5,1042
E01007564,1036,13,87,14,11,1161
E01007565,1114,19,96,17,2,1248
E01007566,1218,22,54,20,19,1333
E01007567,965,8,81,14,8,1076
E01007568,1071,16,46,18,6,1157
E01007569,1125,16,81,19,10,1251
E01007570,1173,13,38,9,4,1237
E01007571,1297,6,4,1,0,1308
E01007572,1153,8,5,1,2,1169
E01007573,1161,7,11,8,3,1190
E01007574,1239,7,8,4,3,1261
E01007575,1075,8,5,5,0,1093
E01007576,1261,8,7,1,0,1277
E01007577,1211,8,9,4,2,1234
E01007578,1287,4,9,4,0,1304
E01007579,1232,2,4,6,1,1245
E01007580,1181,3,8,7,2,1201
E01007581,1245,0,19,7,3,1274
E01007582,1181,3,10,1,1,1196
E01007583,1233,4,7,3,5,1252
E01007584,1224,8,16,4,6,1258
E01007585,1257,6,11,5,3,1282
E01007586,1306,1,5,1,1,1314
E01007587,1326,7,8,7,2,1350
E01007588,1303,12,11,8,0,1334
E01007589,1414,5,11,2,0,1432
E01007590,951,3,7,3,0,964
E01007591,1183,4,6,3,1,1197
E01007592,1212,3,10,6,1,1232
E01007593,1000,2,7,1,0,1010
E01007594,1556,7,12,15,2,1592
E01007595,1236,2,4,2,1,1245
E01007596,1058,6,2,6,0,1072
E01007597,1156,5,4,7,3,1175
E01007598,1295,6,7,12,1,1321
E01007599,1413,6,20,5,2,1446
E01007600,1199,12,6,2,1,1220
E01007601,1144,3,13,5,2,1167
E01007602,1191,13,23,4,0,1231
E01007603,1193,2,29,1,1,1226
E01007604,1118,8,57,9,7,1199
E01007605,1237,12,39,12,6,1306
E01007606,1161,7,92,9,8,1277
E01007607,1109,16,22,17,7,1171
E01007608,1215,14,14,2,1,1246
E01007609,1836,4,33,5,3,1881
E01007610,1491,7,15,2,1,1516
E01007611,1082,5,5,2,3,1097
E01007612,1189,6,2,5,1,1203
E01007613,1346,11,12,4,6,1379
E01007614,1124,1,3,7,3,1138
E01007615,1060,6,9,2,2,1079
E01007616,1056,3,8,3,0,1070
E01007617,1238,9,7,5,2,1261
E01007618,1048,1,10,0,2,1061
E01007619,1430,3,9,3,2,1447
E01007620,1372,4,10,1,0,1387
E01007621,1076,8,12,6,4,1106
E01007622,1256,4,11,0,1,1272
E01007623,996,3,5,3,2,1009
E01007624,1431,2,11,7,0,1451
E01007625,1243,3,10,1,2,1259
E01007626,973,11,29,11,2,1026
E01007627,1287,4,3,4,2,1300
E01007628,1088,5,9,8,0,1110
E01007629,1201,13,4,3,1,1222
E01007630,1155,3,9,6,1,1174
E01007631,1024,3,0,0,0,1027
E01007632,1240,0,4,0,2,1246
E01007633,988,7,7,0,1,1003
E01007634,1209,5,13,0,2,1229
E01007635,1152,3,7,2,0,1164
E01007636,1193,3,7,1,6,1210
E01007637,1240,2,12,2,1,1257
E01007638,1272,7,8,2,0,1289
E01007639,1597,6,9,3,0,1615
E01007640,1373,6,13,1,2,1395
E01007641,1198,4,4,1,4,1211
E01007642,1223,4,9,1,1,1238
E01007643,1064,25,95,34,19,1237
E01007644,1120,16,112,26,5,1279
E01007645,1218,31,329,42,45,1665
E01007646,1158,4,86,26,6,1280
E01007647,1148,12,104,10,11,1285
E01007648,1339,31,161,32,20,1583
E01007649,1108,17,97,15,10,1247
E01007650,1379,12,34,9,7,1441
E01007651,1202,11,90,26,8,1337
E01007652,1338,20,49,22,14,1443
E01007653,1193,24,40,21,3,1281
E01007654,1050,11,135,32,6,1234
E01007655,1363,28,124,38,39,1592
E01007656,1179,10,21,6,4,1220
E01007657,1167,6,10,1,0,1184
E01007658,1131,3,8,1,1,1144
E01007659,926,0,6,4,0,936
E01007660,1022,6,6,0,1,1035
E01007661,1132,6,13,3,1,1155
E01007662,816,6,2,0,0,824
E01007663,1237,7,8,1,0,1253
E01007664,1595,5,2,0,2,1604
E01007665,1438,12,12,19,9,1490
E01007666,1171,6,11,3,0,1191
E01007667,1091,5,10,0,1,1107
E01007668,1203,10,14,4,0,1231
E01007669,1264,8,11,2,3,1288
E01007670,1225,6,8,1,1,1241
E01007671,1609,14,19,20,4,1666
E01007672,1138,7,19,8,2,1174
E01007673,1103,6,22,12,0,1143
E01007674,1543,5,11,4,2,1565
E01007675,971,18,387,16,18,1410
E01007676,1269,5,39,24,4,1341
E01007677,960,24,73,33,32,1122
E01007678,1022,16,255,40,38,1371
E01007679,1083,12,349,14,14,1472
E01007680,783,26,549,36,39,1433
E01007681,1112,4,5,2,2,1125
E01007682,1130,5,14,2,1,1152
E01007683,1210,3,7,2,2,1224
E01007684,1280,6,22,5,1,1314
E01007685,1182,4,7,5,0,1198
E01007686,1214,0,18,1,4,1237
E01007687,1191,2,14,1,1,1209
E01007688,1198,3,13,1,0,1215
E01007689,1207,6,11,3,0,1227
E01007690,1357,3,27,2,2,1391
E01007691,1706,3,10,2,2,1723
E01007692,1248,2,9,0,4,1263
E01007693,1659,12,10,6,3,1690
E01007694,1354,4,16,4,5,1383
E01007695,1856,10,15,9,1,1891
E01007696,1252,6,5,2,0,1265
E01007697,1270,4,3,1,0,1278
E01007698,1244,5,14,1,1,1265
E01007699,1389,4,18,15,5,1431
E01007700,1378,11,14,10,4,1417
E01007701,1291,2,12,17,2,1324
E01007702,1149,7,40,21,2,1219
E01007703,970,3,38,1,7,1019
E01007704,1159,4,29,12,3,1207
E01007705,1162,17,31,18,0,1228
E01007706,1127,6,40,10,1,1184
E01007707,1270,7,23,3,4,1307
E01007708,1237,20,68,5,4,1334
E01007709,1179,5,33,1,2,1220
E01007710,1291,4,34,1,4,1334
E01007711,1342,14,99,10,3,1468
E01007712,1284,16,215,32,8,1555
E01007713,1114,9,198,13,10,1344
E01007714,1106,25,371,81,80,1663
E01007715,737,17,375,53,42,1224
E01007716,880,19,480,54,30,1463
E01007717,1352,14,72,38,14,1490
E01007718,987,14,121,17,7,1146
E01007719,955,5,8,2,1,971
E01007720,1213,8,11,8,3,1243
E01007721,1206,10,18,6,11,1251
E01007723,1060,11,6,3,0,1080
E01007724,1135,9,9,3,0,1156
E01007725,1038,2,16,5,4,1065
E01007726,1212,7,6,4,2,1231
E01007727,1254,6,3,1,0,1264
E01007728,938,1,5,6,0,950
E01007729,1329,18,19,24,8,1398
E01007730,1162,7,13,9,5,1196
E01007731,1079,2,9,0,3,1093
E01007732,1221,3,9,8,1,1242
E01007733,1091,7,2,6,4,1110
E01007734,1292,10,80,7,7,1396
E01007735,940,13,51,20,4,1028
E01007736,967,23,171,20,22,1203
E01007737,1026,11,11,31,9,1088
E01007738,1026,11,52,13,8,1110
E01007739,1064,11,125,10,5,1215
E01007740,1211,6,8,13,3,1241
E01007741,1300,8,16,0,3,1327
E01007742,1130,4,19,5,0,1158
E01007743,1089,3,5,0,2,1099
E01007744,1250,6,17,10,4,1287
E01007745,1196,9,20,13,0,1238
E01007746,1226,5,7,4,0,1242
E01007747,1043,5,4,3,0,1055
E01007748,1245,5,8,0,0,1258
E01007749,1425,1,9,2,6,1443
E01007750,1262,4,7,1,1,1275
E01007751,1464,8,30,13,5,1520
E01007752,1212,5,9,2,3,1231
E01007753,1271,2,5,4,1,1283
E01007754,1097,5,16,3,0,1121
E01007755,1137,3,3,1,1,1145
E01007756,1209,6,4,0,3,1222
E01007757,1343,7,11,3,0,1364
E01007758,1048,6,7,1,1,1063
E01007759,1199,11,2,3,0,1215
E01007760,1334,12,12,1,1,1360
E01007761,1295,1,7,2,0,1305
E01007762,1221,5,8,2,1,1237
E01007763,1225,10,12,1,2,1250
E01007764,1234,6,13,4,1,1258
E01007765,1080,4,119,24,10,1237
E01007766,973,9,96,14,15,1107
E01007767,1136,20,180,20,15,1371
E01007768,920,28,356,84,68,1456
E01007769,612,49,397,73,98,1229
E01007770,1055,10,258,11,11,1345
E01007771,1162,7,7,2,2,1180
E01007772,1047,5,11,2,2,1067
E01007773,1111,8,12,5,0,1136
E01007774,1144,1,7,3,4,1159
E01007775,961,5,8,7,7,988
E01007776,1161,11,14,16,4,1206
E01007777,1272,5,3,5,5,1290
E01007778,1239,4,9,2,2,1256
E01007779,1020,6,13,7,5,1051
E01007780,1185,3,13,5,0,1206
E01007781,1203,1,10,3,1,1218
E01007782,1121,7,14,7,3,1152
E01007783,1352,10,25,13,2,1402
E01007784,1344,17,29,16,5,1411
E01007785,1059,5,5,3,1,1073
E01007786,1000,3,2,1,0,1006
E01007787,2219,18,24,12,4,2277
E01007788,1231,6,7,0,2,1246
E01007789,1290,2,11,4,0,1307
E01007790,1155,18,9,2,3,1187
E01007791,1046,6,5,4,0,1061
E01007792,1078,5,5,2,0,1090
E01007793,1153,3,2,4,1,1163
E01007794,1050,7,21,0,2,1080
E01007795,1244,7,4,0,1,1256
E01007796,917,3,5,2,0,927
E01007797,1103,5,10,6,1,1125
E01007798,1068,1,5,0,5,1079
E01007799,1151,2,7,4,1,1165
E01007800,1220,3,3,12,9,1247
E01007801,1226,3,7,3,2,1241
E01007802,1133,2,8,4,3,1150
E01007803,1069,7,4,1,1,1082
E01007804,1152,3,5,16,8,1184
E01007805,1127,5,7,0,7,1146
E01007806,945,3,5,20,2,975
E01007807,1139,7,2,4,3,1155
E01007808,1242,2,11,0,2,1257
E01007809,1237,3,9,4,6,1259
E01007810,1542,11,6,1,4,1564
E01007811,1080,4,50,3,6,1143
E01007812,951,20,42,13,0,1026
E01007813,1050,2,41,1,6,1100
E01007814,904,9,23,3,0,939
E01007815,1341,6,4,1,3,1355
E01007816,1273,4,18,5,2,1302
E01007817,1161,6,3,4,2,1176
E01007818,1302,7,18,6,5,1338
E01007819,1220,9,15,8,4,1256
E01007820,1131,6,4,15,1,1157
E01007821,1294,4,2,8,4,1312
E01007822,1206,2,7,12,8,1235
E01007823,1350,12,22,16,6,1406
E01007824,1092,17,11,7,2,1129
E01007825,1182,6,17,5,2,1212
E01007826,1155,12,18,9,2,1196
E01007827,1250,13,10,17,2,1292
E01007828,1256,12,47,36,8,1359
E01007829,1199,17,56,24,5,1301
E01007830,1280,11,12,16,8,1327
E01007831,1206,14,19,19,2,1260
E01007832,1207,11,12,12,7,1249
E01007833,1389,11,16,11,3,1430
E01007834,1280,13,40,12,8,1353
E01007835,1206,3,6,8,4,1227
E01007836,1328,8,5,14,0,1355
E01007838,1214,10,3,7,3,1237
E01007839,1264,4,16,11,2,1297
E01007841,1298,12,12,4,4,1330
E01007842,1267,8,6,3,2,1286
E01007843,1255,11,12,11,9,1298
E01007846,1211,5,13,8,1,1238
E01007847,968,11,47,41,12,1079
E01007848,1080,28,69,103,34,1314
E01007849,1226,33,124,115,77,1575
E01007850,1205,18,33,23,14,1293
E01007851,691,39,180,112,51,1073
E01007852,1120,19,37,31,9,1216
E01007853,1156,30,27,87,6,1306
E01007854,811,45,158,89,95,1198
E01007855,1131,49,185,124,32,1521
E01007856,922,17,19,55,8,1021
E01007857,1064,24,37,44,4,1173
E01007858,1105,11,54,12,8,1190
E01007859,1283,40,156,26,34,1539
E01007860,1136,27,132,49,49,1393
E01007861,1190,13,37,4,8,1252
E01007862,3406,125,362,70,32,3995
E01007863,1497,24,99,27,17,1664
E01007864,1689,35,73,34,15,1846
E01007865,1271,14,26,17,10,1338
E01007866,1367,43,111,23,12,1556
E01007867,1642,50,159,42,33,1926
E01007868,909,12,56,17,36,1030
E01007869,464,31,451,172,77,1195
E01007870,865,37,287,188,112,1489
E01007871,1035,36,138,155,82,1446
E01007872,666,23,446,107,64,1306
E01007873,494,34,415,208,140,1291
E01007874,530,56,160,286,249,1281
E01007875,370,59,314,275,221,1239
E01007877,441,27,371,84,56,979
E01007878,962,27,113,174,111,1387
E01007879,1041,32,207,88,38,1406
E01007881,1083,28,78,77,14,1280
E01007882,925,31,282,135,23,1396
E01007883,330,20,461,41,52,904
E01007885,886,58,73,154,42,1213
E01007886,1063,25,26,57,15,1186
E01007887,1102,2,16,5,3,1128
E01007888,1127,8,6,4,1,1146
E01007889,2014,13,26,13,5,2071
E01007890,1166,8,1,10,3,1188
E01007891,1282,6,16,8,4,1316
E01007892,1158,7,0,9,1,1175
E01007893,1265,3,7,1,2,1278
E01007894,1168,11,16,14,2,1211
E01007895,1213,12,6,5,7,1243
E01007896,1069,1,11,6,2,1089
E01007897,1188,9,14,3,1,1215
E01007898,1179,10,13,5,2,1209
E01007899,1212,6,8,4,1,1231
E01007900,1323,15,19,11,4,1372
E01007901,1185,11,7,11,1,1215
E01007902,890,17,312,86,50,1355
E01007903,640,30,449,57,25,1201
E01007904,762,27,311,68,74,1242
E01007905,239,44,672,132,98,1185
E01007906,571,15,645,105,58,1394
E01007907,759,30,405,18,26,1238
E01007908,1101,15,80,22,8,1226
E01007909,1479,18,101,27,8,1633
E01007910,1192,13,76,35,4,1320
E01007911,1117,12,10,19,4,1162
E01007912,1235,11,36,7,4,1293
E01007913,321,19,559,49,54,1002
E01007914,345,26,546,69,61,1047
E01007915,1117,6,28,6,5,1162
E01007916,1067,32,15,32,10,1156
E01007917,1201,9,11,11,4,1236
E01007918,1274,13,26,13,12,1338
E01007919,1142,14,29,41,15,1241
E01007920,1302,11,56,3,8,1380
E01007921,1290,15,9,9,7,1330
E01007922,1117,3,38,3,3,1164
E01007923,1401,18,32,16,13,1480
E01007924,1204,10,24,13,9,1260
E01007925,1269,10,30,11,9,1329
E01007926,1363,10,25,8,4,1410
E01007927,1268,15,69,5,4,1361
E01007928,1297,14,79,10,11,1411
E01007929,1184,16,33,31,14,1278
E01007930,1030,13,90,6,13,1152
E01007931,1191,12,62,17,1,1283
E01007932,1067,17,38,18,8,1148
E01007933,1250,12,50,9,7,1328
E01007934,1057,12,28,10,9,1116
E01007935,1091,26,27,12,11,1167
E01007936,1167,27,51,24,9,1278
E01007937,1047,13,41,14,3,1118
E01007938,1105,17,26,9,8,1165
E01007939,1192,7,38,5,4,1246
E01007940,512,62,267,123,210,1174
E01007941,1123,20,75,54,19,1291
E01007942,313,18,764,116,71,1282
E01007943,1161,29,49,54,25,1318
E01007944,365,37,647,122,146,1317
E01007945,1225,33,46,56,17,1377
E01007946,1031,23,25,29,21,1129
E01007947,1044,29,90,65,78,1306
E01007948,677,50,203,131,149,1210
E01007949,569,20,438,58,30,1115
E01007950,1010,26,17,26,16,1095
E01007951,1240,17,46,17,14,1334
E01007952,1189,13,58,6,11,1277
E01007953,1289,11,68,16,9,1393
E01007954,1206,8,56,9,14,1293
E01007955,1022,2,72,4,10,1110
E01007956,1590,5,126,21,8,1750
E01007957,1118,14,110,15,20,1277
E01007958,1117,12,41,6,8,1184
E01007959,1093,9,38,9,16,1165
E01007960,1278,12,54,14,15,1373
E01007961,1092,18,55,8,27,1200
E01007962,1204,20,80,23,15,1342
E01007963,1173,8,11,34,6,1232
E01007964,1222,20,11,15,6,1274
E01007965,1431,8,23,41,3,1506
E01007966,1207,24,23,26,6,1286
E01007967,1286,13,14,37,3,1353
E01007968,1055,21,21,15,17,1129
E01007969,1268,8,16,25,15,1332
E01007970,1370,14,8,21,3,1416
E01007971,1042,15,33,18,8,1116
E01007972,1194,7,0,13,3,1217
E01007973,1179,12,28,13,2,1234
E01007974,1115,20,11,13,4,1163
E01007975,1090,33,102,93,21,1339
E01007976,1070,33,61,70,19,1253
E01007977,1072,38,40,88,58,1296
E01007978,1154,40,108,54,11,1367
E01007979,965,23,81,121,29,1219
E01007980,1083,33,89,32,10,1247
E01007981,941,30,93,72,32,1168
E01007982,1233,24,49,98,11,1415
E01007983,1090,25,56,31,5,1207
E01007984,1139,13,12,11,2,1177
E01007985,1212,18,17,24,9,1280
E01007986,1072,18,33,25,1,1149
E01007987,1152,14,13,10,6,1195
E01007988,1225,7,5,11,3,1251
E01007989,1133,18,8,6,15,1180
E01007990,1201,13,5,6,8,1233
E01007991,1134,12,10,3,13,1172
E01007992,1263,17,25,10,4,1319
E01007993,1293,13,8,9,12,1335
E01007994,1125,5,8,11,7,1156
E01007995,1198,10,10,15,3,1236
E01007996,1235,11,17,7,16,1286
E01007997,1194,12,8,1,4,1219
E01007998,1318,14,23,8,8,1371
E01007999,1103,13,14,25,2,1157
E01008000,1242,25,16,12,2,1297
E01008001,1195,17,16,19,6,1253
E01008002,1271,11,22,32,2,1338
E01008003,1150,9,25,27,6,1217
E01008004,1259,9,14,26,5,1313
E01008005,1294,7,14,10,1,1326
E01008006,1146,11,9,12,3,1181
E01008007,1293,31,15,39,14,1392
E01008008,1283,17,21,30,2,1353
E01008009,1010,21,8,45,8,1092
E01008010,1043,21,18,46,3,1131
E01008011,1030,27,25,57,32,1171
E01008012,1372,40,56,113,39,1620
E01008013,802,21,28,21,18,890
E01008014,1014,9,205,21,23,1272
E01008015,1158,22,40,41,23,1284
E01008016,1071,11,53,37,17,1189
E01008017,1127,27,42,52,14,1262
E01008018,908,17,27,30,22,1004
E01008019,1439,8,14,13,2,1476
E01008020,1157,6,14,18,11,1206
E01008021,1152,13,20,10,2,1197
E01008022,1142,18,12,31,7,1210
E01008023,1644,8,27,4,3,1686
E01008024,1386,12,14,10,1,1423
E01008025,1585,6,17,10,14,1632
E01008027,1196,8,13,14,4,1235
E01008028,1236,13,9,8,3,1269
E01008029,1113,9,20,7,1,1150
E01008030,1133,5,10,1,8,1157
E01008031,1156,12,14,13,7,1202
E01008032,1128,13,5,11,1,1158
E01008033,1098,7,29,18,4,1156
E01008034,1327,19,34,20,3,1403
E01008035,980,5,7,6,1,999
E01008036,1141,7,8,14,3,1173
E01008037,1214,10,8,5,1,1238
E01008038,1322,8,29,15,2,1376
E01008039,1114,10,17,24,2,1167
E01008040,1313,12,28,18,10,1381
E01008041,1145,3,12,7,9,1176
E01008042,861,13,348,53,14,1289
E01008043,1133,18,184,27,15,1377
E01008044,959,14,230,29,14,1246
E01008045,770,12,276,34,6,1098
E01008046,1043,26,202,34,16,1321
E01008047,1284,20,68,27,8,1407
E01008048,1232,27,61,21,34,1375
E01008049,1273,27,81,17,6,1404
E01008050,1169,36,34,19,11,1269
E01008051,889,30,420,63,18,1420
E01008052,1254,28,172,57,10,1521
E01008053,1001,10,3,13,4,1031
E01008054,865,14,34,57,15,985
E01008055,995,25,35,33,10,1098
E01008056,1129,11,5,16,7,1168
E01008057,988,22,25,47,8,1090
E01008058,1229,4,2,2,2,1239
E01008059,1019,25,46,35,6,1131
E01008060,963,18,34,46,2,1063
E01008061,1010,23,66,54,30,1183
E01008062,778,26,168,91,117,1180
E01008063,1176,24,57,21,18,1296
E01008064,1395,36,70,17,18,1536
E01008065,941,63,181,178,170,1533
E01008066,1303,32,125,55,27,1542
E01008067,1373,54,104,66,39,1636
E01008068,1210,80,690,261,230,2471
E01008069,1353,41,87,17,21,1519
E01008072,880,38,77,122,121,1238
E01008073,1320,49,60,66,47,1542
E01008074,1216,22,45,19,13,1315
E01008075,896,27,34,87,42,1086
E01008076,961,30,10,52,5,1058
E01008077,1151,12,7,33,5,1208
E01008078,1136,4,14,12,6,1172
E01008079,967,8,13,14,4,1006
E01008080,1167,13,22,15,7,1224
E01008081,1187,15,10,39,13,1264
E01008082,1140,20,14,45,12,1231
E01008083,1106,17,17,41,10,1191
E01008084,1150,25,15,50,19,1259
E01008085,1062,12,13,5,5,1097
E01008086,990,11,3,20,5,1029
E01008087,1275,14,6,9,9,1313
E01008088,1187,16,3,11,10,1227
E01008089,1065,28,54,77,22,1246
E01008090,1186,13,21,25,17,1262
E01008091,1175,12,18,21,6,1232
E01008092,1097,20,19,27,8,1171
E01008093,1189,6,21,26,9,1251
E01008094,802,17,30,31,6,886
E01008095,1116,30,123,65,25,1359
E01008096,1394,49,120,92,56,1711
E01008097,1074,47,37,77,23,1258
E01008098,1042,29,35,56,10,1172
E01008099,1141,31,101,53,5,1331
E01008100,876,20,21,43,16,976
E01008101,1199,43,91,84,23,1440
E01008102,818,24,15,28,11,896
E01008103,954,21,20,46,16,1057
E01008104,1100,24,93,73,69,1359
E01008105,2017,76,728,147,98,3066
E01008107,772,45,238,143,75,1273
E01008108,1078,33,442,118,40,1711
E01008109,1052,36,493,99,54,1734
E01008111,1325,28,110,61,26,1550
E01008112,479,24,720,82,34,1339
E01008113,824,40,435,53,33,1385
E01008114,1211,62,444,340,181,2238
E01008115,1037,54,340,166,88,1685
E01008116,997,9,8,10,5,1029
E01008117,941,12,10,17,2,982
E01008118,1045,19,29,17,12,1122
E01008119,890,9,10,17,10,936
E01008122,925,19,7,24,8,983
E01008123,889,20,43,29,6,987
E01008124,979,21,33,44,16,1093
E01008125,1154,7,13,7,5,1186
E01008126,1288,2,4,2,0,1296
E01008128,1392,8,14,8,5,1427
E01008129,1132,6,15,5,8,1166
E01008130,1255,6,8,3,0,1272
E01008131,1284,8,6,3,0,1301
E01008132,1154,2,6,0,0,1162
E01008133,1303,9,4,3,3,1322
E01008134,1136,8,13,5,0,1162
E01008135,1423,12,23,17,8,1483
E01008136,1078,5,3,5,6,1097
E01008137,1226,10,13,1,4,1254
E01008138,1044,10,16,8,9,1087
E01008139,1305,8,3,10,2,1328
E01008140,1458,6,12,7,8,1491
E01008141,1273,16,31,7,0,1327
E01008142,1130,7,15,7,1,1160
E01008143,1306,4,7,9,1,1327
E01008144,1331,1,5,5,2,1344
E01008145,1215,3,3,9,2,1232
E01008146,1074,4,4,2,0,1084
E01008147,1206,3,4,5,0,1218
E01008148,1215,6,3,12,1,1237
E01008149,1224,5,4,5,2,1240
E01008150,1170,5,6,10,0,1191
E01008151,1214,36,74,19,25,1368
E01008152,1167,7,10,4,4,1192
E01008153,1348,24,42,18,20,1452
E01008154,1314,18,53,22,11,1418
E01008155,1208,23,47,33,22,1333
E01008156,1222,19,10,6,6,1263
E01008157,1212,20,30,54,32,1348
E01008158,1213,20,6,17,6,1262
E01008159,1244,27,44,4,6,1325
E01008160,1156,13,15,7,3,1194
E01008161,1321,21,44,21,19,1426
E01008162,1716,39,223,34,39,2051
E01008163,1372,11,38,14,19,1454
E01008164,998,11,62,27,8,1106
E01008165,1080,11,12,8,11,1122
E01008166,1119,37,118,79,99,1452
E01008167,1213,16,97,14,25,1365
E01008168,1892,34,104,37,28,2095
E01008169,862,5,59,8,40,974
E01008170,1525,21,107,21,24,1698
E01008171,1124,10,37,17,26,1214
E01008172,1420,4,13,2,8,1447
E01008173,1223,7,16,5,2,1253
E01008174,1644,7,19,4,1,1675
E01008175,1198,2,33,5,4,1242
E01008176,1263,1,7,0,0,1271
E01008177,1209,4,20,0,4,1237
E01008178,1259,9,13,4,4,1289
E01008179,972,1,9,1,2,985
E01008180,1140,14,7,2,2,1165
E01008181,1210,5,9,4,3,1231
E01008182,1263,8,12,4,5,1292
E01008183,1152,3,11,1,3,1170
E01008184,1207,2,6,0,0,1215
E01008185,1091,3,3,1,0,1098
E01008186,1584,3,22,5,5,1619
E01008187,1390,4,5,3,3,1405
E01008188,1175,6,3,1,1,1186
E01008189,1115,3,13,10,4,1145
E01008190,1092,2,14,0,2,1110
E01008191,1193,6,9,7,16,1231
E01008192,1191,4,10,5,1,1211
E01008193,1070,8,18,0,0,1096
E01008194,1168,4,10,0,2,1184
E01008195,1619,7,6,2,2,1636
E01008196,1637,5,6,2,3,1653
E01008197,1278,3,8,1,0,1290
E01008198,1128,9,2,1,1,1141
E01008199,1175,3,5,0,0,1183
E01008200,1104,7,7,3,0,1121
E01008201,1136,8,26,5,4,1179
E01008202,1416,7,27,9,5,1464
E01008203,1370,13,72,27,39,1521
E01008204,1206,7,20,3,6,1242
E01008205,1280,5,19,1,0,1305
E01008206,1394,5,7,5,0,1411
E01008207,1195,4,21,0,3,1223
E01008208,1314,5,11,4,1,1335
E01008209,1636,14,66,17,4,1737
E01008210,1082,10,27,7,6,1132
E01008211,1420,4,18,3,2,1447
E01008212,1093,9,15,6,9,1132
E01008213,1227,2,4,1,4,1238
E01008214,1264,15,32,15,2,1328
E01008215,1244,20,22,17,12,1315
E01008216,1262,6,18,7,6,1299
E01008217,1292,1,3,5,2,1303
E01008218,1355,1,9,3,3,1371
E01008219,1352,9,27,3,21,1412
E01008220,906,10,12,5,4,937
E01008221,1314,4,16,10,2,1346
E01008222,1181,6,5,1,0,1193
E01008223,1342,7,20,6,3,1378
E01008224,1524,8,29,3,4,1568
E01008225,1444,2,3,2,4,1455
E01008226,1263,5,7,4,1,1280
E01008227,1158,12,23,19,8,1220
E01008228,965,5,4,2,0,976
E01008229,1196,3,4,3,3,1209
E01008230,1101,8,32,4,8,1153
E01008231,1235,5,12,3,4,1259
E01008232,1050,0,12,2,0,1064
E01008233,1191,4,1,2,1,1199
E01008234,1772,9,38,0,1,1820
E01008235,1231,6,10,4,0,1251
E01008236,1270,4,19,6,5,1304
E01008237,1229,3,14,3,0,1249
E01008238,1246,7,11,0,2,1266
E01008239,1252,6,14,5,2,1279
E01008240,1199,3,13,5,8,1228
E01008241,1320,6,7,3,0,1336
E01008242,1268,3,17,3,0,1291
E01008243,1305,12,7,4,2,1330
E01008244,1647,12,52,6,8,1725
E01008245,1214,9,5,0,0,1228
E01008246,1135,2,3,1,0,1141
E01008247,1334,7,4,0,4,1349
E01008248,1416,3,13,3,2,1437
E01008249,1367,7,15,1,0,1390
E01008250,1154,6,3,1,1,1165
E01008251,1338,22,95,30,28,1513
E01008252,1205,14,63,18,15,1315
E01008253,1230,23,74,32,37,1396
E01008254,1010,8,48,23,24,1113
E01008255,1360,12,61,6,17,1456
E01008256,1458,6,21,1,1,1487
E01008257,1216,7,16,4,3,1246
E01008258,1698,21,101,32,25,1877
E01008259,1445,23,75,42,47,1632
E01008260,1223,7,47,2,5,1284
E01008261,1152,5,15,2,1,1175
E01008262,1361,11,71,1,11,1455
E01008263,1174,11,13,1,2,1201
E01008264,1173,6,7,2,2,1190
E01008265,1138,8,11,5,3,1165
E01008266,1148,7,5,8,2,1170
E01008267,1306,4,10,0,3,1323
E01008268,1194,6,8,2,0,1210
E01008269,1243,6,7,2,0,1258
E01008270,1136,4,10,0,2,1152
E01008271,1191,4,6,0,0,1201
E01008272,1192,4,11,0,3,1210
E01008273,1186,3,13,0,0,1202
E01008274,1145,1,9,3,0,1158
E01008275,1255,8,14,0,4,1281
E01008276,1242,3,1,2,0,1248
E01008277,1271,2,10,3,0,1286
E01008278,1226,3,6,0,1,1236
E01008279,1295,9,5,0,1,1310
E01008280,1485,6,11,3,2,1507
E01008281,1165,3,22,3,0,1193
E01008282,1172,6,4,3,1,1186
E01008283,1148,3,19,0,1,1171
E01008284,1184,6,6,1,0,1197
E01008285,1139,5,7,0,0,1151
E01008286,1188,4,21,1,7,1221
E01008287,1566,6,26,4,6,1608
E01008288,1045,7,29,12,8,1101
E01008289,1173,18,46,3,0,1240
E01008290,894,16,46,23,5,984
E01008291,1250,35,155,71,21,1532
E01008292,1064,2,40,3,1,1110
E01008293,1082,6,49,15,35,1187
E01008294,1136,9,62,4,42,1253
E01008295,1020,10,56,32,1,1119
E01008296,1185,4,11,7,2,1209
E01008297,1023,12,56,10,7,1108
E01008298,1081,13,31,8,4,1137
E01008299,978,5,28,2,0,1013
E01008300,1114,18,93,22,13,1260
E01008301,1423,17,55,33,7,1535
E01008302,1259,9,35,26,3,1332
E01008303,1601,23,62,40,20,1746
E01008304,1353,30,71,86,28,1568
E01008305,1398,14,55,93,35,1595
E01008306,1351,5,16,1,6,1379
E01008307,830,4,7,1,2,844
E01008308,1074,12,47,3,6,1142
E01008309,1405,4,41,5,5,1460
E01008311,1227,13,94,6,36,1376
E01008312,837,5,60,10,62,974
E01008313,871,2,64,5,31,973
E01008314,1146,20,143,20,6,1335
E01008315,1139,8,101,8,8,1264
E01008316,1226,13,103,2,4,1348
E01008317,1042,6,134,7,9,1198
E01008318,1071,9,82,5,12,1179
E01008319,1165,13,257,12,9,1456
E01008320,1139,7,65,5,1,1217
E01008321,1227,15,165,14,29,1450
E01008322,1085,11,107,15,6,1224
E01008323,1313,10,113,19,10,1465
E01008324,1016,3,5,8,4,1036
E01008325,1111,7,10,2,3,1133
E01008326,1208,15,11,4,2,1240
E01008327,968,1,8,7,1,985
E01008328,1099,2,12,3,0,1116
E01008329,1160,10,21,9,2,1202
E01008330,1027,4,11,0,2,1044
E01008331,432,27,753,72,36,1320
E01008332,974,43,475,111,57,1660
E01008333,736,23,544,43,57,1403
E01008334,932,27,501,72,44,1576
E01008335,629,38,714,63,22,1466
E01008336,1052,9,39,16,12,1128
E01008337,1025,8,26,34,17,1110
E01008338,898,11,39,20,10,978
E01008339,1100,2,56,16,8,1182
E01008340,1000,16,53,23,10,1102
E01008341,1087,9,36,4,8,1144
E01008342,1193,10,22,8,5,1238
E01008343,1114,7,89,10,5,1225
E01008344,1205,9,59,4,7,1284
E01008345,1272,7,18,5,4,1306
E01008346,1244,21,144,16,6,1431
E01008347,965,8,175,2,7,1157
E01008348,690,15,149,9,2,865
E01008349,426,6,659,14,29,1134
E01008350,969,6,48,9,4,1036
E01008351,1108,6,82,12,3,1211
E01008352,983,10,125,31,32,1181
E01008353,1150,5,62,20,11,1248
E01008354,1253,15,92,12,21,1393
E01008355,1218,9,60,8,10,1305
E01008356,1051,17,174,16,16,1274
E01008357,1164,14,174,2,7,1361
E01008358,1123,4,96,13,13,1249
E01008359,1341,27,95,16,3,1482
E01008360,1405,22,97,30,9,1563
E01008361,1293,22,102,24,15,1456
E01008362,1561,32,81,17,6,1697
E01008363,1344,19,62,9,3,1437
E01008364,1392,31,122,23,7,1575
E01008365,1202,12,99,11,6,1330
E01008366,1834,37,101,5,6,1983
E01008367,1890,44,115,33,21,2103
E01008368,1646,18,50,18,14,1746
E01008369,1733,38,77,10,10,1868
E01008370,1365,35,163,29,10,1602
E01008371,1022,23,110,5,7,1167
E01008372,1676,41,115,20,17,1869
E01008373,2132,40,108,16,11,2307
E01008374,1186,13,67,9,6,1281
E01008375,1141,4,33,11,16,1205
E01008376,880,8,62,15,3,968
E01008377,1367,25,160,64,23,1639
E01008378,914,7,213,10,16,1160
E01008379,1101,5,94,16,7,1223
E01008380,985,19,120,105,28,1257
E01008381,1155,4,8,1,1,1169
E01008382,980,4,2,2,1,989
E01008383,1109,7,7,3,4,1130
E01008384,1134,5,8,4,1,1152
E01008385,1098,10,20,4,6,1138
E01008386,1085,4,9,5,7,1110
E01008387,1108,3,23,5,6,1145
E01008388,1282,10,49,30,5,1376
E01008389,1272,12,21,14,1,1320
E01008390,1195,22,24,41,13,1295
E01008391,1057,11,23,7,1,1099
E01008392,1179,16,53,31,16,1295
E01008394,1179,27,165,14,23,1408
E01008395,995,18,304,59,37,1413
E01008396,1523,63,741,138,89,2554
E01008397,1059,43,573,43,51,1769
E01008398,729,42,351,125,95,1342
E01008399,975,44,255,98,55,1427
E01008400,1078,12,5,4,1,1100
E01008401,1219,8,7,3,0,1237
E01008402,1201,8,13,2,2,1226
E01008403,1233,7,8,0,3,1251
E01008404,1330,9,18,0,2,1359
E01008405,1124,5,5,1,2,1137
E01008406,998,21,312,31,19,1381
E01008407,2198,34,384,61,28,2705
E01008409,1462,20,81,14,7,1584
E01008410,1363,26,139,32,10,1570
E01008411,1457,23,208,27,11,1726
E01008412,1401,24,75,10,9,1519
E01008413,1213,24,101,25,7,1370
E01008415,868,11,35,10,0,924
E01008416,1370,8,36,3,2,1419
E01008418,1529,13,88,10,11,1651
E01008419,1134,13,60,1,7,1215
E01008420,1047,14,35,2,7,1105
E01008421,1128,8,58,8,6,1208
E01008422,1304,13,76,5,8,1406
E01008423,989,15,94,4,3,1105
E01008424,1271,21,147,36,47,1522
E01008425,1329,30,64,90,37,1550
E01008426,1130,11,31,15,2,1189
E01008427,883,10,17,32,13,955
E01008428,981,8,20,14,5,1028
E01008429,1083,9,15,14,0,1121
E01008430,1073,4,11,6,9,1103
E01008431,1128,4,12,0,1,1145
E01008432,1130,6,13,8,1,1158
E01008433,1204,6,8,2,5,1225
E01008434,1241,5,9,2,7,1264
E01008435,1094,7,30,20,4,1155
E01008436,1090,12,68,53,14,1237
E01008437,834,21,58,54,24,991
E01008438,1088,15,126,80,47,1356
E01008439,1046,28,204,67,41,1386
E01008441,1346,5,18,4,6,1379
E01008442,1146,3,25,0,0,1174
E01008443,1173,2,12,0,0,1187
E01008444,1268,7,28,2,0,1305
E01008445,1581,3,21,5,2,1612
E01008446,1243,3,6,0,0,1252
E01008447,1127,6,26,2,1,1162
E01008448,1278,2,14,1,1,1296
E01008449,673,26,599,84,87,1469
E01008450,888,18,149,22,8,1085
E01008451,1281,27,111,18,25,1462
E01008452,711,17,396,8,19,1151
E01008453,909,23,379,5,29,1345
E01008455,356,16,713,46,57,1188
E01008456,1161,10,28,3,0,1202
E01008457,1272,5,19,6,6,1308
E01008458,1303,11,57,1,28,1400
E01008459,1289,9,50,12,12,1372
E01008460,1148,4,7,3,5,1167
E01008461,1103,4,13,5,1,1126
E01008462,1018,5,4,9,1,1037
E01008463,1107,5,9,3,2,1126
E01008464,1156,3,6,2,1,1168
E01008465,1187,3,4,3,0,1197
E01008466,1150,3,11,1,0,1165
E01008467,1161,5,6,2,0,1174
E01008468,1132,2,13,2,0,1149
E01008469,1262,3,32,3,2,1302
E01008470,1166,13,18,0,0,1197
E01008471,1255,6,29,3,2,1295
E01008472,1225,1,10,5,1,1242
E01008473,1049,4,16,2,3,1074
E01008474,1096,7,19,9,3,1134
E01008475,1303,5,20,2,2,1332
E01008476,1334,5,8,4,0,1351
E01008477,1215,7,7,6,1,1236
E01008478,1262,11,6,4,1,1284
E01008479,1146,1,18,5,2,1172
E01008480,1274,4,14,2,0,1294
E01008481,1125,7,23,7,2,1164
E01008482,1308,11,21,8,4,1352
E01008483,1251,13,27,5,3,1299
E01008484,1020,8,19,6,0,1053
E01008485,1036,14,12,6,2,1070
E01008486,1142,8,7,1,5,1163
E01008487,1206,3,19,0,1,1229
E01008488,1085,4,22,14,7,1132
E01008489,1207,12,72,6,11,1308
E01008490,1317,7,23,4,2,1353
E01008491,1127,12,60,0,7,1206
E01008492,1311,19,29,6,2,1367
E01008493,1224,2,12,1,6,1245
E01008494,1219,3,34,1,0,1257
E01008495,1417,6,15,1,3,1442
E01008496,1265,12,10,5,1,1293
E01008497,1212,6,4,0,0,1222
E01008498,1310,2,12,1,1,1326
E01008499,1310,8,5,3,4,1330
E01008500,1298,14,41,1,5,1359
E01008501,1465,9,77,5,6,1562
E01008502,1272,13,21,2,0,1308
E01008503,1305,5,18,4,4,1336
E01008504,1271,4,16,1,3,1295
E01008505,1353,5,24,9,1,1392
E01008506,1126,5,7,3,2,1143
E01008507,1211,4,26,1,0,1242
E01008508,1213,5,14,3,2,1237
E01008509,1275,5,8,5,0,1293
E01008510,1268,10,11,2,1,1292
E01008511,1316,4,14,8,3,1345
E01008512,1258,8,19,9,1,1295
E01008513,1720,19,98,26,9,1872
E01008514,1367,14,57,6,0,1444
E01008516,1122,5,6,3,3,1139
E01008517,1194,9,5,0,1,1209
E01008518,1372,5,7,1,6,1391
E01008519,1125,6,19,2,0,1152
E01008520,1082,8,16,1,1,1108
E01008521,1256,9,12,2,1,1280
E01008522,1277,6,8,0,1,1292
E01008523,990,4,15,0,1,1010
E01008524,1514,8,21,7,2,1552
E01008525,1313,9,6,0,3,1331
E01008526,1205,6,9,1,6,1227
E01008527,1280,12,13,4,0,1309
E01008528,1189,7,7,2,3,1208
E01008529,1341,15,20,7,4,1387
E01008530,1385,10,18,1,4,1418
E01008531,1175,5,67,3,8,1258
E01008532,1164,7,39,4,1,1215
E01008533,1153,5,13,1,0,1172
E01008534,1132,4,60,0,0,1196
E01008535,1239,3,9,3,2,1256
E01008536,1183,5,19,10,0,1217
E01008537,1080,7,27,7,2,1123
E01008538,1054,2,9,1,2,1068
E01008539,1168,2,11,7,3,1191
E01008540,1194,16,20,5,0,1235
E01008541,1221,16,26,7,2,1272
E01008542,1117,14,21,26,1,1179
E01008543,1622,16,42,13,1,1694
E01008544,1316,21,21,5,9,1372
E01008545,1003,7,16,16,8,1050
E01008546,1165,9,11,1,0,1186
E01008547,1120,2,26,9,1,1158
E01008548,1090,1,29,0,9,1129
E01008549,1256,1,19,0,3,1279
E01008550,1237,9,12,3,2,1263
E01008551,1224,1,7,0,1,1233
E01008552,1359,2,10,3,0,1374
E01008553,1456,13,14,2,1,1486
E01008554,1263,5,48,3,2,1321
E01008555,1210,10,34,1,1,1256
E01008556,1572,12,68,4,5,1661
E01008557,1295,7,54,6,2,1364
E01008558,1317,9,11,3,4,1344
E01008559,1273,15,15,1,2,1306
E01008560,1414,10,23,9,3,1459
E01008561,1355,13,4,3,1,1376
E01008562,1226,14,13,2,0,1255
E01008563,1151,10,16,3,1,1181
E01008564,1240,6,2,1,1,1250
E01008565,1557,7,18,2,7,1591
E01008567,1062,4,15,0,1,1082
E01008568,1243,9,13,2,4,1271
E01008569,1088,10,17,2,2,1119
E01008570,1032,4,37,6,4,1083
E01008571,1447,11,23,8,9,1498
E01008572,1319,9,39,19,5,1391
E01008573,1259,16,34,21,1,1331
E01008574,1303,5,12,1,2,1323
E01008575,1065,7,47,13,7,1139
E01008576,1534,10,43,6,4,1597
E01008577,1119,6,5,2,0,1132
E01008578,1122,5,11,5,2,1145
E01008579,1300,7,7,3,2,1319
E01008580,1119,4,7,6,1,1137
E01008581,1213,2,11,3,1,1230
E01008582,1074,3,16,11,0,1104
E01008583,1145,4,13,1,1,1164
E01008584,1237,20,26,3,5,1291
E01008585,1210,7,54,0,2,1273
E01008586,1181,16,30,1,7,1235
E01008587,1149,7,29,1,1,1187
E01008588,1224,13,41,2,8,1288
E01008589,1147,6,11,0,4,1168
E01008590,1221,7,27,3,9,1267
E01008591,1123,15,30,11,5,1184
E01008592,1168,13,25,11,14,1231
E01008593,913,22,18,8,13,974
E01008594,1386,12,20,1,6,1425
E01008595,1252,21,23,5,11,1312
E01008596,706,15,307,10,51,1089
E01008597,1881,13,47,4,25,1970
E01008598,998,22,206,11,20,1257
E01008599,1073,15,106,6,16,1216
E01008600,1014,10,30,3,5,1062
E01008601,1196,5,11,4,5,1221
E01008602,1140,6,7,1,5,1159
E01008603,1068,8,11,3,3,1093
E01008604,1298,22,13,2,4,1339
E01008605,937,3,7,0,6,953
E01008606,1075,11,7,2,7,1102
E01008607,1005,8,4,6,2,1025
E01008608,885,14,4,1,3,907
E01008609,1108,8,3,5,7,1131
E01008610,1049,5,9,0,2,1065
E01008611,1173,7,47,2,1,1230
E01008612,1226,6,20,0,0,1252
E01008613,1226,6,29,0,5,1266
E01008614,1303,7,9,3,0,1322
E01008615,1162,3,13,1,0,1179
E01008616,1264,4,16,0,2,1286
E01008617,1184,7,20,2,6,1219
E01008618,988,8,55,1,21,1073
E01008619,1330,0,31,0,7,1368
E01008620,1198,9,10,2,1,1220
E01008621,1138,9,50,1,3,1201
E01008622,1376,8,9,2,12,1407
E01008624,1077,6,0,2,1,1086
E01008625,1155,7,16,2,4,1184
E01008627,1134,3,4,0,2,1143
E01008628,1138,3,1,0,0,1142
E01008629,1164,0,6,1,0,1171
E01008630,1099,5,5,1,1,1111
E01008631,1170,1,13,0,4,1188
E01008632,1021,3,4,3,1,1032
E01008633,1086,8,10,2,1,1107
E01008634,1043,5,10,1,3,1062
E01008635,1154,10,5,1,1,1171
E01008636,1173,6,5,7,1,1192
E01008637,1186,11,4,1,2,1204
E01008638,1084,7,11,1,1,1104
E01008639,1480,6,27,3,5,1521
E01008640,1591,8,13,4,2,1618
E01008641,1241,6,10,1,4,1262
E01008642,1216,4,12,1,9,1242
E01008643,1185,2,5,0,2,1194
E01008644,1252,9,1,6,4,1272
E01008645,1151,6,7,0,0,1164
E01008646,1183,9,11,3,2,1208
E01008647,1260,6,10,1,1,1278
E01008648,1222,8,10,0,3,1243
E01008649,1297,10,12,0,3,1322
E01008650,1183,5,8,2,0,1198
E01008651,1368,4,22,3,1,1398
E01008652,925,6,2,0,4,937
E01008653,969,6,11,2,10,998
E01008654,1025,7,12,1,2,1047
E01008655,1211,2,3,6,5,1227
E01008656,1190,5,3,3,1,1202
E01008657,1119,4,7,1,8,1139
E01008658,1057,6,7,6,9,1085
E01008659,1180,7,5,2,6,1200
E01008660,1181,9,12,0,14,1216
E01008661,960,2,8,0,0,970
E01008662,990,2,8,1,3,1004
E01008663,1134,6,2,2,4,1148
E01008664,929,26,163,14,75,1207
E01008665,1137,8,33,8,21,1207
E01008666,984,19,88,17,47,1155
E01008667,1274,24,36,5,13,1352
E01008668,1125,19,91,11,23,1269
E01008669,1084,14,11,5,7,1121
E01008670,1241,6,9,3,5,1264
E01008671,992,12,13,3,17,1037
E01008672,1097,6,2,1,4,1110
E01008673,990,6,6,1,12,1015
E01008674,1048,7,15,6,6,1082
E01008675,1146,11,27,15,9,1208
E01008676,1003,11,23,0,6,1043
E01008677,1232,4,11,5,4,1256
E01008678,1033,18,23,0,31,1105
E01008679,1063,11,18,5,11,1108
E01008680,1192,9,5,3,2,1211
E01008681,1183,11,23,1,10,1228
E01008682,897,15,13,1,1,927
E01008683,1173,17,28,4,17,1239
E01008684,1026,5,3,0,6,1040
E01008685,1492,13,21,0,11,1537
E01008686,1390,9,10,0,0,1409
E01008687,1438,11,14,0,6,1469
E01008688,1148,7,2,0,1,1158
E01008689,1291,9,11,0,3,1314
E01008690,1141,7,4,3,1,1156
E01008691,1058,10,10,0,0,1078
E01008692,1151,6,4,0,3,1164
E01008693,1049,4,2,5,0,1060
E01008694,1104,6,15,1,4,1130
E01008695,1179,2,4,0,3,1188
E01008696,1030,7,9,0,0,1046
E01008697,1095,1,7,3,1,1107
E01008698,1214,4,2,3,5,1228
E01008699,1124,1,4,2,1,1132
E01008700,967,13,56,26,7,1069
E01008701,1347,10,119,45,16,1537
E01008702,850,3,25,10,0,888
E01008703,1718,29,256,48,38,2089
E01008704,1004,12,182,32,11,1241
E01008705,780,8,132,29,17,966
E01008706,1070,12,187,14,23,1306
E01008707,908,19,357,34,21,1339
E01008708,1247,6,6,0,0,1259
E01008709,1130,2,11,3,0,1146
E01008711,1209,8,9,4,0,1230
E01008712,1344,8,11,10,2,1375
E01008713,1321,2,14,1,3,1341
E01008714,938,4,17,2,5,966
E01008715,1067,3,5,4,1,1080
E01008716,1171,4,2,2,0,1179
E01008717,1290,7,11,2,2,1312
E01008718,1169,9,2,2,1,1183
E01008719,1016,3,3,1,0,1023
E01008720,1133,3,2,1,2,1141
E01008721,1257,3,13,4,0,1277
E01008722,1244,3,3,3,0,1253
E01008723,1142,7,7,0,1,1157
E01008724,1025,4,0,0,2,1031
E01008725,1195,3,8,0,3,1209
E01008726,1254,8,4,1,0,1267
E01008727,1317,4,6,0,0,1327
E01008728,1221,2,3,0,0,1226
E01008729,842,3,1,0,0,846
E01008730,1266,4,19,2,0,1291
E01008731,988,6,5,2,0,1001
E01008732,1639,7,18,5,0,1669
E01008733,1373,4,17,2,3,1399
E01008734,1269,1,4,1,0,1275
E01008735,1560,18,88,15,8,1689
E01008736,937,9,30,9,0,985
E01008737,1071,7,33,8,5,1124
E01008738,1023,3,26,16,8,1076
E01008739,1191,19,20,6,4,1240
E01008740,1182,11,63,4,10,1270
E01008741,1169,0,24,4,2,1199
E01008742,1396,4,9,1,2,1412
E01008743,1293,7,0,1,0,1301
E01008744,1264,6,12,2,5,1289
E01008745,1395,3,2,2,0,1402
E01008746,1255,2,12,1,5,1275
E01008747,1209,6,4,2,0,1221
E01008748,1200,1,2,3,0,1206
E01008749,1254,2,1,0,0,1257
E01008750,1538,5,14,1,1,1559
E01008751,861,1,12,0,5,879
E01008752,1230,5,12,6,0,1253
E01008753,988,6,4,1,1,1000
E01008754,1192,4,2,2,1,1201
E01008755,1087,1,6,3,1,1098
E01008756,1173,5,53,8,0,1239
E01008757,1129,9,89,6,6,1239
E01008758,1208,8,9,1,2,1228
E01008759,1228,4,52,7,0,1291
E01008760,1190,9,40,9,3,1251
E01008761,1217,3,18,5,1,1244
E01008762,1167,5,29,3,0,1204
E01008763,1153,3,13,5,15,1189
E01008764,1219,1,30,4,5,1259
E01008765,1229,6,13,0,4,1252
E01008766,1779,5,10,0,5,1799
E01008767,1229,6,12,3,4,1254
E01008768,1173,7,8,3,0,1191
E01008769,1344,3,27,2,14,1390
E01008770,1187,0,2,6,4,1199
E01008771,1217,3,8,0,5,1233
E01008772,1148,3,6,3,2,1162
E01008773,1096,4,12,2,2,1116
E01008774,1106,0,6,0,1,1113
E01008775,1192,4,16,5,2,1219
E01008776,995,4,2,2,1,1004
E01008777,1243,4,3,3,2,1255
E01008778,1104,2,14,0,0,1120
E01008779,1172,6,28,2,5,1213
E01008780,1510,13,43,5,3,1574
E01008781,1208,8,91,8,6,1321
E01008782,1213,5,33,3,5,1259
E01008783,1190,6,30,5,0,1231
E01008784,1281,7,33,3,9,1333
E01008785,1245,8,11,3,3,1270
E01008786,1181,4,5,0,6,1196
E01008787,1254,12,125,21,8,1420
E01008788,1254,2,26,4,4,1290
E01008789,1130,8,41,1,13,1193
E01008790,1245,7,36,0,5,1293
E01008791,1369,8,164,61,21,1623
E01008792,1141,7,8,0,0,1156
E01008793,1313,4,8,3,1,1329
E01008795,1400,1,32,4,1,1438
E01008796,1288,4,18,3,3,1316
E01008797,1560,7,35,6,9,1617
E01008799,1300,6,30,1,3,1340
E01008800,1086,1,7,1,1,1096
E01008801,1304,4,3,0,1,1312
E01008802,1207,3,19,0,5,1234
E01008803,1156,3,8,0,2,1169
E01008804,1329,5,7,0,1,1342
E01008805,1153,2,16,1,3,1175
E01008808,1225,6,10,0,2,1243
E01008809,1292,3,10,1,0,1306
E01008810,1330,4,7,2,0,1343
E01008811,1362,4,4,2,1,1373
E01008812,1292,8,31,4,1,1336
E01008813,1301,8,17,4,1,1331
E01008814,1248,0,23,1,0,1272
E01008817,880,5,2,3,0,890
E01008819,1151,5,3,0,0,1159
E01008820,967,4,0,4,0,975
E01008821,1069,4,4,0,0,1077
E01008822,1272,6,3,0,1,1282
E01008823,1117,3,30,0,0,1150
E01008824,1123,1,11,0,2,1137
E01008825,1273,3,3,2,2,1283
E01008826,1166,2,5,4,5,1182
E01008827,936,6,18,5,6,971
E01008828,1159,4,32,7,0,1202
E01008829,1058,8,16,7,2,1091
E01008830,910,15,234,44,19,1222
E01008831,1351,60,396,115,88,2010
E01008832,982,7,195,8,15,1207
E01008833,1038,9,158,21,12,1238
E01008834,1492,29,89,27,13,1650
E01008835,1108,12,153,7,46,1326
E01008836,1002,13,230,24,9,1278
E01008837,1041,3,3,0,0,1047
E01008838,1251,8,7,2,2,1270
E01008839,1091,4,6,3,0,1104
E01008840,1095,4,6,6,0,1111
E01008841,928,8,4,2,0,942
E01008842,1201,1,2,0,0,1204
E01008843,1076,1,11,5,5,1098
E01008844,1249,4,4,0,0,1257
E01008845,1213,7,9,1,0,1230
E01008846,882,5,13,4,2,906
E01008847,984,1,6,8,0,999
E01008848,1175,6,2,1,1,1185
E01008849,903,2,10,4,1,920
E01008850,1311,15,56,2,4,1388
E01008851,1310,1,14,0,3,1328
E01008852,1029,3,4,5,3,1044
E01008853,1059,4,13,5,0,1081
E01008854,1263,10,19,6,2,1300
E01008855,1149,16,15,2,0,1182
E01008856,1210,6,6,0,0,1222
E01008857,1110,6,4,1,2,1123
E01008858,1028,6,2,1,1,1038
E01008859,973,4,6,11,1,995
E01008860,1104,4,2,6,0,1116
E01008861,1227,3,37,1,1,1269
E01008862,1223,5,12,2,6,1248
E01008863,1291,3,59,5,7,1365
E01008864,1062,12,40,1,4,1119
E01008865,1123,3,13,1,0,1140
E01008866,1110,1,9,0,4,1124
E01008867,1261,12,14,7,5,1299
E01008868,1034,6,10,1,3,1054
E01008869,1064,2,4,0,0,1070
E01008870,1168,9,9,2,1,1189
E01008871,1164,6,8,0,0,1178
E01008872,1259,7,5,0,0,1271
E01008873,1079,8,8,0,2,1097
E01008874,1325,6,11,1,1,1344
E01008875,1219,3,8,1,4,1235
E01008876,1239,5,51,10,2,1307
E01008877,1207,2,5,1,1,1216
E01008878,1214,2,16,3,0,1235
E01008879,1197,4,4,0,0,1205
E01008880,958,2,5,1,1,967
E01008881,787,41,288,73,9,1198
E01008882,735,47,354,91,17,1244
E01008883,778,49,404,84,21,1336
E01008884,631,41,488,112,19,1291
E01008885,807,23,162,20,7,1019
E01008886,1032,39,111,41,15,1238
E01008887,843,22,198,47,10,1120
E01008888,1110,18,120,32,8,1288
E01008889,904,37,357,83,9,1390
E01008890,883,40,301,80,32,1336
E01008891,1092,30,97,33,12,1264
E01008892,581,61,384,100,9,1135
E01008893,1060,22,230,46,16,1374
E01008894,930,25,178,74,12,1219
E01008895,1170,41,167,48,9,1435
E01008896,681,52,285,65,20,1103
E01008897,804,45,319,82,18,1268
E01008898,677,33,336,83,25,1154
E01008899,272,39,300,247,14,872
E01008901,285,45,556,303,9,1198
E01008905,53,20,931,116,4,1124
E01008906,131,32,764,195,10,1132
E01008907,198,49,572,350,31,1200
E01008909,207,54,288,445,18,1012
E01008910,219,56,407,469,45,1196
E01008911,188,81,181,553,37,1040
E01008913,298,74,153,516,37,1078
E01008914,850,125,473,668,70,2186
E01008915,423,33,353,161,9,979
E01008916,170,34,636,131,7,978
E01008917,953,28,31,55,5,1072
E01008918,993,63,83,121,9,1269
E01008919,950,26,174,87,19,1256
E01008920,980,17,39,63,3,1102
E01008921,1022,16,41,64,6,1149
E01008923,896,45,12,77,4,1034
E01008924,1057,32,47,36,9,1181
E01008925,1006,13,24,29,3,1075
E01008927,930,49,15,85,8,1087
E01008928,975,52,42,85,8,1162
E01008929,976,38,51,76,6,1147
E01008930,948,29,64,85,14,1140
E01008931,839,44,75,117,6,1081
E01008932,950,37,165,47,7,1206
E01008933,691,41,391,57,20,1200
E01008934,657,25,392,32,24,1130
E01008935,944,49,189,67,14,1263
E01008936,879,17,322,31,13,1262
E01008937,831,41,217,47,23,1159
E01008938,896,40,163,61,17,1177
E01008939,947,41,144,67,10,1209
E01008940,957,50,84,64,6,1161
E01008941,905,44,129,37,9,1124
E01008942,1058,35,61,36,8,1198
E01008943,935,33,68,88,8,1132
E01008944,1173,36,61,56,5,1331
E01008945,1218,35,114,51,3,1421
E01008946,1112,27,36,28,6,1209
E01008947,996,26,43,31,4,1100
E01008948,1143,8,43,14,4,1212
E01008949,1012,19,12,7,6,1056
E01008950,1079,36,69,33,8,1225
E01008951,1010,19,33,32,6,1100
E01008952,1109,35,151,42,5,1342
E01008953,896,42,190,85,16,1229
E01008954,1012,24,54,20,17,1127
E01008955,1140,28,70,40,2,1280
E01008956,1103,26,32,13,6,1180
E01008957,1093,41,91,100,8,1333
E01008958,1178,54,36,34,13,1315
E01008959,1301,32,41,39,7,1420
E01008960,1118,20,49,33,9,1229
E01008961,1154,28,66,40,5,1293
E01008962,1164,49,51,139,6,1409
E01008963,875,38,114,42,2,1071
E01008964,992,35,104,50,9,1190
E01008965,1009,30,164,28,7,1238
E01008966,866,42,247,98,17,1270
E01008967,1012,27,256,59,18,1372
E01008968,1123,41,151,43,4,1362
E01008969,1086,28,153,35,12,1314
E01008970,804,29,203,86,9,1131
E01008971,1052,39,176,65,18,1350
E01008972,1088,55,108,105,16,1372
E01008973,1290,38,111,76,17,1532
E01008974,1703,78,264,93,28,2166
E01008975,1196,26,37,34,7,1300
E01008976,1006,37,52,91,17,1203
E01008977,1116,40,38,54,6,1254
E01008978,818,87,48,95,24,1072
E01008979,1135,43,21,91,3,1293
E01008980,1045,46,23,107,11,1232
E01008981,978,21,201,30,9,1239
E01008982,646,50,390,88,44,1218
E01008984,1008,91,509,159,67,1834
E01008986,797,74,397,200,52,1520
E01008987,923,63,181,194,10,1371
E01008988,1061,63,424,178,56,1782
E01008989,938,72,288,191,55,1544
E01008990,637,39,285,27,26,1014
E01008991,668,18,483,30,30,1229
E01008992,1082,68,351,46,42,1589
E01008994,1143,45,179,87,28,1482
E01008995,675,92,281,377,63,1488
E01008996,275,47,439,240,120,1121
E01008997,650,50,309,122,36,1167
E01008998,744,55,278,185,33,1295
E01008999,625,48,293,208,23,1197
E01009000,972,67,230,163,12,1444
E01009001,1059,42,57,89,4,1251
E01009002,804,44,81,120,7,1056
E01009003,1248,37,109,76,4,1474
E01009005,963,22,57,67,8,1117
E01009006,1086,45,58,56,8,1253
E01009007,962,58,135,117,3,1275
E01009008,1040,27,105,50,4,1226
E01009009,1027,30,77,66,7,1207
E01009011,1207,32,117,86,17,1459
E01009012,979,36,101,60,10,1186
E01009013,1134,62,149,166,15,1526
E01009014,615,39,616,108,38,1416
E01009015,1028,31,268,79,19,1425
E01009016,941,49,228,40,7,1265
E01009017,317,31,783,47,40,1218
E01009018,990,53,279,45,17,1384
E01009019,802,54,208,85,15,1164
E01009020,842,39,222,48,9,1160
E01009021,912,31,164,62,4,1173
E01009022,835,23,394,79,12,1343
E01009023,722,18,424,59,13,1236
E01009024,907,51,171,67,6,1202
E01009025,852,26,176,59,12,1125
E01009026,666,34,316,48,14,1078
E01009028,767,42,345,38,17,1209
E01009029,659,35,343,43,13,1093
E01009030,536,21,540,32,32,1161
E01009031,784,18,463,27,18,1310
E01009032,751,18,605,17,7,1398
E01009033,882,59,291,58,6,1296
E01009034,698,18,543,32,43,1334
E01009035,792,24,521,23,23,1383
E01009036,677,21,476,15,21,1210
E01009037,1037,20,249,17,13,1336
E01009039,929,28,325,30,24,1336
E01009040,1016,13,291,23,13,1356
E01009041,984,19,251,15,11,1280
E01009042,926,10,112,17,4,1069
E01009043,562,34,781,64,45,1486
E01009044,284,20,765,29,33,1131
E01009045,526,29,661,59,21,1296
E01009046,786,23,525,20,33,1387
E01009047,140,39,811,296,24,1310
E01009048,199,51,692,368,37,1347
E01009049,253,25,625,313,39,1255
E01009050,272,38,648,401,30,1389
E01009051,161,22,787,211,16,1197
E01009053,170,31,643,169,6,1019
E01009054,101,22,895,177,16,1211
E01009056,295,80,687,451,30,1543
E01009057,185,49,766,366,45,1411
E01009058,112,19,859,160,15,1165
E01009059,160,40,625,398,23,1246
E01009060,102,25,732,217,25,1101
E01009061,54,14,1037,154,26,1285
E01009062,71,38,827,192,21,1149
E01009064,878,33,123,91,10,1135
E01009065,1093,35,200,45,15,1388
E01009066,770,20,397,36,34,1257
E01009067,1085,27,65,19,8,1204
E01009068,1097,42,132,44,18,1333
E01009069,1179,49,93,55,16,1392
E01009070,1088,26,180,36,20,1350
E01009071,1130,35,154,38,11,1368
E01009072,1173,34,140,36,12,1395
E01009073,692,64,93,185,29,1063
E01009074,745,74,159,189,31,1198
E01009075,954,59,286,100,24,1423
E01009077,997,44,218,78,38,1375
E01009078,818,51,272,81,31,1253
E01009079,771,82,80,245,12,1190
E01009080,460,40,101,132,6,739
E01009081,660,48,118,106,26,958
E01009082,709,27,149,139,8,1032
E01009083,660,43,161,129,6,999
E01009084,599,19,537,63,12,1230
E01009085,419,43,868,46,7,1383
E01009086,656,23,583,111,8,1381
E01009087,881,23,233,52,2,1191
E01009088,1062,24,134,74,5,1299
E01009089,601,20,436,43,18,1118
E01009090,547,23,706,72,12,1360
E01009091,991,40,113,80,12,1236
E01009092,810,41,139,109,6,1105
E01009093,906,50,75,79,12,1122
E01009094,747,31,137,98,5,1018
E01009095,731,38,384,107,5,1265
E01009096,1190,41,25,77,2,1335
E01009097,1336,58,30,93,4,1521
E01009098,1414,49,99,81,16,1659
E01009099,1154,57,14,69,13,1307
E01009100,1220,56,154,136,13,1579
E01009101,1111,38,23,65,8,1245
E01009102,927,33,97,80,4,1141
E01009103,1017,42,9,86,3,1157
E01009104,897,56,103,116,6,1178
E01009105,1149,19,62,63,8,1301
E01009106,1058,18,13,31,10,1130
E01009107,1020,66,48,126,20,1280
E01009108,994,27,38,27,2,1088
E01009109,670,45,32,87,10,844
E01009110,1065,39,38,60,9,1211
E01009111,1058,29,15,35,2,1139
E01009112,1082,31,26,42,5,1186
E01009113,925,40,36,76,1,1078
E01009114,1081,46,27,60,12,1226
E01009115,1015,47,28,46,10,1146
E01009116,1088,14,65,16,11,1194
E01009117,1103,81,63,130,18,1395
E01009118,1083,35,40,55,4,1217
E01009119,1107,17,35,29,13,1201
E01009120,1062,34,31,32,4,1163
E01009121,1252,89,156,189,14,1700
E01009122,1046,42,42,88,9,1227
E01009123,833,43,75,153,1,1105
E01009124,716,53,56,223,17,1065
E01009125,949,47,176,132,8,1312
E01009126,835,28,119,119,14,1115
E01009127,915,38,73,78,10,1114
E01009128,889,20,33,67,5,1014
E01009129,963,35,47,91,3,1139
E01009130,1025,21,21,62,9,1138
E01009131,909,29,52,60,3,1053
E01009132,974,36,35,59,6,1110
E01009133,958,31,32,86,2,1109
E01009134,1049,24,42,115,1,1231
E01009135,956,27,189,77,9,1258
E01009136,1131,40,93,107,10,1381
E01009137,946,46,68,80,3,1143
E01009138,366,33,663,165,61,1288
E01009139,608,33,408,144,57,1250
E01009140,688,62,597,194,51,1592
E01009141,537,78,140,520,46,1321
E01009143,430,71,146,365,45,1057
E01009145,578,47,644,174,95,1538
E01009146,846,117,378,348,81,1770
E01009147,695,45,477,140,66,1423
E01009151,287,55,747,241,44,1374
E01009152,369,52,952,207,38,1618
E01009153,749,81,440,376,52,1698
E01009155,979,33,15,49,8,1084
E01009157,1007,49,26,60,5,1147
E01009158,1257,54,55,80,3,1449
E01009159,1298,20,59,38,5,1420
E01009160,1032,45,20,81,8,1186
E01009161,1037,35,14,38,2,1126
E01009162,1156,37,30,56,4,1283
E01009163,1040,23,15,58,6,1142
E01009164,1100,35,15,34,5,1189
E01009165,956,38,27,39,1,1061
E01009166,910,23,37,37,10,1017
E01009167,1117,25,22,26,1,1191
E01009168,1156,19,12,23,4,1214
E01009169,1215,19,16,40,3,1293
E01009170,1190,14,6,8,0,1218
E01009171,1160,36,7,31,0,1234
E01009172,899,43,61,51,5,1059
E01009173,1042,52,71,79,14,1258
E01009174,821,33,35,45,5,939
E01009175,925,50,169,43,6,1193
E01009176,748,56,473,39,23,1339
E01009177,915,31,210,59,12,1227
E01009178,976,47,186,47,15,1271
E01009179,979,35,310,52,11,1387
E01009182,582,65,437,172,90,1346
E01009183,693,24,539,26,32,1314
E01009184,1040,70,167,72,35,1384
E01009185,970,31,342,56,19,1418
E01009186,973,32,316,58,28,1407
E01009187,1040,41,148,48,23,1300
E01009188,932,53,195,35,16,1231
E01009189,869,27,212,55,12,1175
E01009192,75,28,1598,90,14,1805
E01009194,179,22,1496,163,42,1902
E01009195,215,32,1252,144,20,1663
E01009197,204,29,649,144,46,1072
E01009198,121,30,715,125,40,1031
E01009199,347,62,338,238,52,1037
E01009200,316,71,473,292,58,1210
E01009201,606,83,237,309,32,1267
E01009202,416,79,245,277,31,1048
E01009203,542,100,253,857,80,1832
E01009204,393,98,222,442,51,1206
E01009205,1136,21,36,22,12,1227
E01009206,1192,29,72,21,4,1318
E01009207,1265,21,21,40,6,1353
E01009208,1176,19,22,17,4,1238
E01009209,1578,48,49,53,13,1741
E01009210,1261,38,53,87,13,1452
E01009211,1152,27,36,20,4,1239
E01009212,1187,37,53,44,0,1321
E01009213,1144,20,50,34,1,1249
E01009214,1150,54,22,58,4,1288
E01009215,1176,43,21,90,9,1339
E01009216,1459,33,26,54,7,1579
E01009217,1273,16,15,12,1,1317
E01009218,1133,18,62,19,4,1236
E01009219,1039,31,31,64,8,1173
E01009220,1077,26,44,60,2,1209
E01009221,1077,19,54,35,0,1185
E01009222,974,42,41,83,3,1143
E01009223,1086,26,83,53,12,1260
E01009224,1065,10,55,62,4,1196
E01009225,1130,20,80,80,3,1313
E01009226,1043,26,57,68,5,1199
E01009227,1061,18,124,109,7,1319
E01009228,1115,19,88,66,1,1289
E01009229,1034,19,121,91,6,1271
E01009230,1077,19,61,83,4,1244
E01009231,1249,26,143,100,7,1525
E01009232,937,37,157,132,6,1269
E01009233,1060,29,23,36,2,1150
E01009234,960,24,85,100,9,1178
E01009235,885,27,207,150,20,1289
E01009236,907,30,137,131,4,1209
E01009237,650,43,247,162,13,1115
E01009238,792,33,341,146,16,1328
E01009239,825,61,510,243,20,1659
E01009240,722,39,239,198,20,1218
E01009241,572,38,426,250,13,1299
E01009242,571,32,546,225,16,1390
E01009243,916,23,165,121,8,1233
E01009244,893,14,103,86,3,1099
E01009245,779,28,210,123,7,1147
E01009246,961,25,137,142,7,1272
E01009247,812,30,181,140,12,1175
E01009248,1137,30,102,111,0,1380
E01009249,1016,32,93,75,9,1225
E01009250,1129,41,83,50,10,1313
E01009251,976,24,149,80,13,1242
E01009252,893,32,293,30,35,1283
E01009253,992,27,142,70,10,1241
E01009254,967,43,140,92,14,1256
E01009255,921,46,115,98,19,1199
E01009256,956,55,136,68,10,1225
E01009257,852,47,109,93,25,1126
E01009258,911,38,79,102,15,1145
E01009259,904,59,76,128,19,1186
E01009260,692,12,524,11,61,1300
E01009261,877,29,305,60,39,1310
E01009262,342,23,821,143,81,1410
E01009263,486,79,437,299,18,1319
E01009264,725,53,218,242,28,1266
E01009265,431,52,676,192,60,1411
E01009266,355,58,596,222,91,1322
E01009267,362,21,864,111,107,1465
E01009268,179,23,763,135,83,1183
E01009269,351,29,501,196,41,1118
E01009270,230,75,698,345,72,1420
E01009271,237,38,537,264,34,1110
E01009272,260,55,399,296,20,1030
E01009273,176,42,664,283,63,1228
E01009274,203,50,905,401,70,1629
E01009275,158,36,710,191,33,1128
E01009276,341,24,738,166,47,1316
E01009278,344,21,772,188,38,1363
E01009279,268,22,701,142,48,1181
E01009280,890,25,130,37,6,1088
E01009281,1068,29,49,35,16,1197
E01009282,1087,47,181,77,8,1400
E01009283,868,49,228,42,31,1218
E01009284,1198,69,667,131,65,2130
E01009286,1757,91,202,50,28,2128
E01009288,819,18,202,42,13,1094
E01009289,1610,77,254,45,30,2016
E01009290,1598,70,216,30,28,1942
E01009291,956,53,104,49,17,1179
E01009292,1011,26,220,71,32,1360
E01009293,964,53,246,33,10,1306
E01009294,1207,31,130,71,15,1454
E01009295,1073,49,297,95,30,1544
E01009296,925,42,224,83,15,1289
E01009297,1225,29,33,17,10,1314
E01009298,838,46,118,80,6,1088
E01009299,999,49,86,94,3,1231
E01009300,1008,75,88,109,13,1293
E01009301,1130,47,32,53,5,1267
E01009302,1207,22,13,34,4,1280
E01009303,1099,38,16,41,4,1198
E01009304,1314,40,30,38,2,1424
E01009305,1009,63,56,71,9,1208
E01009306,1114,37,32,45,1,1229
E01009307,1090,41,34,45,7,1217
E01009308,1200,54,40,86,8,1388
E01009309,987,47,28,54,4,1120
E01009310,1268,45,32,66,4,1415
E01009311,848,42,150,92,6,1138
E01009312,1123,18,99,30,2,1272
E01009313,1073,21,131,17,7,1249
E01009314,1141,19,68,27,8,1263
E01009315,1240,23,75,27,17,1382
E01009316,1123,35,117,37,7,1319
E01009317,1191,27,55,46,1,1320
E01009318,1147,24,58,10,1,1240
E01009319,1204,29,75,31,5,1344
E01009320,1080,11,123,42,6,1262
E01009321,1167,41,64,65,10,1347
E01009322,863,28,74,76,8,1049
E01009323,975,17,88,40,6,1126
E01009324,1242,12,57,29,8,1348
E01009325,294,32,682,120,18,1146
E01009326,371,34,722,108,28,1263
E01009327,94,11,772,99,53,1029
E01009328,76,22,1381,104,36,1619
E01009329,77,32,1339,121,77,1646
E01009331,143,21,1092,115,42,1413
E01009332,356,52,520,175,63,1166
E01009333,119,33,751,86,25,1014
E01009334,110,16,1060,76,47,1309
E01009335,131,11,976,92,52,1262
E01009337,131,8,877,105,47,1168
E01009338,109,25,844,75,28,1081
E01009339,170,20,683,91,58,1022
E01009340,838,39,837,98,39,1851
E01009341,378,45,525,98,36,1082
E01009342,304,40,805,78,32,1259
E01009343,246,36,689,144,34,1149
E01009344,117,37,667,154,38,1013
E01009345,830,127,405,474,31,1867
E01009346,155,42,675,211,54,1137
E01009347,431,90,198,542,33,1294
E01009348,571,88,297,501,34,1491
E01009349,237,50,557,283,45,1172
E01009350,157,29,671,228,11,1096
E01009351,193,35,741,209,36,1214
E01009352,108,28,828,233,53,1250
E01009353,87,34,887,172,21,1201
E01009354,169,54,583,272,21,1099
E01009355,126,41,658,321,40,1186
E01009358,292,51,743,397,54,1537
E01009359,220,82,755,339,83,1479
E01009360,475,89,523,598,59,1744
E01009361,386,90,586,402,54,1518
E01009362,222,91,206,323,73,915
E01009363,260,45,599,154,77,1135
E01009364,210,53,272,285,92,912
E01009365,216,65,663,220,107,1271
E01009366,229,56,387,150,252,1074
E01009367,159,39,745,115,124,1182
E01009368,97,29,719,130,76,1051
E01009371,108,41,900,74,78,1201
E01009372,92,11,1008,26,55,1192
E01009373,47,27,1055,55,42,1226
E01009374,184,38,313,169,98,802
E01009375,149,22,782,158,176,1287
E01009376,281,63,470,177,165,1156
E01009377,169,39,400,140,138,886
E01009378,859,84,432,258,95,1728
E01009379,345,64,489,286,45,1229
E01009380,102,18,797,110,62,1089
E01009382,122,13,1069,52,48,1304
E01009383,225,37,720,85,21,1088
E01009384,638,72,209,170,40,1129
E01009385,734,48,242,85,17,1126
E01009389,259,26,1016,47,28,1376
E01009390,721,53,412,70,35,1291
E01009391,174,20,818,58,11,1081
E01009392,177,21,992,31,50,1271
E01009393,157,30,784,56,28,1055
E01009394,704,30,594,41,55,1424
E01009395,403,47,689,97,28,1264
E01009396,79,28,1306,38,78,1529
E01009397,91,28,860,103,84,1166
E01009399,129,23,723,74,88,1037
E01009400,671,58,203,180,6,1118
E01009401,600,68,321,248,14,1251
E01009403,917,47,62,114,7,1147
E01009404,954,26,79,118,2,1179
E01009405,887,28,85,102,4,1106
E01009406,1050,44,97,115,2,1308
E01009407,995,55,127,144,16,1337
E01009408,854,46,189,209,11,1309
E01009409,967,49,121,160,2,1299
E01009410,954,48,241,211,10,1464
E01009411,947,61,222,220,14,1464
E01009412,709,60,362,261,4,1396
E01009413,692,67,278,252,18,1307
E01009414,797,66,323,277,15,1478
E01009415,1248,15,79,7,2,1351
E01009416,1726,29,164,20,18,1957
E01009417,1067,8,66,20,9,1170
E01009418,1097,23,60,16,0,1196
E01009419,1006,12,61,9,10,1098
E01009420,1133,8,54,17,3,1215
E01009421,1178,6,157,8,27,1376
E01009422,1485,8,57,14,3,1567
E01009423,1274,28,60,26,1,1389
E01009424,1177,23,54,17,4,1275
E01009425,1355,12,52,16,2,1437
E01009426,1117,4,69,4,5,1199
E01009427,1079,17,148,17,18,1279
E01009428,1271,7,79,17,2,1376
E01009429,1118,8,52,7,5,1190
E01009430,1230,18,93,13,16,1370
E01009431,1165,16,60,7,2,1250
E01009432,1086,12,60,29,2,1189
E01009433,1318,12,98,34,5,1467
E01009434,1113,14,58,17,4,1206
E01009435,1256,24,120,29,15,1444
E01009436,1049,5,85,20,6,1165
E01009437,1310,13,110,36,2,1471
E01009438,1113,12,61,11,9,1206
E01009439,1062,17,41,23,7,1150
E01009440,1226,12,63,24,2,1327
E01009441,1161,25,15,21,3,1225
E01009442,1115,16,65,25,7,1228
E01009443,931,8,42,17,3,1001
E01009444,1205,15,50,10,0,1280
E01009445,1106,22,36,38,6,1208
E01009446,1703,32,117,56,8,1916
E01009447,1120,17,89,14,0,1240
E01009448,1195,13,35,38,4,1285
E01009449,1440,37,82,20,2,1581
E01009450,1301,14,47,14,1,1377
E01009451,1031,23,52,21,4,1131
E01009452,1228,24,60,34,5,1351
E01009453,1037,15,79,22,2,1155
E01009454,1155,10,35,22,3,1225
E01009455,1025,25,32,43,1,1126
E01009456,1246,34,36,17,4,1337
E01009457,1174,19,74,22,3,1292
E01009458,1118,16,104,50,0,1288
E01009459,1200,8,94,34,4,1340
E01009460,1224,26,88,65,7,1410
E01009461,965,11,86,24,16,1102
E01009462,1299,30,72,35,2,1438
E01009463,1142,13,115,8,8,1286
E01009464,1019,15,77,30,6,1147
E01009465,927,18,118,35,0,1098
E01009466,1289,8,39,13,5,1354
E01009467,1124,27,86,64,12,1313
E01009468,1217,10,50,11,4,1292
E01009469,962,9,174,49,17,1211
E01009470,1027,9,141,20,9,1206
E01009471,1390,24,102,19,3,1538
E01009472,1138,27,88,35,10,1298
E01009473,1063,30,125,48,7,1273
E01009474,1166,15,76,30,4,1291
E01009475,362,46,726,153,26,1313
E01009476,332,41,674,121,46,1214
E01009477,519,56,497,105,15,1192
E01009478,514,49,534,124,20,1241
E01009479,260,47,961,157,34,1459
E01009480,572,21,467,92,13,1165
E01009481,514,30,891,100,6,1541
E01009482,113,18,863,123,23,1140
E01009483,67,22,1012,73,14,1188
E01009484,152,27,840,135,30,1184
E01009485,173,16,910,106,9,1214
E01009486,377,28,835,96,21,1357
E01009487,358,17,993,76,16,1460
E01009488,453,35,829,97,22,1436
E01009489,86,19,1042,136,7,1290
E01009490,519,40,672,90,31,1352
E01009491,149,20,946,62,22,1199
E01009492,378,31,663,61,13,1146
E01009493,721,49,237,122,60,1189
E01009494,917,61,70,70,11,1129
E01009495,806,29,26,48,14,923
E01009496,1117,24,61,31,21,1254
E01009497,1128,20,117,74,9,1348
E01009498,1076,53,49,52,7,1237
E01009499,1052,39,147,81,4,1323
E01009500,927,53,72,84,21,1157
E01009501,992,34,68,60,19,1173
E01009502,973,38,57,49,9,1126
E01009503,990,43,71,51,12,1167
E01009504,1058,6,91,26,23,1204
E01009505,1080,33,68,66,18,1265
E01009506,1052,26,113,31,32,1254
E01009507,640,45,393,106,17,1201
E01009508,861,32,206,93,11,1203
E01009509,625,42,530,95,18,1310
E01009510,931,43,181,91,11,1257
E01009511,672,28,207,125,7,1039
E01009512,1029,32,66,85,3,1215
E01009513,733,48,330,98,14,1223
E01009514,880,35,146,86,3,1150
E01009515,960,24,237,49,8,1278
E01009516,861,38,150,39,2,1090
E01009517,1102,31,99,69,1,1302
E01009518,1086,13,185,30,7,1321
E01009519,1120,17,56,30,7,1230
E01009520,1208,14,164,39,2,1427
E01009521,1012,28,227,34,5,1306
E01009522,1006,18,97,24,5,1150
E01009523,1284,13,29,1,10,1337
E01009524,1144,9,52,12,17,1234
E01009525,866,12,239,25,39,1181
E01009526,1223,5,46,6,4,1284
E01009527,1127,18,73,28,5,1251
E01009528,1258,12,38,7,3,1318
E01009529,1123,6,75,34,4,1242
E01009530,1048,7,25,9,4,1093
E01009531,1220,6,27,8,12,1273
E01009532,1023,7,47,15,9,1101
E01009535,1000,6,95,9,9,1119
E01009536,1090,4,132,13,6,1245
E01009537,1019,16,79,60,3,1177
E01009538,1012,24,42,48,2,1128
E01009539,1050,23,15,105,5,1198
E01009540,984,15,35,257,10,1301
E01009541,1208,21,24,62,13,1328
E01009542,1197,31,62,112,5,1407
E01009543,932,14,408,14,17,1385
E01009544,1050,15,169,45,5,1284
E01009548,1342,40,368,104,119,1973
E01009549,987,21,260,46,31,1345
E01009550,1171,18,223,50,37,1499
E01009552,964,21,240,35,21,1281
E01009553,1373,48,398,122,33,1974
E01009554,977,19,106,15,10,1127
E01009555,1130,7,89,10,11,1247
E01009556,1180,22,88,23,6,1319
E01009557,1007,10,133,5,19,1174
E01009558,1097,25,91,30,18,1261
E01009559,1000,23,162,27,4,1216
E01009560,919,6,283,7,32,1247
E01009561,1137,21,160,18,5,1341
E01009562,1013,14,324,14,20,1385
E01009563,1016,10,257,15,36,1334
E01009564,511,26,468,105,36,1146
E01009565,129,8,880,89,60,1166
E01009566,469,28,372,158,72,1099
E01009567,386,22,739,116,60,1323
E01009568,247,30,871,85,51,1284
E01009569,370,28,404,88,47,937
E01009570,337,24,790,102,66,1319
E01009571,468,31,486,119,61,1165
E01009572,617,54,536,222,58,1487
E01009573,292,19,686,70,61,1128
E01009574,347,43,594,109,54,1147
E01009575,498,25,359,46,21,949
E01009576,1114,20,82,54,6,1276
E01009577,706,29,35,132,8,910
E01009578,945,14,196,19,16,1190
E01009579,943,31,47,164,13,1198
E01009580,817,18,136,26,13,1010
E01009581,969,38,37,130,9,1183
E01009582,1204,22,108,65,12,1411
E01009583,958,19,236,47,13,1273
E01009584,1024,14,19,53,8,1118
E01009585,516,22,14,128,7,687
E01009586,1232,9,50,39,5,1335
E01009587,691,23,349,66,21,1150
E01009588,969,27,141,46,21,1204
E01009589,882,17,151,33,9,1092
E01009590,1037,5,65,10,14,1131
E01009591,953,23,154,31,15,1176
E01009592,876,34,202,50,22,1184
E01009593,990,15,263,26,27,1321
E01009594,998,15,76,16,17,1122
E01009596,662,32,353,76,22,1145
E01009597,818,27,400,56,46,1347
E01009598,961,10,348,16,43,1378
E01009599,908,18,54,44,4,1028
E01009604,771,38,270,33,16,1128
E01009605,967,27,63,91,5,1153
E01009606,755,19,259,44,33,1110
E01009607,963,45,52,120,15,1195
E01009608,950,32,139,63,9,1193
E01009609,752,18,292,60,40,1162
E01009610,906,28,124,49,17,1124
E01009611,976,33,130,291,7,1437
E01009612,757,28,79,162,7,1033
E01009613,867,12,139,35,2,1055
E01009614,927,12,159,33,11,1142
E01009615,1107,32,224,78,36,1477
E01009616,922,26,216,50,26,1240
E01009617,771,15,161,43,19,1009
E01009618,1057,8,133,23,5,1226
E01009619,1122,24,219,175,38,1578
E01009620,1030,12,95,32,7,1176
E01009621,872,23,87,84,9,1075
E01009622,1108,44,111,30,6,1299
E01009623,913,33,186,46,20,1198
E01009624,872,15,270,43,29,1229
E01009625,1063,31,548,81,53,1776
E01009626,879,12,308,39,17,1255
E01009627,961,25,202,44,30,1262
E01009628,942,13,192,51,12,1210
E01009629,1196,53,704,156,69,2178
E01009630,1002,34,172,77,18,1303
E01009631,825,22,96,74,18,1035
E01009632,1056,41,196,145,38,1476
E01009633,903,21,300,222,34,1480
E01009634,922,34,316,152,16,1440
E01009635,1762,99,715,323,84,2983
E01009636,979,48,400,340,60,1827
E01009637,232,41,586,97,47,1003
E01009638,442,43,288,295,53,1121
E01009639,230,30,815,123,67,1265
E01009640,610,50,400,182,44,1286
E01009641,1564,71,479,357,88,2559
E01009642,1493,103,552,277,239,2664
E01009643,1061,10,77,11,7,1166
E01009644,1195,11,99,11,10,1326
E01009645,1004,13,89,28,9,1143
E01009646,1096,14,81,2,8,1201
E01009647,1135,16,232,54,18,1455
E01009648,1041,14,110,20,4,1189
E01009649,977,9,112,23,15,1136
E01009650,1116,39,173,118,27,1473
E01009651,988,58,96,204,24,1370
E01009652,1104,7,51,11,10,1183
E01009653,1151,13,53,12,5,1234
E01009654,1129,31,149,29,14,1352
E01009655,1081,31,182,79,31,1404
E01009656,979,30,171,95,21,1296
E01009657,1050,14,213,32,8,1317
E01009658,870,10,265,37,40,1222
E01009659,915,32,209,151,27,1334
E01009660,704,10,572,90,40,1416
E01009661,979,34,355,129,40,1537
E01009662,584,15,472,62,55,1188
E01009663,965,9,148,52,14,1188
E01009664,891,33,154,50,23,1151
E01009665,779,12,203,8,25,1027
E01009666,830,12,148,14,28,1032
E01009667,801,9,339,1,34,1184
E01009668,1059,12,182,16,7,1276
E01009669,746,17,195,8,15,981
E01009670,1071,11,195,5,18,1300
E01009671,2327,108,1436,82,47,4000
E01009672,1327,16,349,10,44,1746
E01009674,1174,17,37,29,11,1268
E01009676,1085,13,56,29,2,1185
E01009679,956,19,128,58,18,1179
E01009681,1006,15,43,12,3,1079
E01009682,1143,7,74,12,8,1244
E01009683,939,14,47,43,0,1043
E01009684,1053,19,60,30,5,1167
E01009685,1253,15,60,27,3,1358
E01009686,1230,11,109,17,7,1374
E01009687,988,24,85,35,18,1150
E01009688,934,38,225,76,21,1294
E01009689,1098,27,156,59,9,1349
E01009690,992,18,243,39,14,1306
E01009691,983,25,170,44,2,1224
E01009692,1041,8,31,3,2,1085
E01009693,1166,9,52,6,6,1239
E01009694,1118,9,50,3,1,1181
E01009695,1300,6,26,2,0,1334
E01009696,1227,10,29,11,5,1282
E01009697,1178,6,17,5,5,1211
E01009698,1218,7,49,5,4,1283
E01009699,1110,11,20,20,4,1165
E01009700,1182,24,18,69,9,1302
E01009701,1164,14,20,20,7,1225
E01009702,984,17,28,96,13,1138
E01009703,1798,31,128,44,8,2009
E01009704,1161,8,45,4,9,1227
E01009705,1143,12,51,5,2,1213
E01009706,1207,4,25,9,1,1246
E01009707,1235,16,172,22,9,1454
E01009708,997,13,194,36,8,1248
E01009709,487,28,16,181,1,713
E01009710,1002,17,111,28,12,1170
E01009711,1006,19,100,28,9,1162
E01009712,987,9,175,42,21,1234
E01009713,939,12,105,28,10,1094
E01009714,985,12,120,30,27,1174
E01009715,756,27,242,49,18,1092
E01009716,1078,12,162,35,20,1307
E01009717,909,7,202,38,18,1174
E01009718,1108,37,82,121,37,1385
E01009719,1105,9,33,7,1,1155
E01009720,1097,9,28,3,2,1139
E01009721,1521,13,51,11,4,1600
E01009722,1105,5,16,1,2,1129
E01009723,987,3,30,2,7,1029
E01009724,1231,2,7,3,0,1243
E01009725,1023,9,57,14,3,1106
E01009726,1053,3,29,0,0,1085
E01009727,1076,4,32,2,0,1114
E01009728,1064,10,18,10,0,1102
E01009729,1226,12,25,3,0,1266
E01009730,1145,5,24,1,2,1177
E01009731,1222,6,39,16,0,1283
E01009732,1252,18,60,22,55,1407
E01009733,1127,35,66,63,116,1407
E01009734,1191,12,25,18,26,1272
E01009735,1207,7,15,7,0,1236
E01009736,1149,5,15,2,11,1182
E01009737,1188,14,22,15,10,1249
E01009738,1132,8,34,6,42,1222
E01009739,1157,15,28,11,19,1230
E01009740,1207,18,28,12,1,1266
E01009741,1655,36,124,57,10,1882
E01009742,1185,17,10,10,0,1222
E01009743,1250,23,27,13,1,1314
E01009744,1321,17,138,35,3,1514
E01009745,1409,17,12,0,1,1439
E01009746,963,10,319,19,11,1322
E01009747,1110,7,59,5,2,1183
E01009748,1147,12,68,26,8,1261
E01009749,1190,10,48,4,2,1254
E01009750,1189,9,36,4,0,1238
E01009751,1162,8,32,17,2,1221
E01009752,1092,11,20,11,4,1138
E01009753,1104,18,32,2,5,1161
E01009754,1188,22,69,13,7,1299
E01009756,964,22,44,51,15,1096
E01009757,1159,18,97,41,2,1317
E01009758,1227,25,27,34,4,1317
E01009759,1037,6,51,11,3,1108
E01009760,974,12,19,21,3,1029
E01009762,866,29,46,33,5,979
E01009763,1235,19,50,42,8,1354
E01009764,1149,6,34,11,0,1200
E01009765,1223,12,54,9,1,1299
E01009766,1224,8,33,21,0,1286
E01009767,1145,11,29,7,0,1192
E01009768,1078,10,38,15,0,1141
E01009769,1155,20,26,27,0,1228
E01009770,1094,14,60,21,5,1194
E01009771,1208,8,14,6,0,1236
E01009772,973,21,11,16,0,1021
E01009773,1229,5,4,8,0,1246
E01009774,1234,11,19,14,0,1278
E01009775,1163,21,54,19,5,1262
E01009776,1199,7,23,18,1,1248
E01009777,1132,10,20,11,5,1178
E01009778,1221,4,14,12,0,1251
E01009779,1178,6,5,2,1,1192
E01009780,1393,12,149,24,7,1585
E01009781,1490,18,16,29,2,1555
E01009782,1193,12,6,6,2,1219
E01009783,1153,8,15,6,2,1184
E01009784,1209,20,65,17,12,1323
E01009785,1243,8,7,2,0,1260
E01009786,1080,25,25,22,2,1154
E01009787,1188,5,75,6,5,1279
E01009788,1248,14,7,18,6,1293
E01009789,1261,4,1,3,0,1269
E01009790,1227,10,17,15,0,1269
E01009791,1079,14,113,15,11,1232
E01009792,1006,17,153,21,23,1220
E01009793,963,14,95,16,4,1092
E01009794,1089,13,121,28,8,1259
E01009795,1039,25,226,13,14,1317
E01009796,1075,17,139,21,10,1262
E01009797,980,19,100,22,14,1135
E01009798,1238,15,128,21,3,1405
E01009799,1204,9,27,1,5,1246
E01009800,1162,25,70,24,3,1284
E01009801,1292,12,90,20,4,1418
E01009802,1213,12,60,22,5,1312
E01009803,1289,6,94,1,7,1397
E01009804,1077,9,59,8,3,1156
E01009805,1144,8,39,9,10,1210
E01009806,1203,21,27,7,8,1266
E01009807,1492,6,16,4,4,1522
E01009808,1187,7,23,5,0,1222
E01009809,1130,32,50,15,54,1281
E01009810,1369,3,36,7,19,1434
E01009811,1239,20,8,11,2,1280
E01009812,1207,8,32,3,13,1263
E01009813,1143,19,56,10,36,1264
E01009814,1115,4,2,2,1,1124
E01009815,1070,5,13,3,1,1092
E01009816,1215,5,15,5,1,1241
E01009817,1034,6,19,8,1,1068
E01009818,929,3,9,0,0,941
E01009819,1223,11,15,8,1,1258
E01009820,1269,7,11,8,3,1298
E01009821,1176,6,10,2,1,1195
E01009822,1256,8,14,4,2,1284
E01009823,1125,4,32,3,2,1166
E01009824,1266,16,18,8,1,1309
E01009825,1149,1,28,3,4,1185
E01009826,1236,8,14,2,4,1264
E01009827,1278,4,14,8,3,1307
E01009828,1153,9,12,2,4,1180
E01009829,1244,6,25,1,0,1276
E01009830,1323,10,11,4,1,1349
E01009831,1136,11,54,8,1,1210
E01009832,1214,8,32,6,1,1261
E01009833,580,9,409,10,2,1010
E01009834,1180,14,89,7,2,1292
E01009835,838,15,294,11,13,1171
E01009836,966,19,366,31,18,1400
E01009837,932,8,314,3,13,1270
E01009838,1246,4,50,5,2,1307
E01009839,1001,27,184,47,7,1266
E01009840,593,37,364,76,7,1077
E01009841,1066,31,68,36,7,1208
E01009842,1225,21,170,83,9,1508
E01009843,1177,28,42,33,3,1283
E01009844,690,29,284,102,7,1112
E01009845,1229,5,46,3,7,1290
E01009846,1223,3,14,1,3,1244
E01009847,1211,4,1,2,4,1222
E01009848,1132,12,18,3,1,1166
E01009849,1229,12,2,7,3,1253
E01009850,1201,3,17,1,0,1222
E01009851,1199,9,5,5,0,1218
E01009852,1176,19,51,4,2,1252
E01009853,1199,5,13,3,1,1221
E01009854,1245,8,54,2,7,1316
E01009855,1275,2,109,7,2,1395
E01009856,1441,11,110,6,6,1574
E01009857,1133,11,120,1,0,1265
E01009858,1140,22,51,14,0,1227
E01009859,1225,14,54,8,6,1307
E01009860,1256,2,51,2,3,1314
E01009861,1108,25,51,10,31,1225
E01009862,1294,29,56,9,22,1410
E01009863,1272,20,31,23,30,1376
E01009864,1206,9,45,13,3,1276
E01009865,1128,9,22,6,8,1173
E01009866,1297,18,32,14,1,1362
E01009867,1343,7,51,3,0,1404
E01009868,1101,14,77,11,31,1234
E01009869,1246,6,27,25,11,1315
E01009870,1226,6,13,17,1,1263
E01009871,1415,24,70,29,4,1542
E01009872,1008,18,99,23,0,1148
E01009873,1168,22,63,15,1,1269
E01009874,1143,25,39,23,2,1232
E01009875,1179,19,44,18,6,1266
E01009876,1193,22,67,22,2,1306
E01009877,1105,27,28,13,2,1175
E01009878,1531,18,28,12,3,1592
E01009879,1196,28,312,86,6,1628
E01009880,1045,23,177,40,5,1290
E01009881,1253,38,247,193,15,1746
E01009882,870,11,169,59,7,1116
E01009883,980,11,40,24,6,1061
E01009884,994,31,142,43,12,1222
E01009885,826,36,315,98,8,1283
E01009886,1262,11,43,23,2,1341
E01009887,998,32,267,72,14,1383
E01009888,1109,33,124,26,4,1296
E01009889,662,50,533,133,15,1393
E01009890,1007,22,159,63,10,1261
E01009891,813,38,280,93,3,1227
E01009892,687,43,340,99,8,1177
E01009893,731,41,279,107,18,1176
E01009894,1097,20,196,59,7,1379
E01009895,1111,8,15,11,0,1145
E01009896,1219,14,19,2,3,1257
E01009897,1222,2,17,3,0,1244
E01009898,1271,8,15,1,1,1296
E01009899,1237,3,0,0,0,1240
E01009900,1254,10,0,3,1,1268
E01009901,1155,6,42,9,0,1212
E01009902,1043,13,28,7,0,1091
E01009903,1224,4,0,0,0,1228
E01009904,1211,11,12,1,0,1235
E01009905,1162,7,12,1,0,1182
E01009906,1307,9,22,9,1,1348
E01009907,1185,8,23,5,1,1222
E01009908,1291,10,11,3,8,1323
E01009909,1124,8,10,3,3,1148
E01009910,1254,13,10,8,1,1286
E01009911,1158,6,12,2,4,1182
E01009912,1329,8,27,10,1,1375
E01009913,1232,11,14,3,6,1266
E01009914,1195,1,4,1,2,1203
E01009915,1442,11,18,8,4,1483
E01009916,1370,9,5,6,1,1391
E01009917,1008,6,6,1,0,1021
E01009918,1121,9,13,2,1,1146
E01009919,1034,6,5,4,2,1051
E01009920,1132,9,10,4,0,1155
E01009921,992,37,189,69,19,1306
E01009922,797,26,110,63,15,1011
E01009923,982,23,124,49,13,1191
E01009924,971,25,71,46,5,1118
E01009925,944,24,84,44,8,1104
E01009926,944,43,96,48,9,1140
E01009927,983,66,150,77,16,1292
E01009928,1077,52,130,118,15,1392
E01009929,1229,30,41,26,1,1327
E01009930,1116,19,51,19,7,1212
E01009931,1653,21,118,21,10,1823
E01009932,1179,27,151,25,10,1392
E01009933,980,19,99,19,16,1133
E01009934,876,22,123,85,9,1115
E01009935,1260,20,130,111,27,1548
E01009936,1236,8,77,27,12,1360
E01009937,1082,42,52,46,3,1225
E01009938,1159,42,85,63,6,1355
E01009939,1104,28,178,55,27,1392
E01009940,1035,38,69,44,3,1189
E01009941,811,24,301,55,10,1201
E01009942,1013,48,161,77,13,1312
E01009943,749,52,200,86,34,1121
E01009944,847,52,174,63,26,1162
E01009946,1056,18,233,49,17,1373
E01009947,1123,42,285,71,27,1548
E01009948,1037,12,148,42,23,1262
E01009949,826,17,356,29,52,1280
E01009950,1133,29,157,50,8,1377
E01009951,1223,55,82,153,16,1529
E01009952,1289,35,106,61,15,1506
E01009953,1300,27,24,18,7,1376
E01009954,1361,25,27,9,6,1428
E01009955,1205,19,273,30,8,1535
E01009956,1097,16,107,16,5,1241
E01009957,1080,21,90,19,14,1224
E01009958,1267,9,22,12,8,1318
E01009959,1157,14,26,2,3,1202
E01009960,1186,9,42,22,5,1264
E01009961,1005,8,47,5,0,1065
E01009962,947,19,16,30,1,1013
E01009963,946,18,33,23,2,1022
E01009964,1049,19,35,23,1,1127
E01009965,949,16,19,30,1,1015
E01009966,820,15,64,8,7,914
E01009967,1235,19,119,54,2,1429
E01009968,877,12,279,50,43,1261
E01009969,964,46,331,85,31,1457
E01009970,1084,9,68,30,3,1194
E01009971,1035,40,84,58,7,1224
E01009972,1176,14,267,39,19,1515
E01009973,582,21,1043,113,84,1843
E01009974,897,9,287,48,32,1273
E01009975,1003,18,252,50,27,1350
E01009976,1378,30,435,77,42,1962
E01009977,1109,23,166,63,15,1376
E01009978,1349,8,48,20,0,1425
E01009979,1085,25,105,70,1,1286
E01009980,1267,38,331,107,29,1772
E01009981,1149,24,145,54,17,1389
E01009982,1027,12,113,14,6,1172
E01009983,1099,8,20,26,8,1161
E01009985,920,27,292,72,26,1337
E01009986,490,18,460,56,46,1070
E01009987,578,21,198,78,46,921
E01009988,958,42,217,120,27,1364
E01009989,840,24,311,91,26,1292
E01009991,1139,65,334,147,19,1704
E01009992,811,30,376,81,13,1311
E01009993,976,45,257,136,20,1434
E01009994,1079,32,64,52,3,1230
E01009995,1106,21,69,59,6,1261
E01009996,1129,25,55,61,3,1273
E01009997,947,45,221,96,9,1318
E01009998,1127,46,170,110,12,1465
E01009999,859,28,135,56,9,1087
E01010000,1076,22,158,39,18,1313
E01010001,1231,23,77,51,13,1395
E01010002,1199,45,260,121,14,1639
E01010003,976,31,152,77,4,1240
E01010004,1073,28,88,82,11,1282
E01010005,734,23,338,68,16,1179
E01010006,1056,18,186,57,23,1340
E01010007,575,22,255,134,31,1017
E01010008,837,22,275,121,23,1278
E01010009,789,24,181,101,1,1096
E01010010,684,42,162,157,7,1052
E01010011,1061,19,187,60,10,1337
E01010012,955,15,134,50,5,1159
E01010013,742,12,218,50,7,1029
E01010014,1043,14,194,114,15,1380
E01010015,728,17,465,111,36,1357
E01010016,730,25,367,72,20,1214
E01010017,920,46,399,105,28,1498
E01010018,1080,40,282,191,25,1618
E01010019,549,25,580,80,20,1254
E01010020,822,46,447,109,24,1448
E01010021,707,42,429,115,33,1326
E01010022,1052,20,111,54,5,1242
E01010023,1222,21,156,64,17,1480
E01010024,1005,15,187,36,16,1259
E01010025,1071,19,59,75,9,1233
E01010026,1120,25,170,75,11,1401
E01010027,895,26,231,55,23,1230
E01010028,936,28,54,74,5,1097
E01010029,965,14,8,23,4,1014
E01010030,1072,27,35,38,2,1174
E01010031,1157,8,24,42,3,1234
E01010032,905,15,10,23,4,957
E01010033,1178,14,36,45,1,1274
E01010034,1064,9,62,12,3,1150
E01010035,1108,9,43,16,14,1190
E01010036,1056,27,46,60,2,1191
E01010037,739,14,15,29,0,797
E01010038,1235,32,47,37,3,1354
E01010039,925,8,53,21,1,1008
E01010040,1095,9,37,27,1,1169
E01010041,1237,19,41,38,7,1342
E01010042,1264,14,119,13,24,1434
E01010043,1108,5,89,9,0,1211
E01010044,1021,13,25,30,0,1089
E01010045,1153,14,38,26,1,1232
E01010046,268,37,945,109,30,1389
E01010047,346,27,841,81,69,1364
E01010048,231,17,875,98,77,1298
E01010049,324,24,748,108,98,1302
E01010050,310,13,732,73,76,1204
E01010051,505,35,308,69,39,956
E01010052,405,25,471,96,11,1008
E01010053,423,47,614,214,63,1361
E01010054,700,63,422,258,39,1482
E01010055,662,47,416,118,50,1293
E01010056,773,51,303,82,16,1225
E01010057,513,32,725,168,78,1516
E01010058,982,38,168,87,3,1278
E01010059,318,50,733,229,50,1380
E01010060,494,30,694,176,91,1485
E01010061,233,37,828,147,53,1298
E01010062,420,48,436,251,61,1216
E01010063,457,92,351,479,70,1449
E01010064,390,50,551,295,34,1320
E01010065,517,74,813,360,62,1826
E01010066,903,18,213,31,9,1174
E01010067,653,18,410,50,12,1143
E01010068,1085,19,146,39,8,1297
E01010069,688,27,543,124,33,1415
E01010070,1159,22,81,39,5,1306
E01010071,936,15,303,83,17,1354
E01010072,1127,36,390,119,32,1704
E01010073,727,41,267,136,27,1198
E01010074,1590,28,119,71,5,1813
E01010075,562,7,429,34,30,1062
E01010076,921,12,61,34,3,1031
E01010077,1102,27,30,40,6,1205
E01010078,1011,14,66,18,5,1114
E01010079,1138,14,79,18,7,1256
E01010080,1056,32,90,113,13,1304
E01010081,1179,9,44,24,2,1258
E01010082,1399,25,241,96,18,1779
E01010083,1186,20,55,54,4,1319
E01010084,994,31,50,64,11,1150
E01010085,1203,12,91,23,1,1330
E01010086,1141,29,130,30,8,1338
E01010087,1184,9,129,16,0,1338
E01010088,1018,13,164,10,0,1205
E01010089,1209,21,165,25,1,1421
E01010090,1105,28,148,61,5,1347
E01010091,1031,18,187,18,2,1256
E01010092,1246,35,180,37,5,1503
E01010093,617,24,153,72,14,880
E01010094,554,17,474,86,43,1174
E01010095,870,28,82,59,10,1049
E01010096,1143,17,77,15,6,1258
E01010097,1303,6,153,33,3,1498
E01010098,1162,33,113,58,10,1376
E01010099,1127,20,117,68,3,1335
E01010100,716,28,518,111,62,1435
E01010101,941,39,400,158,49,1587
E01010102,598,34,568,132,39,1371
E01010103,979,36,346,136,22,1519
E01010104,1061,27,225,71,25,1409
E01010105,317,13,697,110,74,1211
E01010106,439,14,574,124,55,1206
E01010107,411,55,622,225,34,1347
E01010108,1538,18,59,5,4,1624
E01010109,1116,11,21,14,3,1165
E01010110,1227,28,62,41,10,1368
E01010111,1043,21,18,39,0,1121
E01010112,1165,40,26,28,1,1260
E01010113,1001,9,21,19,0,1050
E01010114,1392,24,54,39,4,1513
E01010115,1115,11,81,15,8,1230
E01010116,988,10,189,4,15,1206
E01010117,1140,16,12,24,4,1196
E01010118,999,23,45,37,0,1104
E01010119,1229,9,10,19,3,1270
E01010120,1019,16,33,34,3,1105
E01010121,1156,12,35,14,5,1222
E01010122,1119,15,66,17,3,1220
E01010123,1163,12,16,10,0,1201
E01010124,1273,24,16,15,3,1331
E01010125,1083,34,13,40,1,1171
E01010126,1062,28,9,35,0,1134
E01010127,1257,31,8,43,1,1340
E01010128,1040,36,6,49,1,1132
E01010129,1078,31,18,52,0,1179
E01010130,1238,25,15,56,1,1335
E01010131,990,25,7,52,0,1074
E01010132,1078,16,66,12,1,1173
E01010133,1133,10,128,15,7,1293
E01010134,1045,3,72,23,4,1147
E01010135,1106,19,94,13,13,1245
E01010136,946,10,34,4,3,997
E01010137,1001,14,76,13,9,1113
E01010138,1069,5,69,14,2,1159
E01010139,828,16,3,22,2,871
E01010140,1071,43,10,41,5,1170
E01010141,945,33,24,41,0,1043
E01010142,964,32,28,46,1,1071
E01010143,999,44,18,33,3,1097
E01010144,1253,9,22,57,2,1343
E01010145,1182,23,12,22,2,1241
E01010146,1153,23,22,59,2,1259
E01010147,935,42,13,60,2,1052
E01010148,1197,26,16,58,1,1298
E01010149,1165,26,12,14,0,1217
E01010150,1249,3,36,6,2,1296
E01010151,1307,12,13,5,4,1341
E01010152,1059,7,37,0,7,1110
E01010153,1219,14,15,10,10,1268
E01010154,1309,10,84,6,9,1418
E01010155,1257,6,4,5,8,1280
E01010156,1227,9,28,5,5,1274
E01010157,1033,14,67,18,4,1136
E01010158,1069,18,64,17,13,1181
E01010159,856,11,201,20,16,1104
E01010160,1130,19,81,14,5,1249
E01010161,1121,8,100,15,5,1249
E01010162,1095,15,108,27,7,1252
E01010163,991,4,123,22,6,1146
E01010164,1298,9,25,13,2,1347
E01010165,1215,11,19,2,4,1251
E01010166,1123,7,38,7,4,1179
E01010167,1242,11,12,3,1,1269
E01010168,1426,11,55,8,1,1501
E01010169,1268,8,26,5,3,1310
E01010170,1147,9,38,2,6,1202
E01010171,1050,13,22,5,6,1096
E01010172,1101,10,116,10,11,1248
E01010173,973,3,135,9,17,1137
E01010174,1134,31,111,37,15,1328
E01010175,1192,16,155,21,25,1409
E01010176,872,9,208,10,6,1105
E01010177,1016,18,63,14,0,1111
E01010178,1355,34,142,35,5,1571
E01010179,1286,11,94,4,1,1396
E01010180,983,8,24,5,10,1030
E01010181,1375,17,102,8,4,1506
E01010183,1040,9,37,3,5,1094
E01010184,1106,6,17,7,0,1136
E01010185,1205,7,46,5,0,1263
E01010186,1459,11,30,6,5,1511
E01010187,1058,13,50,4,3,1128
E01010188,1356,4,30,6,3,1399
E01010189,1257,2,19,5,9,1292
E01010190,1229,22,80,7,14,1352
E01010191,1300,15,196,15,29,1555
E01010192,1163,15,185,19,24,1406
E01010193,1011,9,72,8,4,1104
E01010194,1204,14,63,10,10,1301
E01010195,1088,5,147,6,12,1258
E01010196,1203,9,129,12,20,1373
E01010197,1134,8,203,4,18,1367
E01010198,1205,13,102,7,7,1334
E01010199,1227,13,172,11,11,1434
E01010200,1089,12,96,9,8,1214
E01010201,1114,8,183,14,6,1325
E01010202,1095,7,115,13,29,1259
E01010203,1236,23,137,16,9,1421
E01010204,887,29,100,15,4,1035
E01010205,945,13,229,8,9,1204
E01010206,1098,11,172,13,14,1308
E01010207,1049,12,147,8,11,1227
E01010208,1167,9,77,8,12,1273
E01010209,1292,10,93,9,6,1410
E01010210,1258,5,91,3,1,1358
E01010211,1140,6,71,5,7,1229
E01010212,962,9,176,16,21,1184
E01010213,1304,13,62,17,8,1404
E01010214,943,6,67,2,9,1027
E01010215,1092,14,210,15,15,1346
E01010216,1004,7,188,12,23,1234
E01010217,1262,8,24,3,0,1297
E01010218,1053,17,43,26,5,1144
E01010219,1228,19,73,14,4,1338
E01010220,1216,10,73,5,7,1311
E01010221,1182,6,27,9,2,1226
E01010222,1162,9,60,12,2,1245
E01010223,849,17,77,18,9,970
E01010225,1046,7,87,16,4,1160
E01010226,1235,16,155,13,13,1432
E01010227,1370,30,179,17,25,1621
E01010228,1169,20,108,12,8,1317
E01010229,1020,14,151,9,12,1206
E01010230,1248,16,146,22,10,1442
E01010231,1156,14,180,16,26,1392
E01010232,1431,15,118,17,11,1592
E01010233,1274,8,146,25,8,1461
E01010234,877,19,14,45,1,956
E01010235,998,22,15,64,2,1101
E01010236,1012,18,21,55,3,1109
E01010237,1391,32,17,61,5,1506
E01010238,1019,40,10,45,0,1114
E01010239,1088,32,15,52,2,1189
E01010240,940,37,3,54,3,1037
E01010241,1797,15,63,16,8,1899
E01010242,1299,11,27,14,2,1353
E01010243,1230,8,26,7,0,1271
E01010244,1091,17,15,8,3,1134
E01010245,1217,12,46,9,2,1286
E01010246,1194,13,53,12,4,1276
E01010247,1300,8,45,12,3,1368
E01010248,1246,10,80,16,5,1357
E01010249,1315,22,22,15,0,1374
E01010250,1166,19,23,15,1,1224
E01010251,1065,6,54,16,3,1144
E01010252,1337,24,35,10,1,1407
E01010253,996,3,18,3,3,1023
E01010254,1149,11,25,13,9,1207
E01010255,1137,8,9,1,3,1158
E01010256,1231,14,13,3,5,1266
E01010257,1017,5,17,3,0,1042
E01010258,1172,41,37,52,1,1303
E01010259,1236,26,78,18,12,1370
E01010260,1158,20,64,33,9,1284
E01010261,1026,33,89,59,11,1218
E01010262,1005,11,157,35,10,1218
E01010263,455,32,685,32,4,1208
E01010264,983,43,237,26,5,1294
E01010265,686,32,569,48,7,1342
E01010266,896,39,46,58,6,1045
E01010267,1082,18,171,71,15,1357
E01010268,607,15,571,33,10,1236
E01010269,378,28,629,39,3,1077
E01010270,857,27,409,61,30,1384
E01010271,1226,39,22,28,4,1319
E01010272,1138,14,31,6,9,1198
E01010273,1114,19,11,9,0,1153
E01010274,1139,6,12,28,2,1187
E01010275,1137,10,7,26,0,1180
E01010277,1158,19,27,26,8,1238
E01010279,1046,32,82,85,3,1248
E01010282,930,12,25,10,4,981
E01010283,1248,44,52,27,6,1377
E01010284,1205,12,14,5,2,1238
E01010285,1380,17,27,8,1,1433
E01010286,1209,18,21,6,1,1255
E01010287,1215,10,22,22,2,1271
E01010288,1240,17,15,17,2,1291
E01010289,1190,21,8,15,1,1235
E01010290,1379,17,6,4,0,1406
E01010291,1045,15,6,6,2,1074
E01010292,1307,27,19,12,0,1365
E01010293,1242,13,7,8,1,1271
E01010294,1149,17,14,12,3,1195
E01010295,1125,16,14,11,1,1167
E01010296,1144,6,31,13,0,1194
E01010297,1167,6,49,7,0,1229
E01010298,934,15,6,7,1,963
E01010299,1148,13,13,10,0,1184
E01010300,1146,6,8,16,3,1179
E01010301,1149,7,8,11,6,1181
E01010302,1191,11,12,13,0,1227
E01010303,1239,11,20,5,1,1276
E01010304,1382,16,24,11,0,1433
E01010305,1086,11,11,2,1,1111
E01010306,1440,9,81,26,11,1567
E01010307,1309,10,7,18,4,1348
E01010308,1014,8,22,12,0,1056
E01010309,1074,54,217,52,6,1403
E01010310,1167,29,80,24,0,1300
E01010311,940,19,290,38,5,1292
E01010312,1137,25,139,26,2,1329
E01010313,955,13,148,19,3,1138
E01010314,1155,16,49,34,7,1261
E01010315,959,6,41,31,2,1039
E01010316,1079,26,70,46,6,1227
E01010317,1067,17,244,21,32,1381
E01010318,909,94,153,85,23,1264
E01010319,833,18,233,49,22,1155
E01010320,1041,23,19,22,2,1107
E01010321,1170,11,56,25,1,1263
E01010322,1159,22,48,14,2,1245
E01010323,1152,16,31,12,2,1213
E01010324,1169,31,64,19,6,1289
E01010325,1056,40,194,48,14,1352
E01010326,774,19,498,18,19,1328
E01010327,674,31,423,52,22,1202
E01010328,669,12,465,16,52,1214
E01010329,1083,16,188,14,42,1343
E01010330,772,30,302,39,14,1157
E01010331,859,10,471,13,51,1404
E01010332,700,14,663,30,102,1509
E01010333,898,14,416,10,20,1358
E01010334,785,11,430,19,46,1291
E01010335,863,39,260,58,8,1228
E01010336,495,21,609,44,49,1218
E01010337,764,13,304,33,11,1125
E01010338,658,30,615,41,26,1370
E01010339,733,12,389,20,25,1179
E01010340,240,38,890,72,16,1256
E01010341,147,35,938,43,20,1183
E01010342,396,31,648,59,13,1147
E01010343,251,29,746,30,26,1082
E01010344,607,22,498,54,18,1199
E01010345,926,5,11,7,0,949
E01010346,1072,8,16,10,2,1108
E01010347,1155,13,14,5,2,1189
E01010348,1141,3,11,3,2,1160
E01010349,1049,8,21,3,0,1081
E01010350,1134,5,11,3,0,1153
E01010351,1415,15,13,4,1,1448
E01010352,1350,12,19,8,3,1392
E01010353,1190,17,23,8,0,1238
E01010354,1241,23,13,7,1,1285
E01010355,1175,3,21,17,0,1216
E01010356,1203,4,40,6,20,1273
E01010357,1314,20,143,53,9,1539
E01010358,1161,6,41,15,0,1223
E01010359,1181,21,24,22,0,1248
E01010360,1118,16,70,36,3,1243
E01010361,742,41,369,55,9,1216
E01010362,771,27,415,48,24,1285
E01010363,779,56,499,70,18,1422
E01010364,435,41,525,55,28,1084
E01010365,391,71,572,75,12,1121
E01010366,690,48,487,77,19,1321
E01010367,621,37,540,57,31,1286
E01010368,1047,96,298,90,8,1539
E01010369,980,92,334,92,31,1529
E01010370,843,88,373,110,19,1433
E01010371,607,106,819,157,9,1698
E01010372,626,28,461,98,33,1246
E01010373,1025,35,461,75,22,1618
E01010374,807,32,331,103,13,1286
E01010375,649,58,614,155,18,1494
E01010376,965,12,115,38,25,1155
E01010377,1139,5,59,13,4,1220
E01010378,858,7,124,14,15,1018
E01010379,1096,7,23,5,2,1133
E01010380,1267,9,66,14,0,1356
E01010381,1076,33,69,25,9,1212
E01010382,1207,24,47,7,12,1297
E01010383,1037,43,47,26,2,1155
E01010384,1116,11,60,14,11,1212
E01010385,1152,11,139,9,10,1321
E01010386,1290,7,68,5,0,1370
E01010387,1218,11,71,9,8,1317
E01010388,1088,14,115,12,6,1235
E01010389,1018,16,185,22,12,1253
E01010390,1291,20,113,16,7,1447
E01010391,1417,21,155,20,4,1617
E01010392,1218,13,69,15,4,1319
E01010393,1089,14,85,28,26,1242
E01010394,943,10,165,17,15,1150
E01010395,941,14,150,22,8,1135
E01010396,1261,15,17,3,3,1299
E01010397,1178,17,48,13,4,1260
E01010398,1214,13,89,19,24,1359
E01010399,1182,17,58,16,1,1274
E01010400,1455,50,19,23,1,1548
E01010401,1029,40,52,28,4,1153
E01010402,1012,20,253,31,14,1330
E01010403,940,49,231,47,37,1304
E01010404,1136,48,180,38,8,1410
E01010405,1027,15,254,35,23,1354
E01010406,1329,95,435,58,53,1970
E01010407,1147,27,106,25,15,1320
E01010408,1026,46,81,25,5,1183
E01010409,946,30,227,43,35,1281
E01010410,1222,24,50,34,1,1331
E01010411,1082,41,109,21,2,1255
E01010412,1362,32,108,60,8,1570
E01010413,1249,11,22,39,1,1322
E01010414,1186,91,191,97,13,1578
E01010415,862,56,152,132,17,1219
E01010416,969,25,222,53,28,1297
E01010417,1059,83,94,83,6,1325
E01010418,945,22,249,17,17,1250
E01010419,916,26,125,51,10,1128
E01010420,646,47,233,76,14,1016
E01010421,904,68,145,97,8,1222
E01010422,1031,45,281,52,3,1412
E01010423,971,53,127,54,10,1215
E01010424,996,28,216,28,31,1299
E01010425,767,30,201,55,33,1086
E01010426,492,37,560,117,86,1292
E01010427,474,21,749,75,87,1406
E01010428,207,31,740,87,64,1129
E01010429,211,39,564,107,91,1012
E01010430,518,64,524,163,65,1334
E01010431,272,12,865,75,110,1334
E01010432,298,22,829,31,129,1309
E01010433,261,37,470,109,66,943
E01010434,1056,53,64,175,3,1351
E01010435,719,59,139,131,4,1052
E01010436,1169,13,58,27,3,1270
E01010437,1003,9,5,25,1,1043
E01010438,1063,22,63,40,3,1191
E01010439,1024,26,7,40,1,1098
E01010440,1181,46,8,35,2,1272
E01010441,947,42,33,61,4,1087
E01010442,642,43,244,118,4,1051
E01010443,903,77,61,152,20,1213
E01010444,816,43,193,70,9,1131
E01010445,710,69,82,135,7,1003
E01010446,1031,47,145,96,25,1344
E01010447,1243,70,78,109,5,1505
E01010448,1004,71,80,93,9,1257
E01010449,764,91,617,249,66,1787
E01010450,954,67,239,122,7,1389
E01010451,611,40,487,91,29,1258
E01010452,751,53,234,165,24,1227
E01010453,729,72,348,189,64,1402
E01010454,602,65,427,114,34,1242
E01010455,755,140,285,230,16,1426
E01010456,801,62,25,74,2,964
E01010457,1146,22,69,37,3,1277
E01010458,1271,38,53,39,17,1418
E01010459,1128,35,114,56,8,1341
E01010460,1018,28,140,116,17,1319
E01010461,1054,27,167,38,7,1293
E01010462,1097,55,8,48,1,1209
E01010463,591,60,506,124,42,1323
E01010464,750,111,242,236,22,1361
E01010465,530,54,502,108,37,1231
E01010466,381,76,514,133,28,1132
E01010467,830,47,355,100,30,1362
E01010468,843,33,267,52,11,1206
E01010469,924,22,181,42,4,1173
E01010470,532,44,400,118,26,1120
E01010471,702,123,282,181,70,1358
E01010472,652,95,354,320,46,1467
E01010473,724,176,216,594,117,1827
E01010474,1059,39,152,40,16,1306
E01010475,1015,32,225,41,19,1332
E01010476,1042,61,187,149,21,1460
E01010477,868,77,148,183,30,1306
E01010478,516,53,288,166,7,1030
E01010479,885,32,195,124,8,1244
E01010480,534,57,187,158,10,946
E01010481,960,42,42,114,6,1164
E01010482,866,49,20,54,1,990
E01010483,866,57,16,57,0,996
E01010484,858,50,17,91,6,1022
E01010485,732,86,126,219,7,1170
E01010486,865,102,52,165,3,1187
E01010487,1002,14,149,34,8,1207
E01010488,928,24,178,48,20,1198
E01010489,1068,46,105,55,5,1279
E01010490,1188,58,91,60,8,1405
E01010491,1030,33,91,24,2,1180
E01010492,918,13,139,26,6,1102
E01010493,984,28,155,33,13,1213
E01010494,1078,16,137,28,11,1270
E01010495,1225,45,39,57,0,1366
E01010496,907,56,80,106,1,1150
E01010497,789,21,173,25,9,1017
E01010498,1109,27,48,42,4,1230
E01010499,887,28,112,83,5,1115
E01010500,757,49,95,89,13,1003
E01010501,964,41,63,65,10,1143
E01010502,757,23,215,79,12,1086
E01010503,791,49,126,93,13,1072
E01010504,879,15,271,41,18,1224
E01010505,749,14,283,24,20,1090
E01010506,882,94,319,135,32,1462
E01010507,998,30,224,13,18,1283
E01010508,718,66,316,97,49,1246
E01010509,1082,46,54,35,17,1234
E01010510,942,52,278,74,25,1371
E01010511,530,62,478,151,71,1292
E01010512,716,53,333,96,24,1222
E01010513,1027,23,218,17,24,1309
E01010514,965,34,234,37,25,1295
E01010515,1059,28,194,34,13,1328
E01010516,820,28,263,29,26,1166
E01010517,935,22,220,80,26,1283
E01010518,868,27,375,29,49,1348
E01010519,739,33,472,64,38,1346
E01010520,871,22,402,37,57,1389
E01010521,1162,188,440,409,78,2277
E01010522,475,97,414,198,71,1255
E01010523,699,62,342,126,44,1273
E01010524,490,57,313,254,41,1155
E01010525,400,41,402,139,55,1037
E01010526,284,44,544,115,85,1072
E01010527,465,95,569,230,107,1466
E01010528,931,94,403,216,54,1698
E01010529,486,67,605,171,49,1378
E01010530,491,92,328,126,18,1055
E01010531,1164,49,131,40,8,1392
E01010532,1151,47,73,62,3,1336
E01010533,851,43,309,108,16,1327
E01010534,386,12,708,56,85,1247
E01010535,884,55,162,64,20,1185
E01010536,1027,12,297,21,26,1383
E01010537,1113,5,131,9,3,1261
E01010538,1116,31,92,31,7,1277
E01010539,1004,30,165,56,7,1262
E01010540,1055,20,135,19,14,1243
E01010541,879,64,67,103,7,1120
E01010542,1010,32,102,56,6,1206
E01010543,789,78,67,117,10,1061
E01010544,946,12,207,44,51,1260
E01010545,1071,25,142,63,8,1309
E01010546,957,8,295,12,18,1290
E01010547,1183,9,150,11,7,1360
E01010548,1084,20,103,28,6,1241
E01010549,1048,23,136,32,10,1249
E01010550,1119,12,201,10,14,1356
E01010551,1231,19,135,28,10,1423
E01010552,1339,24,107,36,13,1519
E01010553,1012,28,233,20,24,1317
E01010554,1163,15,25,3,6,1212
E01010555,1145,29,17,43,3,1237
E01010556,1149,19,4,10,6,1188
E01010557,1201,12,29,9,4,1255
E01010558,1177,13,182,43,27,1442
E01010559,1144,17,3,20,6,1190
E01010560,1320,19,15,25,0,1379
E01010561,1112,17,151,19,12,1311
E01010562,1051,28,142,62,14,1297
E01010563,1064,68,27,36,1,1196
E01010564,876,58,468,81,44,1527
E01010565,1216,18,254,21,35,1544
E01010566,1239,20,93,43,17,1412
E01010567,1106,53,32,20,15,1226
E01010568,1411,15,34,6,9,1475
E01010569,1375,19,14,3,7,1418
E01010570,1108,9,53,2,0,1172
E01010571,1305,23,14,8,18,1368
E01010572,1204,10,11,6,3,1234
E01010573,1407,13,19,8,8,1455
E01010574,1154,13,44,2,4,1217
E01010575,1333,11,15,3,5,1367
E01010576,1268,9,20,1,1,1299
E01010577,1266,13,12,3,5,1299
E01010578,1250,16,20,15,5,1306
E01010579,1264,9,20,12,3,1308
E01010580,1865,25,58,15,3,1966
E01010581,1253,17,22,20,3,1315
E01010582,1274,15,20,9,6,1324
E01010583,1227,24,25,13,28,1317
E01010584,1399,25,37,5,12,1478
E01010585,1479,16,28,19,64,1606
E01010586,1326,8,5,1,4,1344
E01010587,1415,13,74,4,16,1522
E01010588,1235,15,84,7,14,1355
E01010589,1239,5,17,1,0,1262
E01010590,1408,19,34,3,3,1467
E01010591,1144,18,56,7,8,1233
E01010592,1186,22,19,9,2,1238
E01010593,1382,16,15,5,1,1419
E01010594,1328,24,21,5,3,1381
E01010595,1356,15,33,20,4,1428
E01010596,1162,14,47,5,4,1232
E01010597,882,35,171,28,43,1159
E01010598,1090,33,258,18,22,1421
E01010599,572,27,380,26,58,1063
E01010600,496,11,459,30,71,1067
E01010601,1222,18,98,15,1,1354
E01010602,900,25,263,18,23,1229
E01010603,1146,26,100,23,8,1303
E01010604,1335,16,106,19,25,1501
E01010605,1065,33,55,35,6,1194
E01010606,274,26,973,31,44,1348
E01010607,177,31,1043,32,73,1356
E01010608,126,31,936,32,40,1165
E01010609,998,30,141,23,17,1209
E01010610,993,34,71,26,23,1147
E01010611,1099,44,400,58,30,1631
E01010612,858,29,24,47,4,962
E01010613,809,21,248,34,27,1139
E01010614,878,29,137,28,6,1078
E01010615,894,36,117,17,31,1095
E01010616,651,38,495,98,27,1309
E01010617,461,35,433,63,42,1034
E01010618,387,17,719,16,19,1158
E01010619,159,18,1342,22,16,1557
E01010620,251,25,926,25,23,1250
E01010621,66,5,1373,8,20,1472
E01010622,194,25,1313,16,33,1581
E01010623,333,22,762,18,52,1187
E01010624,107,33,1296,23,35,1494
E01010625,507,45,614,5,9,1180
E01010626,303,19,965,20,10,1317
E01010627,473,14,615,30,29,1161
E01010628,957,24,316,31,22,1350
E01010629,549,33,696,32,53,1363
E01010630,798,21,296,13,16,1144
E01010631,741,30,243,55,13,1082
E01010632,659,33,206,24,9,931
E01010633,930,23,268,14,27,1262
E01010634,1182,11,24,7,3,1227
E01010635,959,26,115,13,11,1124
E01010636,1267,21,109,15,18,1430
E01010637,898,19,297,10,7,1231
E01010638,1293,2,4,2,1,1302
E01010639,1435,11,5,1,9,1461
E01010640,1349,3,22,4,9,1387
E01010641,1278,3,13,3,3,1300
E01010642,1501,7,3,2,5,1518
E01010643,1172,2,24,4,0,1202
E01010644,1200,5,80,9,6,1300
E01010645,1063,8,26,9,3,1109
E01010646,1100,5,6,1,0,1112
E01010647,886,8,2,1,1,898
E01010648,1110,4,3,0,2,1119
E01010649,1047,13,28,14,0,1102
E01010650,978,27,43,49,6,1103
E01010651,1094,18,102,6,2,1222
E01010652,1280,13,21,20,6,1340
E01010653,1087,27,36,24,17,1191
E01010654,983,25,21,13,3,1045
E01010655,930,27,23,17,8,1005
E01010656,1096,18,91,16,5,1226
E01010657,1162,33,37,5,6,1243
E01010658,468,39,751,44,81,1383
E01010659,632,39,578,12,10,1271
E01010662,625,23,396,18,8,1070
E01010663,618,52,470,51,23,1214
E01010664,603,18,518,9,19,1167
E01010665,623,36,532,18,23,1232
E01010666,872,39,252,19,11,1193
E01010667,675,42,366,53,25,1161
E01010668,789,15,255,22,5,1086
E01010669,568,32,680,37,31,1348
E01010670,569,31,656,13,13,1282
E01010671,353,20,797,12,22,1204
E01010672,911,21,96,15,2,1045
E01010673,290,27,899,8,20,1244
E01010674,478,22,511,21,37,1069
E01010675,689,39,792,26,18,1564
E01010676,146,25,1422,12,6,1611
E01010677,543,41,686,26,35,1331
E01010678,856,14,208,14,7,1099
E01010679,307,22,873,36,61,1299
E01010680,1303,36,49,23,29,1440
E01010681,987,11,113,13,6,1130
E01010682,1114,18,37,35,8,1212
E01010683,1296,16,25,11,0,1348
E01010684,1228,24,18,8,3,1281
E01010685,1344,11,11,5,7,1378
E01010686,1312,15,15,10,1,1353
E01010687,1423,15,23,7,7,1475
E01010688,1442,17,54,20,9,1542
E01010689,1310,24,48,9,0,1391
E01010690,1426,26,80,19,6,1557
E01010691,1225,10,10,1,1,1247
E01010692,1527,7,14,1,1,1550
E01010693,1214,10,21,5,0,1250
E01010694,1281,10,9,0,1,1301
E01010695,1320,15,22,7,7,1371
E01010696,1204,8,13,1,1,1227
E01010697,1212,11,13,2,4,1242
E01010698,1446,12,18,3,7,1486
E01010699,1357,11,15,4,2,1389
E01010700,371,16,656,7,2,1052
E01010701,201,7,748,3,5,964
E01010702,247,9,1150,4,16,1426
E01010703,1077,17,164,13,4,1275
E01010704,1088,12,59,4,1,1164
E01010705,1321,10,49,2,1,1383
E01010706,1304,10,33,3,2,1352
E01010707,1341,10,84,6,12,1453
E01010708,1029,14,243,5,3,1294
E01010709,1878,15,167,6,11,2077
E01010710,781,29,700,29,49,1588
E01010711,869,17,238,18,40,1182
E01010712,422,17,657,15,4,1115
E01010713,1016,10,20,9,2,1057
E01010714,1001,9,74,7,1,1092
E01010715,846,6,29,1,3,885
E01010716,1402,15,45,27,2,1491
E01010717,1163,16,40,4,0,1223
E01010718,1161,14,27,19,4,1225
E01010719,446,11,712,5,0,1174
E01010720,990,6,136,11,4,1147
E01010721,1044,12,59,8,0,1123
E01010722,1098,17,48,7,5,1175
E01010723,357,8,619,13,40,1037
E01010724,963,16,118,3,9,1109
E01010725,1142,5,76,8,2,1233
E01010726,1250,10,19,3,2,1284
E01010727,1301,18,144,10,2,1475
E01010728,567,17,671,25,22,1302
E01010729,859,5,362,0,4,1230
E01010730,625,85,297,159,92,1258
E01010731,493,51,539,181,132,1396
E01010732,388,64,711,155,124,1442
E01010733,449,70,655,109,95,1378
E01010734,693,25,299,25,17,1059
E01010735,463,55,457,86,30,1091
E01010736,601,38,581,114,71,1405
E01010737,259,21,744,75,68,1167
E01010738,316,27,858,73,23,1297
E01010739,596,53,447,55,13,1164
E01010740,260,19,916,33,46,1274
E01010741,1103,37,76,8,1,1225
E01010742,347,40,801,75,42,1305
E01010743,456,47,604,116,70,1293
E01010744,239,23,845,47,26,1180
E01010745,678,38,398,50,13,1177
E01010746,1151,21,197,5,2,1376
E01010747,815,44,324,41,18,1242
E01010748,1084,30,26,42,4,1186
E01010749,1013,26,28,12,6,1085
E01010750,1249,13,53,18,5,1338
E01010751,1208,16,28,15,6,1273
E01010752,1315,21,85,11,1,1433
E01010753,1204,14,11,2,1,1232
E01010754,1209,17,22,6,0,1254
E01010755,1063,38,40,32,5,1178
E01010756,1127,18,41,4,2,1192
E01010758,994,6,24,7,5,1036
E01010759,1191,20,22,8,11,1252
E01010760,1250,6,4,3,2,1265
E01010761,975,26,259,14,20,1294
E01010762,872,41,245,18,17,1193
E01010763,1117,12,130,11,3,1273
E01010764,1335,7,20,2,10,1374
E01010765,1851,20,18,3,5,1897
E01010766,1041,6,13,0,1,1061
E01010767,1128,6,7,1,0,1142
E01010768,1253,10,5,5,0,1273
E01010769,1261,14,12,2,0,1289
E01010770,1264,14,9,2,0,1289
E01010771,984,3,4,1,7,999
E01010772,1030,2,3,2,0,1037
E01010773,1113,9,17,3,1,1143
E01010774,1311,8,9,0,5,1333
E01010775,1233,17,170,29,12,1461
E01010776,1192,25,52,12,2,1283
E01010777,1054,30,48,14,17,1163
E01010778,1197,31,119,34,34,1415
E01010779,1068,18,26,16,15,1143
E01010781,1044,24,34,6,11,1119
E01010782,1345,35,39,17,4,1440
E01010783,1172,10,54,6,17,1259
E01010784,1241,29,44,2,2,1318
E01010785,1218,28,78,10,1,1335
E01010786,995,22,196,18,8,1239
E01010787,1149,24,117,24,6,1320
E01010788,1000,36,131,8,9,1184
E01010789,901,29,402,18,13,1363
E01010790,1049,19,129,6,16,1219
E01010791,614,19,642,18,3,1296
E01010792,427,35,849,20,21,1352
E01010793,473,31,799,41,38,1382
E01010794,1154,35,225,27,21,1462
E01010795,1364,21,37,11,7,1440
E01010796,1236,18,36,3,8,1301
E01010797,1100,8,27,2,11,1148
E01010798,1208,23,30,6,4,1271
E01010799,966,18,185,16,5,1190
E01010800,901,37,161,70,25,1194
E01010801,687,33,567,17,13,1317
E01010802,923,46,154,35,15,1173
E01010803,273,30,909,19,27,1258
E01010804,123,10,1527,19,36,1715
E01010805,493,22,647,13,13,1188
E01010806,334,9,760,25,9,1137
E01010807,338,27,1115,36,74,1590
E01010808,102,19,1294,13,28,1456
E01010809,115,18,1415,12,18,1578
E01010810,322,27,962,38,15,1364
E01010811,132,20,1200,28,28,1408
E01010812,367,28,828,71,68,1362
E01010813,239,10,862,41,26,1178
E01010814,1257,33,31,21,6,1348
E01010815,1382,55,222,72,42,1773
E01010816,1330,27,58,36,16,1467
E01010817,1363,37,96,78,32,1606
E01010818,1119,26,213,30,35,1423
E01010819,1007,28,38,61,6,1140
E01010820,982,22,14,55,2,1075
E01010821,1233,50,49,77,5,1414
E01010822,976,13,36,41,7,1073
E01010824,597,42,536,82,79,1336
E01010825,889,22,106,16,15,1048
E01010826,730,18,228,25,13,1014
E01010827,792,15,177,11,9,1004
E01010828,1041,31,181,28,8,1289
E01010829,643,32,478,32,18,1203
E01010830,681,40,501,23,21,1266
E01010831,368,29,845,35,25,1302
E01010832,439,17,720,6,8,1190
E01010833,285,33,754,71,69,1212
E01010834,1354,91,1513,412,103,3473
E01010835,244,20,1821,68,83,2236
E01010836,397,29,1237,145,48,1856
E01010837,96,24,1347,11,55,1533
E01010838,176,27,998,52,17,1270
E01010839,315,17,750,40,39,1161
E01010840,241,24,904,39,17,1225
E01010841,125,26,1065,35,40,1291
E01010842,194,55,945,72,61,1327
E01010843,64,7,1244,34,20,1369
E01010845,1343,47,56,51,10,1507
E01010846,1416,38,143,38,17,1652
E01010847,1090,23,97,13,3,1226
E01010848,1023,26,161,17,1,1228
E01010849,1146,14,17,4,3,1184
E01010850,907,25,18,26,2,978
E01010851,1172,23,61,16,6,1278
E01010852,855,22,262,43,5,1187
E01010853,817,26,145,25,25,1038
E01010854,1391,14,30,7,4,1446
E01010855,1405,13,15,2,8,1443
E01010856,1299,10,13,7,4,1333
E01010857,1344,8,15,6,5,1378
E01010858,1267,5,8,3,2,1285
E01010859,1352,21,9,3,2,1387
E01010860,1274,5,9,4,6,1298
E01010861,1444,10,17,5,1,1477
E01010862,1362,7,3,4,0,1376
E01010863,1183,9,20,4,3,1219
E01010864,897,29,25,13,3,967
E01010865,1268,18,26,6,2,1320
E01010866,1033,32,42,11,3,1121
E01010867,983,21,52,23,2,1081
E01010868,1127,43,44,33,9,1256
E01010869,1291,26,26,16,11,1370
E01010870,1236,18,18,8,5,1285
E01010871,1273,19,49,11,17,1369
E01010872,1154,22,30,26,2,1234
E01010873,998,9,22,7,0,1036
E01010874,934,16,12,11,1,974
E01010875,1415,6,15,1,3,1440
E01010876,1299,9,17,3,2,1330
E01010877,1262,8,33,6,1,1310
E01010878,1409,17,22,12,2,1462
E01010879,1530,7,11,4,3,1555
E01010880,1152,14,12,10,0,1188
E01010881,1275,20,3,5,2,1305
E01010882,1133,12,11,3,2,1161
E01010883,1230,6,2,4,0,1242
E01010884,1325,4,10,1,1,1341
E01010885,1184,4,4,1,2,1195
E01010886,912,7,1,2,0,922
E01010887,1299,8,13,1,4,1325
E01010888,1227,32,14,4,3,1280
E01010889,1361,24,39,10,1,1435
E01010890,1381,20,64,6,1,1472
E01010891,1331,26,13,11,8,1389
E01010892,1411,12,36,8,2,1469
E01010893,1097,13,42,3,0,1155
E01010894,1110,23,121,13,0,1267
E01010895,1131,7,18,6,1,1163
E01010896,1297,13,0,0,2,1312
E01010897,1347,10,16,9,2,1384
E01010898,1324,11,11,7,1,1354
E01010899,1090,11,11,1,0,1113
E01010900,1305,5,12,0,1,1323
E01010901,1299,9,56,4,1,1369
E01010902,1186,15,7,7,2,1217
E01010903,1311,9,26,3,3,1352
E01010904,1147,6,3,3,1,1160
E01010905,1477,8,2,3,1,1491
E01010906,1141,4,17,2,1,1165
E01010907,1150,7,19,3,5,1184
E01010908,1662,11,22,12,3,1710
E01010909,1216,13,22,2,1,1254
E01010910,1004,12,7,5,2,1030
E01010911,1385,9,7,2,0,1403
E01010912,1198,10,2,2,2,1214
E01010913,1101,9,2,2,0,1114
E01010914,1386,13,11,4,0,1414
E01010915,1155,7,3,6,0,1171
E01010916,1052,12,10,4,1,1079
E01010917,1488,11,17,1,0,1517
E01010918,1338,10,7,4,3,1362
E01010919,1290,10,5,4,1,1310
E01010920,1347,7,18,2,4,1378
E01010921,1253,14,13,8,0,1288
E01010922,1510,3,10,9,0,1532
E01010923,1236,27,8,8,7,1286
E01010924,923,25,12,15,1,976
E01010925,1065,12,9,2,0,1088
E01010926,792,7,2,5,1,807
E01010927,1355,8,11,3,2,1379
E01010928,1016,17,31,10,1,1075
E01010929,1178,24,418,21,10,1651
E01010930,1122,19,67,4,2,1214
E01010931,1152,7,17,3,2,1181
E01010932,1291,8,28,0,2,1329
E01010933,1288,8,24,0,0,1320
E01010934,1635,7,8,3,8,1661
E01010935,1295,7,18,2,0,1322
E01010936,1517,9,22,4,1,1553
E01010937,1246,12,11,2,1,1272
E01010938,992,22,17,17,2,1050
E01010939,1387,9,14,5,4,1419
E01010940,1138,17,10,9,0,1174
E01010941,998,16,5,2,1,1022
E01010942,1232,30,13,6,4,1285
E01010943,1081,21,5,8,0,1115
E01010944,997,16,26,6,2,1047
E01010945,1286,5,19,6,1,1317
E01010946,1109,9,30,8,1,1157
E01010947,1188,5,21,7,0,1221
E01010948,1207,7,16,5,1,1236
E01010949,1228,12,27,3,7,1277
E01010950,1144,20,4,9,1,1178
E01010951,1207,12,18,6,4,1247
E01010952,1279,3,6,0,0,1288
E01010953,1140,5,10,3,1,1159
E01010954,1769,18,18,2,1,1808
E01010955,1137,12,50,1,6,1206
E01010956,1300,5,3,1,0,1309
E01010957,1240,4,3,1,0,1248
E01010958,1160,7,9,3,2,1181
E01010959,1391,15,5,1,0,1412
E01010960,392,9,717,17,17,1152
E01010961,913,5,13,5,0,936
E01010964,380,16,715,26,16,1153
E01010965,292,20,757,17,12,1098
E01010966,188,22,902,20,18,1150
E01010967,1189,16,13,5,4,1227
E01010968,1364,19,125,4,9,1521
E01010969,1243,17,123,6,0,1389
E01010970,1334,11,188,7,7,1547
E01010971,1374,20,89,8,6,1497
E01010972,1138,4,117,12,14,1285
E01010973,1325,14,50,5,7,1401
E01010974,754,21,398,1,5,1179
E01010975,1300,7,17,3,1,1328
E01010976,1460,17,22,2,1,1502
E01010977,1265,7,12,2,0,1286
E01010978,1006,15,19,4,1,1045
E01010979,1254,11,27,1,6,1299
E01010980,1186,7,20,3,0,1216
E01010981,1170,11,12,3,2,1198
E01010982,1032,12,58,5,1,1108
E01010983,1150,25,170,2,2,1349
E01010984,984,6,43,0,0,1033
E01010985,1145,5,9,4,0,1163
E01010986,1288,16,14,5,3,1326
E01010987,1401,17,15,5,1,1439
E01010988,1187,6,17,2,2,1214
E01010989,1185,9,77,5,2,1278
E01010990,1298,10,7,0,6,1321
E01010991,1252,11,12,5,0,1280
E01010992,1300,19,28,6,2,1355
E01010993,1279,7,25,5,2,1318
E01010994,1297,32,206,25,14,1574
E01010995,265,28,670,2,11,976
E01010996,205,22,834,14,6,1081
E01010997,1161,2,79,5,0,1247
E01010998,1050,9,196,6,1,1262
E01010999,1153,15,87,3,0,1258
E01011000,510,16,820,9,8,1363
E01011001,252,7,854,11,4,1128
E01011002,768,20,477,4,8,1277
E01011003,575,10,332,10,3,930
E01011004,984,37,45,40,16,1122
E01011005,1198,11,53,33,6,1301
E01011006,1139,29,69,38,4,1279
E01011007,1071,39,82,59,7,1258
E01011008,1098,24,74,49,5,1250
E01011009,1038,23,26,23,6,1116
E01011010,999,33,71,76,9,1188
E01011011,1281,8,25,7,3,1324
E01011012,1121,34,75,34,66,1330
E01011013,1125,5,140,2,2,1274
E01011014,712,9,445,10,4,1180
E01011015,342,7,836,2,5,1192
E01011016,469,17,720,2,5,1213
E01011017,108,8,1126,1,1,1244
E01011018,247,5,808,1,3,1064
E01011019,545,9,793,1,2,1350
E01011020,282,5,648,3,4,942
E01011021,1280,6,65,3,3,1357
E01011022,1060,6,126,9,0,1201
E01011023,830,16,419,6,3,1274
E01011024,892,5,384,5,5,1291
E01011025,942,22,162,6,4,1136
E01011026,532,9,613,6,5,1165
E01011027,926,16,37,1,0,980
E01011028,1104,11,61,3,2,1181
E01011029,829,7,254,8,8,1106
E01011030,992,17,63,3,11,1086
E01011031,1197,20,141,5,5,1368
E01011032,715,3,388,6,2,1114
E01011033,1086,14,223,6,1,1330
E01011034,263,11,865,2,1,1142
E01011035,256,8,900,9,6,1179
E01011036,605,14,537,5,9,1170
E01011037,1051,24,438,13,4,1530
E01011038,618,50,341,188,42,1239
E01011039,717,33,601,84,22,1457
E01011040,693,45,585,84,15,1422
E01011041,649,85,304,149,25,1212
E01011042,864,31,332,29,23,1279
E01011043,843,56,809,118,26,1852
E01011044,540,17,514,68,26,1165
E01011045,428,62,755,154,37,1436
E01011046,929,10,157,16,5,1117
E01011047,1183,10,96,21,12,1322
E01011048,1397,20,18,9,5,1449
E01011049,1273,8,17,9,2,1309
E01011050,1231,8,14,3,0,1256
E01011051,1257,9,13,7,8,1294
E01011052,1266,8,11,5,6,1296
E01011053,1204,9,11,6,0,1230
E01011054,1126,10,60,2,3,1201
E01011055,967,9,53,1,6,1036
E01011056,1291,11,29,9,4,1344
E01011057,1078,13,22,12,4,1129
E01011058,975,6,8,8,1,998
E01011059,1029,16,21,2,2,1070
E01011060,1325,11,44,13,4,1397
E01011061,1330,10,67,11,3,1421
E01011062,1313,14,32,2,0,1361
E01011063,1582,5,71,13,2,1673
E01011064,1153,9,22,3,0,1187
E01011065,1278,9,15,4,5,1311
E01011066,1195,8,38,6,2,1249
E01011067,1272,6,27,3,0,1308
E01011068,1343,5,16,6,0,1370
E01011069,1108,4,14,6,0,1132
E01011070,1252,10,10,6,0,1278
E01011071,1343,13,14,4,2,1376
E01011072,1262,12,13,4,3,1294
E01011073,1157,17,15,16,3,1208
E01011074,1531,6,7,4,2,1550
E01011075,1184,3,9,5,0,1201
E01011076,1171,10,7,14,1,1203
E01011077,1269,21,12,14,7,1323
E01011078,1370,14,17,8,0,1409
E01011079,1041,47,342,59,12,1501
E01011080,726,42,572,60,39,1439
E01011081,782,39,468,74,37,1400
E01011082,80,9,1081,62,37,1269
E01011083,1068,29,253,34,10,1394
E01011084,650,65,342,142,29,1228
E01011085,989,36,181,59,6,1271
E01011086,1222,12,139,10,5,1388
E01011087,1243,34,26,20,5,1328
E01011088,1179,2,23,11,0,1215
E01011089,1017,21,11,15,6,1070
E01011090,1116,43,59,38,7,1263
E01011091,1108,15,19,12,0,1154
E01011092,1073,18,8,2,0,1101
E01011093,853,48,80,95,33,1109
E01011094,830,55,86,178,14,1163
E01011095,1097,17,39,28,3,1184
E01011096,905,35,233,72,8,1253
E01011097,1094,27,104,53,11,1289
E01011098,1020,45,122,62,22,1271
E01011099,1066,31,36,55,11,1199
E01011100,865,93,116,127,17,1218
E01011101,748,117,59,286,17,1227
E01011102,900,32,130,41,11,1114
E01011103,722,65,52,218,15,1072
E01011104,848,86,125,201,14,1274
E01011105,939,109,163,183,35,1429
E01011106,800,56,82,161,16,1115
E01011107,811,76,329,154,86,1456
E01011108,952,31,181,55,16,1235
E01011109,1416,1,5,0,1,1423
E01011110,1099,2,7,7,1,1116
E01011111,1312,10,10,1,0,1333
E01011112,1266,6,10,4,2,1288
E01011113,1411,7,1,1,2,1422
E01011114,1256,9,12,1,0,1278
E01011115,1450,7,3,2,0,1462
E01011116,1355,7,15,2,0,1379
E01011117,1413,4,15,1,0,1433
E01011118,1226,8,6,3,1,1244
E01011119,1224,5,10,1,0,1240
E01011120,1205,11,10,1,3,1230
E01011121,1112,12,9,7,2,1142
E01011122,957,10,1,3,0,971
E01011123,1078,20,208,16,1,1323
E01011124,1474,15,22,0,2,1513
E01011125,1161,16,55,8,0,1240
E01011126,1253,12,27,4,1,1297
E01011127,1099,6,38,2,2,1147
E01011128,698,13,774,4,4,1493
E01011129,982,21,47,4,1,1055
E01011130,1156,25,444,10,7,1642
E01011132,1106,15,48,2,1,1172
E01011133,471,14,494,6,7,992
E01011134,394,33,810,5,7,1249
E01011136,815,16,246,13,2,1092
E01011137,1010,17,119,6,13,1165
E01011138,618,35,500,16,15,1184
E01011139,653,13,386,8,2,1062
E01011140,445,16,558,5,2,1026
E01011141,557,17,668,7,0,1249
E01011142,1285,13,15,2,2,1317
E01011143,351,24,686,5,18,1084
E01011144,346,15,647,18,10,1036
E01011145,1193,11,16,10,10,1240
E01011146,1258,11,12,9,0,1290
E01011147,1203,23,12,12,3,1253
E01011148,1207,40,27,40,6,1320
E01011149,1365,47,74,44,4,1534
E01011150,1262,19,22,14,5,1322
E01011151,1281,11,10,1,4,1307
E01011152,1378,8,12,10,3,1411
E01011153,1285,23,61,39,1,1409
E01011154,1075,34,39,30,9,1187
E01011155,1482,21,25,13,1,1542
E01011156,1216,14,29,4,2,1265
E01011157,681,10,542,6,4,1243
E01011158,1277,19,142,2,1,1441
E01011159,1393,3,15,3,0,1414
E01011160,1069,9,26,2,0,1106
E01011161,950,9,74,2,1,1036
E01011162,1218,8,19,4,1,1250
E01011163,971,8,77,7,0,1063
E01011164,1265,7,67,6,5,1350
E01011165,683,9,646,5,3,1346
E01011166,922,4,336,10,5,1277
E01011167,913,27,522,9,3,1474
E01011168,1327,5,5,6,0,1343
E01011169,1189,9,6,4,4,1212
E01011170,1447,11,16,2,2,1478
E01011171,1117,12,14,5,3,1151
E01011172,804,14,18,12,1,849
E01011173,1009,8,10,8,1,1036
E01011174,1486,12,15,5,0,1518
E01011175,1074,10,15,1,0,1100
E01011176,1118,14,20,4,0,1156
E01011177,1395,10,21,0,2,1428
E01011178,1493,14,17,3,2,1529
E01011179,1441,4,7,6,0,1458
E01011180,1527,12,13,2,1,1555
E01011181,1452,5,6,3,2,1468
E01011182,1379,11,6,2,0,1398
E01011183,1560,10,5,1,2,1578
E01011184,1111,5,9,7,0,1132
E01011185,1245,5,11,4,0,1265
E01011186,1354,8,7,2,0,1371
E01011187,1329,22,18,9,4,1382
E01011188,1340,12,12,3,1,1368
E01011189,1306,8,10,1,0,1325
E01011190,1332,12,31,3,0,1378
E01011191,1267,11,11,7,1,1297
E01011192,1231,19,10,2,3,1265
E01011193,1467,17,26,9,0,1519
E01011194,1144,3,17,0,4,1168
E01011195,1863,37,96,33,16,2045
E01011196,1429,6,21,4,1,1461
E01011197,1260,20,7,9,1,1297
E01011198,1254,6,5,3,3,1271
E01011199,1174,6,9,3,1,1193
E01011200,1693,31,98,27,6,1855
E01011201,1262,31,106,37,6,1442
E01011202,1148,19,106,15,12,1300
E01011203,1302,8,113,19,9,1451
E01011204,1018,10,179,7,10,1224
E01011205,1258,5,66,12,5,1346
E01011206,1208,34,103,25,0,1370
E01011207,1072,14,79,28,3,1196
E01011208,1124,52,81,41,2,1300
E01011209,1210,10,44,9,2,1275
E01011210,1244,19,225,38,15,1541
E01011211,1160,19,110,32,4,1325
E01011212,1308,20,15,4,0,1347
E01011213,1280,6,15,3,3,1307
E01011214,1222,10,17,1,4,1254
E01011215,1681,21,26,13,2,1743
E01011216,1161,21,19,12,2,1215
E01011217,1362,5,18,1,1,1387
E01011218,1299,7,19,1,6,1332
E01011219,1301,11,18,8,0,1338
E01011220,1293,38,13,15,4,1363
E01011221,1392,14,10,6,3,1425
E01011222,1358,45,61,66,19,1549
E01011223,1236,67,100,116,17,1536
E01011224,1172,56,103,74,19,1424
E01011225,1144,56,154,70,34,1458
E01011226,1132,22,110,24,6,1294
E01011227,1139,55,79,71,9,1353
E01011228,1130,22,85,17,9,1263
E01011229,1925,68,481,119,93,2686
E01011230,289,28,970,42,77,1406
E01011231,1100,34,122,32,7,1295
E01011232,796,36,448,63,23,1366
E01011233,952,37,234,32,14,1269
E01011234,988,56,91,51,7,1193
E01011235,876,59,490,112,55,1592
E01011236,904,45,358,122,74,1503
E01011237,757,28,397,37,9,1228
E01011238,1066,30,242,44,35,1417
E01011239,1046,32,195,43,13,1329
E01011240,1108,34,163,46,20,1371
E01011241,1314,10,26,1,5,1356
E01011242,1232,7,30,7,5,1281
E01011243,1351,14,22,4,3,1394
E01011244,1535,15,25,14,0,1589
E01011245,1184,15,39,6,1,1245
E01011246,1041,6,82,3,1,1133
E01011247,1258,5,25,0,2,1290
E01011248,1195,1,34,5,2,1237
E01011249,1182,10,29,3,1,1225
E01011250,1327,10,40,5,4,1386
E01011251,1183,21,14,13,3,1234
E01011252,981,3,22,2,2,1010
E01011253,974,4,9,6,0,993
E01011254,1275,10,21,3,0,1309
E01011255,1097,12,12,1,0,1122
E01011256,1053,10,23,2,4,1092
E01011257,14,1,1606,3,2,1626
E01011258,48,19,1493,3,10,1573
E01011259,505,4,745,2,3,1259
E01011260,731,7,238,8,8,992
E01011261,293,12,581,2,5,893
E01011262,447,9,629,4,10,1099
E01011263,880,8,350,7,3,1248
E01011264,1077,4,5,0,1,1087
E01011265,1330,12,12,0,4,1358
E01011266,1590,17,45,12,10,1674
E01011267,1156,9,20,5,1,1191
E01011268,1055,7,16,3,4,1085
E01011269,1276,10,14,2,1,1303
E01011270,1272,8,26,4,3,1313
E01011271,1664,9,21,4,16,1714
E01011272,1162,4,10,6,5,1187
E01011273,1218,4,18,5,2,1247
E01011274,1165,13,14,3,1,1196
E01011275,1089,5,9,0,2,1105
E01011276,1090,5,19,2,4,1120
E01011277,1120,7,29,6,0,1162
E01011278,1274,14,30,11,1,1330
E01011279,1070,6,7,2,0,1085
E01011280,1375,9,8,4,6,1402
E01011281,1305,47,100,64,8,1524
E01011282,1041,21,12,7,2,1083
E01011283,890,27,33,37,1,988
E01011284,1333,33,51,20,9,1446
E01011286,942,11,63,18,3,1037
E01011287,1038,11,25,12,0,1086
E01011292,1070,23,193,39,11,1336
E01011293,1015,28,208,62,30,1343
E01011294,1056,40,157,34,5,1292
E01011295,1120,17,19,32,3,1191
E01011296,1415,2,1,4,2,1424
E01011297,1218,9,17,5,5,1254
E01011298,1181,5,11,10,3,1210
E01011299,1742,10,7,9,4,1772
E01011300,1106,7,9,2,1,1125
E01011301,1091,4,1,3,1,1100
E01011302,1260,5,1,4,0,1270
E01011303,907,5,4,4,0,920
E01011304,1229,12,5,5,5,1256
E01011305,1189,13,10,9,1,1222
E01011306,1094,5,4,3,3,1109
E01011307,1206,7,3,1,1,1218
E01011308,1216,4,3,4,2,1229
E01011309,1221,5,11,2,1,1240
E01011310,1291,5,31,10,4,1341
E01011311,866,9,99,2,7,983
E01011312,547,42,400,122,33,1144
E01011313,1049,14,93,35,13,1204
E01011314,982,33,140,14,5,1174
E01011315,1135,21,75,11,8,1250
E01011316,725,39,328,122,30,1244
E01011317,1132,22,48,95,30,1327
E01011318,878,34,45,101,25,1083
E01011319,952,10,232,21,10,1225
E01011320,1119,15,161,35,6,1336
E01011321,962,27,56,92,13,1150
E01011322,1101,26,75,31,7,1240
E01011323,1040,8,10,4,1,1063
E01011324,1714,52,36,60,11,1873
E01011325,1110,11,27,18,7,1173
E01011326,986,11,17,20,6,1040
E01011327,1046,15,21,15,5,1102
E01011328,1151,14,7,13,1,1186
E01011329,1242,14,5,4,4,1269
E01011330,976,11,20,7,1,1015
E01011331,1011,12,7,7,1,1038
E01011332,933,17,20,20,3,993
E01011333,988,14,11,15,3,1031
E01011334,1026,21,13,11,1,1072
E01011335,1304,22,30,12,2,1370
E01011336,1215,11,7,9,3,1245
E01011337,850,13,27,20,7,917
E01011338,615,72,84,372,71,1214
E01011339,1075,51,97,159,3,1385
E01011340,922,43,90,166,9,1230
E01011341,1100,16,26,26,1,1169
E01011342,772,20,41,157,6,996
E01011343,1297,39,28,29,5,1398
E01011344,957,76,133,133,24,1323
E01011345,1029,19,29,8,10,1095
E01011346,1196,30,37,88,8,1359
E01011347,902,60,84,178,10,1234
E01011348,811,44,80,176,17,1128
E01011349,1025,56,118,197,43,1439
E01011350,1075,24,149,81,24,1353
E01011351,1402,35,58,29,11,1535
E01011352,1372,60,84,84,21,1621
E01011353,1289,33,108,104,18,1552
E01011354,765,57,52,176,11,1061
E01011355,888,47,49,68,12,1064
E01011356,898,78,339,286,42,1643
E01011357,606,105,250,428,42,1431
E01011358,726,54,143,215,14,1152
E01011359,687,81,298,288,16,1370
E01011360,236,80,636,484,23,1459
E01011361,345,160,373,936,26,1840
E01011362,1262,38,95,97,11,1503
E01011363,1000,41,54,124,19,1238
E01011364,1000,58,124,81,17,1280
E01011366,877,42,182,111,19,1231
E01011368,715,26,129,106,13,989
E01011369,1190,21,45,11,5,1272
E01011370,983,19,279,88,12,1381
E01011371,945,35,133,68,13,1194
E01011372,394,32,372,111,30,939
E01011373,681,49,164,92,25,1011
E01011374,839,22,52,55,7,975
E01011375,572,35,530,131,8,1276
E01011376,1243,6,15,5,1,1270
E01011377,1146,5,35,4,4,1194
E01011378,946,37,69,20,55,1127
E01011379,1101,21,44,20,36,1222
E01011380,1150,11,78,14,19,1272
E01011381,874,15,133,5,44,1071
E01011382,1166,9,24,11,5,1215
E01011383,1111,20,102,28,57,1318
E01011384,1144,19,31,7,26,1227
E01011385,856,15,125,22,18,1036
E01011386,993,14,128,13,24,1172
E01011388,1028,20,71,6,37,1162
E01011390,1152,3,9,1,1,1166
E01011391,1359,8,11,4,2,1384
E01011392,1212,5,4,1,0,1222
E01011393,1311,5,4,1,7,1328
E01011394,1002,3,5,2,1,1013
E01011395,860,7,7,9,1,884
E01011396,1435,16,29,6,4,1490
E01011397,1193,12,14,1,3,1223
E01011398,1022,3,8,1,0,1034
E01011399,1194,4,8,4,0,1210
E01011400,1146,10,8,2,1,1167
E01011401,1161,2,16,10,0,1189
E01011402,1500,8,12,5,5,1530
E01011403,1163,4,13,5,2,1187
E01011404,1042,2,7,3,0,1054
E01011405,1226,4,1,4,0,1235
E01011406,1146,3,7,9,0,1165
E01011407,1149,13,13,8,2,1185
E01011408,1282,4,9,6,1,1302
E01011409,1170,9,12,5,4,1200
E01011410,1080,6,19,11,0,1116
E01011411,1243,11,22,6,6,1288
E01011412,1160,3,4,1,2,1170
E01011413,1223,5,4,7,0,1239
E01011414,1208,5,14,6,3,1236
E01011415,1293,13,9,5,3,1323
E01011416,1176,10,4,4,1,1195
E01011417,1268,7,16,8,1,1300
E01011418,1174,8,23,4,2,1211
E01011419,1025,5,12,2,3,1047
E01011420,1131,10,11,5,2,1159
E01011421,875,29,176,65,13,1158
E01011422,301,56,547,137,28,1069
E01011423,822,36,191,96,7,1152
E01011424,592,31,295,120,11,1049
E01011425,984,28,154,85,6,1257
E01011426,128,71,710,179,35,1123
E01011427,529,34,472,116,13,1164
E01011428,264,31,838,139,56,1328
E01011429,274,101,774,249,27,1425
E01011430,262,26,625,96,26,1035
E01011431,933,59,157,162,13,1324
E01011432,445,42,433,133,15,1068
E01011433,615,51,240,171,24,1101
E01011434,389,47,369,165,30,1000
E01011435,1655,60,48,24,7,1794
E01011440,1491,40,34,18,10,1593
E01011441,1574,59,149,40,17,1839
E01011442,1381,64,78,31,12,1566
E01011443,1153,41,85,24,23,1326
E01011444,1549,64,101,49,21,1784
E01011445,1431,45,145,18,7,1646
E01011446,1178,74,191,22,33,1498
E01011447,1096,47,173,25,19,1360
E01011448,1145,59,163,51,23,1441
E01011449,952,41,188,37,9,1227
E01011450,770,36,101,62,21,990
E01011451,1837,65,82,25,19,2028
E01011452,1169,14,19,0,4,1206
E01011453,1183,16,21,6,3,1229
E01011454,1168,14,43,7,5,1237
E01011455,1120,11,22,4,1,1158
E01011456,1360,9,17,1,4,1391
E01011457,1185,11,57,4,3,1260
E01011458,1071,9,15,3,2,1100
E01011459,1303,10,24,7,5,1349
E01011460,1121,17,23,16,3,1180
E01011461,1221,2,13,1,1,1238
E01011462,1248,23,44,15,7,1337
E01011463,1242,18,42,10,6,1318
E01011464,1386,11,37,18,6,1458
E01011465,1274,13,27,10,9,1333
E01011466,1171,19,3,27,4,1224
E01011467,1053,19,103,61,13,1249
E01011468,1098,24,16,56,8,1202
E01011469,1165,16,9,17,5,1212
E01011470,995,10,18,24,3,1050
E01011471,1008,36,21,38,0,1103
E01011472,1180,18,10,24,1,1233
E01011473,898,31,22,84,1,1036
E01011474,995,20,15,56,0,1086
E01011475,1070,14,10,54,2,1150
E01011476,850,11,10,17,5,893
E01011477,1156,54,195,84,91,1580
E01011478,1313,62,98,45,13,1531
E01011479,1270,55,50,40,8,1423
E01011480,1129,30,183,17,25,1384
E01011481,924,66,292,62,32,1376
E01011482,1344,43,50,60,14,1511
E01011483,840,61,292,98,28,1319
E01011484,1015,30,69,35,12,1161
E01011485,1054,27,99,51,26,1257
E01011488,1165,42,36,14,5,1262
E01011489,1341,30,60,21,17,1469
E01011490,1898,37,60,46,4,2045
E01011491,986,12,10,20,1,1029
E01011492,925,8,15,55,0,1003
E01011493,1097,8,8,38,1,1152
E01011494,925,11,15,31,2,984
E01011496,1130,7,23,2,3,1165
E01011497,1084,16,27,63,3,1193
E01011499,1905,14,34,28,4,1985
E01011500,1319,6,6,7,3,1341
E01011502,1021,7,13,11,0,1052
E01011504,937,71,69,72,18,1167
E01011505,882,22,305,42,51,1302
E01011506,622,18,402,45,22,1109
E01011507,1055,13,179,37,18,1302
E01011508,727,12,268,24,40,1071
E01011509,913,25,160,19,24,1141
E01011510,1115,50,94,47,28,1334
E01011511,721,17,262,38,42,1080
E01011512,968,21,241,40,30,1300
E01011513,1444,38,185,50,9,1726
E01011514,930,19,306,31,40,1326
E01011515,1011,24,141,20,14,1210
E01011516,1061,24,192,56,34,1367
E01011517,1067,44,131,57,25,1324
E01011518,1601,19,100,10,15,1745
E01011519,1146,5,16,6,2,1175
E01011520,1199,8,27,6,0,1240
E01011521,1565,6,59,9,3,1642
E01011522,1137,11,13,2,4,1167
E01011523,1414,6,30,5,5,1460
E01011524,986,12,28,4,1,1031
E01011525,1255,13,32,8,0,1308
E01011526,946,10,51,11,7,1025
E01011527,1445,4,28,4,5,1486
E01011528,1159,15,67,7,1,1249
E01011529,1073,10,11,2,0,1096
E01011530,1140,21,37,11,8,1217
E01011531,1252,15,36,7,2,1312
E01011532,1192,14,9,13,6,1234
E01011533,1033,14,48,11,1,1107
E01011534,1131,16,16,8,0,1171
E01011535,1290,9,28,6,4,1337
E01011536,1253,12,34,2,1,1302
E01011537,1721,9,16,7,5,1758
E01011538,1177,10,12,1,5,1205
E01011540,1085,6,17,7,1,1116
E01011541,1468,12,35,10,8,1533
E01011545,1090,9,31,6,0,1136
E01011546,1287,14,35,10,1,1347
E01011547,1358,15,53,11,2,1439
E01011548,1168,6,19,7,0,1200
E01011549,1101,9,62,4,17,1193
E01011550,1080,4,15,7,13,1119
E01011551,1186,5,24,5,0,1220
E01011552,1073,15,12,5,3,1108
E01011553,1139,9,29,6,1,1184
E01011554,1027,10,93,23,24,1177
E01011555,899,9,193,19,24,1144
E01011556,994,32,200,29,18,1273
E01011557,1036,21,169,17,37,1280
E01011558,926,42,135,65,44,1212
E01011559,748,29,106,65,32,980
E01011560,1082,54,145,105,60,1446
E01011561,895,20,94,8,3,1020
E01011562,1055,13,218,15,24,1325
E01011563,1021,7,143,14,16,1201
E01011564,1069,13,92,21,12,1207
E01011565,926,13,167,26,43,1175
E01011566,842,6,183,13,24,1068
E01011567,920,14,142,22,17,1115
E01011568,1255,11,242,16,38,1562
E01011569,1373,9,13,5,1,1401
E01011570,1713,13,25,9,5,1765
E01011571,1335,8,8,2,2,1355
E01011572,1430,8,12,3,0,1453
E01011573,1075,11,9,1,4,1100
E01011574,1221,15,3,2,3,1244
E01011576,1154,5,26,7,12,1204
E01011578,1100,7,15,4,0,1126
E01011579,965,7,5,3,1,981
E01011580,1107,3,19,0,0,1129
E01011581,1190,7,6,2,0,1205
E01011582,1272,5,19,3,0,1299
E01011583,1166,11,12,4,2,1195
E01011584,1003,8,8,1,1,1021
E01011585,1117,8,20,5,1,1151
E01011586,856,11,289,21,20,1197
E01011587,1358,4,30,5,0,1397
E01011588,1298,13,35,4,6,1356
E01011589,1187,16,23,6,9,1241
E01011590,1217,5,35,2,4,1263
E01011591,1358,8,34,5,4,1409
E01011592,1206,7,7,2,1,1223
E01011593,1405,14,53,3,1,1476
E01011594,1111,7,15,7,0,1140
E01011595,806,16,532,14,65,1433
E01011596,1339,9,23,10,1,1382
E01011597,663,12,454,15,24,1168
E01011598,1263,12,22,7,0,1304
E01011599,1066,8,143,9,10,1236
E01011600,1249,10,18,4,3,1284
E01011601,1114,22,16,5,3,1160
E01011602,1238,11,37,3,4,1293
E01011603,1195,10,41,3,4,1253
E01011604,1035,10,32,4,2,1083
E01011605,1205,10,9,2,0,1226
E01011606,1051,20,190,11,8,1280
E01011607,1192,5,41,7,1,1246
E01011608,1071,6,11,7,6,1101
E01011609,1111,14,18,2,0,1145
E01011610,1140,8,31,7,2,1188
E01011611,1038,19,12,3,0,1072
E01011612,1117,5,18,4,0,1144
E01011613,948,11,40,3,2,1004
E01011614,1437,13,41,6,3,1500
E01011615,1131,19,43,25,2,1220
E01011616,1071,31,18,26,3,1149
E01011617,1095,14,57,44,3,1213
E01011618,1089,20,59,45,5,1218
E01011620,841,11,20,61,4,937
E01011621,952,33,29,85,2,1101
E01011622,970,34,52,123,4,1183
E01011623,863,58,64,119,20,1124
E01011624,1061,43,58,105,5,1272
E01011625,974,24,64,73,8,1143
E01011626,1202,46,86,113,18,1465
E01011627,1100,5,17,7,1,1130
E01011628,1105,9,4,3,3,1124
E01011629,1057,6,5,6,4,1078
E01011630,1636,6,40,5,0,1687
E01011632,995,16,21,8,0,1040
E01011633,1195,1,23,2,6,1227
E01011634,1202,9,6,1,0,1218
E01011635,1237,6,35,8,1,1287
E01011636,1352,10,17,8,0,1387
E01011637,1357,17,17,3,6,1400
E01011638,1160,6,15,1,0,1182
E01011639,1169,14,11,5,1,1200
E01011641,1046,22,89,30,2,1189
E01011642,751,29,205,37,19,1041
E01011643,1008,13,127,27,9,1184
E01011644,904,24,84,26,8,1046
E01011645,919,39,165,44,3,1170
E01011646,921,30,250,63,26,1290
E01011647,371,21,736,88,25,1241
E01011648,581,15,537,122,36,1291
E01011649,1169,9,46,2,2,1228
E01011650,1001,13,124,17,26,1181
E01011651,959,37,93,37,14,1140
E01011652,873,24,145,18,23,1083
E01011653,984,30,96,16,11,1137
E01011654,961,17,85,27,3,1093
E01011655,1087,10,72,16,12,1197
E01011656,996,33,28,26,5,1088
E01011657,980,18,20,12,6,1036
E01011658,924,19,22,37,2,1004
E01011659,1070,17,16,8,0,1111
E01011660,987,23,14,23,2,1049
E01011661,1326,18,9,11,3,1367
E01011662,752,17,27,43,11,850
E01011663,726,21,19,44,4,814
E01011664,820,14,19,11,2,866
E01011665,1083,18,19,7,3,1130
E01011666,1166,20,21,10,1,1218
E01011667,843,17,17,47,2,926
E01011668,1255,67,116,64,21,1523
E01011669,1123,60,86,57,24,1350
E01011670,1449,114,391,299,69,2322
E01011671,640,75,137,282,22,1156
E01011673,501,82,366,263,61,1273
E01011677,681,53,245,211,32,1222
E01011678,3267,133,481,126,57,4064
E01011681,890,60,386,118,48,1502
E01011684,1092,11,122,8,26,1259
E01011685,1711,44,137,16,16,1924
E01011686,1121,37,84,22,18,1282
E01011687,977,34,171,12,29,1223
E01011688,857,56,164,89,20,1186
E01011689,1223,19,41,26,9,1318
E01011690,1129,20,52,6,9,1216
E01011691,1013,47,50,76,9,1195
E01011692,1130,29,47,14,7,1227
E01011693,1291,47,47,18,12,1415
E01011694,1357,41,157,17,11,1583
E01011695,1079,33,65,15,33,1225
E01011696,1193,8,27,9,3,1240
E01011697,1646,65,111,23,2,1847
E01011698,1226,4,7,2,0,1239
E01011699,1112,5,12,1,1,1131
E01011700,1138,21,18,8,4,1189
E01011701,1027,5,6,4,0,1042
E01011702,969,5,8,4,2,988
E01011703,1090,6,8,3,3,1110
E01011704,1532,4,16,3,3,1558
E01011705,1091,4,6,2,1,1104
E01011706,1167,18,16,2,2,1205
E01011707,1119,5,3,0,2,1129
E01011708,1190,6,11,3,5,1215
E01011709,1271,5,5,1,6,1288
E01011710,1136,6,7,2,0,1151
E01011711,1144,8,12,1,1,1166
E01011712,1132,2,6,0,1,1141
E01011713,1395,15,30,9,15,1464
E01011714,1112,9,73,15,1,1210
E01011715,1036,9,17,2,2,1066
E01011716,1052,7,176,21,8,1264
E01011717,1125,14,37,16,2,1194
E01011718,1051,14,15,11,0,1091
E01011719,1199,5,13,1,2,1220
E01011720,1187,7,9,14,1,1218
E01011721,1097,9,6,13,2,1127
E01011722,1411,31,19,30,1,1492
E01011723,1025,14,17,4,8,1068
E01011724,1369,21,16,12,3,1421
E01011725,1042,26,39,35,2,1144
E01011726,1085,16,12,29,5,1147
E01011727,1206,11,24,12,13,1266
E01011728,1150,5,18,6,1,1180
E01011729,1208,36,62,35,3,1344
E01011730,1086,20,19,20,3,1148
E01011731,1134,8,29,5,5,1181
E01011732,1393,22,86,23,2,1526
E01011733,1238,16,15,12,2,1283
E01011734,1690,31,84,51,9,1865
E01011735,1208,18,25,28,0,1279
E01011736,1192,7,35,5,2,1241
E01011737,1193,21,28,4,1,1247
E01011738,1138,10,31,6,0,1185
E01011739,1167,25,16,22,0,1230
E01011740,1152,0,5,4,2,1163
E01011741,1231,7,4,4,0,1246
E01011742,1295,5,1,6,0,1307
E01011743,1252,6,1,0,2,1261
E01011744,1320,7,2,3,1,1333
E01011745,1230,13,7,10,3,1263
E01011746,1138,1,7,4,0,1150
E01011747,1228,6,13,13,4,1264
E01011748,1329,4,2,7,0,1342
E01011749,1672,15,42,12,2,1743
E01011750,1106,9,9,5,2,1131
E01011751,1076,3,11,2,0,1092
E01011752,1234,10,24,6,2,1276
E01011753,1168,7,6,1,0,1182
E01011754,1187,2,10,5,1,1205
E01011755,1372,6,7,5,1,1391
E01011756,1238,6,13,4,1,1262
E01011757,1371,4,25,9,2,1411
E01011758,1083,4,28,0,7,1122
E01011759,1523,7,17,3,3,1553
E01011760,1380,2,10,10,1,1403
E01011761,1544,11,13,13,3,1584
E01011762,1277,5,14,8,7,1311
E01011763,1209,6,4,3,3,1225
E01011764,1241,10,13,11,7,1282
E01011765,1253,4,4,5,0,1266
E01011766,1182,5,3,6,1,1197
E01011767,1459,7,10,3,3,1482
E01011768,1129,8,8,1,4,1150
E01011769,1706,9,14,8,1,1738
E01011770,1477,14,45,5,1,1542
E01011771,1084,7,2,7,1,1101
E01011772,1319,5,9,1,1,1335
E01011773,1271,5,11,1,0,1288
E01011774,1127,6,4,4,0,1141
E01011775,2173,18,35,10,0,2236
E01011776,1228,7,19,5,0,1259
E01011777,1146,3,8,4,0,1161
E01011778,1240,5,9,5,0,1259
E01011779,1207,1,6,0,3,1217
E01011780,1438,5,9,0,1,1453
E01011781,1356,1,8,3,9,1377
E01011782,1216,4,14,2,2,1238
E01011783,1066,5,21,6,2,1100
E01011784,1439,6,7,0,0,1452
E01011785,1176,7,18,6,1,1208
E01011786,1237,5,6,3,0,1251
E01011787,1427,8,9,1,1,1446
E01011788,1416,11,11,2,0,1440
E01011789,1032,3,3,11,0,1049
E01011790,1330,6,9,2,0,1347
E01011791,1182,8,5,4,2,1201
E01011792,1131,4,7,8,3,1153
E01011793,1365,1,8,7,7,1388
E01011794,1120,8,5,3,6,1142
E01011795,1049,4,1,0,1,1055
E01011796,1137,12,5,3,4,1161
E01011797,1353,7,11,4,5,1380
E01011798,1101,8,8,10,2,1129
E01011799,1292,8,23,3,6,1332
E01011800,1310,12,20,7,1,1350
E01011801,1168,12,12,4,1,1197
E01011802,1278,3,7,1,0,1289
E01011803,1070,4,7,0,0,1081
E01011804,1304,3,3,2,1,1313
E01011805,1228,11,12,12,2,1265
E01011806,1246,14,7,6,0,1273
E01011807,1121,8,21,4,1,1155
E01011808,1417,7,15,6,0,1445
E01011809,1243,7,7,1,12,1270
E01011810,1201,3,13,2,2,1221
E01011811,1194,3,13,9,5,1224
E01011812,1943,14,67,6,1,2031
E01011813,1252,2,15,3,0,1272
E01011814,1326,7,15,16,1,1365
E01011815,1206,11,19,14,2,1252
E01011816,1114,6,8,6,0,1134
E01011817,1036,6,9,3,0,1054
E01011818,1098,2,11,1,1,1113
E01011819,1272,11,23,10,1,1317
E01011820,1170,7,11,3,2,1193
E01011821,1108,5,13,8,1,1135
E01011822,1122,8,6,4,2,1142
E01011823,1180,4,17,6,0,1207
E01011824,1096,9,23,6,0,1134
E01011825,1378,8,14,8,3,1411
E01011826,1138,11,11,2,2,1164
E01011827,1002,5,11,3,0,1021
E01011828,1144,7,5,7,2,1165
E01011829,1144,4,7,4,2,1161
E01011830,1090,5,5,3,3,1106
E01011831,1379,7,16,4,0,1406
E01011832,1156,4,9,4,0,1173
E01011833,1226,6,12,4,3,1251
E01011834,1174,9,14,16,0,1213
E01011835,1275,8,11,11,0,1305
E01011836,1126,5,17,6,0,1154
E01011837,1138,9,55,7,3,1212
E01011838,1623,10,32,24,12,1701
E01011839,1275,3,10,4,3,1295
E01011840,1219,7,15,1,0,1242
E01011841,1267,4,15,3,0,1289
E01011842,1103,11,14,7,1,1136
E01011843,1216,6,21,3,5,1251
E01011844,1436,5,12,5,2,1460
E01011845,1194,4,12,2,1,1213
E01011846,1123,4,7,4,1,1139
E01011847,1179,6,10,4,0,1199
E01011848,1233,2,6,4,1,1246
E01011849,1359,5,10,4,1,1379
E01011850,1170,2,11,1,0,1184
E01011851,1177,3,13,9,4,1206
E01011852,1164,9,12,10,3,1198
E01011853,1142,4,15,3,0,1164
E01011854,953,3,6,0,0,962
E01011855,1267,4,5,3,0,1279
E01011856,1166,1,0,1,1,1169
E01011857,1367,6,10,14,3,1400
E01011858,1231,7,5,2,1,1246
E01011859,1186,0,11,5,2,1204
E01011860,1246,5,5,2,1,1259
E01011861,1562,12,2,2,2,1580
E01011862,1153,7,2,9,3,1174
E01011863,1066,3,3,3,0,1075
E01011864,1267,7,3,6,0,1283
E01011865,1358,7,4,2,0,1371
E01011866,1260,2,4,1,0,1267
E01011867,1296,8,13,3,0,1320
E01011868,1476,3,4,3,0,1486
E01011869,1142,5,10,5,2,1164
E01011870,1230,2,0,0,0,1232
E01011871,1248,5,4,5,3,1265
E01011872,1200,4,3,1,3,1211
E01011873,1259,8,9,10,3,1289
E01011874,1368,5,6,2,3,1384
E01011875,1134,11,6,3,1,1155
E01011876,1090,14,32,5,0,1141
E01011877,1166,11,46,15,7,1245
E01011878,1270,7,21,7,5,1310
E01011879,1188,5,13,0,0,1206
E01011880,1141,18,54,14,5,1232
E01011881,1189,9,17,2,2,1219
E01011882,1278,5,5,3,0,1291
E01011883,1150,8,15,2,2,1177
E01011884,1694,16,135,31,28,1904
E01011885,1250,8,15,4,0,1277
E01011886,1214,9,19,4,0,1246
E01011887,965,3,15,8,5,996
E01011888,1216,6,10,0,1,1233
E01011889,956,6,26,6,4,998
E01011890,986,12,19,8,0,1025
E01011891,1264,6,14,6,1,1291
E01011892,1380,5,22,3,8,1418
E01011893,1243,4,11,15,4,1277
E01011894,1101,4,25,7,0,1137
E01011895,1162,5,31,4,0,1202
E01011896,1126,5,22,11,2,1166
E01011897,1162,3,21,2,2,1190
E01011898,1081,10,67,48,2,1208
E01011899,1037,32,11,12,5,1097
E01011900,1210,11,14,24,8,1267
E01011901,1082,8,34,19,2,1145
E01011902,1149,9,30,11,5,1204
E01011903,1001,5,22,27,14,1069
E01011904,912,11,28,25,2,978
E01011905,1276,8,40,8,1,1333
E01011906,1033,21,37,52,7,1150
E01011907,1288,15,171,45,15,1534
E01011908,1428,21,264,61,14,1788
E01011909,1003,10,133,18,12,1176
E01011910,1133,6,65,21,16,1241
E01011911,1053,10,41,24,6,1134
E01011912,843,25,335,57,33,1293
E01011913,721,14,516,17,14,1282
E01011914,1030,16,96,28,23,1193
E01011915,922,15,223,37,28,1225
E01011916,1436,33,224,113,47,1853
E01011917,908,24,230,50,40,1252
E01011918,1102,10,24,26,0,1162
E01011919,1363,7,57,24,8,1459
E01011920,1609,41,270,83,21,2024
E01011921,1155,6,26,3,0,1190
E01011922,1097,13,17,34,1,1162
E01011923,1254,16,55,12,11,1348
E01011924,1102,7,111,25,10,1255
E01011925,1116,6,65,23,10,1220
E01011926,991,13,190,18,10,1222
E01011927,1061,6,11,10,2,1090
E01011928,1126,5,3,2,1,1137
E01011929,1397,5,9,0,4,1415
E01011930,1354,7,14,12,2,1389
E01011931,1216,5,3,7,2,1233
E01011932,1165,7,9,2,6,1189
E01011933,1263,10,20,3,0,1296
E01011934,1224,4,22,4,0,1254
E01011935,1406,8,19,3,5,1441
E01011936,1164,9,10,16,0,1199
E01011937,1195,5,8,3,0,1211
E01011938,1384,16,25,13,2,1440
E01011939,1191,4,45,3,8,1251
E01011940,1135,4,14,5,6,1164
E01011941,1205,5,15,10,1,1236
E01011942,1037,4,13,1,0,1055
E01011943,1345,3,12,13,1,1374
E01011944,925,5,127,20,7,1084
E01011945,1204,8,46,7,5,1270
E01011946,1245,6,20,8,1,1280
E01011947,1274,14,67,4,14,1373
E01011948,1272,6,57,2,7,1344
E01011949,1485,8,10,0,4,1507
E01011950,1214,4,3,1,3,1225
E01011951,1081,3,12,3,1,1100
E01011952,1277,9,12,5,1,1304
E01011953,1395,7,10,2,0,1414
E01011954,1703,2,2,1,1,1709
E01011955,1036,5,18,2,0,1061
E01011957,1018,3,28,2,2,1053
E01011959,1655,7,42,3,3,1710
E01011960,1230,2,3,0,0,1235
E01011961,1142,6,1,1,0,1150
E01011962,1115,7,9,1,1,1133
E01011963,1219,3,6,1,1,1230
E01011964,997,7,122,14,2,1142
E01011965,1321,8,18,0,0,1347
E01011966,1147,3,8,4,0,1162
E01011967,1178,4,4,0,0,1186
E01011968,1812,1,6,0,0,1819
E01011969,1178,0,3,1,1,1183
E01011970,946,3,9,0,0,958
E01011971,1053,5,6,0,0,1064
E01011973,957,6,50,10,1,1024
E01011974,1365,23,57,7,6,1458
E01011975,1078,4,7,0,2,1091
E01011976,783,3,29,3,4,822
E01011977,1311,11,18,0,1,1341
E01011978,1186,5,1,1,0,1193
E01011979,1153,6,10,0,0,1169
E01011980,1346,2,14,0,2,1364
E01011981,1308,4,3,0,0,1315
E01011982,1059,6,26,3,1,1095
E01011983,1367,5,23,1,4,1400
E01011984,1072,8,3,3,0,1086
E01011985,987,1,1,1,3,993
E01011986,1044,0,4,1,0,1049
E01011987,1129,1,3,2,0,1135
E01011988,1546,3,14,0,1,1564
E01011989,1433,5,13,0,3,1454
E01011990,1383,4,7,0,0,1394
E01011991,1528,4,4,0,0,1536
E01011992,1223,8,4,5,2,1242
E01011993,1406,5,9,3,1,1424
E01011994,1200,8,18,1,1,1228
E01011995,1176,7,1,0,1,1185
E01011996,1292,2,12,0,2,1308
E01011997,1624,7,5,3,0,1639
E01011998,1233,8,2,0,2,1245
E01011999,1579,14,61,4,11,1669
E01012000,1084,8,25,5,2,1124
E01012001,1515,4,18,2,5,1544
E01012002,1124,9,12,0,1,1146
E01012003,1290,6,15,2,1,1314
E01012005,1479,7,40,0,4,1530
E01012007,1173,2,70,17,3,1265
E01012008,1058,13,45,2,1,1119
E01012009,1336,7,95,4,6,1448
E01012010,1029,11,96,4,5,1145
E01012011,1366,15,17,6,12,1416
E01012012,1234,22,104,6,10,1376
E01012013,1000,6,13,8,2,1029
E01012014,1083,25,42,16,9,1175
E01012015,1231,5,10,6,3,1255
E01012016,1297,16,7,16,4,1340
E01012017,1327,7,15,6,2,1357
E01012018,1230,21,145,20,17,1433
E01012019,914,13,8,5,3,943
E01012020,1111,13,43,11,8,1186
E01012021,964,11,18,6,7,1006
E01012022,1246,7,17,4,3,1277
E01012023,1232,4,26,0,0,1262
E01012024,1241,8,28,0,2,1279
E01012025,1035,7,32,1,15,1090
E01012026,1144,10,102,12,12,1280
E01012027,1303,15,68,5,6,1397
E01012030,1239,10,14,4,0,1267
E01012031,1281,11,9,3,4,1308
E01012032,1303,12,13,1,2,1331
E01012033,1104,10,3,2,3,1122
E01012034,1149,9,11,6,3,1178
E01012035,1096,5,10,8,2,1121
E01012036,876,26,239,56,49,1246
E01012037,957,18,130,63,33,1201
E01012038,948,33,126,41,21,1169
E01012039,849,45,300,91,33,1318
E01012040,783,21,255,54,38,1151
E01012041,813,16,33,19,20,901
E01012042,1187,5,3,3,1,1199
E01012043,1218,6,5,3,1,1233
E01012044,1092,6,10,7,5,1120
E01012045,1027,10,6,7,3,1053
E01012046,1398,9,98,2,11,1518
E01012047,1073,7,144,2,5,1231
E01012048,1374,10,71,4,7,1466
E01012049,1144,11,40,6,5,1206
E01012050,1063,9,31,11,2,1116
E01012051,972,2,32,18,6,1030
E01012052,1056,9,47,1,2,1115
E01012053,1079,23,227,2,13,1344
E01012054,1059,15,247,4,21,1346
E01012055,1313,18,236,4,11,1582
E01012056,1537,30,135,20,82,1804
E01012057,1326,23,207,8,21,1585
E01012058,1185,25,59,23,9,1301
E01012059,1084,17,99,16,4,1220
E01012060,1165,12,11,7,0,1195
E01012061,1047,11,12,5,3,1078
E01012062,1185,11,31,2,3,1232
E01012063,1184,9,14,2,1,1210
E01012064,1383,6,79,9,13,1490
E01012065,1365,3,24,3,1,1396
E01012066,1513,6,45,1,4,1569
E01012067,1342,7,41,0,6,1396
E01012068,1461,44,383,73,87,2048
E01012071,1178,5,44,10,2,1239
E01012073,1158,11,28,2,7,1206
E01012074,1157,7,16,1,1,1182
E01012075,1163,12,5,4,1,1185
E01012076,1054,4,7,10,2,1077
E01012077,1094,10,3,10,1,1118
E01012078,911,22,187,22,30,1172
E01012079,988,9,116,5,9,1127
E01012080,937,13,64,0,7,1021
E01012081,1139,31,204,11,8,1393
E01012082,1181,15,12,4,2,1214
E01012083,1129,12,3,11,0,1155
E01012084,1203,16,4,15,0,1238
E01012085,1105,12,5,0,0,1122
E01012088,1008,12,5,1,1,1027
E01012089,1121,8,6,8,1,1144
E01012090,1173,6,11,14,2,1206
E01012091,1155,13,8,10,3,1189
E01012092,1235,42,392,92,90,1851
E01012093,678,43,613,48,70,1452
E01012094,1153,46,691,58,60,2008
E01012095,1096,2,1,1,0,1100
E01012096,1231,5,2,1,2,1241
E01012097,999,1,3,0,0,1003
E01012098,1055,5,1,1,0,1062
E01012099,1183,1,8,0,1,1193
E01012100,1338,10,18,3,1,1370
E01012101,1291,3,14,1,0,1309
E01012102,1707,13,12,6,0,1738
E01012105,1096,7,7,1,1,1112
E01012106,1122,7,3,1,0,1133
E01012107,1134,4,5,2,0,1145
E01012108,1137,3,4,2,0,1146
E01012109,1187,4,3,0,0,1194
E01012110,1175,1,4,1,0,1181
E01012111,1111,4,1,0,1,1117
E01012112,1176,8,3,1,0,1188
E01012113,1000,1,7,0,1,1009
E01012114,1028,5,7,1,4,1045
E01012117,1248,4,14,1,0,1267
E01012118,1129,4,1,1,3,1138
E01012119,1657,2,16,1,7,1683
E01012120,1201,2,8,0,2,1213
E01012121,1064,4,5,1,0,1074
E01012124,1211,5,20,0,2,1238
E01012127,807,3,8,2,0,820
E01012128,899,0,2,1,0,902
E01012129,1771,7,6,0,1,1785
E01012130,1100,4,5,3,6,1118
E01012131,1105,9,6,0,2,1122
E01012132,1686,4,5,2,3,1700
E01012134,1246,8,5,0,1,1260
E01012136,1187,3,6,0,1,1197
E01012137,1120,2,0,0,0,1122
E01012138,2043,6,11,1,0,2061
E01012139,1628,6,3,0,6,1643
E01012140,1094,8,3,1,0,1106
E01012141,936,2,5,0,3,946
E01012142,1381,2,9,0,0,1392
E01012143,920,4,4,1,0,929
E01012144,1165,4,16,3,1,1189
E01012145,1221,5,4,1,1,1232
E01012146,1071,2,11,0,0,1084
E01012147,1340,4,4,3,0,1351
E01012148,1132,4,6,3,5,1150
E01012149,1021,4,1,0,1,1027
E01012150,1226,11,0,0,1,1238
E01012151,1260,6,5,1,5,1277
E01012152,1327,6,15,0,1,1349
E01012154,1116,2,3,1,1,1123
E01012155,1262,3,3,1,0,1269
E01012156,1452,5,9,1,2,1469
E01012157,1383,6,2,0,1,1392
E01012158,1216,6,3,0,1,1226
E01012159,1400,11,16,1,3,1431
E01012160,1188,7,3,0,1,1199
E01012161,1216,9,7,0,3,1235
E01012162,1141,1,1,1,2,1146
E01012163,1747,3,3,2,2,1757
E01012164,1338,13,3,0,1,1355
E01012165,1717,4,12,1,1,1735
E01012167,1166,2,9,0,0,1177
E01012168,1519,4,9,0,0,1532
E01012170,998,10,30,4,0,1042
E01012171,1195,3,3,0,0,1201
E01012172,1176,3,2,1,0,1182
E01012173,1003,6,3,0,0,1012
E01012174,960,2,3,3,0,968
E01012175,1082,7,1,0,0,1090
E01012176,1222,10,9,0,0,1241
E01012177,1192,1,4,2,0,1199
E01012178,1157,4,4,2,1,1168
E01012179,1214,4,7,2,1,1228
E01012180,1361,6,5,0,0,1372
E01012181,1308,3,21,0,1,1333
E01012182,1241,0,1,0,0,1242
E01012183,1253,1,4,0,0,1258
E01012184,1191,9,4,0,0,1204
E01012185,1168,5,2,0,1,1176
E01012186,1370,7,7,1,3,1388
E01012187,1110,0,25,0,0,1135
E01012188,984,2,22,1,1,1010
E01012189,1190,3,22,0,1,1216
E01012190,1232,1,12,1,6,1252
E01012191,1385,9,17,0,2,1413
E01012192,1313,7,10,3,0,1333
E01012193,1169,1,17,1,4,1192
E01012194,1167,7,14,6,3,1197
E01012195,1107,12,29,5,3,1156
E01012196,1326,3,4,0,1,1334
E01012197,1503,9,3,1,1,1517
E01012198,1116,11,3,7,2,1139
E01012199,1194,8,27,2,2,1233
E01012200,1621,13,33,5,10,1682
E01012201,1418,2,25,3,0,1448
E01012202,1201,7,25,1,1,1235
E01012203,1337,11,40,9,4,1401
E01012204,1164,5,14,1,2,1186
E01012205,1169,4,24,7,1,1205
E01012206,1208,5,37,5,2,1257
E01012207,1498,8,46,6,3,1561
E01012208,1356,4,19,2,2,1383
E01012209,1357,10,40,8,3,1418
E01012210,1309,5,32,2,0,1348
E01012211,1460,9,11,2,0,1482
E01012212,1261,6,14,1,2,1284
E01012213,1247,5,5,0,0,1257
E01012214,1242,5,4,4,1,1256
E01012215,987,4,6,1,4,1002
E01012216,994,6,6,1,1,1008
E01012217,1113,13,100,8,14,1248
E01012218,1153,8,98,3,3,1265
E01012219,1399,11,34,6,6,1456
E01012223,1270,4,29,1,1,1305
E01012224,1463,9,15,4,3,1494
E01012225,1280,5,32,5,0,1322
E01012226,1196,1,16,1,1,1215
E01012227,1069,6,41,2,6,1124
E01012228,1042,4,36,3,2,1087
E01012230,1106,3,105,4,5,1223
E01012231,1344,5,51,2,4,1406
E01012232,1029,2,34,10,1,1076
E01012233,1137,8,26,1,4,1176
E01012234,1224,8,32,3,1,1268
E01012235,1137,18,42,7,1,1205
E01012236,1022,2,69,2,3,1098
E01012237,1007,11,92,1,7,1118
E01012238,1173,8,25,3,3,1212
E01012239,1375,24,28,12,4,1443
E01012240,1445,8,18,4,2,1477
E01012241,1248,8,5,2,1,1264
E01012242,1262,8,5,1,3,1279
E01012243,1305,5,15,1,2,1328
E01012244,1210,2,6,2,0,1220
E01012245,1264,10,0,2,0,1276
E01012246,1209,6,6,0,1,1222
E01012247,951,5,27,6,2,991
E01012248,1134,6,28,1,2,1171
E01012249,1205,8,26,5,0,1244
E01012250,1096,7,35,4,4,1146
E01012251,1175,15,42,7,1,1240
E01012252,1066,8,18,6,4,1102
E01012253,1027,2,16,1,0,1046
E01012254,997,7,54,18,6,1082
E01012255,1272,1,5,0,0,1278
E01012256,1173,5,6,2,1,1187
E01012257,1208,3,3,2,0,1216
E01012258,1717,61,29,9,5,1821
E01012259,1441,4,11,0,1,1457
E01012260,1409,4,15,2,1,1431
E01012261,1215,3,23,1,3,1245
E01012262,1329,40,313,63,32,1777
E01012264,1771,20,85,19,17,1912
E01012266,1645,19,112,113,16,1905
E01012267,1153,14,189,23,13,1392
E01012268,1289,11,14,19,1,1334
E01012269,1365,6,22,0,7,1400
E01012270,1088,9,15,4,0,1116
E01012271,1040,9,17,7,1,1074
E01012272,934,4,16,1,0,955
E01012273,1172,5,6,4,1,1188
E01012274,1001,10,14,2,3,1030
E01012275,1216,5,5,2,0,1228
E01012276,1370,7,7,1,2,1387
E01012277,1299,6,9,0,0,1314
E01012278,1005,6,15,0,3,1029
E01012279,1366,3,0,1,1,1371
E01012280,1261,14,2,2,3,1282
E01012281,1025,6,9,4,0,1044
E01012282,1003,0,21,3,4,1031
E01012283,974,3,4,4,2,987
E01012284,1236,7,19,4,3,1269
E01012285,1125,9,16,6,1,1157
E01012286,980,14,115,17,7,1133
E01012287,1723,35,308,28,34,2128
E01012288,928,13,172,12,7,1132
E01012289,893,3,120,9,2,1027
E01012290,1490,5,34,4,2,1535
E01012291,1330,13,61,4,4,1412
E01012292,1772,8,62,5,5,1852
E01012294,1000,6,15,1,0,1022
E01012295,942,4,10,0,2,958
E01012296,1140,1,13,1,1,1156
E01012297,2079,13,20,0,8,2120
E01012298,1124,13,43,4,1,1185
E01012299,1178,8,46,0,5,1237
E01012300,1247,5,24,1,9,1286
E01012301,1068,9,51,2,1,1131
E01012302,1017,9,19,3,4,1052
E01012303,1149,5,11,0,5,1170
E01012304,890,7,97,9,3,1006
E01012305,964,7,34,3,4,1012
E01012306,1269,11,38,3,3,1324
E01012307,1473,14,33,8,9,1537
E01012309,1448,9,20,2,1,1480
E01012310,1593,3,7,2,3,1608
E01012311,1232,3,5,0,0,1240
E01012312,990,5,13,1,2,1011
E01012313,1106,6,4,3,4,1123
E01012314,1038,5,7,3,0,1053
E01012315,1295,11,11,1,0,1318
E01012316,2019,15,37,7,13,2091
E01012317,1119,5,12,5,1,1142
E01012318,1702,12,24,14,6,1758
E01012319,2056,13,33,5,2,2109
E01012323,1202,14,12,2,0,1230
E01012324,1136,2,3,1,2,1144
E01012325,1203,7,17,7,1,1235
E01012326,903,9,2,3,3,920
E01012327,1069,5,19,4,1,1098
E01012328,1255,7,16,5,2,1285
E01012329,1517,9,17,0,0,1543
E01012330,915,5,12,0,0,932
E01012331,1000,10,19,0,0,1029
E01012332,1151,4,6,2,2,1165
E01012333,1165,9,13,4,0,1191
E01012334,1851,10,18,1,4,1884
E01012335,1137,8,7,0,1,1153
E01012336,1424,8,43,2,8,1485
E01012337,1439,1,26,5,0,1471
E01012338,1537,6,11,1,5,1560
E01012339,1452,6,8,1,2,1469
E01012340,1856,13,35,5,8,1917
E01012341,1310,9,26,4,1,1350
E01012342,1372,15,28,14,2,1431
E01012343,1600,11,24,10,11,1656
E01012344,1084,9,14,1,2,1110
E01012345,1290,2,8,6,0,1306
E01012346,1368,5,28,0,10,1411
E01012347,1415,9,28,2,3,1457
E01012348,1618,14,31,7,8,1678
E01012349,1183,7,20,3,3,1216
E01012350,1228,12,8,5,2,1255
E01012351,1120,18,23,2,1,1164
E01012352,1263,9,20,9,2,1303
E01012353,1180,14,74,10,9,1287
E01012354,1055,3,188,12,8,1266
E01012355,1046,16,135,15,11,1223
E01012356,1228,15,34,7,3,1287
E01012357,1089,12,29,2,0,1132
E01012358,1295,7,29,5,5,1341
E01012359,1056,22,21,3,0,1102
E01012360,1404,10,18,0,0,1432
E01012361,1546,4,21,0,3,1574
E01012362,1078,9,15,1,5,1108
E01012363,1076,8,14,2,8,1108
E01012364,1210,11,24,3,6,1254
E01012365,1024,5,19,1,0,1049
E01012366,1691,9,14,4,0,1718
E01012367,1248,15,23,2,5,1293
E01012368,1544,7,9,0,0,1560
E01012369,1221,3,5,0,1,1230
E01012370,1394,22,22,1,0,1439
E01012371,1035,5,4,1,3,1048
E01012372,983,4,10,1,3,1001
E01012373,1096,7,3,1,2,1109
E01012374,2083,10,32,4,1,2130
E01012375,1262,7,28,0,0,1297
E01012376,1879,18,38,8,2,1945
E01012377,1458,3,6,2,2,1471
E01012378,1270,10,3,4,1,1288
E01012379,1232,5,2,0,1,1240
E01012380,1093,8,0,1,0,1102
E01012381,1038,9,8,1,0,1056
E01012382,1138,16,9,0,1,1164
E01012383,1359,11,16,1,3,1390
E01012384,1337,10,8,3,2,1360
E01012385,1127,5,17,4,0,1153
E01012386,1400,15,27,1,2,1445
E01012387,919,8,10,0,1,938
E01012388,1379,11,0,1,0,1391
E01012389,1511,4,9,1,1,1526
E01012390,1312,3,0,0,1,1316
E01012391,1709,20,14,12,4,1759
E01012392,1798,13,17,7,4,1839
E01012393,1687,18,8,2,3,1718
E01012394,1211,4,9,0,0,1224
E01012395,1214,4,16,2,4,1240
E01012396,1149,7,11,3,0,1170
E01012397,1129,10,9,4,0,1152
E01012398,973,9,4,0,0,986
E01012399,1081,9,14,0,0,1104
E01012400,977,6,3,0,0,986
E01012401,1572,12,5,6,0,1595
E01012402,1264,3,7,2,2,1278
E01012403,1174,7,3,2,2,1188
E01012404,1087,4,2,7,0,1100
E01012405,1598,12,9,3,1,1623
E01012406,1238,8,13,6,0,1265
E01012407,1235,31,7,14,0,1287
E01012408,1435,13,7,3,1,1459
E01012409,1144,14,14,5,0,1177
E01012410,1065,6,9,1,0,1081
E01012411,1112,3,8,5,5,1133
E01012412,1146,6,10,12,0,1174
E01012413,1160,12,9,4,0,1185
E01012414,1026,5,5,0,3,1039
E01012415,1138,3,9,0,0,1150
E01012416,1442,6,10,4,0,1462
E01012417,1018,8,8,0,3,1037
E01012418,1199,4,9,0,0,1212
E01012419,876,6,0,1,1,884
E01012420,1168,18,7,2,7,1202
E01012421,1129,1,16,3,0,1149
E01012422,1076,9,3,9,4,1101
E01012423,1194,5,10,1,0,1210
E01012424,1385,10,12,10,2,1419
E01012425,1283,5,12,2,9,1311
E01012426,1140,7,2,1,1,1151
E01012427,1325,20,12,0,2,1359
E01012428,1772,10,17,4,0,1803
E01012429,1097,5,3,2,0,1107
E01012430,1391,15,7,5,1,1419
E01012431,1647,19,21,11,7,1705
E01012432,1137,11,7,0,0,1155
E01012433,1183,15,5,6,0,1209
E01012434,1248,9,14,4,1,1276
E01012435,1619,10,15,4,1,1649
E01012436,884,10,2,1,0,897
E01012437,985,14,2,3,0,1004
E01012438,883,10,6,1,4,904
E01012439,1159,14,7,1,3,1184
E01012440,1081,7,10,2,5,1105
E01012441,1761,22,6,6,4,1799
E01012442,1154,6,8,1,1,1170
E01012443,1277,11,10,0,2,1300
E01012444,824,1,3,0,0,828
E01012445,988,11,5,0,0,1004
E01012446,1119,10,44,1,3,1177
E01012447,1047,4,58,2,5,1116
E01012448,1263,22,47,6,3,1341
E01012449,1199,5,28,0,3,1235
E01012450,1127,10,35,2,1,1175
E01012451,1230,7,10,7,0,1254
E01012452,1383,9,42,6,0,1440
E01012453,1213,13,21,6,4,1257
E01012454,1446,10,109,6,4,1575
E01012455,1358,17,49,8,3,1435
E01012457,1171,13,139,9,14,1346
E01012458,1756,12,57,2,5,1832
E01012459,1080,10,11,5,2,1108
E01012460,1093,9,24,8,1,1135
E01012461,1031,13,24,3,3,1074
E01012462,1013,11,41,4,5,1074
E01012463,991,5,12,2,0,1010
E01012464,1109,12,23,3,6,1153
E01012465,1036,10,21,2,2,1071
E01012466,1105,15,28,5,5,1158
E01012467,1071,1,13,0,0,1085
E01012468,1862,15,36,8,5,1926
E01012469,1274,5,12,0,0,1291
E01012470,927,3,6,1,0,937
E01012471,1815,55,89,87,16,2062
E01012472,1473,5,9,1,4,1492
E01012473,1258,3,8,2,0,1271
E01012474,1141,7,19,2,0,1169
E01012475,1175,7,10,8,0,1200
E01012476,1289,18,7,2,4,1320
E01012477,1214,7,12,3,2,1238
E01012478,1152,10,3,2,2,1169
E01012479,1257,12,39,4,3,1315
E01012480,1568,7,102,11,6,1694
E01012481,1220,14,17,0,2,1253
E01012482,1315,3,19,3,2,1342
E01012483,1270,14,51,6,3,1344
E01012485,1211,8,15,2,0,1236
E01012486,1178,2,13,2,1,1196
E01012487,1226,3,16,0,0,1245
E01012488,1405,4,25,4,3,1441
E01012489,1432,10,27,3,0,1472
E01012490,1205,5,5,1,0,1216
E01012491,1148,8,9,3,0,1168
E01012492,1184,2,16,3,0,1205
E01012493,1437,6,9,3,4,1459
E01012494,1281,9,15,5,1,1311
E01012495,1273,4,47,3,5,1332
E01012496,1132,6,19,2,0,1159
E01012497,963,4,35,6,1,1009
E01012498,1153,11,26,7,4,1201
E01012499,1403,11,40,6,0,1460
E01012500,1144,7,5,2,1,1159
E01012501,1141,4,16,4,1,1166
E01012502,1266,4,17,0,1,1288
E01012503,1104,4,22,2,4,1136
E01012504,1354,12,20,9,6,1401
E01012505,1101,9,11,4,5,1130
E01012506,1182,4,10,1,3,1200
E01012507,1474,9,30,5,6,1524
E01012508,1222,14,28,5,0,1269
E01012509,1526,14,21,3,3,1567
E01012510,1410,15,46,4,5,1480
E01012511,1327,11,28,15,3,1384
E01012512,1368,6,15,1,0,1390
E01012513,1491,8,31,2,3,1535
E01012514,1403,8,22,3,0,1436
E01012515,1164,9,19,3,2,1197
E01012516,1095,2,13,1,1,1112
E01012517,1648,8,38,5,6,1705
E01012518,1534,11,10,8,1,1564
E01012519,1197,6,10,3,4,1220
E01012520,1134,19,10,3,7,1173
E01012521,1252,8,11,0,2,1273
E01012522,1087,7,14,2,1,1111
E01012523,1144,5,8,3,1,1161
E01012524,1268,5,3,0,2,1278
E01012525,1155,8,17,1,5,1186
E01012526,1161,8,21,8,3,1201
E01012527,1211,5,17,2,2,1237
E01012528,1053,5,10,0,3,1071
E01012529,1162,4,11,2,1,1180
E01012530,1163,3,10,0,3,1179
E01012531,1231,4,11,0,0,1246
E01012532,1218,5,5,1,1,1230
E01012533,988,9,9,2,2,1010
E01012534,1144,16,5,5,0,1170
E01012535,1226,12,9,4,1,1252
E01012536,1083,6,11,5,0,1105
E01012537,1165,9,2,0,0,1176
E01012538,1197,7,10,3,2,1219
E01012539,1213,9,5,4,1,1232
E01012540,1098,10,16,3,1,1128
E01012541,1029,10,9,4,1,1053
E01012542,1150,10,4,2,5,1171
E01012543,1443,14,6,10,1,1474
E01012544,1140,13,10,7,3,1173
E01012545,1153,14,28,4,5,1204
E01012546,1115,10,7,4,1,1137
E01012547,1371,5,6,5,2,1389
E01012548,1450,4,7,3,3,1467
E01012549,1190,4,2,2,2,1200
E01012550,1342,5,3,1,2,1353
E01012551,1227,2,25,3,3,1260
E01012552,1100,12,29,2,2,1145
E01012553,1086,5,10,1,0,1102
E01012554,1617,6,15,3,0,1641
E01012555,1146,7,13,0,4,1170
E01012556,1260,1,14,3,2,1280
E01012557,1259,15,22,2,2,1300
E01012558,1364,13,22,0,0,1399
E01012559,1224,5,15,3,3,1250
E01012560,1159,8,14,0,3,1184
E01012561,1218,5,53,0,4,1280
E01012562,1211,16,96,9,10,1342
E01012563,1292,8,94,6,4,1404
E01012564,1123,6,28,11,7,1175
E01012565,1707,10,142,8,3,1870
E01012566,1330,10,197,12,8,1557
E01012567,1345,16,51,1,6,1419
E01012568,1713,15,130,12,3,1873
E01012569,1368,7,100,8,8,1491
E01012570,974,9,38,4,1,1026
E01012571,235,10,713,18,36,1012
E01012572,220,17,830,11,24,1102
E01012573,110,14,1100,9,10,1243
E01012574,594,10,451,6,8,1069
E01012575,435,8,495,11,26,975
E01012576,510,9,674,18,19,1230
E01012577,162,15,1064,9,14,1264
E01012578,168,8,1180,3,7,1366
E01012579,278,25,868,10,30,1211
E01012580,33,3,1461,16,25,1538
E01012581,818,4,174,3,4,1003
E01012582,730,9,497,9,32,1277
E01012583,1011,15,286,1,9,1322
E01012584,745,11,384,11,15,1166
E01012585,528,15,696,1,20,1260
E01012586,409,10,775,11,17,1222
E01012587,782,16,658,3,14,1473
E01012588,385,15,967,2,37,1406
E01012589,1088,8,48,3,4,1151
E01012590,1031,12,28,5,4,1080
E01012591,1242,9,25,3,3,1282
E01012592,1623,10,12,1,5,1651
E01012593,1342,9,32,8,3,1394
E01012594,1052,9,15,4,3,1083
E01012595,1374,28,60,11,9,1482
E01012596,1231,23,111,19,9,1393
E01012597,1349,9,35,3,1,1397
E01012598,2074,18,71,9,6,2178
E01012599,949,4,10,4,1,968
E01012600,1045,5,48,3,2,1103
E01012601,1066,13,29,4,2,1114
E01012602,1205,4,32,7,6,1254
E01012603,1106,13,15,10,0,1144
E01012604,1053,15,108,24,28,1228
E01012605,232,28,1038,7,9,1314
E01012606,287,7,805,3,7,1109
E01012607,935,13,271,6,5,1230
E01012608,1029,17,215,8,4,1273
E01012609,1323,6,3,4,4,1340
E01012610,993,8,10,1,3,1015
E01012611,893,2,10,0,2,907
E01012612,1191,1,4,1,2,1199
E01012613,1117,6,14,3,0,1140
E01012614,1343,6,38,5,1,1393
E01012615,1218,5,28,5,1,1257
E01012616,1395,14,9,2,6,1426
E01012617,1067,6,32,6,1,1112
E01012618,1224,10,7,8,6,1255
E01012619,989,9,13,4,2,1017
E01012620,1198,1,12,1,1,1213
E01012621,1104,9,30,7,6,1156
E01012622,983,22,200,22,9,1236
E01012623,1127,12,52,0,5,1196
E01012624,1212,10,6,6,0,1234
E01012625,1241,10,15,2,3,1271
E01012628,964,9,9,1,3,986
E01012629,600,9,250,8,7,874
E01012630,204,11,1240,7,69,1531
E01012631,676,12,246,10,11,955
E01012632,924,27,612,12,32,1607
E01012633,1196,11,106,3,1,1317
E01012634,890,7,192,10,5,1104
E01012635,665,24,544,5,5,1243
E01012636,1257,3,21,5,2,1288
E01012637,1108,7,17,7,5,1144
E01012638,1121,14,44,16,28,1223
E01012639,1129,7,154,9,5,1304
E01012640,1054,12,263,3,7,1339
E01012641,742,13,337,19,20,1131
E01012642,258,14,943,12,27,1254
E01012643,345,12,820,6,28,1211
E01012644,176,24,1678,10,26,1914
E01012645,426,17,943,3,8,1397
E01012646,1210,11,45,2,2,1270
E01012647,1044,13,32,6,2,1097
E01012648,869,3,31,7,5,915
E01012649,1053,6,63,19,4,1145
E01012650,903,11,111,5,11,1041
E01012651,1270,6,31,1,3,1311
E01012652,1301,3,14,1,6,1325
E01012653,997,12,20,2,0,1031
E01012654,1183,10,110,5,7,1315
E01012655,1138,23,225,44,47,1477
E01012656,495,22,658,20,22,1217
E01012657,556,14,807,28,30,1435
E01012658,1129,12,256,6,10,1413
E01012659,1125,5,19,6,3,1158
E01012660,946,3,17,1,0,967
E01012661,1191,9,16,2,1,1219
E01012662,1294,8,12,3,2,1319
E01012663,1303,4,8,5,0,1320
E01012664,1318,6,9,3,1,1337
E01012665,1441,2,7,2,1,1453
E01012666,1233,10,15,2,6,1266
E01012667,1283,6,1,2,7,1299
E01012668,1320,10,11,3,1,1345
E01012669,1499,17,17,3,4,1540
E01012670,920,11,15,6,10,962
E01012671,1138,21,22,2,4,1187
E01012672,1069,20,36,5,1,1131
E01012673,1037,25,44,8,3,1117
E01012674,1244,24,44,5,1,1318
E01012675,1097,14,45,5,6,1167
E01012676,1062,9,52,0,7,1130
E01012677,1073,15,36,5,7,1136
E01012678,1075,22,23,4,2,1126
E01012679,1029,32,19,3,5,1088
E01012680,1170,15,26,1,2,1214
E01012681,1324,30,44,5,8,1411
E01012682,1115,13,18,9,9,1164
E01012683,1113,22,40,2,6,1183
E01012684,1099,12,17,5,6,1139
E01012685,1121,13,4,2,0,1140
E01012686,1081,6,7,3,1,1098
E01012687,1085,5,4,1,3,1098
E01012688,1029,8,32,3,5,1077
E01012689,1070,10,4,1,0,1085
E01012690,1371,10,13,1,2,1397
E01012691,1450,15,14,6,1,1486
E01012692,1378,12,16,5,0,1411
E01012693,1277,3,21,2,1,1304
E01012694,1067,12,8,2,1,1090
E01012695,1057,11,9,6,2,1085
E01012696,1174,4,17,0,1,1196
E01012697,1148,11,4,1,3,1167
E01012698,1131,12,17,0,0,1160
E01012699,1380,13,17,3,1,1414
E01012700,1451,9,17,3,2,1482
E01012701,1164,4,6,1,5,1180
E01012702,1239,5,12,2,1,1259
E01012703,1252,6,7,1,1,1267
E01012704,1602,15,23,4,3,1647
E01012705,1250,4,14,2,0,1270
E01012706,1305,4,9,1,1,1320
E01012707,993,10,18,5,3,1029
E01012708,1048,10,31,2,0,1091
E01012709,1178,12,32,0,3,1225
E01012710,972,11,55,0,3,1041
E01012711,1115,4,11,4,2,1136
E01012712,1351,9,10,0,2,1372
E01012713,1487,11,25,1,1,1525
E01012714,1417,10,3,2,2,1434
E01012715,1238,12,8,3,1,1262
E01012716,1215,8,9,2,0,1234
E01012717,1406,1,4,1,1,1413
E01012718,1408,2,11,2,0,1423
E01012719,1177,4,7,2,1,1191
E01012720,1129,8,13,3,0,1153
E01012721,1257,14,8,4,3,1286
E01012722,955,7,80,10,12,1064
E01012723,1161,14,22,3,4,1204
E01012724,981,9,1,3,3,997
E01012725,1226,5,8,1,0,1240
E01012726,1478,9,7,3,1,1498
E01012727,1335,8,8,1,0,1352
E01012728,1232,10,19,8,6,1275
E01012729,1346,6,7,2,7,1368
E01012730,1364,9,14,3,1,1391
E01012731,1286,13,11,3,5,1318
E01012732,1393,10,15,2,1,1421
E01012733,797,12,11,2,3,825
E01012734,1111,8,16,4,4,1143
E01012735,1131,11,15,13,11,1181
E01012736,1224,19,25,10,7,1285
E01012737,1202,19,26,5,12,1264
E01012738,931,8,35,8,5,987
E01012739,1049,4,17,2,0,1072
E01012740,1270,12,17,1,1,1301
E01012741,1102,7,10,0,5,1124
E01012742,937,7,19,3,1,967
E01012743,1293,11,24,5,8,1341
E01012744,1235,16,18,2,2,1273
E01012745,1344,16,5,2,3,1370
E01012746,1374,14,26,5,2,1421
E01012747,1237,8,9,2,3,1259
E01012748,1346,16,28,7,5,1402
E01012749,1418,15,19,6,5,1463
E01012750,1384,6,22,2,4,1418
E01012751,1225,30,45,9,5,1314
E01012752,1158,8,15,0,2,1183
E01012753,955,4,13,1,1,974
E01012754,932,11,20,1,2,966
E01012755,1219,9,5,3,2,1238
E01012756,1219,22,20,8,9,1278
E01012757,1170,19,71,16,14,1290
E01012758,1220,28,51,21,8,1328
E01012759,1295,15,43,10,9,1372
E01012760,1127,17,59,14,15,1232
E01012761,1327,21,114,62,36,1560
E01012762,1224,24,64,10,4,1326
E01012763,1471,62,157,40,38,1768
E01012764,1002,1,15,3,3,1024
E01012765,1194,7,12,1,4,1218
E01012766,1156,8,25,4,3,1196
E01012767,1389,22,67,26,16,1520
E01012768,1185,3,10,6,6,1210
E01012769,1162,7,9,7,3,1188
E01012770,1201,4,8,0,2,1215
E01012771,1236,9,17,7,1,1270
E01012772,1160,4,25,4,1,1194
E01012773,1350,6,11,5,0,1372
E01012774,1210,15,11,6,1,1243
E01012775,1165,7,3,3,0,1178
E01012776,1193,2,10,1,1,1207
E01012777,1242,6,18,1,2,1269
E01012778,1059,11,0,2,1,1073
E01012779,892,6,2,9,0,909
E01012780,1099,6,2,4,3,1114
E01012781,872,6,2,6,0,886
E01012782,1044,6,2,4,5,1061
E01012783,887,4,4,1,0,896
E01012784,1512,7,4,4,5,1532
E01012785,941,5,2,4,0,952
E01012786,988,6,4,3,1,1002
E01012787,1159,6,1,3,4,1173
E01012788,1101,9,3,2,0,1115
E01012789,1013,1,3,5,2,1024
E01012790,1097,2,1,3,3,1106
E01012791,1358,5,21,2,10,1396
E01012792,1238,13,21,3,4,1279
E01012793,1194,11,44,20,10,1279
E01012794,1249,8,17,11,10,1295
E01012795,1538,11,13,13,6,1581
E01012796,1083,5,5,2,3,1098
E01012797,1106,8,2,6,4,1126
E01012798,1293,5,6,12,0,1316
E01012799,1011,5,3,3,0,1022
E01012800,1253,6,4,1,3,1267
E01012801,1185,5,5,0,6,1201
E01012802,1149,13,6,0,1,1169
E01012803,1155,3,4,0,3,1165
E01012804,1226,8,9,2,3,1248
E01012805,1083,7,19,9,4,1122
E01012806,1154,12,11,10,2,1189
E01012807,1140,8,7,3,0,1158
E01012808,1349,10,44,18,7,1428
E01012809,1359,22,62,22,22,1487
E01012810,1401,16,82,28,22,1549
E01012811,1211,21,115,12,31,1390
E01012812,1143,5,9,1,0,1158
E01012813,1426,4,8,0,5,1443
E01012814,1257,7,4,1,0,1269
E01012815,1273,2,3,4,3,1285
E01012816,1123,13,8,4,0,1148
E01012817,1117,9,17,5,1,1149
E01012818,1028,5,0,1,5,1039
E01012819,1167,2,12,0,2,1183
E01012820,1095,7,2,7,2,1113
E01012821,1017,8,5,6,0,1036
E01012822,1236,3,5,0,2,1246
E01012823,1075,5,4,8,1,1093
E01012824,1380,5,9,5,3,1402
E01012825,1251,12,10,2,6,1281
E01012826,1219,1,5,4,1,1230
E01012827,1325,3,11,3,3,1345
E01012828,1251,3,10,1,5,1270
E01012829,1324,4,7,6,0,1341
E01012830,1217,9,5,9,2,1242
E01012832,1059,5,6,5,7,1082
E01012833,1145,7,3,5,5,1165
E01012834,1181,6,5,3,3,1198
E01012835,1015,3,2,1,0,1021
E01012836,1253,4,6,4,1,1268
E01012837,1340,5,8,6,1,1360
E01012838,1060,8,6,6,0,1080
E01012839,1016,5,13,5,2,1041
E01012840,1142,7,8,3,0,1160
E01012841,1104,15,7,7,1,1134
E01012842,1111,5,7,3,0,1126
E01012843,1131,9,8,5,2,1155
E01012844,1007,5,7,0,3,1022
E01012845,1126,9,11,1,1,1148
E01012846,1110,7,4,3,0,1124
E01012847,929,7,4,4,0,944
E01012848,1594,20,32,18,9,1673
E01012849,1205,9,4,6,1,1225
E01012850,1260,43,101,86,63,1553
E01012851,1722,73,138,67,97,2097
E01012852,1159,33,105,54,41,1392
E01012854,1429,61,139,98,111,1838
E01012855,1220,42,99,49,60,1470
E01012856,1181,27,47,27,16,1298
E01012857,1146,23,84,26,20,1299
E01012858,1323,20,20,13,8,1384
E01012859,1048,14,62,7,15,1146
E01012860,1240,12,22,10,5,1289
E01012862,1043,11,25,2,7,1088
E01012863,1093,15,37,8,9,1162
E01012864,1215,18,46,27,11,1317
E01012865,1029,11,50,14,11,1115
E01012866,1166,14,127,31,21,1359
E01012867,1142,29,49,47,29,1296
E01012868,1316,31,192,62,23,1624
E01012869,1343,24,177,47,28,1619
E01012870,1191,29,218,57,26,1521
E01012871,1369,19,93,43,27,1551
E01012872,1379,29,194,73,24,1699
E01012873,1084,11,17,12,9,1133
E01012874,1105,7,14,19,3,1148
E01012875,1024,14,10,16,6,1070
E01012876,1153,11,10,40,8,1222
E01012877,948,11,6,16,4,985
E01012878,1170,6,10,10,6,1202
E01012879,1026,15,10,1,4,1056
E01012880,1215,9,6,27,7,1264
E01012881,1108,9,8,27,2,1154
E01012882,1331,3,2,4,3,1343
E01012883,1307,6,23,5,1,1342
E01012884,1466,9,16,4,1,1496
E01012886,1242,9,20,7,2,1280
E01012887,1127,11,14,4,6,1162
E01012888,1163,9,26,17,10,1225
E01012889,1049,16,16,5,17,1103
E01012891,1543,42,114,71,44,1814
E01012892,1382,31,26,35,11,1485
E01012893,1145,13,35,14,13,1220
E01012894,1241,6,6,6,0,1259
E01012895,1059,9,5,4,1,1078
E01012896,1583,14,15,13,6,1631
E01012897,1108,10,5,6,7,1136
E01012898,1133,3,5,1,7,1149
E01012899,1240,9,3,8,2,1262
E01012900,1275,10,17,11,10,1323
E01012901,1201,5,5,3,6,1220
E01012902,1268,3,11,5,0,1287
E01012903,1387,10,17,22,1,1437
E01012904,1261,3,9,3,0,1276
E01012905,1051,6,2,2,0,1061
E01012906,1201,4,3,2,2,1212
E01012907,1122,1,2,7,1,1133
E01012908,954,5,0,0,0,959
E01012909,1088,3,4,3,1,1099
E01012910,1009,1,2,7,0,1019
E01012911,1002,4,4,3,1,1014
E01012912,1484,8,11,8,0,1511
E01012913,1347,25,67,38,52,1529
E01012914,1356,57,424,167,52,2056
E01012915,1084,22,18,30,10,1164
E01012916,1111,12,140,31,26,1320
E01012917,1226,18,37,21,13,1315
E01012918,1112,7,37,11,10,1177
E01012919,1260,5,9,1,2,1277
E01012920,1194,4,5,0,0,1203
E01012921,908,7,3,1,3,922
E01012922,1247,4,8,1,0,1260
E01012923,1242,6,30,9,1,1288
E01012924,1404,7,11,0,4,1426
E01012925,1083,0,6,1,0,1090
E01012926,2034,4,13,3,1,2055
E01012927,1324,2,14,1,1,1342
E01012928,1256,7,6,1,0,1270
E01012929,1495,4,13,0,0,1512
E01012930,1194,3,6,0,2,1205
E01012931,1332,6,4,2,0,1344
E01012932,1249,5,9,0,2,1265
E01012933,920,2,1,0,0,923
E01012934,1319,5,1,1,2,1328
E01012935,1176,9,1,0,0,1186
E01012936,1258,0,3,4,1,1266
E01012937,1918,4,9,1,0,1932
E01012938,1939,3,4,1,2,1949
E01012939,1518,6,7,2,1,1534
E01012940,1473,3,7,1,4,1488
E01012941,1252,1,3,0,1,1257
E01012942,1132,1,3,0,0,1136
E01012943,1295,9,4,8,0,1316
E01012944,1167,20,9,5,0,1201
E01012945,1254,8,12,5,0,1279
E01012946,1236,10,8,4,1,1259
E01012947,1156,5,9,2,1,1173
E01012948,1169,8,9,2,0,1188
E01012949,1143,5,16,2,1,1167
E01012950,1225,2,9,1,1,1238
E01012951,1158,4,7,2,0,1171
E01012952,1219,5,2,6,2,1234
E01012953,896,6,19,2,4,927
E01012954,1002,9,37,4,12,1064
E01012955,1282,7,11,3,5,1308
E01012956,982,3,11,7,2,1005
E01012957,2265,38,58,30,8,2399
E01012958,905,3,23,1,0,932
E01012959,1198,4,8,8,0,1218
E01012960,1390,5,14,5,8,1422
E01012961,1262,12,23,2,2,1301
E01012962,972,4,9,1,5,991
E01012963,1214,5,18,0,1,1238
E01012964,1360,6,12,3,1,1382
E01012965,861,3,13,2,0,879
E01012966,1133,4,11,3,1,1152
E01012967,1279,8,27,1,0,1315
E01012968,1369,7,22,3,0,1401
E01012969,1526,40,53,23,4,1646
E01012970,1214,5,16,3,4,1242
E01012972,1219,2,12,5,2,1240
E01012973,2093,12,53,10,12,2180
E01012974,1235,2,22,2,6,1267
E01012975,1303,2,4,2,0,1311
E01012976,1176,1,6,3,1,1187
E01012977,2044,8,12,0,1,2065
E01012978,1228,1,1,0,0,1230
E01012979,1277,8,6,0,2,1293
E01012980,1521,12,9,6,5,1553
E01012981,1203,3,0,0,1,1207
E01012982,1381,7,5,1,2,1396
E01012983,1453,9,8,2,1,1473
E01012984,1396,2,4,1,0,1403
E01012985,1380,1,3,1,2,1387
E01012986,1366,5,3,0,0,1374
E01012987,1402,6,2,0,1,1411
E01012988,1228,4,6,2,0,1240
E01012989,1480,3,1,0,0,1484
E01012990,1157,3,3,0,0,1163
E01012991,1313,3,5,0,1,1322
E01012992,1259,9,1,0,0,1269
E01012993,1221,5,8,2,1,1237
E01012994,1423,5,7,2,0,1437
E01012995,1459,7,8,0,0,1474
E01012996,1318,1,9,1,0,1329
E01012997,1494,7,14,1,12,1528
E01012998,1769,7,14,2,4,1796
E01012999,1297,15,27,5,9,1353
E01013000,1475,14,10,3,8,1510
E01013001,1465,3,4,0,1,1473
E01013002,1242,9,7,2,2,1262
E01013003,1217,6,5,2,1,1231
E01013004,1268,10,3,3,1,1285
E01013005,1244,6,25,0,6,1281
E01013006,1186,8,10,2,3,1209
E01013007,1244,6,27,0,4,1281
E01013008,1203,9,6,0,1,1219
E01013009,1246,4,14,3,7,1274
E01013010,1206,11,8,2,1,1228
E01013011,1213,3,15,0,4,1235
E01013012,1079,3,56,6,6,1150
E01013013,1229,5,14,1,0,1249
E01013014,1181,8,13,2,1,1205
E01013015,1278,5,14,0,3,1300
E01013016,1411,1,9,0,0,1421
E01013017,1331,4,5,2,0,1342
E01013018,1488,5,4,0,0,1497
E01013019,987,6,5,4,1,1003
E01013020,1455,5,5,0,1,1466
E01013021,1267,4,10,0,4,1285
E01013022,1551,5,1,1,2,1560
E01013023,1555,3,4,2,2,1566
E01013024,1479,11,1,0,1,1492
E01013025,1108,5,4,0,0,1117
E01013026,1373,4,3,1,0,1381
E01013027,1409,12,7,1,0,1429
E01013028,1292,3,9,1,0,1305
E01013029,1225,1,4,0,1,1231
E01013030,1270,1,5,0,0,1276
E01013031,1313,6,3,1,3,1326
E01013032,1234,2,3,2,1,1242
E01013033,1291,2,5,2,1,1301
E01013034,1448,1,4,1,0,1454
E01013035,1134,4,0,0,2,1140
E01013036,1260,12,24,7,3,1306
E01013037,1201,5,9,1,0,1216
E01013038,1133,4,8,2,0,1147
E01013039,1476,11,17,2,1,1507
E01013040,1596,12,21,6,2,1637
E01013041,1390,8,3,5,1,1407
E01013042,1281,13,24,5,4,1327
E01013043,1113,10,19,5,7,1154
E01013044,1287,3,11,1,1,1303
E01013045,1151,7,11,1,2,1172
E01013046,1456,9,1,0,4,1470
E01013047,1366,8,8,4,2,1388
E01013048,1708,1,2,1,0,1712
E01013049,1364,2,9,4,3,1382
E01013050,1429,4,4,0,1,1438
E01013051,1236,6,2,0,2,1246
E01013052,1265,2,11,1,0,1279
E01013053,1219,3,3,3,2,1230
E01013054,1493,8,33,6,0,1540
E01013055,1255,6,12,0,0,1273
E01013056,1329,4,7,2,2,1344
E01013057,1228,6,7,2,0,1243
E01013058,1109,3,1,3,4,1120
E01013059,1324,9,4,3,2,1342
E01013060,1578,10,13,3,2,1606
E01013061,1315,10,9,1,3,1338
E01013062,1428,8,28,1,2,1467
E01013063,1264,4,4,0,0,1272
E01013064,1118,14,16,0,2,1150
E01013065,1405,5,8,1,1,1420
E01013066,1337,4,8,0,3,1352
E01013067,1358,9,26,1,4,1398
E01013068,1233,6,6,0,2,1247
E01013069,1298,6,16,1,0,1321
E01013070,1272,7,14,0,1,1294
E01013071,1332,13,11,4,2,1362
E01013072,1356,4,3,0,0,1363
E01013073,1321,4,6,0,1,1332
E01013074,1384,5,2,0,1,1392
E01013075,1097,7,1,1,0,1106
E01013076,1219,3,1,1,0,1224
E01013077,1629,5,1,0,0,1635
E01013078,1204,3,1,0,0,1208
E01013079,1311,3,4,1,2,1321
E01013080,1029,5,4,1,1,1040
E01013081,1274,4,6,0,4,1288
E01013082,1349,3,5,2,0,1359
E01013083,1176,3,10,2,0,1191
E01013084,1176,4,0,2,1,1183
E01013085,1357,4,6,4,2,1373
E01013086,1286,5,6,1,2,1300
E01013087,1115,6,5,1,0,1127
E01013088,1312,7,30,7,2,1358
E01013089,1346,6,33,3,4,1392
E01013090,1150,6,17,3,0,1176
E01013091,1259,6,33,6,2,1306
E01013092,1568,4,30,1,5,1608
E01013093,1184,2,41,1,6,1234
E01013094,1179,1,2,1,0,1183
E01013095,1340,3,6,2,0,1351
E01013096,1352,4,9,2,1,1368
E01013097,1216,5,1,1,0,1223
E01013098,1753,7,7,3,1,1771
E01013099,1116,5,1,0,0,1122
E01013100,1419,2,1,0,0,1422
E01013101,1374,2,4,1,1,1382
E01013102,1237,1,6,0,1,1245
E01013103,1197,3,3,0,0,1203
E01013104,1056,8,0,0,0,1064
E01013105,1149,6,8,6,1,1170
E01013106,920,3,8,0,2,933
E01013107,1248,9,6,1,3,1267
E01013108,1282,12,25,1,8,1328
E01013110,1221,6,13,1,13,1254
E01013111,1177,11,8,1,4,1201
E01013112,1221,2,12,4,3,1242
E01013113,1282,4,14,3,0,1303
E01013114,1252,5,25,4,4,1290
E01013115,1220,8,16,2,4,1250
E01013116,1251,7,32,0,0,1290
E01013117,1248,13,20,5,1,1287
E01013118,1222,5,26,2,2,1257
E01013119,1220,3,5,0,2,1230
E01013120,1635,3,10,3,1,1652
E01013121,1563,5,7,4,1,1580
E01013122,1218,3,2,1,0,1224
E01013123,1262,1,6,5,3,1277
E01013124,1681,7,12,2,4,1706
E01013125,1415,2,1,1,1,1420
E01013126,1653,40,64,64,8,1829
E01013127,1207,5,6,0,2,1220
E01013128,1114,6,43,1,2,1166
E01013129,1155,11,69,8,12,1255
E01013130,1138,3,9,3,1,1154
E01013131,1231,7,13,6,2,1259
E01013132,1188,5,10,3,3,1209
E01013133,1254,9,22,2,1,1288
E01013134,1222,0,6,1,3,1232
E01013135,1267,3,5,1,2,1278
E01013136,1231,18,19,12,12,1292
E01013137,1233,19,38,8,22,1320
E01013138,994,8,19,2,8,1031
E01013139,948,7,5,3,3,966
E01013140,1155,9,13,5,5,1187
E01013141,1201,11,7,3,0,1222
E01013142,1242,5,23,7,9,1286
E01013143,1030,2,9,2,3,1046
E01013144,1168,5,4,0,3,1180
E01013145,1082,3,4,1,1,1091
E01013146,1325,11,8,1,5,1350
E01013147,1089,9,5,4,0,1107
E01013148,1213,1,3,0,2,1219
E01013149,963,1,8,3,1,976
E01013150,1087,4,7,3,3,1104
E01013151,1056,4,4,0,2,1066
E01013152,1235,7,6,1,4,1253
E01013153,1168,5,11,0,2,1186
E01013154,1209,2,3,2,0,1216
E01013155,1151,3,8,0,3,1165
E01013156,1110,3,6,0,0,1119
E01013157,1450,3,8,7,2,1470
E01013158,1152,6,7,1,2,1168
E01013159,1100,8,11,7,0,1126
E01013160,1235,3,9,2,1,1250
E01013161,1014,6,9,4,4,1037
E01013162,1188,7,23,7,3,1228
E01013163,1159,3,4,0,1,1167
E01013164,1432,11,21,0,3,1467
E01013165,1013,2,25,6,4,1050
E01013166,1351,6,8,1,2,1368
E01013167,1521,4,8,7,1,1541
E01013168,1377,2,48,5,11,1443
E01013169,929,3,2,0,0,934
E01013170,1245,3,5,3,2,1258
E01013171,1285,7,36,11,11,1350
E01013172,1263,6,14,1,9,1293
E01013173,1041,3,3,5,1,1053
E01013174,955,8,3,0,3,969
E01013175,1158,7,7,2,5,1179
E01013176,1106,8,10,3,6,1133
E01013177,1261,6,14,1,5,1287
E01013178,1223,4,0,2,1,1230
E01013179,1238,3,2,2,0,1245
E01013180,1208,6,11,3,1,1229
E01013181,1081,8,35,7,4,1135
E01013182,1282,8,69,0,2,1361
E01013183,1245,10,10,0,2,1267
E01013184,1237,18,29,14,9,1307
E01013185,1119,16,138,17,15,1305
E01013186,1087,4,25,2,5,1123
E01013187,1187,5,45,4,4,1245
E01013188,1332,6,16,1,3,1358
E01013189,1227,2,16,3,1,1249
E01013190,2040,15,93,12,13,2173
E01013191,1305,5,18,2,2,1332
E01013192,1190,3,16,1,2,1212
E01013193,1361,1,5,0,0,1367
E01013194,1220,8,12,0,3,1243
E01013195,1079,2,7,3,1,1092
E01013196,1034,6,2,2,6,1050
E01013197,1017,1,13,5,2,1038
E01013198,1152,11,11,1,5,1180
E01013199,952,5,4,6,7,974
E01013200,1034,2,1,1,3,1041
E01013201,1125,10,17,7,1,1160
E01013202,1125,9,7,1,4,1146
E01013203,1231,7,9,1,5,1253
E01013204,1090,2,14,10,3,1119
E01013205,937,9,8,3,3,960
E01013206,1071,2,2,2,0,1077
E01013207,1124,6,14,1,1,1146
E01013208,942,1,3,1,2,949
E01013209,1113,4,4,1,1,1123
E01013210,963,9,3,0,1,976
E01013211,1196,6,13,2,2,1219
E01013212,1010,2,5,1,3,1021
E01013213,1050,3,6,2,4,1065
E01013214,1234,3,11,3,4,1255
E01013215,1304,8,24,6,10,1352
E01013216,1031,0,11,0,0,1042
E01013217,1211,5,4,0,0,1220
E01013218,1039,14,20,4,6,1083
E01013219,1079,10,15,2,4,1110
E01013220,1225,10,18,8,1,1262
E01013221,1399,12,22,2,5,1440
E01013222,1164,14,40,5,3,1226
E01013223,2261,9,55,6,4,2335
E01013224,1488,8,18,2,0,1516
E01013225,924,2,16,5,0,947
E01013226,1236,6,13,1,1,1257
E01013227,1353,10,5,5,2,1375
E01013228,1262,10,17,1,2,1292
E01013229,1092,7,8,5,2,1114
E01013231,1281,6,6,6,5,1304
E01013233,1163,2,5,0,2,1172
E01013234,1172,6,5,3,0,1186
E01013236,1298,2,7,0,1,1308
E01013237,1288,8,23,3,0,1322
E01013238,1339,2,20,2,2,1365
E01013239,1346,6,29,0,4,1385
E01013240,1823,9,36,6,4,1878
E01013241,1299,2,7,1,4,1313
E01013242,1434,8,18,4,1,1465
E01013243,1699,4,16,2,6,1727
E01013244,1419,5,3,0,1,1428
E01013245,1122,4,12,2,1,1141
E01013246,1253,6,10,0,0,1269
E01013247,1434,7,7,1,0,1449
E01013248,1483,5,25,1,0,1514
E01013249,1388,2,4,3,1,1398
E01013250,1351,3,6,2,1,1363
E01013251,1542,3,9,2,1,1557
E01013252,1393,6,14,0,1,1414
E01013253,1573,4,7,2,0,1586
E01013254,1408,2,5,1,1,1417
E01013255,1438,8,11,1,3,1461
E01013256,1945,11,8,3,5,1972
E01013257,1488,7,8,1,0,1504
E01013258,1304,2,6,0,0,1312
E01013259,1273,5,9,4,0,1291
E01013260,1272,3,11,1,1,1288
E01013261,1218,4,9,0,1,1232
E01013262,1132,5,12,0,5,1154
E01013263,1235,5,7,1,2,1250
E01013264,1393,7,11,5,1,1417
E01013265,1393,4,14,1,2,1414
E01013266,1549,3,28,1,3,1584
E01013267,1017,7,7,0,0,1031
E01013268,1027,7,3,1,0,1038
E01013269,1449,6,14,2,0,1471
E01013270,1551,5,14,4,0,1574
E01013271,1468,7,16,6,4,1501
E01013272,1398,8,29,1,5,1441
E01013273,1470,7,12,0,5,1494
E01013274,1713,10,29,4,10,1766
E01013275,1263,11,4,0,0,1278
E01013276,1321,5,7,0,4,1337
E01013277,1245,2,1,2,0,1250
E01013278,1097,7,10,2,1,1117
E01013279,1168,10,19,1,3,1201
E01013280,1176,4,17,3,2,1202
E01013281,999,5,8,3,0,1015
E01013282,1197,4,16,4,7,1228
E01013283,1036,6,32,0,4,1078
E01013284,1229,11,9,3,2,1254
E01013285,1028,4,29,0,2,1063
E01013286,1943,15,35,1,2,1996
E01013287,1279,7,10,0,1,1297
E01013288,1271,3,14,1,1,1290
E01013289,1283,8,61,6,3,1361
E01013290,1404,7,16,0,2,1429
E01013291,1145,3,0,2,2,1152
E01013292,1445,3,3,0,0,1451
E01013293,1259,9,15,0,1,1284
E01013294,1293,5,5,1,0,1304
E01013295,1127,0,36,1,3,1167
E01013296,1006,20,162,27,23,1238
E01013297,1700,18,69,13,1,1801
E01013298,985,11,59,27,16,1098
E01013299,1123,11,37,10,5,1186
E01013300,1017,22,272,16,9,1336
E01013301,1203,13,62,5,9,1292
E01013302,1085,5,110,15,6,1221
E01013303,1075,7,4,2,2,1090
E01013304,1315,5,3,3,0,1326
E01013305,1340,2,6,1,1,1350
E01013306,1243,5,8,0,1,1257
E01013307,1428,4,6,5,1,1444
E01013308,1420,4,11,2,4,1441
E01013309,1322,3,19,1,2,1347
E01013310,1132,3,37,0,0,1172
E01013311,1347,13,12,4,2,1378
E01013312,1337,4,50,8,5,1404
E01013313,1225,10,28,0,5,1268
E01013314,1183,3,22,2,6,1216
E01013315,1286,4,6,1,2,1299
E01013316,1173,1,42,5,1,1222
E01013317,1125,7,25,1,1,1159
E01013318,1180,9,24,3,6,1222
E01013319,1624,13,23,4,0,1664
E01013320,1173,3,24,2,0,1202
E01013321,1343,8,23,8,3,1385
E01013322,1547,5,9,0,0,1561
E01013323,1388,6,15,2,0,1411
E01013324,1272,4,24,0,0,1300
E01013325,1319,7,16,2,3,1347
E01013326,1327,4,6,4,10,1351
E01013327,1223,1,8,1,0,1233
E01013328,1023,5,14,2,0,1044
E01013329,1453,4,7,1,1,1466
E01013330,1143,16,194,23,22,1398
E01013331,1318,7,67,15,7,1414
E01013332,1000,26,355,19,17,1417
E01013333,862,9,352,10,19,1252
E01013334,1173,5,74,5,3,1260
E01013335,1210,10,10,4,2,1236
E01013336,1210,4,6,1,4,1225
E01013337,1326,8,17,2,1,1354
E01013338,1828,7,12,3,3,1853
E01013339,1262,5,11,3,3,1284
E01013340,997,2,13,5,0,1017
E01013341,1051,4,13,0,1,1069
E01013342,1165,2,8,1,0,1176
E01013343,1599,22,118,28,14,1781
E01013344,1278,10,38,11,2,1339
E01013345,1419,20,54,16,5,1514
E01013346,1368,7,42,7,6,1430
E01013347,1201,15,46,3,5,1270
E01013348,1586,19,84,14,19,1722
E01013349,959,1,26,14,2,1002
E01013350,1214,8,83,18,14,1337
E01013351,1554,4,9,1,1,1569
E01013352,1407,8,5,3,1,1424
E01013353,1272,13,19,9,2,1315
E01013354,1185,9,12,4,3,1213
E01013355,1284,5,21,3,4,1317
E01013356,1216,8,12,1,2,1239
E01013357,1583,7,16,3,2,1611
E01013358,1278,3,11,2,0,1294
E01013359,1209,5,14,5,2,1235
E01013360,1133,21,221,19,32,1426
E01013361,1509,25,85,16,12,1647
E01013362,1580,20,116,10,11,1737
E01013363,1650,23,189,46,19,1927
E01013364,1628,35,136,22,22,1843
E01013365,2203,13,105,6,10,2337
E01013366,1604,23,162,25,11,1825
E01013368,1842,40,105,10,12,2009
E01013369,1595,20,70,7,17,1709
E01013370,1273,1,18,4,0,1296
E01013371,1176,7,30,1,0,1214
E01013372,1401,3,11,0,1,1416
E01013373,1204,6,3,4,0,1217
E01013374,1255,7,10,0,0,1272
E01013375,1123,5,9,2,1,1140
E01013376,1235,7,6,4,2,1254
E01013377,1367,1,2,0,0,1370
E01013378,3455,132,896,64,72,4619
E01013379,1169,8,25,1,4,1207
E01013380,1394,9,116,12,10,1541
E01013381,1248,9,18,2,2,1279
E01013382,1258,10,70,7,14,1359
E01013383,1796,37,88,19,52,1992
E01013384,1362,15,78,6,6,1467
E01013385,1133,13,25,3,6,1180
E01013386,1285,10,76,17,2,1390
E01013387,1242,2,8,3,2,1257
E01013388,917,1,5,5,0,928
E01013389,964,6,10,5,0,985
E01013390,1296,13,32,6,6,1353
E01013391,1768,11,58,23,7,1867
E01013392,1220,8,15,4,1,1248
E01013393,1267,11,13,4,5,1300
E01013394,1057,7,9,2,1,1076
E01013395,1179,5,8,1,2,1195
E01013396,1332,5,26,8,3,1374
E01013397,1197,11,16,4,2,1230
E01013398,1252,19,70,13,15,1369
E01013399,1213,21,49,15,8,1306
E01013400,1515,32,191,36,14,1788
E01013401,1316,33,87,21,15,1472
E01013402,1413,24,123,7,8,1575
E01013403,1553,22,139,17,10,1741
E01013404,1192,5,14,5,1,1217
E01013405,1171,8,13,1,5,1198
E01013406,1541,10,36,7,2,1596
E01013407,1232,5,11,1,0,1249
E01013408,1163,6,16,0,0,1185
E01013409,1312,1,14,1,1,1329
E01013410,1136,4,17,3,3,1163
E01013411,1309,5,11,0,1,1326
E01013412,1471,18,31,4,3,1527
E01013413,1301,14,34,9,14,1372
E01013414,1350,12,35,9,5,1411
E01013416,1239,24,52,8,8,1331
E01013417,1463,28,105,5,3,1604
E01013418,1285,13,32,16,3,1349
E01013419,1267,9,36,2,7,1321
E01013420,1629,15,41,4,15,1704
E01013421,1278,19,16,8,3,1324
E01013422,1263,6,39,0,0,1308
E01013423,1049,3,6,2,2,1062
E01013424,1053,9,8,11,0,1081
E01013425,1253,8,4,1,0,1266
E01013426,1387,8,8,0,1,1404
E01013427,1175,3,5,3,0,1186
E01013428,1266,11,25,5,5,1312
E01013429,1472,21,45,5,5,1548
E01013430,1274,11,11,1,1,1298
E01013431,1121,8,47,7,13,1196
E01013432,1622,11,36,3,2,1674
E01013433,1206,4,26,9,2,1247
E01013434,1200,10,23,1,5,1239
E01013435,1172,7,21,0,1,1201
E01013436,1261,11,52,18,4,1346
E01013437,1034,4,4,7,1,1050
E01013438,1398,7,10,3,4,1422
E01013439,1127,2,16,7,1,1153
E01013440,1507,9,15,3,3,1537
E01013441,1259,4,18,9,1,1291
E01013442,1135,2,5,2,0,1144
E01013443,1213,4,19,3,3,1242
E01013444,1040,12,9,3,4,1068
E01013445,1229,8,10,6,3,1256
E01013446,1278,8,29,5,1,1321
E01013447,1142,7,16,4,2,1171
E01013448,1007,6,8,21,3,1045
E01013449,1317,8,21,5,3,1354
E01013450,989,3,11,4,3,1010
E01013451,933,4,6,0,0,943
E01013452,1293,7,10,0,0,1310
E01013453,1813,62,91,95,16,2077
E01013454,1105,41,78,57,14,1295
E01013455,1310,29,183,31,13,1566
E01013456,1466,74,80,74,32,1726
E01013457,1316,33,89,59,21,1518
E01013458,791,21,500,43,23,1378
E01013459,556,40,733,82,26,1437
E01013460,1501,62,116,90,26,1795
E01013461,1310,8,17,3,20,1358
E01013462,1175,10,14,7,5,1211
E01013463,1175,4,51,4,1,1235
E01013464,1166,12,29,2,5,1214
E01013465,1307,10,12,15,3,1347
E01013466,1241,9,14,10,3,1277
E01013467,1091,8,20,14,6,1139
E01013468,1310,8,42,3,2,1365
E01013469,1115,7,35,13,18,1188
E01013470,1155,17,27,9,6,1214
E01013471,1227,38,86,62,16,1429
E01013472,1341,58,94,89,7,1589
E01013473,1082,19,64,24,6,1195
E01013474,1204,23,28,21,0,1276
E01013475,988,32,56,45,15,1136
E01013476,1175,23,31,17,1,1247
E01013477,1343,24,66,21,1,1455
E01013479,1417,73,170,125,78,1863
E01013480,1361,82,224,93,47,1807
E01013481,360,18,856,91,22,1347
E01013483,717,53,691,68,39,1568
E01013484,399,56,763,81,84,1383
E01013485,515,32,727,79,76,1429
E01013486,361,34,864,74,72,1405
E01013487,573,55,736,126,83,1573
E01013488,810,23,358,55,44,1290
E01013489,961,19,282,27,24,1313
E01013490,1017,18,188,24,14,1261
E01013491,742,20,412,79,44,1297
E01013492,923,35,279,49,21,1307
E01013493,768,26,314,92,30,1230
E01013494,1219,43,99,66,7,1434
E01013495,1032,41,226,55,32,1386
E01013496,1018,47,36,19,3,1123
E01013497,968,29,87,39,13,1136
E01013498,1151,11,14,15,1,1192
E01013499,1090,16,31,19,2,1158
E01013500,1334,17,38,23,3,1415
E01013501,1157,17,20,13,2,1209
E01013502,1049,16,30,22,5,1122
E01013503,1125,25,25,34,6,1215
E01013504,1204,27,83,52,12,1378
E01013505,1167,15,8,11,2,1203
E01013506,1292,24,8,4,6,1334
E01013507,1234,13,13,5,7,1272
E01013508,919,7,25,6,0,957
E01013509,1301,18,12,6,2,1339
E01013510,1121,16,17,6,3,1163
E01013511,1264,6,24,4,1,1299
E01013512,1098,15,23,20,17,1173
E01013513,969,6,6,12,0,993
E01013514,1244,11,51,8,7,1321
E01013515,1241,31,110,16,7,1405
E01013517,1128,9,56,27,0,1220
E01013518,1100,24,50,20,10,1204
E01013519,1007,29,73,19,3,1131
E01013520,1176,14,53,10,3,1256
E01013521,1060,8,26,34,1,1129
E01013522,1342,42,66,40,30,1520
E01013523,1270,27,42,35,29,1403
E01013524,2055,74,130,85,63,2407
E01013525,1602,31,49,35,26,1743
E01013526,1290,6,18,10,2,1326
E01013527,1191,7,17,7,3,1225
E01013528,1275,23,55,16,11,1380
E01013529,1828,32,56,26,9,1951
E01013530,1104,22,20,23,6,1175
E01013531,1079,17,12,15,2,1125
E01013532,1106,14,10,11,7,1148
E01013533,1150,18,19,14,1,1202
E01013534,1223,13,15,19,6,1276
E01013535,966,21,26,24,12,1049
E01013536,1117,21,16,31,5,1190
E01013537,1269,19,22,15,8,1333
E01013538,1155,12,31,23,2,1223
E01013539,898,20,703,44,103,1768
E01013540,999,11,222,28,21,1281
E01013541,854,40,213,50,14,1171
E01013542,1072,32,223,35,20,1382
E01013543,1131,14,204,6,23,1378
E01013544,1025,15,332,42,44,1458
E01013545,1034,25,203,41,15,1318
E01013546,1037,25,223,26,19,1330
E01013547,1422,29,52,33,25,1561
E01013548,1164,21,15,18,5,1223
E01013549,1104,13,10,21,1,1149
E01013550,936,14,26,21,3,1000
E01013551,1531,41,88,34,15,1709
E01013552,1239,23,21,26,6,1315
E01013553,1166,5,14,11,2,1198
E01013554,1270,23,72,45,11,1421
E01013555,1155,6,12,20,4,1197
E01013556,1101,14,42,17,2,1176
E01013557,1171,6,22,3,2,1204
E01013558,1448,14,111,32,14,1619
E01013559,1096,10,37,7,3,1153
E01013560,1114,5,103,12,13,1247
E01013561,1274,12,21,19,1,1327
E01013562,1183,9,24,10,6,1232
E01013563,1125,13,22,9,9,1178
E01013564,1538,22,72,19,9,1660
E01013565,414,25,638,52,44,1173
E01013566,446,31,756,91,124,1448
E01013567,396,36,811,102,82,1427
E01013568,532,33,741,128,72,1506
E01013569,368,47,583,91,63,1152
E01013570,630,53,566,91,60,1400
E01013571,931,53,333,68,30,1415
E01013572,952,38,311,68,27,1396
E01013573,979,95,208,156,30,1468
E01013574,1082,7,25,9,0,1123
E01013575,1085,7,45,10,4,1151
E01013576,1120,20,39,15,2,1196
E01013577,1155,11,37,10,4,1217
E01013578,1019,14,38,13,3,1087
E01013579,1105,15,39,16,3,1178
E01013580,1185,13,25,11,2,1236
E01013581,1067,19,16,11,1,1114
E01013582,1229,15,17,14,1,1276
E01013583,975,47,93,58,7,1180
E01013584,978,58,111,89,24,1260
E01013585,864,45,262,86,14,1271
E01013586,871,51,106,73,7,1108
E01013587,757,29,323,52,43,1204
E01013588,906,40,146,69,37,1198
E01013589,805,23,300,32,21,1181
E01013590,913,58,115,112,12,1210
E01013591,1140,57,124,100,34,1455
E01013592,1151,8,8,3,1,1171
E01013593,1150,5,6,7,1,1169
E01013594,1169,5,4,1,2,1181
E01013595,1695,31,33,31,13,1803
E01013596,1308,6,6,9,2,1331
E01013597,1154,15,12,8,5,1194
E01013598,1183,12,22,16,1,1234
E01013599,1181,9,15,3,1,1209
E01013600,1195,27,96,72,9,1399
E01013601,1074,28,71,69,16,1258
E01013602,1138,44,108,115,12,1417
E01013603,924,53,200,131,21,1329
E01013604,1045,40,88,76,5,1254
E01013605,859,27,395,58,25,1364
E01013606,856,22,480,51,17,1426
E01013607,1025,48,887,94,134,2188
E01013608,1112,24,80,22,6,1244
E01013609,1265,24,52,17,7,1365
E01013610,1244,25,67,28,3,1367
E01013611,1088,29,85,49,13,1264
E01013612,1159,27,62,17,3,1268
E01013613,1176,42,55,32,12,1317
E01013614,1129,33,74,29,9,1274
E01013615,856,28,281,26,12,1203
E01013616,967,50,159,46,20,1242
E01013617,1067,54,692,139,25,1977
E01013618,902,44,185,125,5,1261
E01013619,759,52,170,212,44,1237
E01013620,824,58,127,187,38,1234
E01013621,804,52,153,269,46,1324
E01013622,701,51,185,245,47,1229
E01013623,898,32,622,117,38,1707
E01013624,444,36,619,36,16,1151
E01013625,183,25,1257,38,22,1525
E01013626,143,17,1223,34,22,1439
E01013627,96,4,970,16,20,1106
E01013628,418,35,732,56,22,1263
E01013629,165,17,1109,37,10,1338
E01013630,136,9,1209,16,32,1402
E01013631,931,25,81,53,6,1096
E01013632,1179,33,34,87,13,1346
E01013633,1023,33,102,63,19,1240
E01013634,1013,34,75,58,11,1191
E01013635,755,32,411,43,34,1275
E01013636,542,19,525,26,57,1169
E01013637,1310,48,63,79,14,1514
E01013638,1043,27,22,108,4,1204
E01013639,836,36,90,56,9,1027
E01013640,965,39,21,182,10,1217
E01013641,989,38,200,54,44,1325
E01013642,1272,44,215,49,41,1621
E01013643,1224,40,316,33,37,1650
E01013646,1307,102,897,211,107,2624
E01013647,1257,75,610,333,110,2385
E01013648,1294,111,733,234,67,2439
E01013649,984,38,324,53,46,1445
E01013650,1420,52,158,33,15,1678
E01013651,553,33,482,104,70,1242
E01013652,568,29,442,130,36,1205
E01013653,708,79,467,116,30,1400
E01013654,377,62,871,234,47,1591
E01013655,460,46,793,135,83,1517
E01013656,116,23,1142,56,35,1372
E01013657,154,29,1014,63,43,1303
E01013658,169,23,1076,69,55,1392
E01013659,107,27,1216,43,32,1425
E01013660,432,40,726,96,71,1365
E01013661,496,47,552,151,42,1288
E01013662,95,15,1159,44,69,1382
E01013663,208,17,989,52,85,1351
E01013664,584,55,596,151,27,1413
E01013665,315,34,943,61,50,1403
E01013666,545,15,773,17,26,1376
E01013667,559,42,565,66,15,1247
E01013668,391,22,653,89,38,1193
E01013669,334,11,776,10,50,1181
E01013670,794,24,619,35,34,1506
E01013671,562,25,691,54,53,1385
E01013672,524,17,529,18,41,1129
E01013673,1085,28,25,41,2,1181
E01013674,1215,19,25,34,2,1295
E01013675,1182,27,19,26,8,1262
E01013676,1278,47,37,63,4,1429
E01013677,1119,37,22,21,4,1203
E01013678,1084,30,91,44,10,1259
E01013679,866,41,42,97,14,1060
E01013680,1225,38,322,64,26,1675
E01013681,1142,48,162,84,12,1448
E01013682,1199,37,72,70,9,1387
E01013683,1318,70,188,117,20,1713
E01013684,1189,51,182,146,43,1611
E01013685,998,22,168,34,2,1224
E01013686,1116,19,349,37,22,1543
E01013687,1081,42,88,75,22,1308
E01013688,1029,40,107,43,4,1223
E01013689,975,49,585,84,23,1716
E01013690,1058,38,106,62,9,1273
E01013691,922,41,61,106,23,1153
E01013692,761,43,50,84,6,944
E01013693,845,41,38,108,15,1047
E01013694,847,49,262,36,19,1213
E01013695,959,36,108,37,5,1145
E01013696,676,26,938,45,83,1768
E01013697,783,46,1028,111,67,2035
E01013698,918,21,201,34,7,1181
E01013699,734,31,586,42,24,1417
E01013700,895,24,250,30,18,1217
E01013702,895,28,329,33,27,1312
E01013703,787,17,217,14,20,1055
E01013704,933,26,202,11,23,1195
E01013705,810,38,322,56,50,1276
E01013706,1001,28,245,15,22,1311
E01013707,881,40,250,28,24,1223
E01013709,463,13,663,43,85,1267
E01013710,847,25,260,40,32,1204
E01013711,1070,29,251,34,52,1436
E01013712,909,30,313,32,31,1315
E01013713,70,12,1161,24,21,1288
E01013714,90,6,1300,17,13,1426
E01013715,70,11,1009,13,9,1112
E01013716,83,5,1367,21,13,1489
E01013717,229,25,872,46,14,1186
E01013718,161,10,1078,23,12,1284
E01013719,78,17,1179,17,3,1294
E01013720,176,13,928,32,6,1155
E01013721,974,29,203,51,6,1263
E01013722,1024,29,110,54,8,1225
E01013723,836,21,59,49,6,971
E01013725,790,23,42,77,13,945
E01013726,1145,34,44,81,31,1335
E01013727,1013,27,28,72,5,1145
E01013728,957,37,54,73,9,1130
E01013729,956,9,45,22,2,1034
E01013730,943,43,58,76,22,1142
E01013731,937,44,56,131,22,1190
E01013732,794,42,653,68,49,1606
E01013733,755,32,377,22,19,1205
E01013734,254,10,940,26,23,1253
E01013735,120,9,988,28,19,1164
E01013736,940,20,365,47,17,1389
E01013737,136,9,975,13,32,1165
E01013738,182,3,1062,9,30,1286
E01013739,268,21,951,23,23,1286
E01013740,183,12,1018,25,9,1247
E01013741,257,18,990,11,46,1322
E01013742,46,12,1210,66,13,1347
E01013743,63,18,1121,46,17,1265
E01013744,19,6,1396,34,19,1474
E01013745,54,15,1098,40,31,1238
E01013746,85,57,1073,140,80,1435
E01013747,101,24,1161,66,39,1391
E01013748,119,31,1022,273,82,1527
E01013749,192,6,881,48,54,1181
E01013750,45,11,1002,47,24,1129
E01013751,74,15,1261,66,22,1438
E01013752,49,10,1043,42,26,1170
E01013753,101,24,939,125,45,1234
E01013754,283,44,515,416,32,1290
E01013755,227,42,563,423,75,1330
E01013756,511,47,837,54,71,1520
E01013757,241,17,934,28,63,1283
E01013758,127,9,978,49,47,1210
E01013759,189,25,1136,46,70,1466
E01013760,716,50,627,151,82,1626
E01013761,266,56,824,200,41,1387
E01013762,234,24,1004,125,39,1426
E01013763,813,72,605,181,42,1713
E01013764,122,9,1062,36,50,1279
E01013765,422,54,770,102,41,1389
E01013766,203,26,1052,41,79,1401
E01013767,798,27,362,26,24,1237
E01013768,1034,29,179,32,13,1287
E01013770,696,22,307,53,26,1104
E01013771,487,28,664,43,43,1265
E01013772,991,44,111,42,7,1195
E01013773,839,26,253,35,23,1176
E01013774,1047,66,316,79,38,1546
E01013775,1225,57,361,81,154,1878
E01013776,980,56,345,113,46,1540
E01013777,996,34,215,66,18,1329
E01013778,1410,89,423,182,104,2208
E01013779,1339,60,222,81,36,1738
E01013780,1015,18,156,28,9,1226
E01013781,1156,74,144,88,15,1477
E01013782,1059,37,137,36,20,1289
E01013783,910,20,272,39,25,1266
E01013784,836,56,251,64,17,1224
E01013785,1041,19,154,26,15,1255
E01013786,1023,45,176,25,12,1281
E01013787,1035,5,2,2,2,1046
E01013788,2084,12,11,11,6,2124
E01013789,1174,7,4,4,1,1190
E01013790,1707,61,53,60,2,1883
E01013791,923,5,7,3,0,938
E01013792,1345,13,4,3,1,1366
E01013793,1120,4,4,2,0,1130
E01013794,1068,2,8,5,1,1084
E01013795,966,7,6,4,3,986
E01013796,1322,14,9,61,11,1417
E01013797,1340,7,13,6,5,1371
E01013798,1105,11,18,8,3,1145
E01013799,1241,9,43,13,2,1308
E01013800,1267,5,8,5,2,1287
E01013801,1326,10,16,4,1,1357
E01013802,2120,7,17,1,4,2149
E01013803,1821,15,11,5,0,1852
E01013804,1280,3,7,1,1,1292
E01013805,1030,3,7,0,0,1040
E01013806,1439,14,29,3,3,1488
E01013807,1090,8,11,3,1,1113
E01013808,1051,3,9,3,1,1067
E01013809,1043,1,4,0,2,1050
E01013810,538,61,423,138,40,1200
E01013811,584,100,296,129,50,1159
E01013812,520,95,371,207,25,1218
E01013813,1482,207,223,111,25,2048
E01013814,1351,181,187,175,25,1919
E01013815,1323,112,152,102,24,1713
E01013816,1516,147,510,171,75,2419
E01013817,856,73,31,131,4,1095
E01013818,922,58,26,136,8,1150
E01013819,1014,66,51,114,12,1257
E01013820,974,62,59,117,13,1225
E01013821,885,84,65,91,12,1137
E01013822,895,47,41,138,7,1128
E01013823,1029,59,106,114,3,1311
E01013824,846,74,63,104,2,1089
E01013825,1066,54,91,104,10,1325
E01013826,977,86,33,141,3,1240
E01013827,800,67,84,132,6,1089
E01013828,1111,85,82,84,12,1374
E01013829,1037,69,78,120,12,1316
E01013830,1050,48,170,76,8,1352
E01013831,1122,19,91,41,14,1287
E01013832,1113,112,173,92,5,1495
E01013833,743,79,85,117,6,1030
E01013834,967,43,49,101,4,1164
E01013835,1006,97,60,134,10,1307
E01013836,1149,93,82,99,6,1429
E01013837,1053,48,238,86,13,1438
E01013838,1145,40,199,77,10,1471
E01013839,981,116,109,168,11,1385
E01013840,1229,70,339,108,13,1759
E01013841,817,105,148,122,23,1215
E01013842,621,84,411,110,32,1258
E01013843,964,64,269,72,25,1394
E01013844,726,73,255,91,26,1171
E01013845,570,45,523,81,13,1232
E01013846,666,70,481,138,47,1402
E01013847,460,53,535,49,24,1121
E01013849,964,48,33,112,3,1160
E01013850,1071,47,14,61,6,1199
E01013851,986,78,26,138,10,1238
E01013852,1172,51,15,55,4,1297
E01013853,1094,43,26,69,4,1236
E01013854,918,67,20,106,5,1116
E01013855,867,66,34,101,5,1073
E01013856,1013,50,74,79,2,1218
E01013858,954,44,41,78,4,1121
E01013859,1135,26,59,30,8,1258
E01013860,1125,30,52,48,9,1264
E01013861,1104,34,51,30,9,1228
E01013862,810,90,104,144,5,1153
E01013863,944,33,136,51,9,1173
E01013864,886,82,27,108,7,1110
E01013865,1063,44,33,82,2,1224
E01013866,1047,28,53,41,4,1173
E01013867,943,44,65,86,7,1145
E01013868,1057,32,45,54,2,1190
E01013870,1116,95,229,196,39,1675
E01013871,877,100,177,168,29,1351
E01013872,828,109,308,165,31,1441
E01013873,1005,73,471,159,19,1727
E01013874,1052,36,120,61,5,1274
E01013875,999,24,42,21,3,1089
E01013876,1165,79,33,126,6,1409
E01013877,844,69,20,79,4,1016
E01013878,777,62,14,76,2,931
E01013879,858,31,19,48,3,959
E01013880,1073,52,11,48,4,1188
E01013881,1006,45,26,58,3,1138
E01013882,1054,32,18,40,3,1147
E01013883,1055,39,26,95,4,1219
E01013884,912,58,9,57,2,1038
E01013885,1114,42,35,70,2,1263
E01013886,1073,44,28,62,4,1211
E01013887,1061,13,167,74,3,1318
E01013888,1165,30,20,35,4,1254
E01013889,1234,35,35,59,2,1365
E01013890,1133,38,11,43,2,1227
E01013891,1141,43,38,104,5,1331
E01013892,1016,16,119,71,2,1224
E01013893,764,48,32,121,13,978
E01013894,1083,32,75,58,5,1253
E01013895,1171,6,84,18,3,1282
E01013896,921,34,52,37,1,1045
E01013897,1178,17,50,13,2,1260
E01013898,1242,53,124,24,11,1454
E01013899,916,18,21,30,2,987
E01013900,1125,26,45,24,3,1223
E01013901,1123,19,44,15,5,1206
E01013902,1172,21,46,12,4,1255
E01013903,951,23,43,20,6,1043
E01013904,1095,50,31,23,2,1201
E01013905,1136,13,23,29,4,1205
E01013906,1183,32,49,26,3,1293
E01013907,1120,32,33,19,6,1210
E01013908,1248,38,26,29,2,1343
E01013909,1149,58,20,34,1,1262
E01013910,1095,18,25,14,9,1161
E01013911,1176,19,13,15,2,1225
E01013912,1260,30,29,17,0,1336
E01013913,1029,42,279,61,14,1425
E01013914,967,47,305,43,17,1379
E01013915,1078,26,98,48,11,1261
E01013916,853,59,142,52,9,1115
E01013917,1064,61,164,80,11,1380
E01013918,923,56,355,132,18,1484
E01013919,1006,64,420,111,26,1627
E01013920,1277,222,201,153,26,1879
E01013921,941,122,312,153,45,1573
E01013924,1147,118,129,164,43,1601
E01013926,1080,68,239,81,36,1504
E01013928,651,51,562,101,77,1442
E01013929,1237,43,220,56,12,1568
E01013930,695,57,529,120,47,1448
E01013931,773,21,476,38,39,1347
E01013932,849,28,404,56,34,1371
E01013933,809,103,281,136,37,1366
E01013934,769,47,308,104,23,1251
E01013935,1170,33,51,51,8,1313
E01013936,1453,103,153,109,17,1835
E01013937,1179,57,101,80,14,1431
E01013938,1020,44,148,49,21,1282
E01013939,1121,63,47,78,21,1330
E01013940,897,123,95,185,5,1305
E01013941,1097,57,181,48,11,1394
E01013942,1139,143,122,206,9,1619
E01013943,1209,123,190,114,15,1651
E01013944,643,34,467,113,77,1334
E01013945,776,108,317,231,59,1491
E01013947,865,128,311,293,42,1639
E01013948,459,126,163,305,24,1077
E01013953,2150,143,722,161,34,3210
E01013954,774,76,75,106,10,1041
E01013957,858,73,188,77,26,1222
E01013958,761,126,139,333,34,1393
E01013959,851,131,91,279,31,1383
E01013960,727,97,82,272,29,1207
E01013961,1263,184,271,263,30,2011
E01013962,1039,102,110,175,27,1453
E01013963,1052,51,35,71,17,1226
E01013964,1001,52,167,80,11,1311
E01013965,876,59,107,111,14,1167
E01013966,855,54,59,91,20,1079
E01013967,1224,81,193,68,26,1592
E01013968,1041,36,42,33,9,1161
E01013969,1207,64,55,70,12,1408
E01013970,1075,48,79,51,10,1263
E01013971,1174,41,47,56,8,1326
E01013972,1008,46,81,99,5,1239
E01013973,2516,109,864,157,98,3744
E01013974,1206,61,534,65,41,1907
E01013975,1691,65,383,52,20,2211
E01013976,890,67,158,112,27,1254
E01013977,1169,35,273,34,13,1524
E01013978,903,22,329,51,27,1332
E01013979,929,19,241,30,17,1236
E01013980,1103,12,158,19,23,1315
E01013981,1114,18,207,17,8,1364
E01013982,1050,30,155,17,22,1274
E01013983,843,86,163,62,20,1174
E01013984,1049,9,154,11,18,1241
E01013985,1016,19,375,39,29,1478
E01013986,1311,12,40,3,3,1369
E01013987,1346,8,24,4,8,1390
E01013988,1596,6,38,10,16,1666
E01013989,1178,11,61,15,2,1267
E01013990,1491,7,2,3,4,1507
E01013991,1070,5,3,2,0,1080
E01013992,1121,5,1,0,4,1131
E01013993,1210,7,5,0,0,1222
E01013994,1191,8,7,3,2,1211
E01013995,1227,7,4,3,0,1241
E01013996,1244,5,9,1,1,1260
E01013997,1575,15,7,2,2,1601
E01013998,1156,4,1,1,2,1164
E01013999,1204,4,26,2,0,1236
E01014000,1159,4,5,0,0,1168
E01014001,1228,2,5,2,1,1238
E01014002,1223,6,1,0,1,1231
E01014003,1213,7,6,10,1,1237
E01014004,1188,4,4,0,0,1196
E01014005,1282,10,6,1,1,1300
E01014006,1305,7,7,3,1,1323
E01014007,1443,5,8,2,2,1460
E01014008,1351,6,4,2,0,1363
E01014009,1256,4,3,0,0,1263
E01014010,1354,8,44,3,19,1428
E01014011,1183,9,34,11,6,1243
E01014012,1454,4,7,3,0,1468
E01014013,1386,10,2,4,4,1406
E01014014,1485,4,1,1,0,1491
E01014015,1352,5,5,2,0,1364
E01014016,1223,5,7,1,1,1237
E01014017,1224,3,4,0,2,1233
E01014018,1229,12,4,2,1,1248
E01014019,1290,4,2,0,0,1296
E01014020,1273,5,2,3,0,1283
E01014021,1218,4,1,0,0,1223
E01014022,1654,3,6,3,5,1671
E01014023,1378,3,12,2,0,1395
E01014024,1082,4,1,1,1,1089
E01014025,1185,5,6,3,4,1203
E01014026,1768,7,8,3,2,1788
E01014027,1067,3,7,0,0,1077
E01014028,1235,3,2,2,0,1242
E01014029,1216,6,8,1,1,1232
E01014030,1133,10,22,2,1,1168
E01014031,1290,8,6,1,0,1305
E01014032,1380,4,9,0,1,1394
E01014033,1438,6,13,2,0,1459
E01014034,1179,8,29,7,1,1224
E01014035,1372,11,29,4,5,1421
E01014036,1351,9,16,2,1,1379
E01014037,1289,3,7,2,0,1301
E01014038,1172,1,13,6,3,1195
E01014039,1337,13,9,0,0,1359
E01014040,1365,2,7,1,1,1376
E01014041,1284,5,5,0,2,1296
E01014042,1209,4,4,1,0,1218
E01014043,961,2,3,0,0,966
E01014044,1170,3,2,1,3,1179
E01014045,1297,8,6,3,2,1316
E01014046,1216,2,1,0,3,1222
E01014047,1135,5,9,1,0,1150
E01014048,1222,7,26,2,3,1260
E01014049,1335,6,7,1,1,1350
E01014050,1457,0,4,1,0,1462
E01014051,1370,4,4,2,0,1380
E01014052,1253,3,10,1,0,1267
E01014053,1499,5,10,0,0,1514
E01014054,1155,4,2,1,1,1163
E01014055,1313,2,4,0,1,1320
E01014056,1279,4,17,0,0,1300
E01014057,1404,9,7,0,3,1423
E01014058,1363,8,5,1,2,1379
E01014059,1652,4,6,1,2,1665
E01014060,1323,8,6,1,0,1338
E01014061,1336,1,4,1,0,1342
E01014062,1382,9,11,6,1,1409
E01014063,1443,4,2,0,0,1449
E01014064,1275,12,7,2,1,1297
E01014065,1208,4,7,0,3,1222
E01014066,958,4,13,1,0,976
E01014067,1186,3,2,1,0,1192
E01014068,1221,6,11,1,0,1239
E01014069,1408,4,5,2,2,1421
E01014070,1775,8,10,0,4,1797
E01014071,1128,10,3,1,0,1142
E01014072,1572,13,9,7,2,1603
E01014073,1396,16,27,5,9,1453
E01014074,1267,6,6,0,4,1283
E01014075,1373,9,5,5,10,1402
E01014076,1729,16,19,8,12,1784
E01014077,1302,0,3,4,1,1310
E01014078,1155,5,8,1,2,1171
E01014079,1303,8,11,1,0,1323
E01014080,1174,4,9,2,2,1191
E01014081,1195,7,3,4,0,1209
E01014082,1573,5,7,2,1,1588
E01014083,1334,2,7,1,0,1344
E01014084,1262,7,20,3,5,1297
E01014085,1140,8,4,2,1,1155
E01014086,1149,13,24,5,7,1198
E01014087,1253,4,11,2,3,1273
E01014088,1185,4,10,0,0,1199
E01014089,1179,7,4,3,1,1194
E01014090,1203,8,14,4,2,1231
E01014091,1227,7,22,6,2,1264
E01014092,1486,22,30,7,4,1549
E01014093,1193,6,11,1,1,1212
E01014094,1214,9,17,0,1,1241
E01014095,1145,8,22,3,4,1182
E01014096,1274,1,0,1,0,1276
E01014097,1118,1,2,4,1,1126
E01014098,1208,3,4,1,0,1216
E01014099,1489,8,8,6,1,1512
E01014100,1291,2,3,0,0,1296
E01014101,892,3,6,2,1,904
E01014102,1263,16,142,19,1,1441
E01014103,871,8,123,6,1,1009
E01014104,1168,18,98,24,3,1311
E01014105,1187,35,175,20,15,1432
E01014106,1149,13,20,18,0,1200
E01014107,967,10,15,5,0,997
E01014108,1029,14,15,30,1,1089
E01014109,863,12,14,27,1,917
E01014110,968,13,14,23,0,1018
E01014111,1216,7,38,5,1,1267
E01014112,1361,6,15,1,0,1383
E01014113,853,27,343,41,12,1276
E01014114,1126,11,84,9,1,1231
E01014115,992,11,33,12,1,1049
E01014116,1268,8,24,12,0,1312
E01014117,969,9,28,8,5,1019
E01014118,821,18,14,2,2,857
E01014119,1317,11,23,6,2,1359
E01014120,1334,16,10,11,0,1371
E01014121,1189,3,10,2,0,1204
E01014122,1243,10,22,5,1,1281
E01014123,1209,8,14,6,1,1238
E01014124,1306,11,15,7,1,1340
E01014125,1176,16,15,18,1,1226
E01014126,1137,6,9,8,0,1160
E01014127,1215,19,21,22,0,1277
E01014128,1610,11,28,24,3,1676
E01014129,845,11,19,8,1,884
E01014130,1116,4,26,7,1,1154
E01014131,1885,9,73,5,3,1975
E01014132,906,3,5,1,0,915
E01014133,1426,17,71,11,2,1527
E01014134,1089,14,12,5,2,1122
E01014135,1016,7,9,0,0,1032
E01014136,1402,7,10,4,1,1424
E01014137,1004,7,122,20,14,1167
E01014138,1075,17,60,12,2,1166
E01014139,812,23,147,43,14,1039
E01014140,983,34,104,38,6,1165
E01014141,1864,30,149,43,6,2092
E01014142,685,26,187,51,9,958
E01014143,942,20,165,28,4,1159
E01014144,1165,9,39,7,1,1221
E01014145,1318,21,84,25,5,1453
E01014146,1641,14,25,4,2,1686
E01014147,1547,18,27,13,2,1607
E01014148,1263,9,11,3,0,1286
E01014149,912,7,3,1,0,923
E01014150,1299,10,46,11,3,1369
E01014151,1157,12,7,5,0,1181
E01014152,1071,6,10,3,1,1091
E01014153,1431,19,23,7,4,1484
E01014154,1323,8,26,6,1,1364
E01014155,1234,13,39,8,11,1305
E01014156,1480,23,58,9,7,1577
E01014157,1047,17,126,6,6,1202
E01014158,1145,18,43,10,3,1219
E01014159,1017,9,5,2,0,1033
E01014160,1027,13,50,3,1,1094
E01014161,942,14,9,3,0,968
E01014162,1320,12,41,7,0,1380
E01014163,988,11,40,20,7,1066
E01014164,1194,14,17,3,9,1237
E01014165,1027,24,37,23,2,1113
E01014166,1198,10,20,17,2,1247
E01014167,1368,10,43,9,12,1442
E01014168,995,13,45,7,5,1065
E01014169,1208,24,23,38,1,1294
E01014170,1197,7,21,4,1,1230
E01014171,1158,10,3,8,1,1180
E01014172,1135,4,6,2,0,1147
E01014173,1282,5,9,4,3,1303
E01014174,1262,6,12,0,1,1281
E01014175,935,6,4,1,0,946
E01014176,1259,3,16,6,3,1287
E01014177,1150,4,16,1,3,1174
E01014178,1263,9,26,4,6,1308
E01014179,970,2,10,1,2,985
E01014180,1095,10,18,8,0,1131
E01014181,1184,9,256,13,19,1481
E01014182,901,6,97,6,14,1024
E01014183,1130,10,125,7,13,1285
E01014184,1109,8,27,3,6,1153
E01014185,1337,7,23,20,3,1390
E01014186,1118,13,13,6,0,1150
E01014187,1205,6,10,12,0,1233
E01014188,1218,8,19,11,6,1262
E01014189,1133,13,32,17,2,1197
E01014190,1299,8,33,4,5,1349
E01014191,1156,33,134,72,2,1397
E01014192,982,14,36,50,4,1086
E01014193,1185,11,46,35,1,1278
E01014194,1099,13,50,14,0,1176
E01014195,1050,7,69,16,17,1159
E01014196,1134,12,58,27,1,1232
E01014197,1070,16,29,4,4,1123
E01014198,746,16,8,6,0,776
E01014199,1097,29,25,18,5,1174
E01014200,865,10,4,8,0,887
E01014201,854,14,14,5,0,887
E01014202,1803,15,47,9,4,1878
E01014203,1194,7,38,4,1,1244
E01014204,1514,13,31,8,2,1568
E01014205,1072,10,95,14,0,1191
E01014206,940,5,69,20,5,1039
E01014207,928,11,79,22,7,1047
E01014208,941,9,3,4,7,964
E01014209,1091,7,82,18,14,1212
E01014210,1143,8,15,8,6,1180
E01014211,1120,19,6,16,3,1164
E01014212,1046,13,3,10,1,1073
E01014213,963,3,9,10,1,986
E01014214,1255,13,5,0,2,1275
E01014215,1209,10,5,1,1,1226
E01014216,1181,5,6,0,0,1192
E01014217,1071,8,12,9,3,1103
E01014218,1110,11,11,6,5,1143
E01014219,1068,6,11,2,2,1089
E01014220,1194,14,11,11,2,1232
E01014221,1150,17,22,16,2,1207
E01014222,1087,14,11,17,2,1131
E01014223,1198,13,13,22,2,1248
E01014224,1192,13,7,18,4,1234
E01014225,1219,16,13,5,1,1254
E01014226,1219,5,12,9,1,1246
E01014228,1138,4,5,2,0,1149
E01014229,1248,17,5,18,2,1290
E01014230,1199,13,6,9,3,1230
E01014231,1063,23,139,58,36,1319
E01014233,1165,12,14,9,0,1200
E01014234,1095,10,15,19,4,1143
E01014235,1245,14,18,16,3,1296
E01014236,1576,20,101,29,8,1734
E01014237,1214,12,8,9,9,1252
E01014238,1085,12,19,28,16,1160
E01014239,1181,10,5,8,5,1209
E01014240,1168,15,10,9,2,1204
E01014241,1237,19,25,18,9,1308
E01014242,1085,15,27,13,6,1146
E01014243,1145,13,39,8,3,1208
E01014244,992,20,55,25,3,1095
E01014245,1276,13,71,7,4,1371
E01014246,1198,15,27,23,28,1291
E01014247,1256,17,92,27,14,1406
E01014248,1045,23,67,31,15,1181
E01014249,730,35,428,88,46,1327
E01014250,772,11,83,15,10,891
E01014251,1214,46,146,52,28,1486
E01014252,1238,18,58,20,9,1343
E01014253,1136,25,72,12,16,1261
E01014254,629,46,341,87,55,1158
E01014255,870,55,448,43,41,1457
E01014256,1032,41,164,57,23,1317
E01014257,1162,5,13,4,0,1184
E01014258,1144,11,16,6,0,1177
E01014259,1240,9,11,4,1,1265
E01014260,1052,4,17,5,2,1080
E01014261,962,13,15,28,4,1022
E01014262,1009,7,12,13,0,1041
E01014263,1194,15,20,24,1,1254
E01014264,1493,15,19,6,1,1534
E01014265,1280,8,11,2,1,1302
E01014266,947,13,22,6,6,994
E01014267,1854,18,50,24,3,1949
E01014268,1599,17,24,18,10,1668
E01014269,1065,25,76,30,4,1200
E01014270,1220,8,19,15,12,1274
E01014271,1131,16,40,9,12,1208
E01014272,1205,12,8,2,1,1228
E01014273,866,10,89,7,2,974
E01014274,1377,12,29,20,12,1450
E01014275,1078,17,38,22,1,1156
E01014276,1216,17,25,25,2,1285
E01014277,1259,11,14,14,5,1303
E01014278,1037,9,37,3,3,1089
E01014279,1296,18,55,14,7,1390
E01014280,1112,3,9,2,3,1129
E01014281,775,55,439,105,59,1433
E01014282,1088,33,299,97,23,1540
E01014283,1003,45,680,91,22,1841
E01014284,794,38,421,84,20,1357
E01014285,1136,31,447,65,33,1712
E01014286,537,40,433,56,45,1111
E01014287,886,47,349,54,22,1358
E01014288,1179,17,111,13,11,1331
E01014289,1112,18,160,12,16,1318
E01014290,969,19,200,22,16,1226
E01014291,1028,16,86,23,5,1158
E01014292,1189,20,96,26,18,1349
E01014293,1133,28,182,39,27,1409
E01014294,943,13,105,13,13,1087
E01014295,1355,14,39,11,7,1426
E01014296,1135,14,14,2,3,1168
E01014297,1023,11,26,4,1,1065
E01014298,1183,7,27,9,3,1229
E01014299,1168,7,7,10,2,1194
E01014300,1093,6,18,9,2,1128
E01014301,1305,6,31,11,0,1353
E01014302,1424,10,60,8,5,1507
E01014303,1259,6,22,5,0,1292
E01014304,1182,1,17,0,0,1200
E01014305,568,3,414,17,13,1015
E01014306,718,14,319,14,7,1072
E01014307,456,14,471,15,7,963
E01014308,1435,7,13,5,0,1460
E01014309,935,7,104,21,1,1068
E01014310,1395,7,130,11,2,1545
E01014311,1102,3,29,11,2,1147
E01014312,1015,2,126,3,3,1149
E01014313,1298,6,18,11,0,1333
E01014314,1061,12,64,3,1,1141
E01014315,1162,6,9,2,2,1181
E01014316,1067,8,23,4,2,1104
E01014317,1157,7,19,13,1,1197
E01014318,1173,5,14,5,1,1198
E01014319,1144,8,14,6,3,1175
E01014320,974,12,51,5,1,1043
E01014321,1173,7,11,13,1,1205
E01014322,1118,24,116,22,4,1284
E01014323,987,12,18,15,2,1034
E01014324,1207,7,28,12,7,1261
E01014325,1087,14,13,2,0,1116
E01014326,1195,11,28,5,2,1241
E01014327,1116,13,25,17,6,1177
E01014328,999,26,108,29,17,1179
E01014329,1165,9,35,16,7,1232
E01014330,931,47,224,72,78,1352
E01014331,1128,12,8,14,3,1165
E01014332,1449,5,6,3,1,1464
E01014333,1190,14,8,5,0,1217
E01014334,1266,9,15,6,9,1305
E01014335,1379,19,9,6,3,1416
E01014336,1184,12,23,11,4,1234
E01014337,1329,12,7,6,1,1355
E01014338,1113,16,98,18,10,1255
E01014339,1228,15,73,34,16,1366
E01014340,1322,32,133,32,5,1524
E01014341,1281,10,136,31,9,1467
E01014342,1053,12,63,6,2,1136
E01014343,1346,19,42,21,7,1435
E01014344,1028,18,103,14,3,1166
E01014345,1197,28,129,47,20,1421
E01014346,1359,7,11,10,4,1391
E01014347,1165,9,22,1,1,1198
E01014348,1122,12,16,7,4,1161
E01014349,1203,7,8,5,2,1225
E01014350,1134,10,16,3,0,1163
E01014351,1328,8,33,8,1,1378
E01014352,1130,6,27,9,9,1181
E01014353,1202,8,75,9,8,1302
E01014354,1103,15,223,25,12,1378
E01014355,1002,27,396,18,10,1453
E01014356,1085,35,227,16,6,1369
E01014357,1290,8,10,7,1,1316
E01014358,993,12,25,11,10,1051
E01014359,1330,11,43,21,6,1411
E01014360,1465,11,44,10,4,1534
E01014361,872,17,251,29,16,1185
E01014362,1164,4,4,5,2,1179
E01014363,1165,5,7,1,0,1178
E01014364,1188,6,20,6,0,1220
E01014365,1278,9,5,1,2,1295
E01014366,1338,15,16,44,6,1419
E01014367,1072,11,15,20,4,1122
E01014368,1199,6,16,12,0,1233
E01014369,1052,7,9,3,3,1074
E01014370,1443,42,189,17,33,1724
E01014371,1531,22,141,19,20,1733
E01014372,1712,28,82,23,21,1866
E01014373,1190,12,16,7,5,1230
E01014374,1150,14,18,5,3,1190
E01014375,1027,11,17,1,3,1059
E01014376,1241,8,15,5,2,1271
E01014377,1140,17,25,4,5,1191
E01014379,2018,25,19,10,3,2075
E01014380,2698,64,373,32,30,3197
E01014381,1121,22,127,13,25,1308
E01014382,1950,11,6,2,1,1970
E01014383,833,4,1,2,3,843
E01014384,1078,9,6,4,0,1097
E01014385,1096,8,4,2,1,1111
E01014386,917,8,7,1,0,933
E01014387,936,18,22,15,3,994
E01014388,1020,10,20,5,4,1059
E01014389,1069,16,39,10,5,1139
E01014390,1070,25,16,10,12,1133
E01014391,1180,7,16,2,4,1209
E01014392,890,10,16,5,2,923
E01014393,1068,10,15,2,0,1095
E01014394,1328,9,11,4,1,1353
E01014395,1051,6,11,0,2,1070
E01014396,1127,10,32,4,1,1174
E01014397,1057,5,10,1,1,1074
E01014398,1179,8,8,1,4,1200
E01014399,1296,9,12,7,0,1324
E01014400,1575,13,20,18,1,1627
E01014401,1283,14,2,2,5,1306
E01014402,1325,16,5,8,3,1357
E01014403,1432,9,8,7,2,1458
E01014404,1276,10,13,7,1,1307
E01014405,1645,33,53,23,9,1763
E01014407,893,32,150,23,31,1129
E01014409,1239,35,9,21,0,1304
E01014410,1338,13,32,12,3,1398
E01014411,1637,19,38,17,8,1719
E01014412,1172,12,19,5,4,1212
E01014413,1162,19,69,12,9,1271
E01014414,1289,35,33,27,8,1392
E01014415,1534,24,42,6,7,1613
E01014416,1358,11,30,16,7,1422
E01014417,1469,12,20,1,5,1507
E01014418,1131,1,3,0,5,1140
E01014419,992,1,19,1,1,1014
E01014420,1213,3,13,1,6,1236
E01014421,1119,2,9,0,1,1131
E01014422,1221,2,2,1,4,1230
E01014423,1082,7,20,14,4,1127
E01014424,1368,6,9,0,1,1384
E01014425,1619,10,8,7,2,1646
E01014426,1182,5,14,2,4,1207
E01014427,1055,22,29,14,8,1128
E01014428,1062,19,55,17,12,1165
E01014429,1162,15,37,25,6,1245
E01014430,1187,15,44,16,2,1264
E01014431,963,7,25,14,10,1019
E01014432,967,18,49,14,11,1059
E01014433,941,7,40,19,10,1017
E01014434,1459,15,46,10,10,1540
E01014435,1307,26,116,8,12,1469
E01014436,1302,16,74,17,4,1413
E01014437,1123,11,27,13,4,1178
E01014438,980,19,30,17,8,1054
E01014439,1437,3,8,2,1,1451
E01014440,1464,14,20,3,4,1505
E01014441,1318,8,20,1,3,1350
E01014442,1340,12,14,4,1,1371
E01014443,1254,2,29,3,3,1291
E01014444,1116,6,23,5,0,1150
E01014445,1240,11,11,6,4,1272
E01014446,930,3,4,1,1,939
E01014447,1118,2,8,0,4,1132
E01014448,1223,9,6,8,2,1248
E01014449,1083,14,8,1,4,1110
E01014450,994,6,4,2,0,1006
E01014451,1011,5,4,1,0,1021
E01014452,1239,7,12,1,1,1260
E01014453,1018,3,21,5,2,1049
E01014454,1054,7,12,8,3,1084
E01014455,1033,11,22,11,4,1081
E01014456,1173,10,32,23,3,1241
E01014457,1120,9,26,9,2,1166
E01014458,961,9,25,14,3,1012
E01014459,1169,8,12,3,1,1193
E01014460,994,2,4,2,0,1002
E01014461,861,20,17,23,0,921
E01014462,1054,18,13,18,2,1105
E01014463,1067,26,21,23,3,1140
E01014464,928,29,24,32,0,1013
E01014465,1151,20,25,20,4,1220
E01014466,890,16,57,43,4,1010
E01014467,1314,18,34,25,16,1407
E01014468,1209,33,77,14,8,1341
E01014469,974,9,0,6,2,991
E01014470,1230,3,18,1,0,1252
E01014471,1216,6,12,6,3,1243
E01014472,1123,8,5,1,2,1139
E01014473,1389,17,64,16,7,1493
E01014474,976,19,34,11,1,1041
E01014475,1851,43,103,27,11,2035
E01014476,1189,36,46,12,1,1284
E01014477,1188,6,31,16,3,1244
E01014478,856,18,23,11,7,915
E01014479,1159,10,30,3,6,1208
E01014480,872,16,79,21,14,1002
E01014481,1090,36,173,9,9,1317
E01014482,981,12,35,7,3,1038
E01014483,1144,25,86,9,13,1277
E01014484,1300,39,76,16,9,1440
E01014485,1096,68,101,196,12,1473
E01014486,1047,104,160,475,44,1830
E01014487,1572,48,60,48,25,1753
E01014488,1308,56,74,205,4,1647
E01014489,1541,111,113,301,20,2086
E01014491,1372,60,75,64,17,1588
E01014492,1168,21,16,15,6,1226
E01014493,1129,14,22,24,9,1198
E01014494,1198,14,15,10,2,1239
E01014495,1329,11,27,15,12,1394
E01014496,1220,13,25,11,4,1273
E01014497,1138,20,25,27,2,1212
E01014498,1071,22,22,44,9,1168
E01014499,1210,22,32,3,3,1270
E01014500,1251,16,22,11,8,1308
E01014501,1360,19,24,10,2,1415
E01014502,1329,40,44,16,5,1434
E01014504,1224,30,12,6,6,1278
E01014505,1456,27,21,14,3,1521
E01014506,1250,12,10,4,2,1278
E01014507,1279,34,35,21,4,1373
E01014508,1312,47,50,46,11,1466
E01014509,1547,56,73,55,8,1739
E01014510,1417,48,57,44,11,1577
E01014511,1010,28,29,32,7,1106
E01014512,1088,27,56,28,11,1210
E01014513,1151,29,16,21,12,1229
E01014514,1455,37,60,32,20,1604
E01014515,1127,11,11,16,9,1174
E01014516,1021,17,7,17,2,1064
E01014517,905,16,1,13,3,938
E01014518,1314,12,19,11,2,1358
E01014519,1020,11,9,11,5,1056
E01014520,1282,17,16,6,4,1325
E01014521,1026,11,23,9,1,1070
E01014522,1191,12,13,13,4,1233
E01014523,1077,16,5,28,4,1130
E01014524,1149,13,27,19,2,1210
E01014525,1198,23,26,13,1,1261
E01014526,1089,23,28,39,0,1179
E01014527,1059,23,21,21,7,1131
E01014528,1170,26,25,26,0,1247
E01014529,992,25,32,65,4,1118
E01014530,1034,26,51,36,15,1162
E01014531,1272,32,29,39,7,1379
E01014532,1126,16,16,20,4,1182
E01014533,1131,23,34,30,6,1224
E01014534,1192,34,35,34,7,1302
E01014535,1434,14,63,35,7,1553
E01014536,1115,20,21,25,3,1184
E01014537,1310,21,31,44,3,1409
E01014538,1448,59,306,43,13,1869
E01014539,1451,45,121,29,11,1657
E01014540,1875,78,249,165,74,2441
E01014542,1804,72,251,53,40,2220
E01014544,1056,31,134,25,17,1263
E01014545,1345,38,37,6,16,1442
E01014546,1304,29,33,12,16,1394
E01014547,1420,41,43,5,11,1520
E01014548,1348,39,42,38,20,1487
E01014549,922,29,71,26,9,1057
E01014550,1774,59,99,26,20,1978
E01014551,1513,68,74,8,12,1675
E01014552,1538,62,62,20,8,1690
E01014553,1446,46,56,17,10,1575
E01014554,1399,50,95,24,18,1586
E01014555,1479,45,189,50,21,1784
E01014556,1469,16,45,7,13,1550
E01014557,1323,40,62,13,9,1447
E01014558,1596,53,94,53,8,1804
E01014559,1634,42,62,29,15,1782
E01014560,1377,48,75,18,7,1525
E01014561,1426,49,49,24,13,1561
E01014562,1549,39,82,21,8,1699
E01014563,1490,58,58,46,13,1665
E01014564,840,64,213,267,13,1397
E01014565,1085,63,72,137,8,1365
E01014566,1167,37,76,80,15,1375
E01014567,1262,60,68,124,23,1537
E01014568,904,105,343,387,54,1793
E01014569,856,106,317,307,55,1641
E01014570,1003,70,160,159,14,1406
E01014571,1104,54,93,68,13,1332
E01014572,1089,59,216,111,17,1492
E01014573,1171,44,145,142,19,1521
E01014574,780,110,335,364,37,1626
E01014575,741,48,247,164,21,1221
E01014576,1137,57,141,144,39,1518
E01014577,1055,31,135,37,16,1274
E01014578,1162,20,42,39,13,1276
E01014579,969,17,34,22,4,1046
E01014580,1092,30,15,23,1,1161
E01014581,1064,28,24,18,1,1135
E01014582,945,11,17,48,5,1026
E01014583,963,28,12,29,2,1034
E01014584,898,19,36,23,8,984
E01014585,1126,45,37,34,5,1247
E01014586,1140,30,52,42,12,1276
E01014587,923,31,116,39,12,1121
E01014588,1623,56,108,113,12,1912
E01014589,852,41,73,94,17,1077
E01014590,1256,55,114,93,12,1530
E01014591,1325,30,73,57,14,1499
E01014592,1156,33,65,63,9,1326
E01014593,986,23,9,14,6,1038
E01014594,1032,22,9,26,2,1091
E01014595,1072,17,12,14,7,1122
E01014596,1187,7,13,13,2,1222
E01014597,1015,9,14,24,3,1065
E01014598,1221,9,4,3,0,1237
E01014599,990,14,7,2,1,1014
E01014600,1074,7,6,9,0,1096
E01014601,1204,25,85,34,12,1360
E01014602,1278,22,30,60,6,1396
E01014603,1560,38,74,42,5,1719
E01014605,1123,30,49,49,9,1260
E01014607,1067,14,20,9,2,1112
E01014608,1231,16,25,30,0,1302
E01014609,1330,24,14,22,0,1390
E01014610,1118,8,16,19,6,1167
E01014611,1096,4,3,4,1,1108
E01014612,1177,4,8,6,1,1196
E01014613,1169,24,19,24,7,1243
E01014614,998,1,35,5,3,1042
E01014615,1133,12,45,18,8,1216
E01014616,1181,16,34,11,9,1251
E01014617,1031,11,33,6,3,1084
E01014618,1144,14,37,10,3,1208
E01014619,1128,20,39,21,14,1222
E01014620,1085,18,24,21,6,1154
E01014621,1044,20,33,20,7,1124
E01014622,984,34,122,51,18,1209
E01014623,1065,32,84,76,18,1275
E01014624,1121,37,62,72,1,1293
E01014626,1204,50,132,156,28,1570
E01014627,1528,38,65,79,5,1715
E01014629,853,38,100,73,2,1066
E01014630,1340,93,135,130,19,1717
E01014631,850,16,88,37,11,1002
E01014632,998,32,139,80,8,1257
E01014633,1128,22,62,37,3,1252
E01014634,1213,49,136,81,27,1506
E01014635,1364,51,117,52,8,1592
E01014636,981,42,40,73,7,1143
E01014637,1086,32,44,25,5,1192
E01014638,1175,21,18,55,3,1272
E01014639,937,24,13,56,3,1033
E01014640,1071,13,23,28,2,1137
E01014641,1142,17,16,19,7,1201
E01014642,1075,13,38,26,12,1164
E01014643,1016,12,22,8,1,1059
E01014644,1142,20,22,12,5,1201
E01014645,1203,21,46,28,1,1299
E01014646,1203,20,37,11,1,1272
E01014647,1150,30,23,25,3,1231
E01014648,1165,26,104,19,10,1324
E01014649,1215,13,69,10,4,1311
E01014650,1131,25,61,14,8,1239
E01014651,1238,21,18,23,7,1307
E01014653,552,116,251,750,77,1746
E01014654,588,101,340,561,43,1633
E01014655,670,87,388,587,47,1779
E01014658,651,58,92,530,43,1374
E01014659,1092,63,170,213,10,1548
E01014660,1028,29,96,99,6,1258
E01014661,1041,38,98,91,4,1272
E01014662,1075,31,86,75,12,1279
E01014663,919,51,62,107,5,1144
E01014664,1024,39,100,159,13,1335
E01014665,940,59,253,259,32,1543
E01014666,1227,29,78,18,9,1361
E01014667,1167,23,62,11,12,1275
E01014668,1185,30,29,26,20,1290
E01014669,1172,30,31,15,7,1255
E01014670,1120,57,45,23,8,1253
E01014671,1265,50,62,36,10,1423
E01014672,1667,41,59,36,16,1819
E01014673,1267,31,47,44,9,1398
E01014674,1118,23,54,67,8,1270
E01014675,1129,18,45,32,5,1229
E01014676,1165,12,47,20,1,1245
E01014677,1137,17,27,28,5,1214
E01014678,1172,17,23,64,7,1283
E01014679,1174,12,37,24,4,1251
E01014680,967,13,22,15,4,1021
E01014681,1463,61,78,131,13,1746
E01014682,1130,21,37,57,16,1261
E01014683,1192,46,77,68,7,1390
E01014684,1222,61,45,85,25,1438
E01014685,927,22,116,85,16,1166
E01014686,1086,31,50,107,9,1283
E01014687,1103,31,44,60,15,1253
E01014688,1080,25,69,64,4,1242
E01014689,976,25,58,55,5,1119
E01014690,1235,38,136,98,6,1513
E01014691,1420,26,91,32,7,1576
E01014692,1040,38,100,64,7,1249
E01014693,1100,15,53,16,4,1188
E01014694,1094,24,106,51,23,1298
E01014695,1365,35,29,30,8,1467
E01014696,1295,41,26,15,3,1380
E01014698,1437,49,38,14,26,1564
E01014699,1249,42,18,25,4,1338
E01014700,1271,17,28,7,5,1328
E01014701,1315,44,39,18,14,1430
E01014702,1146,9,11,2,4,1172
E01014703,1112,20,8,13,2,1155
E01014704,1418,27,29,19,5,1498
E01014705,1185,1,13,5,1,1205
E01014706,962,17,21,18,7,1025
E01014707,1269,18,22,15,1,1325
E01014708,1432,15,25,25,6,1503
E01014709,985,10,38,10,5,1048
E01014710,1116,23,60,10,13,1222
E01014711,953,13,34,4,18,1022
E01014712,873,26,45,15,11,970
E01014713,980,8,57,17,9,1071
E01014714,2417,75,166,25,14,2697
E01014715,1192,6,30,2,10,1240
E01014716,1168,7,36,5,4,1220
E01014717,1195,25,110,13,7,1350
E01014718,1060,26,60,10,2,1158
E01014719,1044,14,50,12,6,1126
E01014720,1230,19,30,20,13,1312
E01014721,1234,20,37,11,10,1312
E01014722,1240,8,14,5,1,1268
E01014723,1095,12,5,2,0,1114
E01014725,1237,10,5,11,1,1264
E01014726,1155,19,6,20,5,1205
E01014727,1092,12,4,11,1,1120
E01014729,925,38,59,51,10,1083
E01014730,1198,52,72,48,4,1374
E01014731,1132,51,110,37,7,1337
E01014732,1190,41,97,55,7,1390
E01014733,1282,46,31,45,13,1417
E01014734,1181,22,28,35,5,1271
E01014735,1314,19,39,31,11,1414
E01014736,1379,37,58,68,13,1555
E01014737,1207,3,5,3,5,1223
E01014738,1090,15,8,6,2,1121
E01014739,1220,6,15,3,2,1246
E01014740,1036,3,6,4,0,1049
E01014741,1195,5,3,1,2,1206
E01014742,1243,12,74,10,3,1342
E01014744,1134,8,5,0,0,1147
E01014745,1329,5,0,2,4,1340
E01014746,1102,8,4,1,7,1122
E01014747,1113,8,4,4,1,1130
E01014748,896,7,12,0,0,915
E01014749,1071,6,10,3,2,1092
E01014750,1328,8,15,3,2,1356
E01014751,1310,8,9,3,0,1330
E01014752,1239,6,8,2,1,1256
E01014753,1445,5,16,4,0,1470
E01014754,1010,2,12,5,1,1030
E01014755,1236,8,8,2,1,1255
E01014756,1313,3,25,6,1,1348
E01014757,1183,2,7,1,0,1193
E01014758,1153,6,7,2,1,1169
E01014759,1201,1,4,1,0,1207
E01014760,1205,5,3,2,0,1215
E01014761,1324,8,8,2,0,1342
E01014762,1151,6,9,0,1,1167
E01014763,1382,7,16,1,5,1411
E01014764,1311,10,11,0,4,1336
E01014765,1516,8,11,3,4,1542
E01014766,1108,10,16,2,4,1140
E01014767,1105,6,9,2,4,1126
E01014769,1768,6,23,1,2,1800
E01014770,1192,1,2,0,0,1195
E01014771,1191,4,12,2,1,1210
E01014772,1153,5,6,0,0,1164
E01014773,1282,12,9,4,1,1308
E01014774,1434,11,8,10,3,1466
E01014775,1007,2,4,3,0,1016
E01014776,1038,3,7,4,0,1052
E01014777,1153,5,32,1,2,1193
E01014778,1109,3,3,2,3,1120
E01014779,1002,2,13,0,1,1018
E01014780,1233,12,22,5,0,1272
E01014781,1325,7,4,0,1,1337
E01014782,1166,5,11,2,0,1184
E01014783,1277,4,25,1,0,1307
E01014784,1285,5,7,4,0,1301
E01014785,1214,2,5,0,0,1221
E01014786,1284,5,5,3,6,1303
E01014787,1532,11,29,3,3,1578
E01014789,1157,7,9,0,1,1174
E01014790,1221,7,16,3,2,1249
E01014792,1518,9,13,5,1,1546
E01014793,1211,8,11,3,4,1237
E01014794,1407,4,11,1,0,1423
E01014795,1049,6,29,2,8,1094
E01014796,1396,5,4,3,3,1411
E01014797,1406,10,4,0,2,1422
E01014798,1226,10,8,3,1,1248
E01014799,1224,23,46,19,8,1320
E01014800,1151,11,51,15,10,1238
E01014801,1316,21,64,9,5,1415
E01014802,1294,12,51,17,12,1386
E01014803,1234,4,30,8,1,1277
E01014804,1158,7,16,6,1,1188
E01014805,1286,9,11,1,2,1309
E01014806,1384,8,13,17,19,1441
E01014807,1317,20,27,15,1,1380
E01014808,1149,4,11,1,0,1165
E01014809,1306,6,33,13,9,1367
E01014810,1047,6,29,1,1,1084
E01014811,1295,10,21,2,4,1332
E01014812,1188,4,10,0,1,1203
E01014813,1354,8,12,0,1,1375
E01014815,1043,8,7,0,3,1061
E01014816,1225,6,10,1,6,1248
E01014817,1244,4,10,8,1,1267
E01014818,1439,8,6,3,7,1463
E01014819,1301,3,10,4,1,1319
E01014820,1199,7,7,2,0,1215
E01014821,920,7,7,2,3,939
E01014822,1109,4,16,0,1,1130
E01014823,1018,6,9,3,0,1036
E01014824,1195,8,3,3,2,1211
E01014825,989,6,1,0,3,999
E01014826,1161,14,3,7,2,1187
E01014827,1036,5,8,5,3,1057
E01014828,1022,6,27,2,3,1060
E01014829,1382,16,26,6,1,1431
E01014830,1164,18,34,8,2,1226
E01014831,910,18,13,6,0,947
E01014832,1079,12,8,3,1,1103
E01014833,1082,12,17,6,0,1117
E01014834,1015,14,48,8,1,1086
E01014835,1107,4,22,3,0,1136
E01014836,1165,3,13,8,4,1193
E01014838,1115,2,3,5,0,1125
E01014839,1174,4,16,6,5,1205
E01014840,1076,7,19,9,1,1112
E01014841,1501,18,13,11,8,1551
E01014842,1296,13,11,14,3,1337
E01014843,1297,15,8,8,2,1330
E01014844,1084,9,19,12,4,1128
E01014845,1036,3,18,2,1,1060
E01014846,1301,13,6,7,5,1332
E01014847,1355,15,12,1,3,1386
E01014848,1076,1,3,1,1,1082
E01014849,1278,4,24,4,0,1310
E01014850,1592,8,26,3,2,1631
E01014851,1888,31,27,7,0,1953
E01014852,1261,9,15,3,5,1293
E01014853,1306,12,7,5,1,1331
E01014854,1110,6,3,1,1,1121
E01014855,1215,3,8,0,1,1227
E01014856,1188,7,8,2,0,1205
E01014857,1196,8,9,2,1,1216
E01014858,1361,5,12,1,3,1382
E01014859,1256,7,11,0,6,1280
E01014860,1179,9,16,4,4,1212
E01014861,1487,9,30,11,1,1538
E01014862,2129,13,30,10,9,2191
E01014863,1262,1,8,5,4,1280
E01014864,1255,11,6,4,4,1280
E01014865,1484,13,9,1,0,1507
E01014866,1348,3,17,3,0,1371
E01014867,1091,18,9,18,6,1142
E01014868,1229,11,14,5,0,1259
E01014869,1335,9,6,2,9,1361
E01014870,1334,1,11,1,1,1348
E01014871,1001,0,10,4,0,1015
E01014872,1151,11,78,19,8,1267
E01014873,1114,11,34,12,5,1176
E01014874,1018,11,58,22,7,1116
E01014875,1099,11,245,25,22,1402
E01014876,1131,15,101,27,19,1293
E01014877,1039,20,87,10,10,1166
E01014878,1431,21,116,24,12,1604
E01014879,1253,16,104,6,7,1386
E01014880,1194,15,106,18,16,1349
E01014881,1257,26,129,15,8,1435
E01014882,1369,22,147,17,9,1564
E01014883,919,10,42,6,6,983
E01014884,1578,25,36,63,5,1707
E01014885,1475,2,13,2,1,1493
E01014886,1468,15,22,4,1,1510
E01014887,1164,4,7,0,0,1175
E01014888,1214,3,7,1,3,1228
E01014889,1235,1,16,1,0,1253
E01014890,1664,5,6,2,3,1680
E01014891,1390,7,10,1,3,1411
E01014892,1231,11,25,8,0,1275
E01014893,1148,3,16,3,1,1171
E01014894,986,7,9,8,2,1012
E01014895,1070,8,13,0,0,1091
E01014896,958,5,9,4,1,977
E01014897,1151,8,11,13,3,1186
E01014898,1314,10,21,7,5,1357
E01014899,1284,8,45,22,8,1367
E01014900,1163,9,44,27,9,1252
E01014901,1235,9,40,20,12,1316
E01014902,1006,7,35,2,9,1059
E01014903,1202,4,27,7,0,1240
E01014904,1121,17,60,30,7,1235
E01014905,1211,25,115,24,6,1381
E01014906,1206,19,121,30,3,1379
E01014907,1132,23,123,35,2,1315
E01014908,1029,17,45,15,14,1120
E01014909,1047,20,128,57,8,1260
E01014910,1050,19,95,26,3,1193
E01014911,1118,7,18,3,0,1146
E01014912,1461,8,7,2,0,1478
E01014913,1308,10,3,0,0,1321
E01014914,1281,7,11,7,0,1306
E01014915,1201,20,31,16,0,1268
E01014916,1197,21,11,3,1,1233
E01014917,1189,16,14,11,1,1231
E01014918,1180,6,20,6,0,1212
E01014919,1018,8,12,9,1,1048
E01014920,1104,9,22,7,0,1142
E01014921,1115,5,11,4,3,1138
E01014922,1070,10,25,14,2,1121
E01014923,1163,7,23,29,0,1222
E01014924,1355,18,54,21,11,1459
E01014925,1190,8,9,8,5,1220
E01014926,1241,21,16,18,1,1297
E01014927,1376,20,15,23,1,1435
E01014928,1192,9,8,12,3,1224
E01014929,1616,8,8,4,8,1644
E01014930,1506,3,4,6,6,1525
E01014931,1207,1,8,3,2,1221
E01014932,1379,15,8,6,0,1408
E01014933,1190,5,6,2,4,1207
E01014934,1030,1,4,2,3,1040
E01014935,1218,13,13,5,1,1250
E01014936,1137,10,9,2,4,1162
E01014937,1059,5,3,0,0,1067
E01014938,1196,11,3,9,0,1219
E01014939,936,6,6,2,1,951
E01014940,1068,2,11,9,0,1090
E01014941,1235,12,17,7,1,1272
E01014942,1155,13,13,4,4,1189
E01014943,1378,10,10,8,2,1408
E01014944,1377,8,13,8,1,1407
E01014945,1350,15,11,13,0,1389
E01014946,1225,8,18,11,1,1263
E01014947,1222,4,22,5,3,1256
E01014948,1257,14,33,26,5,1335
E01014949,1058,26,26,17,1,1128
E01014950,1094,13,42,7,4,1160
E01014951,979,22,29,23,3,1056
E01014952,1340,11,46,17,15,1429
E01014953,1585,13,30,1,11,1640
E01014954,1255,10,5,3,3,1276
E01014955,1083,13,7,6,3,1112
E01014956,1287,10,11,10,0,1318
E01014957,1006,3,10,7,6,1032
E01014958,892,11,11,14,3,931
E01014959,1084,13,15,7,9,1128
E01014960,1279,3,23,5,7,1317
E01014961,1221,21,21,10,3,1276
E01014962,1445,4,15,2,2,1468
E01014963,1521,11,7,1,4,1544
E01014964,1237,4,49,13,8,1311
E01014965,1176,7,36,8,0,1227
E01014966,1082,16,42,26,3,1169
E01014967,1499,9,50,8,12,1578
E01014968,1325,12,20,2,6,1365
E01014969,1203,8,21,7,4,1243
E01014972,1403,10,8,5,1,1427
E01014973,1142,12,12,25,2,1193
E01014974,1251,7,15,21,1,1295
E01014975,1223,17,31,39,2,1312
E01014976,1156,23,17,21,3,1220
E01014977,994,16,40,20,6,1076
E01014978,1090,11,63,16,5,1185
E01014979,1172,18,37,7,6,1240
E01014980,1260,18,31,9,3,1321
E01014981,1990,34,158,39,9,2230
E01014982,1160,9,14,13,6,1202
E01014983,1139,7,33,14,3,1196
E01014984,1141,7,27,9,4,1188
E01014985,1149,12,13,3,1,1178
E01014986,1252,10,27,2,1,1292
E01014987,1011,7,21,2,2,1043
E01014988,1139,2,4,1,0,1146
E01014989,1080,14,11,12,2,1119
E01014990,1263,3,11,2,1,1280
E01014991,1674,22,15,5,2,1718
E01014992,1179,5,18,4,0,1206
E01014993,1151,5,8,4,0,1168
E01014994,1455,14,13,4,5,1491
E01014995,1389,8,11,0,3,1411
E01014996,1274,16,59,21,18,1388
E01014998,1257,6,17,4,0,1284
E01014999,1270,8,10,5,6,1299
E01015000,1216,7,32,6,2,1263
E01015001,1261,17,16,5,0,1299
E01015002,1228,12,25,6,1,1272
E01015003,1290,12,23,10,0,1335
E01015004,1370,14,7,13,1,1405
E01015005,1469,21,45,33,3,1571
E01015006,1265,5,31,7,2,1310
E01015007,1323,16,31,31,2,1403
E01015008,1336,7,18,17,3,1381
E01015009,1111,1,11,3,0,1126
E01015010,1030,4,15,5,5,1059
E01015011,1277,11,13,2,0,1303
E01015012,1009,3,7,0,1,1020
E01015013,998,5,14,5,1,1023
E01015014,1144,8,13,0,1,1166
E01015015,1158,12,19,7,1,1197
E01015016,980,5,7,6,0,998
E01015017,1177,7,28,2,2,1216
E01015018,1190,7,25,6,0,1228
E01015019,1365,7,30,9,3,1414
E01015020,1148,14,14,2,1,1179
E01015021,1276,5,11,8,1,1301
E01015022,1241,9,17,2,2,1271
E01015023,1276,14,13,6,1,1310
E01015024,1183,8,8,1,1,1201
E01015025,1347,13,21,5,6,1392
E01015026,1242,9,2,5,1,1259
E01015027,1276,10,17,8,5,1316
E01015028,1092,12,5,5,0,1114
E01015029,1315,8,24,23,2,1372
E01015030,1250,3,7,3,2,1265
E01015031,1345,17,29,22,23,1436
E01015032,1697,53,79,21,13,1863
E01015033,1263,5,10,6,4,1288
E01015034,1091,15,27,4,11,1148
E01015035,1239,5,10,0,5,1259
E01015036,1146,7,11,7,0,1171
E01015037,1078,8,5,5,2,1098
E01015038,1378,11,19,8,5,1421
E01015039,1031,10,4,14,5,1064
E01015040,1126,11,10,10,4,1161
E01015041,1109,16,11,4,3,1143
E01015042,1122,9,20,12,7,1170
E01015043,1106,14,24,5,9,1158
E01015044,1222,28,15,9,7,1281
E01015045,1111,18,26,12,7,1174
E01015046,1490,19,19,15,6,1549
E01015047,1064,15,13,15,2,1109
E01015048,858,21,7,16,5,907
E01015049,1409,21,54,11,12,1507
E01015050,1581,39,91,19,35,1765
E01015051,1619,54,88,63,16,1840
E01015052,1645,53,78,19,20,1815
E01015053,1250,44,69,20,11,1394
E01015054,2040,44,79,27,9,2199
E01015055,1129,2,8,2,0,1141
E01015056,1322,6,6,10,1,1345
E01015057,1120,10,19,7,5,1161
E01015058,1035,13,8,5,0,1061
E01015059,1197,11,10,5,1,1224
E01015060,1176,5,11,16,2,1210
E01015061,1116,21,30,20,14,1201
E01015062,1801,45,53,31,10,1940
E01015063,1159,6,5,3,1,1174
E01015064,1359,14,10,2,0,1385
E01015065,1109,13,21,5,8,1156
E01015066,1201,5,4,3,1,1214
E01015067,1309,2,6,1,0,1318
E01015068,1238,9,11,5,0,1263
E01015069,1247,2,10,3,2,1264
E01015070,1912,16,54,24,16,2022
E01015071,1227,4,13,16,7,1267
E01015072,1217,8,18,0,2,1245
E01015073,1172,8,4,3,0,1187
E01015074,1184,9,9,0,3,1205
E01015075,1109,2,15,7,0,1133
E01015076,1171,9,3,4,0,1187
E01015077,1389,3,16,6,3,1417
E01015078,917,7,7,5,0,936
E01015079,1201,4,9,5,0,1219
E01015080,908,6,10,5,0,929
E01015081,1185,18,9,3,0,1215
E01015082,1266,10,2,3,0,1281
E01015083,1210,11,4,3,0,1228
E01015084,1189,5,3,2,3,1202
E01015085,1296,6,4,3,1,1310
E01015086,1101,3,6,2,0,1112
E01015087,1140,10,14,2,1,1167
E01015088,1098,18,4,5,0,1125
E01015089,1371,8,10,5,2,1396
E01015090,1136,1,12,0,2,1151
E01015091,1294,3,9,1,6,1313
E01015092,1215,13,120,7,11,1366
E01015093,1125,5,21,1,1,1153
E01015094,1120,5,4,1,1,1131
E01015095,1166,5,5,4,3,1183
E01015096,1156,3,2,1,0,1162
E01015097,1518,7,13,4,3,1545
E01015098,1189,15,34,7,3,1248
E01015099,1177,15,12,7,2,1213
E01015100,1143,15,46,9,7,1220
E01015101,1286,6,23,4,3,1322
E01015102,1312,13,45,5,3,1378
E01015103,1170,10,8,2,3,1193
E01015104,1182,8,11,5,4,1210
E01015105,1173,14,11,8,5,1211
E01015106,1007,6,8,0,2,1023
E01015107,1180,9,3,6,0,1198
E01015108,1445,8,11,4,5,1473
E01015109,1201,7,8,2,2,1220
E01015110,1287,1,6,6,0,1300
E01015111,1283,4,9,3,1,1300
E01015112,1168,10,9,1,0,1188
E01015113,1217,7,3,0,0,1227
E01015114,1213,9,5,1,3,1231
E01015115,1222,6,5,4,1,1238
E01015116,1207,9,6,8,0,1230
E01015117,1197,8,1,1,0,1207
E01015118,1288,7,3,3,1,1302
E01015119,1323,8,1,3,1,1336
E01015120,1261,3,5,1,3,1273
E01015121,1237,7,5,1,0,1250
E01015122,1277,5,6,3,1,1292
E01015123,1448,6,9,2,0,1465
E01015124,1329,4,6,0,0,1339
E01015125,1258,5,6,3,0,1272
E01015126,1227,0,3,0,2,1232
E01015127,1249,7,5,6,2,1269
E01015128,1398,5,4,1,0,1408
E01015129,1146,7,1,6,1,1161
E01015130,1260,7,7,9,0,1283
E01015131,1278,4,7,1,0,1290
E01015132,1236,3,6,7,7,1259
E01015133,1315,4,3,1,1,1324
E01015134,1233,10,3,3,0,1249
E01015135,1257,11,10,2,1,1281
E01015136,1222,4,4,5,1,1236
E01015137,1247,5,7,3,1,1263
E01015138,1263,6,10,2,2,1283
E01015139,1180,8,4,1,1,1194
E01015140,1207,4,6,9,3,1229
E01015141,1462,9,6,4,0,1481
E01015142,1095,7,12,1,0,1115
E01015143,1113,7,7,1,1,1129
E01015144,1137,8,8,1,1,1155
E01015145,1157,7,4,1,3,1172
E01015146,1217,10,18,9,2,1256
E01015147,1052,5,8,0,2,1067
E01015148,1166,10,10,5,1,1192
E01015149,1135,8,3,1,1,1148
E01015150,1160,8,2,4,0,1174
E01015151,1430,54,112,43,25,1664
E01015152,1366,56,57,25,22,1526
E01015153,1249,38,100,30,17,1434
E01015155,1329,19,48,16,20,1432
E01015156,1323,29,34,14,9,1409
E01015157,1763,34,49,12,12,1870
E01015158,1878,68,37,18,21,2022
E01015159,1335,3,4,1,3,1346
E01015160,1231,7,11,0,4,1253
E01015161,1190,6,7,0,0,1203
E01015162,1177,5,10,1,1,1194
E01015163,1172,9,10,1,2,1194
E01015164,1429,14,20,9,11,1483
E01015165,1201,3,39,3,2,1248
E01015166,1412,10,16,4,5,1447
E01015167,1241,7,10,7,6,1271
E01015168,1452,16,24,9,9,1510
E01015169,1619,42,57,46,14,1778
E01015170,1300,13,12,11,10,1346
E01015171,1440,22,22,9,14,1507
E01015172,1436,26,29,18,10,1519
E01015173,1369,27,54,12,10,1472
E01015174,1296,20,25,8,6,1355
E01015175,1364,20,31,13,5,1433
E01015176,1178,12,25,4,1,1220
E01015177,1440,17,20,16,1,1494
E01015178,1733,38,59,9,11,1850
E01015179,1399,26,60,16,8,1509
E01015180,1370,19,40,24,5,1458
E01015181,1599,42,57,46,17,1761
E01015182,1432,21,27,7,12,1499
E01015183,1119,5,4,0,0,1128
E01015184,1167,5,4,1,0,1177
E01015185,1140,5,5,2,1,1153
E01015186,1104,7,19,1,0,1131
E01015187,1231,1,4,0,2,1238
E01015188,1263,8,3,2,2,1278
E01015189,981,5,4,0,0,990
E01015190,1314,12,4,3,0,1333
E01015191,1245,9,3,5,1,1263
E01015192,1097,16,3,1,2,1119
E01015193,1049,3,3,2,2,1059
E01015194,1100,19,6,0,7,1132
E01015195,1179,12,8,2,1,1202
E01015196,1072,7,5,1,5,1090
E01015197,1248,4,6,1,4,1263
E01015198,1377,2,8,0,2,1389
E01015199,1197,4,2,1,0,1204
E01015200,821,3,4,0,0,828
E01015201,1153,8,1,2,5,1169
E01015202,1187,6,10,2,1,1206
E01015203,1057,2,1,4,1,1065
E01015204,1104,9,9,1,1,1124
E01015205,1220,7,5,0,1,1233
E01015206,1219,7,13,2,1,1242
E01015207,1235,8,4,6,6,1259
E01015208,1566,7,28,3,6,1610
E01015209,1146,6,16,7,2,1177
E01015210,1117,10,45,2,7,1181
E01015211,1182,5,5,0,1,1193
E01015212,1085,9,17,0,0,1111
E01015213,1107,12,16,0,1,1136
E01015214,1098,10,18,3,2,1131
E01015215,1154,13,4,0,0,1171
E01015216,1105,11,14,2,3,1135
E01015217,1197,18,12,6,5,1238
E01015218,1167,10,3,1,1,1182
E01015219,1187,8,14,4,1,1214
E01015220,1158,11,0,3,1,1173
E01015221,1176,8,7,0,0,1191
E01015222,1173,7,6,1,1,1188
E01015223,1051,6,8,1,0,1066
E01015224,1184,7,4,2,5,1202
E01015225,1194,8,14,1,2,1219
E01015226,1175,6,10,2,0,1193
E01015227,1274,6,6,3,2,1291
E01015228,1300,5,8,2,1,1316
E01015229,1155,10,11,1,3,1180
E01015230,1220,2,9,1,0,1232
E01015231,1288,14,30,2,3,1337
E01015232,1456,10,19,1,1,1487
E01015233,1170,6,22,4,1,1203
E01015234,994,8,12,3,2,1019
E01015235,1525,11,7,3,2,1548
E01015236,1230,3,11,4,1,1249
E01015237,1006,8,13,3,0,1030
E01015238,1156,12,19,2,1,1190
E01015239,1299,13,27,2,4,1345
E01015240,1298,12,11,4,6,1331
E01015241,1159,15,17,2,0,1193
E01015242,945,8,20,3,0,976
E01015243,1081,8,15,1,2,1107
E01015244,1198,6,2,1,1,1208
E01015245,1109,7,4,2,0,1122
E01015246,1202,8,2,1,0,1213
E01015247,1381,5,3,0,0,1389
E01015248,1180,6,5,1,1,1193
E01015249,1126,13,18,2,5,1164
E01015250,1089,10,9,2,0,1110
E01015251,937,6,31,1,2,977
E01015252,1761,15,30,9,4,1819
E01015253,1183,20,32,3,5,1243
E01015254,1160,6,26,1,5,1198
E01015255,1353,23,24,6,6,1412
E01015256,1548,28,35,2,10,1623
E01015257,1023,5,13,2,5,1048
E01015258,1550,27,32,8,5,1622
E01015259,1075,9,9,0,2,1095
E01015260,1291,11,16,2,4,1324
E01015261,1602,17,26,3,3,1651
E01015262,1059,6,10,1,1,1077
E01015263,1106,11,11,3,1,1132
E01015264,1139,4,3,0,1,1147
E01015265,1244,8,7,2,1,1262
E01015266,1116,13,7,3,0,1139
E01015267,1378,18,10,3,7,1416
E01015268,1382,18,18,7,3,1428
E01015269,1425,9,14,8,5,1461
E01015270,1417,19,33,17,12,1498
E01015271,1283,7,4,3,2,1299
E01015272,1445,14,39,11,4,1513
E01015273,1488,22,67,33,9,1619
E01015274,1422,18,13,12,7,1472
E01015275,1402,22,71,24,3,1522
E01015276,1223,24,42,18,9,1316
E01015277,1444,31,77,21,7,1580
E01015279,1445,43,73,24,17,1602
E01015280,1617,36,69,23,14,1759
E01015281,1317,29,71,19,12,1448
E01015282,1537,48,93,57,14,1749
E01015283,1419,81,157,50,48,1755
E01015285,2021,80,329,55,32,2517
E01015286,1596,36,70,21,22,1745
E01015287,1856,52,155,36,29,2128
E01015288,1361,36,126,32,25,1580
E01015289,1533,39,88,36,29,1725
E01015290,1418,28,169,41,26,1682
E01015291,1595,31,163,8,23,1820
E01015292,1251,26,63,21,19,1380
E01015293,1140,23,21,17,16,1217
E01015294,1340,47,77,49,26,1539
E01015295,1255,4,4,1,2,1266
E01015296,1485,29,21,7,5,1547
E01015297,1284,10,26,15,2,1337
E01015298,1397,8,8,4,0,1417
E01015299,1368,9,18,4,3,1402
E01015300,1260,13,16,3,10,1302
E01015301,1220,4,22,7,9,1262
E01015302,1532,7,27,3,3,1572
E01015303,1243,6,15,9,7,1280
E01015304,1335,6,8,7,3,1359
E01015305,1191,10,9,13,7,1230
E01015306,1309,16,10,5,1,1341
E01015307,1056,13,7,3,10,1089
E01015308,1319,8,13,3,3,1346
E01015309,1051,11,17,4,9,1092
E01015310,1177,16,24,2,0,1219
E01015311,1247,4,9,4,2,1266
E01015312,930,3,6,1,8,948
E01015313,992,14,16,12,6,1040
E01015314,1186,6,31,4,3,1230
E01015315,1488,26,77,5,10,1606
E01015316,1288,10,25,6,3,1332
E01015317,1232,13,14,12,4,1275
E01015318,1236,19,68,14,13,1350
E01015319,1009,16,132,10,10,1177
E01015320,1325,15,23,1,5,1369
E01015321,1424,19,57,18,11,1529
E01015322,1263,18,50,9,15,1355
E01015323,1194,16,21,6,7,1244
E01015324,1171,11,51,7,15,1255
E01015325,1271,8,33,8,5,1325
E01015326,1417,42,129,17,40,1645
E01015327,1399,46,97,27,29,1598
E01015328,1453,35,112,34,32,1666
E01015329,1217,44,74,27,36,1398
E01015330,1389,19,63,11,25,1507
E01015331,1657,53,155,46,38,1949
E01015332,1241,8,22,4,4,1279
E01015333,1285,5,27,2,2,1321
E01015334,1308,9,24,0,4,1345
E01015335,1374,6,6,10,5,1401
E01015336,1289,10,32,6,2,1339
E01015337,1313,16,34,8,10,1381
E01015338,1341,14,59,14,12,1440
E01015339,1181,25,45,8,13,1272
E01015340,1293,10,38,13,6,1360
E01015341,1016,22,56,8,21,1123
E01015342,1228,17,20,8,9,1282
E01015343,1149,17,26,12,11,1215
E01015344,1449,17,72,8,12,1558
E01015345,1448,47,105,18,21,1639
E01015346,1318,32,48,11,21,1430
E01015348,1514,29,50,14,27,1634
E01015349,1117,16,44,10,5,1192
E01015350,1154,13,13,10,4,1194
E01015351,1140,10,19,11,4,1184
E01015352,1106,12,23,2,4,1147
E01015353,902,5,8,1,4,920
E01015354,1262,17,60,3,4,1346
E01015355,1307,21,39,11,7,1385
E01015356,1379,24,48,10,5,1466
E01015357,1250,8,13,11,7,1289
E01015358,1544,25,35,5,5,1614
E01015359,1279,12,30,11,8,1340
E01015360,1412,26,49,17,15,1519
E01015361,1018,16,26,10,4,1074
E01015362,889,18,18,3,11,939
E01015363,1237,16,45,2,10,1310
E01015364,1272,14,23,8,9,1326
E01015365,1370,21,45,10,7,1453
E01015366,1584,11,29,4,8,1636
E01015367,1611,80,109,33,39,1872
E01015368,1479,19,50,18,23,1589
E01015369,1488,11,25,10,12,1546
E01015370,1434,24,25,11,11,1505
E01015371,1298,29,48,16,13,1404
E01015372,1635,25,46,9,9,1724
E01015373,1257,31,60,17,26,1391
E01015374,1818,62,114,23,13,2030
E01015375,1490,34,131,23,22,1700
E01015376,1342,38,105,16,25,1526
E01015377,1261,27,65,8,2,1363
E01015378,1295,30,58,21,17,1421
E01015379,1085,20,9,10,1,1125
E01015380,1469,10,10,4,7,1500
E01015381,1256,8,15,6,2,1287
E01015382,1343,17,33,20,2,1415
E01015383,1245,13,26,2,2,1288
E01015384,1057,21,30,4,6,1118
E01015385,1389,15,15,7,7,1433
E01015386,1287,16,79,11,11,1404
E01015387,1197,8,34,5,5,1249
E01015388,1205,25,128,14,5,1377
E01015389,1201,12,36,5,10,1264
E01015390,1283,14,63,4,6,1370
E01015391,1174,12,23,5,5,1219
E01015392,1150,9,24,3,7,1193
E01015393,946,16,21,4,1,988
E01015394,1224,16,29,6,8,1283
E01015395,1107,5,30,3,0,1145
E01015396,1290,11,20,1,2,1324
E01015397,1121,8,27,2,1,1159
E01015398,1084,5,22,1,0,1112
E01015399,1282,5,9,0,0,1296
E01015400,1242,5,11,0,0,1258
E01015401,1253,3,10,1,2,1269
E01015402,1384,17,43,5,14,1463
E01015403,1637,11,29,5,9,1691
E01015404,1431,5,46,4,9,1495
E01015405,1559,12,30,7,12,1620
E01015406,1447,26,44,9,7,1533
E01015407,1219,5,28,3,1,1256
E01015408,1094,4,4,1,3,1106
E01015409,1090,11,20,2,5,1128
E01015410,1185,9,7,4,6,1211
E01015411,1068,7,18,3,2,1098
E01015412,1073,8,16,0,1,1098
E01015413,1144,6,19,2,4,1175
E01015414,1172,11,25,1,1,1210
E01015415,939,11,10,5,3,968
E01015416,1002,5,21,9,5,1042
E01015417,1175,12,13,3,2,1205
E01015418,1243,3,8,0,0,1254
E01015419,1432,3,11,1,1,1448
E01015420,1211,5,10,4,0,1230
E01015421,1201,1,16,4,3,1225
E01015422,1144,6,11,1,2,1164
E01015423,1640,10,43,2,9,1704
E01015424,1115,3,12,0,3,1133
E01015425,1079,5,6,1,0,1091
E01015426,1084,9,10,5,5,1113
E01015427,1243,13,18,6,5,1285
E01015428,1771,8,16,6,1,1802
E01015429,1291,9,15,1,3,1319
E01015430,1118,12,10,2,0,1142
E01015431,1096,12,22,3,3,1136
E01015432,1362,8,10,0,0,1380
E01015433,1254,1,7,1,3,1266
E01015434,1368,10,9,1,1,1389
E01015435,1168,8,15,5,2,1198
E01015436,1091,10,10,3,1,1115
E01015437,1075,8,9,4,3,1099
E01015438,1221,12,22,9,2,1266
E01015439,1334,14,52,6,3,1409
E01015440,1538,13,39,9,3,1602
E01015441,1464,20,42,5,1,1532
E01015442,1470,12,18,4,1,1505
E01015443,1401,12,30,7,5,1455
E01015444,1344,13,23,4,3,1387
E01015445,1521,16,44,1,2,1584
E01015446,1211,10,47,4,1,1273
E01015447,1326,9,14,2,7,1358
E01015448,1206,4,20,1,3,1234
E01015449,1320,12,22,7,5,1366
E01015450,1388,7,14,5,1,1415
E01015451,1213,8,22,1,1,1245
E01015452,1449,8,11,3,2,1473
E01015453,1502,19,32,2,6,1561
E01015454,1437,21,46,9,7,1520
E01015455,1556,10,14,3,6,1589
E01015456,1453,17,13,5,1,1489
E01015457,1372,14,29,4,5,1424
E01015458,1220,10,12,4,4,1250
E01015459,1448,5,25,1,1,1480
E01015460,1266,20,63,18,6,1373
E01015461,1173,22,41,6,9,1251
E01015462,1228,16,25,3,6,1278
E01015463,1245,19,33,3,1,1301
E01015464,1278,7,14,3,6,1308
E01015465,1358,20,59,5,14,1456
E01015466,1360,18,78,6,1,1463
E01015468,1547,15,103,19,6,1690
E01015471,1166,11,64,17,4,1262
E01015472,1883,17,86,24,12,2022
E01015473,1403,11,20,9,3,1446
E01015474,1328,10,11,1,1,1351
E01015475,748,35,894,48,12,1737
E01015476,1494,51,351,42,17,1955
E01015477,1103,43,104,27,13,1290
E01015478,1091,35,64,10,1,1201
E01015479,1043,20,179,40,14,1296
E01015480,675,55,1030,80,19,1859
E01015481,1317,19,58,18,2,1414
E01015482,1036,3,39,5,1,1084
E01015483,1216,6,26,5,6,1259
E01015484,1140,16,38,17,1,1212
E01015485,1154,7,23,10,6,1200
E01015486,1129,10,49,12,3,1203
E01015487,1204,17,84,19,4,1328
E01015488,1108,10,45,20,3,1186
E01015489,1010,14,131,11,2,1168
E01015490,952,16,61,11,1,1041
E01015491,1121,10,45,29,7,1212
E01015492,983,6,72,16,4,1081
E01015493,1027,15,347,29,8,1426
E01015494,1242,25,200,49,11,1527
E01015496,1209,29,103,30,9,1380
E01015497,1192,22,82,15,3,1314
E01015498,1328,29,58,14,9,1438
E01015499,968,17,45,16,4,1050
E01015500,1129,27,52,14,2,1224
E01015501,1006,20,72,17,7,1122
E01015502,1080,31,64,12,6,1193
E01015503,967,21,44,19,7,1058
E01015504,978,11,68,9,5,1071
E01015505,1066,15,51,23,9,1164
E01015506,1123,15,43,16,3,1200
E01015507,1076,18,20,28,2,1144
E01015508,1006,14,63,20,3,1106
E01015509,1173,24,89,24,10,1320
E01015510,1259,42,189,29,18,1537
E01015511,1103,31,130,16,13,1293
E01015512,1135,22,61,15,5,1238
E01015513,1149,16,61,7,1,1234
E01015514,1031,4,12,6,0,1053
E01015515,1134,6,25,7,0,1172
E01015516,1098,13,17,10,0,1138
E01015517,1208,7,13,5,5,1238
E01015518,1015,19,69,12,2,1117
E01015519,1197,13,12,4,0,1226
E01015520,969,11,28,1,1,1010
E01015521,1170,5,11,2,5,1193
E01015522,1174,15,18,3,1,1211
E01015523,1249,12,15,0,3,1279
E01015524,901,7,23,4,2,937
E01015525,1198,12,28,9,6,1253
E01015526,1129,10,12,11,7,1169
E01015527,1248,29,29,19,3,1328
E01015528,1329,25,25,21,2,1402
E01015529,1259,12,28,8,0,1307
E01015530,1280,15,32,9,2,1338
E01015532,1195,20,38,6,5,1264
E01015533,1239,8,39,6,0,1292
E01015534,1538,23,84,13,5,1663
E01015535,1143,12,58,18,4,1235
E01015536,1788,13,89,18,2,1910
E01015537,1195,37,67,30,1,1330
E01015538,1252,18,106,23,4,1403
E01015539,1116,19,84,23,3,1245
E01015540,1228,13,146,38,4,1429
E01015541,1162,15,187,18,18,1400
E01015542,1028,15,73,17,5,1138
E01015543,1078,10,17,5,5,1115
E01015544,1215,17,16,18,6,1272
E01015545,1108,20,29,11,6,1174
E01015546,1140,26,7,14,5,1192
E01015547,1382,7,43,4,2,1438
E01015548,1208,5,29,2,3,1247
E01015549,1369,7,46,8,4,1434
E01015550,1476,17,62,12,2,1569
E01015551,1234,7,30,11,3,1285
E01015552,1580,11,65,17,1,1674
E01015553,1247,9,38,15,2,1311
E01015554,1166,3,24,2,0,1195
E01015555,1213,9,15,6,1,1244
E01015556,1271,9,13,5,3,1301
E01015557,1171,3,17,5,0,1196
E01015558,1136,13,33,9,0,1191
E01015559,1177,7,44,7,6,1241
E01015560,1267,14,20,11,0,1312
E01015561,1080,24,87,16,5,1212
E01015562,1079,16,49,16,5,1165
E01015563,1103,12,79,12,7,1213
E01015564,1143,21,77,12,10,1263
E01015565,1164,18,69,13,2,1266
E01015566,1165,20,73,15,6,1279
E01015567,1102,8,94,18,3,1225
E01015568,1080,18,49,27,3,1177
E01015569,1134,31,44,9,9,1227
E01015570,1109,35,64,36,13,1257
E01015571,1140,21,86,34,4,1285
E01015572,865,27,49,23,1,965
E01015573,1341,57,139,55,9,1601
E01015574,1136,14,121,19,3,1293
E01015575,746,26,85,23,2,882
E01015576,1192,16,89,5,14,1316
E01015578,1195,17,78,12,3,1305
E01015579,1178,7,62,6,4,1257
E01015580,1250,9,38,6,2,1305
E01015581,1183,12,41,5,1,1242
E01015582,1347,21,151,15,10,1544
E01015583,1681,12,33,7,0,1733
E01015584,1218,6,8,1,1,1234
E01015585,1260,20,27,10,2,1319
E01015586,1234,5,8,4,1,1252
E01015587,1534,9,27,6,7,1583
E01015588,1464,7,18,4,3,1496
E01015589,1299,9,13,3,1,1325
E01015590,979,11,11,5,1,1007
E01015591,1098,22,63,15,2,1200
E01015592,1073,15,45,35,7,1175
E01015593,981,22,46,19,7,1075
E01015594,1317,23,69,34,3,1446
E01015595,1002,27,85,37,2,1153
E01015596,1008,27,135,30,8,1208
E01015597,1028,30,33,61,3,1155
E01015598,1102,12,131,16,17,1278
E01015599,703,93,571,56,51,1474
E01015600,460,66,796,36,24,1382
E01015601,413,15,944,37,25,1434
E01015602,1207,64,298,39,47,1655
E01015603,979,50,602,56,27,1714
E01015604,427,65,832,21,16,1361
E01015605,1038,17,157,23,24,1259
E01015606,1211,31,130,26,8,1406
E01015607,983,20,45,29,34,1111
E01015608,1064,27,116,18,17,1242
E01015609,987,47,107,51,42,1234
E01015610,1031,31,107,32,7,1208
E01015611,1209,54,353,28,23,1667
E01015612,1163,32,428,68,35,1726
E01015613,1053,29,50,32,3,1167
E01015614,1205,26,92,50,6,1379
E01015615,1011,23,183,36,15,1268
E01015616,888,45,277,48,32,1290
E01015617,1031,12,11,11,1,1066
E01015618,856,5,9,9,0,879
E01015619,1534,23,43,12,5,1617
E01015620,1304,6,45,14,1,1370
E01015621,1452,35,78,42,16,1623
E01015622,1731,34,117,70,15,1967
E01015623,1327,13,37,22,7,1406
E01015624,1232,22,28,20,23,1325
E01015626,1024,6,2,14,2,1048
E01015627,1412,4,17,4,0,1437
E01015628,1858,23,17,11,2,1911
E01015629,1341,9,21,9,0,1380
E01015630,1181,18,33,17,7,1256
E01015631,1044,10,3,3,3,1063
E01015632,1155,32,285,27,26,1525
E01015633,1593,45,100,41,11,1790
E01015634,1139,28,221,26,16,1430
E01015635,1263,4,17,0,2,1286
E01015636,930,8,10,3,0,951
E01015637,989,25,21,33,3,1071
E01015638,1233,15,46,12,3,1309
E01015639,1058,35,46,50,5,1194
E01015640,1044,38,40,20,5,1147
E01015641,880,17,14,35,4,950
E01015642,984,20,28,35,6,1073
E01015643,1006,14,23,30,6,1079
E01015644,1384,26,82,34,8,1534
E01015645,1285,15,37,20,2,1359
E01015646,1630,13,42,7,3,1695
E01015647,972,26,23,33,6,1060
E01015648,1166,8,44,6,3,1227
E01015650,1511,15,72,25,6,1629
E01015651,1006,32,478,12,2,1530
E01015652,846,29,538,30,27,1470
E01015653,1103,31,288,24,17,1463
E01015654,1317,28,375,44,36,1800
E01015655,1358,32,287,37,20,1734
E01015656,1123,21,42,15,5,1206
E01015657,1216,31,62,51,10,1370
E01015658,1001,33,52,35,5,1126
E01015659,1501,12,34,19,2,1568
E01015660,1148,17,37,24,13,1239
E01015661,1109,31,172,73,18,1403
E01015662,781,28,178,43,10,1040
E01015663,854,26,189,45,22,1136
E01015664,943,31,182,56,20,1232
E01015665,704,24,482,22,17,1249
E01015666,1065,14,22,13,2,1116
E01015667,1015,14,33,13,1,1076
E01015668,1330,20,54,44,4,1452
E01015669,1141,12,17,13,9,1192
E01015670,1141,4,48,6,3,1202
E01015671,1239,19,53,23,4,1338
E01015672,1158,24,59,13,2,1256
E01015673,1098,19,23,21,7,1168
E01015674,1150,13,27,17,8,1215
E01015675,1173,16,70,21,5,1285
E01015676,1171,23,38,20,5,1257
E01015677,784,14,29,12,4,843
E01015678,1073,16,13,19,0,1121
E01015679,1396,30,47,13,7,1493
E01015680,1042,27,36,40,2,1147
E01015681,1169,7,44,11,3,1234
E01015682,1110,14,57,9,2,1192
E01015683,1546,17,22,11,3,1599
E01015684,1227,16,42,11,1,1297
E01015685,1324,6,28,11,5,1374
E01015686,1267,10,23,2,5,1307
E01015687,1051,10,212,20,11,1304
E01015688,889,29,248,23,15,1204
E01015689,1104,11,110,10,1,1236
E01015690,792,8,190,13,7,1010
E01015691,859,6,288,11,16,1180
E01015692,598,7,395,27,16,1043
E01015693,833,16,295,47,18,1209
E01015694,677,11,342,76,20,1126
E01015695,576,33,464,81,14,1168
E01015696,798,32,125,58,21,1034
E01015697,908,42,281,79,17,1327
E01015698,454,40,768,133,24,1419
E01015699,460,53,639,182,44,1378
E01015700,714,28,885,136,28,1791
E01015701,179,8,1225,75,27,1514
E01015702,288,20,830,94,14,1246
E01015703,145,14,1247,73,18,1497
E01015704,216,35,994,93,29,1367
E01015705,267,20,804,178,9,1278
E01015706,906,8,175,65,11,1165
E01015707,983,20,119,59,11,1192
E01015708,835,11,216,48,12,1122
E01015709,969,29,149,77,8,1232
E01015710,951,28,165,72,7,1223
E01015711,415,35,638,124,17,1229
E01015712,660,19,542,119,22,1362
E01015713,602,25,404,75,10,1116
E01015714,684,25,519,101,27,1356
E01015715,296,30,811,106,8,1251
E01015716,752,53,312,218,24,1359
E01015717,459,34,415,170,4,1082
E01015718,817,33,280,129,39,1298
E01015719,909,30,144,67,16,1166
E01015720,683,47,276,136,22,1164
E01015721,1076,19,94,54,6,1249
E01015722,757,26,79,118,16,996
E01015723,717,18,157,108,12,1012
E01015724,512,31,932,140,24,1639
E01015725,159,20,905,34,17,1135
E01015726,208,20,1310,92,13,1643
E01015727,190,15,1030,77,25,1337
E01015728,431,25,633,129,15,1233
E01015729,549,36,742,147,31,1505
E01015730,623,34,911,124,30,1722
E01015731,280,24,908,127,34,1373
E01015732,764,40,200,88,27,1119
E01015733,848,44,301,92,28,1313
E01015734,1092,36,170,140,22,1460
E01015735,804,70,273,213,21,1381
E01015736,941,33,209,119,20,1322
E01015737,733,25,261,106,24,1149
E01015738,1035,48,253,156,45,1537
E01015739,1080,72,259,188,52,1651
E01015740,855,22,252,92,32,1253
E01015741,1074,74,376,266,73,1863
E01015742,1002,56,195,169,43,1465
E01015743,835,35,218,162,32,1282
E01015744,799,29,171,101,12,1112
E01015745,806,29,394,50,21,1300
E01015746,994,31,133,65,11,1234
E01015747,851,11,260,52,13,1187
E01015748,1105,20,176,69,13,1383
E01015749,704,63,237,309,21,1334
E01015750,689,42,643,183,29,1586
E01015751,786,64,235,199,6,1290
E01015752,621,42,184,189,15,1051
E01015753,841,37,97,154,4,1133
E01015754,861,56,196,236,14,1363
E01015755,974,18,197,183,10,1382
E01015756,877,40,145,131,8,1201
E01015757,792,51,157,164,8,1172
E01015758,639,41,205,187,11,1083
E01015759,740,49,186,152,18,1145
E01015760,704,32,181,188,11,1116
E01015761,832,41,200,129,7,1209
E01015762,882,16,285,114,36,1333
E01015763,896,33,203,110,8,1250
E01015764,1092,23,121,68,5,1309
E01015765,846,40,188,184,4,1262
E01015766,720,25,353,97,17,1212
E01015767,874,25,244,103,12,1258
E01015768,915,27,151,65,5,1163
E01015769,674,32,90,131,4,931
E01015770,802,16,162,82,2,1064
E01015771,598,46,219,185,3,1051
E01015772,565,49,213,222,11,1060
E01015773,569,44,135,166,9,923
E01015774,614,30,126,210,27,1007
E01015775,1087,21,111,52,41,1312
E01015776,1145,37,146,132,24,1484
E01015777,1024,22,163,121,57,1387
E01015778,1042,33,145,117,18,1355
E01015779,755,20,223,79,25,1102
E01015780,970,28,163,118,26,1305
E01015781,867,27,139,104,13,1150
E01015782,599,30,736,104,21,1490
E01015783,529,32,526,127,7,1221
E01015784,322,13,1016,82,24,1457
E01015785,941,39,453,191,23,1647
E01015786,330,24,1057,125,19,1555
E01015787,376,31,871,121,20,1419
E01015788,156,16,1161,93,4,1430
E01015789,833,51,344,162,67,1457
E01015790,997,22,143,107,30,1299
E01015791,1125,57,484,288,134,2088
E01015792,1028,27,242,123,11,1431
E01015793,1118,32,150,117,10,1427
E01015794,1197,77,563,414,83,2334
E01015795,1021,83,367,326,38,1835
E01015796,1101,15,99,36,16,1267
E01015797,998,11,47,28,2,1086
E01015798,940,20,66,30,15,1071
E01015799,1043,21,68,25,10,1167
E01015800,1056,36,75,37,17,1221
E01015801,950,34,148,195,10,1337
E01015802,738,48,129,210,4,1129
E01015803,1112,14,56,55,11,1248
E01015804,1016,44,143,148,9,1360
E01015805,859,20,80,133,9,1101
E01015806,948,20,40,42,2,1052
E01015807,801,35,133,92,8,1069
E01015808,995,25,80,45,10,1155
E01015809,1004,20,79,37,13,1153
E01015810,839,26,104,63,9,1041
E01015811,1007,30,75,35,14,1161
E01015812,975,12,43,49,3,1082
E01015813,975,22,59,69,21,1146
E01015814,1115,13,20,14,7,1169
E01015815,1226,15,35,14,6,1296
E01015816,1285,11,9,3,4,1312
E01015817,1318,10,16,7,5,1356
E01015818,1414,10,32,7,1,1464
E01015819,1089,17,20,8,9,1143
E01015820,1078,13,27,17,1,1136
E01015821,1280,8,17,10,2,1317
E01015822,962,8,18,9,0,997
E01015823,1302,10,13,8,8,1341
E01015824,1103,14,46,13,17,1193
E01015825,1207,13,60,6,3,1289
E01015826,1079,9,38,8,0,1134
E01015827,1344,17,42,14,4,1421
E01015828,1322,62,39,40,13,1476
E01015829,1215,18,24,4,10,1271
E01015830,1213,13,34,9,2,1271
E01015831,1343,48,78,199,34,1702
E01015832,1316,40,36,21,7,1420
E01015833,1252,9,22,4,5,1292
E01015834,1193,2,22,12,3,1232
E01015835,1300,6,27,23,6,1362
E01015836,1243,11,14,6,1,1275
E01015837,1321,6,34,5,3,1369
E01015838,1255,7,16,6,1,1285
E01015839,1227,36,23,51,7,1344
E01015840,1210,36,56,47,6,1355
E01015841,1640,43,86,84,18,1871
E01015842,1307,28,36,51,16,1438
E01015843,1220,30,23,29,11,1313
E01015844,1364,39,55,61,11,1530
E01015845,1238,20,13,9,3,1283
E01015846,1327,18,36,6,10,1397
E01015847,1309,20,12,8,8,1357
E01015848,1413,13,22,8,1,1457
E01015849,1293,7,25,11,7,1343
E01015850,1230,11,20,8,3,1272
E01015851,1424,25,53,82,11,1595
E01015852,1241,31,132,61,12,1477
E01015853,1528,17,37,46,4,1632
E01015854,1336,58,192,72,33,1691
E01015855,1360,36,108,85,28,1617
E01015856,1330,24,53,45,6,1458
E01015857,1251,9,31,9,1,1301
E01015858,1301,17,74,14,10,1416
E01015859,1429,10,101,23,13,1576
E01015860,1169,13,53,19,9,1263
E01015861,1238,17,60,26,10,1351
E01015862,1019,21,99,41,13,1193
E01015863,1798,25,56,21,10,1910
E01015864,1102,10,22,10,1,1145
E01015865,1194,5,16,7,2,1224
E01015866,1219,4,33,19,5,1280
E01015867,1087,17,20,39,6,1169
E01015868,1146,9,73,10,3,1241
E01015869,1158,21,32,18,9,1238
E01015870,1236,3,14,22,6,1281
E01015871,1262,13,28,14,3,1320
E01015872,1233,8,25,23,17,1306
E01015873,951,19,30,13,3,1016
E01015874,1267,18,28,35,12,1360
E01015875,1200,19,37,21,8,1285
E01015876,1700,21,19,4,7,1751
E01015877,1373,10,29,16,2,1430
E01015878,1042,16,36,8,3,1105
E01015879,995,15,21,19,2,1052
E01015880,1086,12,31,15,8,1152
E01015881,1107,8,15,12,4,1146
E01015882,1158,23,24,24,11,1240
E01015883,1052,7,64,6,7,1136
E01015884,1558,26,53,23,5,1665
E01015885,1270,13,73,14,5,1375
E01015886,1020,12,46,25,7,1110
E01015887,1137,7,32,36,3,1215
E01015888,1187,6,63,9,4,1269
E01015889,1114,19,67,16,6,1222
E01015890,1182,11,62,14,1,1270
E01015891,1144,17,20,17,5,1203
E01015892,1258,9,31,17,5,1320
E01015893,1371,4,50,2,6,1433
E01015894,1214,11,21,9,0,1255
E01015895,1356,26,123,96,6,1607
E01015896,1217,29,167,74,14,1501
E01015897,1476,33,47,54,10,1620
E01015898,1181,19,70,24,6,1300
E01015899,1318,30,100,54,9,1511
E01015900,940,24,77,70,20,1131
E01015901,1001,24,61,30,7,1123
E01015902,1024,24,139,75,7,1269
E01015903,1094,21,77,39,15,1246
E01015904,1130,18,80,49,13,1290
E01015905,987,17,39,53,7,1103
E01015906,1034,11,86,47,22,1200
E01015907,976,12,79,40,6,1113
E01015908,1248,8,3,6,1,1266
E01015909,1208,7,10,3,3,1231
E01015910,1201,4,15,3,3,1226
E01015911,1023,5,9,1,0,1038
E01015912,1178,12,24,1,3,1218
E01015913,1345,12,24,12,3,1396
E01015914,972,16,105,17,3,1113
E01015915,1166,17,37,9,1,1230
E01015916,943,7,39,52,10,1051
E01015917,1156,29,31,24,2,1242
E01015918,1058,12,16,3,5,1094
E01015919,975,8,28,4,6,1021
E01015920,1266,14,20,3,1,1304
E01015921,761,17,23,115,6,922
E01015922,1125,13,8,48,1,1195
E01015923,1123,18,20,72,6,1239
E01015924,1111,16,9,44,7,1187
E01015925,1161,14,12,75,6,1268
E01015926,1167,15,9,43,4,1238
E01015927,1122,21,30,154,6,1333
E01015928,1276,12,26,48,5,1367
E01015929,1020,17,21,110,4,1172
E01015930,1202,19,25,95,9,1350
E01015931,838,16,42,109,3,1008
E01015932,1070,14,41,89,4,1218
E01015933,1197,19,14,55,5,1290
E01015934,984,15,11,86,2,1098
E01015935,1118,10,18,95,5,1246
E01015936,1259,20,20,63,2,1364
E01015937,1334,10,15,52,2,1413
E01015938,1304,9,11,78,5,1407
E01015939,962,17,60,115,16,1170
E01015941,778,23,114,116,18,1049
E01015942,1032,17,52,65,9,1175
E01015943,1217,5,15,12,1,1250
E01015944,1042,2,4,6,2,1056
E01015945,986,9,6,2,5,1008
E01015946,1230,10,10,6,2,1258
E01015947,1017,13,13,34,2,1079
E01015948,1144,10,4,45,1,1204
E01015949,1244,10,13,29,2,1298
E01015950,1391,10,4,41,2,1448
E01015951,1016,17,58,147,19,1257
E01015952,1087,18,145,250,21,1521
E01015953,1334,36,104,180,23,1677
E01015954,1322,33,126,193,24,1698
E01015955,1064,22,68,68,9,1231
E01015956,1267,28,176,180,28,1679
E01015957,1056,9,55,71,6,1197
E01015958,915,11,82,42,2,1052
E01015959,1041,25,135,109,23,1333
E01015960,1089,10,87,19,5,1210
E01015961,981,17,124,65,16,1203
E01015962,964,27,123,135,1,1250
E01015963,823,15,23,24,4,889
E01015964,1166,4,74,27,9,1280
E01015965,1179,6,21,20,3,1229
E01015966,1255,6,47,17,6,1331
E01015967,1123,17,43,42,7,1232
E01015968,1017,16,55,51,5,1144
E01015969,1271,14,81,52,6,1424
E01015970,928,17,48,38,7,1038
E01015971,1098,11,17,58,1,1185
E01015972,1232,15,27,87,2,1363
E01015973,1144,16,39,97,7,1303
E01015974,1033,19,36,37,1,1126
E01015975,1123,14,30,59,10,1236
E01015976,1260,8,22,87,5,1382
E01015977,1419,22,30,23,7,1501
E01015978,1034,9,17,13,6,1079
E01015979,1008,16,28,28,10,1090
E01015980,1273,13,9,4,2,1301
E01015982,1309,36,191,242,33,1811
E01015983,1200,13,8,17,5,1243
E01015984,1027,8,10,19,6,1070
E01015985,1176,2,2,9,4,1193
E01015986,1114,14,19,28,2,1177
E01015987,1119,13,5,30,1,1168
E01015988,1124,9,6,7,3,1149
E01015989,1131,9,61,35,10,1246
E01015990,1197,9,14,12,1,1233
E01015991,1136,10,18,14,3,1181
E01015992,1455,12,24,15,1,1507
E01015993,1237,11,25,29,3,1305
E01015994,1134,10,40,37,4,1225
E01015995,1251,6,101,44,2,1404
E01015996,1208,7,19,36,5,1275
E01015997,1133,5,10,14,1,1163
E01015998,1265,7,18,3,1,1294
E01015999,1034,5,20,28,2,1089
E01016000,1121,9,20,14,5,1169
E01016001,1030,9,16,19,0,1074
E01016002,1089,2,26,23,3,1143
E01016003,1235,25,49,222,10,1541
E01016004,1089,10,26,98,7,1230
E01016005,977,4,16,145,5,1147
E01016006,985,16,8,93,9,1111
E01016007,1023,10,7,91,6,1137
E01016008,963,16,17,163,6,1165
E01016009,1129,7,33,121,2,1292
E01016010,913,12,23,99,4,1051
E01016011,963,18,57,134,21,1193
E01016012,1470,33,80,279,8,1870
E01016013,1295,27,73,307,13,1715
E01016014,1393,34,67,277,10,1781
E01016015,1079,11,109,127,6,1332
E01016016,949,20,180,55,19,1223
E01016017,990,42,228,87,12,1359
E01016018,1212,31,85,102,9,1439
E01016019,1093,23,143,52,27,1338
E01016020,752,15,152,35,8,962
E01016021,1021,9,141,44,10,1225
E01016022,690,21,345,45,15,1116
E01016023,1060,14,20,57,7,1158
E01016024,1256,21,70,70,21,1438
E01016025,1195,8,55,29,9,1296
E01016026,929,7,20,5,1,962
E01016027,1185,8,21,11,6,1231
E01016028,1110,13,14,2,8,1147
E01016029,1014,7,10,4,3,1038
E01016030,1272,14,49,36,11,1382
E01016031,1117,27,111,84,29,1368
E01016032,872,10,24,14,1,921
E01016033,746,8,68,39,8,869
E01016034,1823,38,64,48,16,1989
E01016035,1196,30,102,89,12,1429
E01016036,1430,51,347,262,32,2122
E01016037,1101,25,121,97,21,1365
E01016038,1033,27,41,26,19,1146
E01016039,1084,25,111,78,12,1310
E01016040,1165,17,107,66,6,1361
E01016041,1092,32,149,54,9,1336
E01016042,918,14,83,73,16,1104
E01016043,1054,25,23,31,3,1136
E01016044,1078,32,178,34,16,1338
E01016045,1007,29,219,21,12,1288
E01016046,1016,26,123,27,8,1200
E01016047,1030,30,195,47,19,1321
E01016048,1028,17,191,47,21,1304
E01016049,1206,29,140,84,49,1508
E01016050,1312,24,60,7,7,1410
E01016051,1138,7,91,5,4,1245
E01016052,1263,17,101,12,9,1402
E01016053,1261,5,62,7,0,1335
E01016054,1126,7,90,7,7,1237
E01016055,1206,14,31,17,1,1269
E01016056,1061,19,20,11,1,1112
E01016057,1283,4,18,7,6,1318
E01016058,1175,8,9,12,5,1209
E01016059,963,13,17,20,4,1017
E01016060,1274,9,38,20,3,1344
E01016061,1098,36,67,89,8,1298
E01016062,1005,16,44,74,7,1146
E01016063,1079,29,85,53,20,1266
E01016064,1073,24,48,45,15,1205
E01016065,1147,8,11,20,4,1190
E01016066,1124,16,19,23,6,1188
E01016067,1218,18,26,31,4,1297
E01016068,1157,11,8,51,9,1236
E01016069,1078,46,124,87,38,1373
E01016070,1360,7,11,14,0,1392
E01016071,1241,7,16,9,1,1274
E01016072,1013,6,19,13,2,1053
E01016073,1621,10,25,2,1,1659
E01016074,1452,3,7,10,8,1480
E01016075,1152,4,18,0,0,1174
E01016076,1813,9,45,25,4,1896
E01016077,1181,15,13,1,1,1211
E01016078,1107,19,16,27,1,1170
E01016079,970,18,49,31,7,1075
E01016080,1124,14,22,24,0,1184
E01016081,1094,19,38,45,2,1198
E01016082,1169,11,25,28,6,1239
E01016083,971,19,18,29,2,1039
E01016084,1007,13,38,37,1,1096
E01016085,1316,7,32,9,2,1366
E01016086,1006,8,62,8,4,1088
E01016087,1311,8,41,10,11,1381
E01016088,1110,24,60,12,6,1212
E01016089,1256,15,16,14,1,1302
E01016090,1199,16,16,6,2,1239
E01016091,1215,9,44,1,12,1281
E01016092,1239,8,31,10,1,1289
E01016093,1257,17,29,5,5,1313
E01016094,1168,12,16,7,2,1205
E01016095,943,7,25,19,4,998
E01016096,1179,8,27,8,4,1226
E01016097,1102,19,20,11,5,1157
E01016098,1036,18,40,16,11,1121
E01016099,1142,5,25,4,7,1183
E01016100,1201,3,36,10,0,1250
E01016101,1083,11,33,5,11,1143
E01016102,1105,17,40,13,6,1181
E01016103,1144,7,16,16,7,1190
E01016104,1083,6,18,12,2,1121
E01016105,1122,16,32,12,4,1186
E01016106,1103,9,24,11,0,1147
E01016107,1155,14,43,9,4,1225
E01016110,1489,44,260,74,24,1891
E01016111,819,23,92,49,14,997
E01016112,1923,38,147,61,31,2200
E01016113,1026,14,117,25,18,1200
E01016114,1142,35,72,20,6,1275
E01016115,1336,17,70,32,9,1464
E01016116,1333,14,77,11,8,1443
E01016117,1235,26,127,21,19,1428
E01016118,1284,29,58,38,9,1418
E01016119,1006,20,213,18,2,1259
E01016120,1054,17,39,12,6,1128
E01016121,1190,8,47,21,2,1268
E01016122,1122,13,115,24,2,1276
E01016123,1211,9,37,23,3,1283
E01016124,1180,22,162,14,5,1383
E01016125,1172,25,122,43,15,1377
E01016126,1139,16,146,16,8,1325
E01016127,1164,19,29,15,12,1239
E01016128,1449,102,74,166,24,1815
E01016129,1347,36,102,28,25,1538
E01016130,1444,50,86,21,12,1613
E01016131,1356,16,33,15,4,1424
E01016132,1222,23,54,21,7,1327
E01016133,1040,6,103,17,1,1167
E01016134,1015,6,79,23,2,1125
E01016135,1139,18,47,22,3,1229
E01016136,1075,29,62,24,9,1199
E01016137,1095,13,75,18,5,1206
E01016138,1139,4,96,18,6,1263
E01016139,1186,12,82,28,4,1312
E01016140,1004,21,119,20,6,1170
E01016141,1137,20,108,32,7,1304
E01016142,999,7,9,9,2,1026
E01016143,1710,14,28,24,5,1781
E01016144,1181,12,30,4,4,1231
E01016145,992,7,21,9,3,1032
E01016146,1527,17,40,23,5,1612
E01016147,1466,3,69,19,5,1562
E01016148,1409,14,117,26,13,1579
E01016149,1074,6,22,13,3,1118
E01016150,1116,14,21,27,7,1185
E01016151,1185,10,60,44,15,1314
E01016152,1152,11,21,17,7,1208
E01016153,1029,17,25,28,6,1105
E01016154,1156,19,62,24,6,1267
E01016155,1181,9,16,23,6,1235
E01016156,1165,11,23,53,7,1259
E01016157,1456,17,33,30,3,1539
E01016158,1549,26,38,57,5,1675
E01016159,923,14,32,22,2,993
E01016160,1150,8,25,12,0,1195
E01016161,1215,17,19,10,3,1264
E01016162,1238,17,34,10,5,1304
E01016163,1018,12,19,14,4,1067
E01016164,1153,16,28,4,0,1201
E01016165,997,11,38,7,3,1056
E01016166,1127,15,44,4,2,1192
E01016167,1113,10,31,0,2,1156
E01016168,1200,16,21,28,5,1270
E01016169,1315,10,41,35,2,1403
E01016170,1211,12,28,18,0,1269
E01016171,1165,12,18,27,0,1222
E01016172,1150,9,19,11,2,1191
E01016173,1148,14,45,35,4,1246
E01016174,990,9,97,57,10,1163
E01016175,1374,12,102,18,0,1506
E01016176,1080,12,148,10,7,1257
E01016177,1135,29,27,23,7,1221
E01016178,1093,18,52,18,4,1185
E01016179,1047,9,55,4,11,1126
E01016180,1014,24,64,9,9,1120
E01016181,1073,20,42,5,10,1150
E01016182,1100,17,44,10,9,1180
E01016183,888,18,61,6,12,985
E01016184,1579,19,62,46,9,1715
E01016185,1003,17,58,55,16,1149
E01016186,1398,18,29,22,2,1469
E01016187,1250,12,25,4,7,1298
E01016188,1189,9,36,13,3,1250
E01016190,1117,11,75,18,5,1226
E01016191,1226,16,49,22,5,1318
E01016192,1031,24,54,9,4,1122
E01016193,906,15,70,9,3,1003
E01016194,1012,4,27,5,2,1050
E01016195,835,10,24,8,9,886
E01016196,1590,39,323,35,27,2014
E01016197,955,8,87,14,6,1070
E01016198,928,9,58,4,1,1000
E01016199,917,11,69,8,1,1006
E01016200,971,14,58,16,8,1067
E01016201,1030,17,28,20,1,1096
E01016202,971,14,32,7,3,1027
E01016203,978,10,41,11,4,1044
E01016204,893,10,36,25,5,969
E01016205,983,11,59,19,5,1077
E01016206,1354,14,69,26,7,1470
E01016207,1097,21,30,36,4,1188
E01016208,1451,15,50,68,5,1589
E01016209,1084,9,40,42,8,1183
E01016210,818,12,66,39,1,936
E01016212,904,5,42,26,6,983
E01016213,839,17,39,28,3,926
E01016214,1040,15,58,26,3,1142
E01016215,810,21,57,49,4,941
E01016216,965,12,35,20,0,1032
E01016217,1035,27,42,14,2,1120
E01016218,1057,13,24,17,11,1122
E01016219,1050,10,30,26,2,1118
E01016220,962,18,36,30,5,1051
E01016221,989,13,23,18,3,1046
E01016222,938,18,57,14,1,1028
E01016223,1039,15,71,22,8,1155
E01016224,1192,20,66,33,2,1313
E01016225,1469,30,98,52,20,1669
E01016226,1026,15,59,20,3,1123
E01016227,989,8,8,2,5,1012
E01016228,1216,14,24,8,2,1264
E01016229,927,3,19,9,1,959
E01016230,1186,28,62,18,3,1297
E01016231,1334,33,74,37,10,1488
E01016232,1075,12,40,22,2,1151
E01016233,1570,32,88,69,4,1763
E01016234,908,14,25,5,1,953
E01016235,1002,9,55,3,1,1070
E01016236,978,17,102,11,5,1113
E01016237,886,9,40,10,0,945
E01016238,994,3,38,3,1,1039
E01016239,1150,14,24,15,6,1209
E01016240,1100,22,45,33,2,1202
E01016241,1139,19,52,22,2,1234
E01016242,1256,22,51,37,4,1370
E01016243,1004,16,74,19,5,1118
E01016245,1654,21,93,20,6,1794
E01016246,1092,13,57,9,1,1172
E01016247,1193,19,53,14,6,1285
E01016248,1133,13,45,35,5,1231
E01016249,1085,24,77,32,8,1226
E01016250,1159,17,101,27,3,1307
E01016252,1140,23,29,4,6,1202
E01016253,980,9,45,5,4,1043
E01016254,1093,14,15,7,5,1134
E01016255,1189,5,12,4,2,1212
E01016256,1354,11,22,4,0,1391
E01016257,1020,15,12,6,2,1055
E01016258,1250,16,22,13,3,1304
E01016259,1160,8,42,26,4,1240
E01016260,1225,18,68,30,6,1347
E01016261,1180,19,39,31,6,1275
E01016262,1070,10,15,16,3,1114
E01016263,1629,10,22,5,2,1668
E01016264,1069,8,31,5,2,1115
E01016265,1153,8,13,2,4,1180
E01016266,1093,5,3,0,0,1101
E01016267,1104,4,17,7,2,1134
E01016268,1195,8,23,13,5,1244
E01016269,1104,9,25,6,1,1145
E01016270,1101,16,12,3,6,1138
E01016271,1031,24,65,58,4,1182
E01016272,1125,23,82,31,7,1268
E01016273,1069,23,43,36,2,1173
E01016274,960,18,96,41,2,1117
E01016275,1042,23,55,26,6,1152
E01016276,1047,10,46,31,6,1140
E01016277,1101,7,18,6,3,1135
E01016278,940,8,33,9,1,991
E01016279,1527,22,95,25,5,1674
E01016280,1345,9,53,21,6,1434
E01016281,1095,9,26,13,2,1145
E01016282,1116,12,32,10,0,1170
E01016283,1372,15,29,14,2,1432
E01016284,1116,10,6,4,2,1138
E01016285,1229,6,10,1,1,1247
E01016286,1175,10,22,3,2,1212
E01016287,1117,9,13,1,2,1142
E01016288,1301,12,14,1,1,1329
E01016289,1150,8,23,2,3,1186
E01016290,1190,13,19,4,5,1231
E01016291,1303,13,29,3,9,1357
E01016292,1243,9,16,6,0,1274
E01016293,1972,15,64,17,5,2073
E01016294,1197,14,33,11,0,1255
E01016295,1052,16,21,2,0,1091
E01016296,1296,9,11,2,1,1319
E01016297,1225,3,11,1,0,1240
E01016298,973,16,16,9,7,1021
E01016299,1177,3,16,1,4,1201
E01016300,1156,4,10,2,0,1172
E01016301,1566,18,13,6,1,1604
E01016302,1287,5,10,1,1,1304
E01016303,1168,3,7,1,0,1179
E01016304,1245,3,22,5,6,1281
E01016305,1034,9,22,6,1,1072
E01016306,1042,2,8,2,0,1054
E01016307,1223,16,13,9,0,1261
E01016308,1433,14,22,8,2,1479
E01016309,1628,17,89,29,1,1764
E01016310,1443,11,25,11,0,1490
E01016311,1292,10,72,14,3,1391
E01016312,1461,9,38,19,4,1531
E01016313,1278,5,19,4,1,1307
E01016314,1033,15,21,7,2,1078
E01016315,1278,12,20,28,2,1340
E01016316,1525,24,50,33,5,1637
E01016317,1071,12,55,16,5,1159
E01016318,1184,11,42,6,5,1248
E01016319,1304,15,28,17,4,1368
E01016320,1097,16,21,10,3,1147
E01016321,1165,15,52,6,12,1250
E01016322,1005,8,14,3,2,1032
E01016323,1132,10,21,2,1,1166
E01016324,1114,15,6,1,7,1143
E01016325,1156,8,25,7,5,1201
E01016326,1070,2,3,2,1,1078
E01016327,920,6,16,1,0,943
E01016328,1341,8,11,14,3,1377
E01016329,1135,9,13,7,1,1165
E01016330,1133,15,15,9,1,1173
E01016331,1137,24,13,12,1,1187
E01016332,1236,17,30,7,5,1295
E01016333,949,11,18,7,5,990
E01016334,1241,13,47,9,2,1312
E01016335,1189,6,22,7,1,1225
E01016336,921,5,6,8,1,941
E01016337,1600,15,50,22,6,1693
E01016338,1449,7,28,4,2,1490
E01016339,2128,27,67,33,10,2265
E01016340,1227,6,13,8,0,1254
E01016341,1064,18,11,9,1,1103
E01016342,1504,12,22,22,4,1564
E01016343,1190,10,8,2,1,1211
E01016344,1135,24,35,16,2,1212
E01016345,1011,10,30,6,2,1059
E01016346,1073,18,85,4,4,1184
E01016347,1168,17,113,10,11,1319
E01016348,1518,20,121,31,9,1699
E01016349,953,17,17,13,0,1000
E01016350,1144,12,28,19,5,1208
E01016353,933,52,340,142,21,1488
E01016355,1074,33,337,59,29,1532
E01016356,861,31,138,153,9,1192
E01016357,1044,36,144,126,6,1356
E01016358,925,42,255,169,20,1411
E01016359,986,46,282,221,23,1558
E01016360,864,52,451,193,26,1586
E01016361,965,46,185,160,6,1362
E01016362,1146,36,93,20,15,1310
E01016363,1015,59,121,98,11,1304
E01016364,1034,16,65,23,5,1143
E01016365,1230,23,74,25,4,1356
E01016366,1120,30,76,32,7,1265
E01016367,1062,23,97,74,8,1264
E01016368,825,29,105,64,11,1034
E01016369,1106,40,98,59,7,1310
E01016370,2077,85,464,172,68,2866
E01016371,1000,30,230,79,9,1348
E01016372,691,42,101,83,13,930
E01016373,842,29,106,107,12,1096
E01016374,986,45,226,80,36,1373
E01016375,687,38,185,111,18,1039
E01016376,928,30,291,73,15,1337
E01016377,873,44,251,125,7,1300
E01016378,1140,56,453,130,39,1818
E01016379,1016,32,367,89,14,1518
E01016380,1206,23,47,43,4,1323
E01016381,849,27,105,83,8,1072
E01016382,935,53,152,175,3,1318
E01016383,1084,19,32,57,2,1194
E01016384,1241,17,60,21,7,1346
E01016385,1179,19,65,39,7,1309
E01016386,1149,13,30,8,6,1206
E01016387,1169,12,34,6,3,1224
E01016388,930,21,174,67,1,1193
E01016389,810,47,129,240,7,1233
E01016390,1042,32,184,84,15,1357
E01016391,992,50,262,137,14,1455
E01016392,1400,59,177,135,16,1787
E01016393,1004,20,180,78,12,1294
E01016394,900,25,39,61,5,1030
E01016395,950,23,88,77,11,1149
E01016396,756,27,62,108,3,956
E01016397,781,37,79,121,2,1020
E01016398,1035,47,116,129,4,1331
E01016399,928,19,110,69,6,1132
E01016400,938,36,114,118,11,1217
E01016401,1005,23,191,37,13,1269
E01016402,1217,39,246,112,10,1624
E01016403,1175,40,256,67,6,1544
E01016404,846,35,529,182,11,1603
E01016405,610,40,840,111,30,1631
E01016406,874,29,359,89,17,1368
E01016407,1138,8,53,7,11,1217
E01016408,1046,19,89,31,7,1192
E01016409,1307,24,72,20,10,1433
E01016410,1163,31,98,33,10,1335
E01016411,1224,12,39,9,8,1292
E01016412,1045,11,123,21,10,1210
E01016413,1162,35,263,97,42,1599
E01016414,949,37,251,108,27,1372
E01016415,804,34,161,197,10,1206
E01016416,1067,51,258,81,27,1484
E01016417,1174,52,221,64,18,1529
E01016418,1158,44,164,66,16,1448
E01016419,1165,39,103,79,14,1400
E01016420,751,28,60,150,2,991
E01016421,971,18,59,40,7,1095
E01016422,950,18,88,61,6,1123
E01016423,976,33,87,47,4,1147
E01016424,888,29,102,34,5,1058
E01016425,1224,14,72,8,9,1327
E01016426,988,12,47,5,3,1055
E01016427,1140,25,63,13,9,1250
E01016428,1299,17,83,13,5,1417
E01016429,1202,10,36,18,3,1269
E01016430,978,15,53,15,3,1064
E01016431,1192,5,37,27,6,1267
E01016432,1112,19,41,29,3,1204
E01016433,1037,24,29,29,6,1125
E01016434,1140,26,99,106,4,1375
E01016435,987,15,52,38,3,1095
E01016436,1123,17,27,34,4,1205
E01016437,829,18,129,79,3,1058
E01016438,782,34,77,87,2,982
E01016439,942,31,84,124,8,1189
E01016440,938,33,80,81,4,1136
E01016441,847,45,80,81,6,1059
E01016442,1523,82,326,172,14,2117
E01016443,830,28,87,100,11,1056
E01016444,388,15,735,64,22,1224
E01016445,459,25,727,63,25,1299
E01016446,312,16,745,83,41,1197
E01016447,335,16,850,93,47,1341
E01016448,380,26,1231,121,62,1820
E01016449,516,21,859,108,28,1532
E01016450,685,54,203,140,12,1094
E01016451,712,39,124,186,7,1068
E01016452,877,27,218,124,14,1260
E01016453,989,47,104,53,11,1204
E01016454,900,25,117,105,8,1155
E01016455,817,28,99,71,6,1021
E01016456,407,21,1020,144,51,1643
E01016457,274,29,1014,85,35,1437
E01016458,480,34,582,131,26,1253
E01016459,568,27,904,135,35,1669
E01016460,399,9,904,77,69,1458
E01016461,696,42,1003,167,39,1947
E01016462,684,39,940,187,30,1880
E01016463,388,30,790,157,57,1422
E01016464,386,29,840,172,26,1453
E01016465,793,41,882,258,56,2030
E01016467,668,39,287,69,45,1108
E01016468,897,36,290,80,16,1319
E01016469,846,39,304,98,20,1307
E01016470,885,40,262,54,20,1261
E01016471,818,10,172,40,15,1055
E01016472,873,35,287,49,18,1262
E01016473,834,29,507,97,32,1499
E01016474,861,42,429,142,29,1503
E01016475,473,37,893,100,79,1582
E01016476,723,34,369,90,24,1240
E01016477,1045,37,456,172,44,1754
E01016478,697,33,556,84,36,1406
E01016479,538,38,439,115,43,1173
E01016480,716,19,274,48,19,1076
E01016481,878,32,187,65,17,1179
E01016482,860,39,459,54,28,1440
E01016483,449,42,732,88,43,1354
E01016484,501,12,565,98,40,1216
E01016485,492,29,650,80,31,1282
E01016486,697,49,283,168,14,1211
E01016487,293,32,872,87,60,1344
E01016488,816,38,363,102,27,1346
E01016490,788,44,325,255,32,1444
E01016491,929,35,309,72,29,1374
E01016492,631,43,459,85,41,1259
E01016493,722,36,189,36,11,994
E01016494,994,29,343,111,15,1492
E01016495,825,33,229,89,8,1184
E01016496,740,26,96,87,12,961
E01016497,753,12,297,32,26,1120
E01016498,883,31,196,134,14,1258
E01016499,480,35,255,208,15,993
E01016500,524,24,712,59,61,1380
E01016501,692,20,326,95,23,1156
E01016502,604,28,332,61,27,1052
E01016503,755,22,308,91,28,1204
E01016504,470,10,584,54,66,1184
E01016505,752,30,374,78,38,1272
E01016506,892,33,350,108,26,1409
E01016507,686,10,448,64,36,1244
E01016508,757,21,437,60,54,1329
E01016509,857,28,264,53,42,1244
E01016510,457,27,661,50,53,1248
E01016511,751,54,535,129,25,1494
E01016512,818,43,430,140,38,1469
E01016513,402,20,1001,25,52,1500
E01016514,819,44,427,106,17,1413
E01016515,470,32,1017,31,59,1609
E01016516,332,27,760,60,41,1220
E01016517,409,22,618,71,39,1159
E01016518,513,21,670,85,50,1339
E01016519,1134,37,685,114,51,2021
E01016520,573,28,466,110,35,1212
E01016521,735,25,528,64,34,1386
E01016522,1418,14,79,18,14,1543
E01016523,1189,25,99,13,8,1334
E01016524,1436,27,94,38,10,1605
E01016525,1111,20,104,16,5,1256
E01016526,1220,16,115,17,14,1382
E01016527,1115,23,118,18,3,1277
E01016528,1042,9,193,14,10,1268
E01016529,925,21,279,22,14,1261
E01016530,1172,9,32,3,1,1217
E01016531,1142,10,32,4,4,1192
E01016532,1608,15,40,6,6,1675
E01016533,1464,13,20,3,1,1501
E01016534,1118,14,141,6,6,1285
E01016535,769,21,207,10,5,1012
E01016536,1268,22,200,30,22,1542
E01016537,724,22,333,39,19,1137
E01016538,1045,20,164,21,14,1264
E01016539,1125,17,139,18,9,1308
E01016540,1158,22,150,18,4,1352
E01016541,933,16,159,9,6,1123
E01016542,853,16,49,4,4,926
E01016543,1284,12,57,5,7,1365
E01016544,1313,32,102,41,15,1503
E01016545,1490,35,92,21,18,1656
E01016546,1161,27,107,13,5,1313
E01016547,1244,22,73,15,5,1359
E01016548,1356,31,112,20,28,1547
E01016549,1448,30,112,19,16,1625
E01016550,1116,25,59,33,3,1236
E01016551,1173,24,95,10,14,1316
E01016552,1157,22,84,10,19,1292
E01016553,1166,11,72,9,0,1258
E01016554,1110,19,105,16,5,1255
E01016555,1011,24,80,21,6,1142
E01016556,1282,21,94,21,12,1430
E01016557,1451,12,82,22,13,1580
E01016558,987,20,81,76,16,1180
E01016559,1121,10,56,10,4,1201
E01016560,1057,18,74,20,15,1184
E01016561,1267,19,138,17,8,1449
E01016562,1003,10,110,5,3,1131
E01016563,999,7,63,14,12,1095
E01016564,1049,8,181,8,24,1270
E01016565,1072,17,164,15,20,1288
E01016566,1128,28,182,26,6,1370
E01016567,1815,50,107,30,12,2014
E01016568,974,8,32,9,4,1027
E01016569,817,18,29,2,8,874
E01016570,1123,11,122,4,15,1275
E01016571,1086,19,110,6,3,1224
E01016572,960,17,97,0,10,1084
E01016573,863,28,174,4,6,1075
E01016574,921,16,250,16,8,1211
E01016575,1195,14,219,4,20,1452
E01016576,1147,19,191,10,15,1382
E01016577,1095,23,256,23,10,1407
E01016578,1167,23,25,5,2,1222
E01016579,1298,13,35,13,4,1363
E01016580,1116,22,54,6,8,1206
E01016581,1100,11,19,4,4,1138
E01016582,694,7,415,6,13,1135
E01016583,1144,15,152,9,21,1341
E01016584,981,29,241,18,29,1298
E01016585,1238,23,139,10,15,1425
E01016586,1022,15,90,9,8,1144
E01016587,1196,9,85,5,15,1310
E01016588,1376,21,62,16,2,1477
E01016589,1218,17,76,10,16,1337
E01016591,1093,15,214,8,18,1348
E01016592,1299,21,232,18,13,1583
E01016593,1137,12,100,32,10,1291
E01016594,993,10,109,10,13,1135
E01016595,1195,13,87,13,7,1315
E01016596,1262,14,121,25,20,1442
E01016597,1096,24,229,24,18,1391
E01016598,1072,17,43,5,7,1144
E01016599,1120,15,97,8,9,1249
E01016600,902,9,35,2,1,949
E01016601,1098,14,84,11,10,1217
E01016602,1194,15,65,4,9,1287
E01016603,1295,27,110,14,9,1455
E01016604,1394,27,128,10,4,1563
E01016605,1098,7,77,4,3,1189
E01016606,1182,14,77,2,6,1281
E01016607,1181,23,59,13,7,1283
E01016608,1317,24,60,14,5,1420
E01016609,1228,30,92,18,17,1385
E01016610,2003,30,77,23,3,2136
E01016611,1090,11,31,18,5,1155
E01016612,1612,15,43,11,5,1686
E01016613,607,33,428,73,23,1164
E01016614,689,18,369,37,18,1131
E01016615,997,24,149,30,10,1210
E01016616,1077,15,101,23,8,1224
E01016617,985,4,50,0,16,1055
E01016618,788,16,195,28,19,1046
E01016619,1133,13,48,9,4,1207
E01016620,1029,17,77,8,1,1132
E01016621,1060,14,81,20,7,1182
E01016622,961,5,27,6,3,1002
E01016623,1124,6,69,8,4,1211
E01016624,1057,15,63,6,8,1149
E01016625,1290,13,35,8,3,1349
E01016626,1236,28,64,8,5,1341
E01016627,1400,13,44,5,9,1471
E01016628,1170,9,53,6,4,1242
E01016629,1095,6,28,8,1,1138
E01016630,1088,4,71,8,6,1177
E01016631,991,5,62,7,3,1068
E01016632,1156,8,35,2,1,1202
E01016633,1019,7,28,1,2,1057
E01016634,1191,12,36,6,2,1247
E01016635,993,16,40,3,7,1059
E01016636,1150,21,21,2,6,1200
E01016637,842,13,17,10,1,883
E01016638,965,12,28,2,0,1007
E01016639,1155,14,35,8,9,1221
E01016640,1253,7,25,8,1,1294
E01016641,1116,6,37,5,1,1165
E01016642,857,8,23,9,6,903
E01016643,994,9,39,3,5,1050
E01016644,871,17,171,19,19,1097
E01016645,1055,21,135,32,14,1257
E01016646,1031,17,144,23,20,1235
E01016647,1154,32,209,40,15,1450
E01016648,944,17,146,28,21,1156
E01016649,979,17,166,18,8,1188
E01016651,880,16,178,53,20,1147
E01016652,807,16,124,25,16,988
E01016653,1015,24,161,53,8,1261
E01016654,915,22,154,19,29,1139
E01016655,886,14,114,16,18,1048
E01016656,1095,10,32,3,8,1148
E01016657,1036,8,24,8,3,1079
E01016658,940,12,55,14,10,1031
E01016659,1039,18,61,10,12,1140
E01016660,1204,14,37,14,8,1277
E01016661,949,12,91,15,11,1078
E01016662,1155,25,79,29,17,1305
E01016663,1099,5,102,21,9,1236
E01016664,829,13,115,9,7,973
E01016665,1036,14,162,30,6,1248
E01016666,922,14,133,18,16,1103
E01016668,1011,21,171,45,8,1256
E01016669,1109,17,247,32,40,1445
E01016670,1466,21,64,14,12,1577
E01016671,1414,16,41,4,3,1478
E01016672,1372,14,33,11,6,1436
E01016673,1280,26,37,7,2,1352
E01016674,1054,12,39,13,3,1121
E01016675,851,7,15,1,1,875
E01016676,1229,11,20,2,1,1263
E01016677,1205,9,15,7,2,1238
E01016678,1097,7,19,3,11,1137
E01016679,1351,45,223,73,25,1717
E01016680,754,21,145,39,14,973
E01016682,1368,19,47,18,5,1457
E01016683,1417,19,46,3,8,1493
E01016684,1172,14,79,17,8,1290
E01016685,1147,19,155,12,11,1344
E01016686,860,8,41,24,1,934
E01016687,904,9,106,19,5,1043
E01016688,1198,31,115,27,12,1383
E01016689,1118,10,37,9,0,1174
E01016690,1331,20,38,11,9,1409
E01016691,924,10,21,6,0,961
E01016692,1130,19,20,3,4,1176
E01016693,1049,12,27,4,4,1096
E01016694,1142,13,33,4,2,1194
E01016695,1166,8,38,4,3,1219
E01016696,1185,15,46,11,1,1258
E01016699,1180,5,66,6,1,1258
E01016700,1344,19,129,12,22,1526
E01016701,1252,10,93,19,5,1379
E01016702,1227,14,155,21,8,1425
E01016703,1341,18,92,20,13,1484
E01016704,1374,35,90,26,10,1535
E01016705,1040,6,47,11,14,1118
E01016706,1236,13,56,6,2,1313
E01016707,1208,10,38,2,2,1260
E01016708,1264,19,37,12,7,1339
E01016709,1194,5,49,8,3,1259
E01016710,1254,23,109,15,3,1404
E01016711,1734,39,95,55,13,1936
E01016713,1277,19,69,28,7,1400
E01016714,1031,36,287,69,5,1428
E01016715,1162,22,41,41,9,1275
E01016716,1303,26,153,30,6,1518
E01016717,999,57,90,59,9,1214
E01016718,784,39,97,260,22,1202
E01016719,1087,13,60,35,14,1209
E01016720,970,22,67,84,3,1146
E01016721,851,35,195,201,6,1288
E01016722,1098,32,124,71,8,1333
E01016723,996,36,216,101,19,1368
E01016724,983,20,215,133,8,1359
E01016725,724,51,271,172,4,1222
E01016726,767,37,159,287,9,1259
E01016727,885,42,292,135,12,1366
E01016728,815,41,447,179,19,1501
E01016729,894,62,318,358,17,1649
E01016731,966,27,134,89,15,1231
E01016732,918,25,168,64,8,1183
E01016733,691,24,233,383,13,1344
E01016734,960,11,11,12,1,995
E01016735,1582,22,31,16,2,1653
E01016736,1118,14,24,6,2,1164
E01016737,1112,19,77,61,4,1273
E01016738,1224,34,70,79,7,1414
E01016739,1088,28,74,61,2,1253
E01016740,991,30,55,46,2,1124
E01016741,1118,29,72,76,5,1300
E01016742,865,20,127,94,7,1113
E01016743,1252,13,70,101,1,1437
E01016744,906,13,83,86,2,1090
E01016745,1121,16,65,67,2,1271
E01016746,1154,20,107,53,4,1338
E01016748,1162,42,209,72,6,1491
E01016750,1065,23,138,46,11,1283
E01016751,981,29,147,40,10,1207
E01016752,958,20,157,95,7,1237
E01016753,1234,51,179,163,14,1641
E01016754,1155,21,106,56,10,1348
E01016755,1076,30,189,77,22,1394
E01016756,1295,33,220,137,9,1694
E01016757,1025,22,91,72,9,1219
E01016758,1009,18,235,61,7,1330
E01016759,1078,7,9,5,2,1101
E01016760,1697,28,56,64,7,1852
E01016761,1097,10,19,3,1,1130
E01016762,915,27,35,44,3,1024
E01016763,1025,11,90,31,5,1162
E01016764,1094,15,66,30,6,1211
E01016765,1238,22,59,44,7,1370
E01016766,895,24,121,39,8,1087
E01016767,999,18,66,17,9,1109
E01016768,1317,36,193,163,13,1722
E01016769,981,20,117,28,4,1150
E01016770,1127,24,134,70,17,1372
E01016771,798,14,165,79,4,1060
E01016772,769,37,146,94,7,1053
E01016773,1285,17,178,54,7,1541
E01016774,1104,24,226,35,9,1398
E01016775,1047,24,184,61,15,1331
E01016776,968,31,160,34,7,1200
E01016777,1074,17,133,47,10,1281
E01016778,1105,27,159,54,6,1351
E01016780,1016,42,185,67,13,1323
E01016781,941,14,175,37,13,1180
E01016783,1099,23,130,117,12,1381
E01016784,1077,44,105,93,8,1327
E01016786,1181,11,25,8,1,1226
E01016787,1283,7,28,18,2,1338
E01016788,1265,12,17,10,1,1305
E01016789,1005,8,10,14,2,1039
E01016790,1103,7,35,9,2,1156
E01016791,1135,10,28,10,2,1185
E01016792,967,13,41,10,3,1034
E01016793,1507,10,35,15,2,1569
E01016794,1188,12,28,1,7,1236
E01016795,1210,24,32,12,4,1282
E01016796,1240,4,21,7,1,1273
E01016797,1432,9,21,12,2,1476
E01016798,1443,9,15,3,4,1474
E01016799,1466,7,10,3,0,1486
E01016800,1268,5,23,10,2,1308
E01016801,1095,3,14,4,3,1119
E01016802,1155,6,12,9,2,1184
E01016803,1056,4,22,7,1,1090
E01016804,977,36,113,130,5,1261
E01016805,1076,28,36,37,6,1183
E01016806,1162,38,75,116,5,1396
E01016807,1123,33,136,78,4,1374
E01016808,922,20,96,49,9,1096
E01016809,828,22,134,77,13,1074
E01016810,781,26,114,75,1,997
E01016811,823,18,50,82,6,979
E01016812,1135,8,87,37,3,1270
E01016813,888,22,150,61,10,1131
E01016814,1353,9,29,15,20,1426
E01016815,873,23,102,20,13,1031
E01016816,1027,25,144,21,5,1222
E01016817,1149,14,67,29,3,1262
E01016818,1428,19,34,5,0,1486
E01016819,656,14,111,60,9,850
E01016820,971,45,112,100,18,1246
E01016821,893,27,114,71,8,1113
E01016822,958,29,81,91,7,1166
E01016823,1042,37,121,122,8,1330
E01016824,1049,22,68,58,8,1205
E01016825,979,22,68,58,12,1139
E01016826,1008,20,113,22,7,1170
E01016827,1094,20,104,64,7,1289
E01016828,1183,25,143,51,21,1423
E01016829,1117,15,49,50,2,1233
E01016830,933,15,30,26,1,1005
E01016831,1143,24,41,67,1,1276
E01016832,907,22,35,45,4,1013
E01016833,945,29,93,16,9,1092
E01016834,1088,24,41,50,5,1208
E01016835,1093,22,45,68,6,1234
E01016836,1095,14,157,31,4,1301
E01016837,1116,17,260,27,10,1430
E01016838,1028,29,135,23,2,1217
E01016839,948,26,66,75,3,1118
E01016840,1784,25,157,94,5,2065
E01016841,1456,28,94,79,7,1664
E01016842,822,21,63,187,11,1104
E01016843,739,22,67,158,14,1000
E01016844,993,9,71,101,13,1187
E01016845,996,30,93,227,7,1353
E01016846,879,28,204,124,9,1244
E01016847,1166,29,159,148,12,1514
E01016848,959,25,142,110,9,1245
E01016849,1291,36,51,11,20,1409
E01016850,1387,72,96,14,27,1596
E01016851,1430,53,51,22,18,1574
E01016852,1295,56,55,25,41,1472
E01016853,1557,37,51,27,28,1700
E01016854,1368,46,54,29,27,1524
E01016855,1420,48,72,24,22,1586
E01016856,1339,52,60,19,33,1503
E01016857,1236,43,33,27,25,1364
E01016858,1214,38,28,20,15,1315
E01016859,1209,37,69,13,22,1350
E01016860,1142,52,53,28,28,1303
E01016861,1349,42,56,16,14,1477
E01016862,1273,32,71,20,10,1406
E01016863,1246,37,63,29,21,1396
E01016864,1093,28,32,30,16,1199
E01016865,1031,32,28,28,13,1132
E01016866,980,11,27,27,17,1062
E01016867,973,24,53,31,31,1112
E01016868,1058,26,55,21,18,1178
E01016869,1372,31,74,16,16,1509
E01016870,1181,29,46,20,19,1295
E01016871,1442,45,48,24,56,1615
E01016872,1434,46,60,24,25,1589
E01016873,1345,41,78,29,47,1540
E01016874,1406,36,79,24,43,1588
E01016875,1193,27,34,13,15,1282
E01016876,1220,57,75,30,24,1406
E01016877,1401,59,85,16,22,1583
E01016878,1439,38,57,14,37,1585
E01016879,1064,39,44,19,21,1187
E01016880,844,22,65,18,32,981
E01016881,1025,22,40,32,29,1148
E01016882,1034,11,57,23,22,1147
E01016883,1175,22,17,15,26,1255
E01016884,1102,24,63,20,49,1258
E01016885,871,40,46,23,39,1019
E01016886,1119,19,54,7,32,1231
E01016887,1095,19,16,14,18,1162
E01016888,1081,28,26,6,22,1163
E01016889,1496,51,54,25,9,1635
E01016890,1404,66,58,37,20,1585
E01016891,1401,46,51,36,22,1556
E01016892,1268,35,56,20,11,1390
E01016893,1499,42,38,11,10,1600
E01016894,1476,58,102,25,23,1684
E01016895,1052,31,56,24,18,1181
E01016896,1395,46,29,28,7,1505
E01016897,1347,40,62,12,13,1474
E01016898,1748,37,77,52,15,1929
E01016899,2342,146,449,137,47,3121
E01016900,1157,42,84,42,29,1354
E01016901,1184,37,57,7,11,1296
E01016902,1057,13,76,26,11,1183
E01016903,1406,66,70,28,13,1583
E01016904,1075,26,56,40,20,1217
E01016905,1285,43,64,35,24,1451
E01016906,1161,35,28,14,15,1253
E01016907,1359,45,100,48,21,1573
E01016908,1029,17,38,31,14,1129
E01016909,1366,55,95,75,30,1621
E01016910,1046,41,64,25,20,1196
E01016911,1147,29,42,45,12,1275
E01016912,1484,52,87,51,14,1688
E01016913,1347,51,88,62,32,1580
E01016914,1589,76,243,104,51,2063
E01016915,1004,51,63,41,21,1180
E01016916,1144,17,18,12,2,1193
E01016917,1103,12,16,4,5,1140
E01016918,1062,16,26,13,6,1123
E01016919,1007,9,30,21,13,1080
E01016920,1159,10,29,10,6,1214
E01016921,1145,27,22,27,4,1225
E01016922,959,12,28,5,11,1015
E01016923,1206,20,33,9,12,1280
E01016924,1119,19,27,4,9,1178
E01016925,1131,27,36,14,9,1217
E01016926,1064,23,23,39,17,1166
E01016927,1137,35,33,12,8,1225
E01016928,1240,17,24,5,6,1292
E01016929,1195,22,32,12,1,1262
E01016930,1464,20,23,4,6,1517
E01016931,1241,6,15,5,3,1270
E01016932,1184,35,50,10,11,1290
E01016933,1168,28,36,12,5,1249
E01016934,991,24,26,7,8,1056
E01016935,1217,39,57,11,8,1332
E01016936,1232,41,36,12,11,1332
E01016937,1625,49,98,43,19,1834
E01016938,1406,44,66,19,25,1560
E01016939,1121,18,43,8,5,1195
E01016940,1191,44,41,14,3,1293
E01016941,1598,62,105,27,34,1826
E01016942,1375,25,146,27,25,1598
E01016943,1184,28,24,23,9,1268
E01016944,1331,34,67,17,8,1457
E01016945,1392,52,61,26,19,1550
E01016946,1095,26,49,14,5,1189
E01016947,1142,57,113,32,44,1388
E01016948,1317,47,33,28,13,1438
E01016949,1384,61,65,22,17,1549
E01016950,1459,48,33,12,11,1563
E01016951,1181,51,45,24,15,1316
E01016952,1268,60,113,22,67,1530
E01016953,1342,45,57,18,15,1477
E01016954,1524,53,66,27,33,1703
E01016955,1416,56,117,28,36,1653
E01016956,1238,23,19,1,22,1303
E01016957,1269,44,199,44,29,1585
E01016958,1390,21,42,9,12,1474
E01016959,1197,16,34,5,6,1258
E01016960,1391,19,32,10,5,1457
E01016961,1409,15,35,8,20,1487
E01016962,1314,22,71,10,15,1432
E01016963,1486,47,66,36,17,1652
E01016964,1676,88,96,44,36,1940
E01016966,1419,60,72,32,26,1609
E01016967,1600,58,62,27,23,1770
E01016968,1319,67,50,12,17,1465
E01016969,1590,79,109,29,30,1837
E01016970,1259,43,46,12,19,1379
E01016971,1602,77,72,32,20,1803
E01016972,1460,61,52,14,22,1609
E01016973,1105,17,26,22,13,1183
E01016974,1173,28,46,13,37,1297
E01016975,1025,26,75,12,20,1158
E01016976,1263,13,33,7,17,1333
E01016977,1154,18,34,22,14,1242
E01016978,1241,19,18,18,28,1324
E01016979,1146,29,39,18,25,1257
E01016980,1062,30,53,15,15,1175
E01016981,1217,28,73,11,17,1346
E01016982,916,12,55,5,31,1019
E01016983,1019,22,92,11,44,1188
E01016984,1061,24,73,7,26,1191
E01016985,1084,36,60,13,26,1219
E01016986,1301,46,54,26,17,1444
E01016987,1359,34,77,23,27,1520
E01016988,1156,41,43,18,28,1286
E01016989,1246,46,41,20,21,1374
E01016990,1137,46,59,24,16,1282
E01016991,1277,45,62,19,13,1416
E01016992,1146,37,41,18,19,1261
E01016993,1069,24,59,18,29,1199
E01016994,1162,29,53,15,46,1305
E01016995,1205,31,59,12,27,1334
E01016996,1145,38,42,22,14,1261
E01016997,1103,43,58,12,18,1234
E01016998,1113,20,35,5,11,1184
E01016999,1087,23,48,6,14,1178
E01017000,1319,39,40,10,15,1423
E01017001,1128,24,28,17,4,1201
E01017002,1258,28,89,29,18,1422
E01017003,1194,31,36,16,9,1286
E01017004,1265,32,40,18,9,1364
E01017005,1212,41,32,16,15,1316
E01017006,1190,35,42,22,17,1306
E01017007,1170,23,32,9,10,1244
E01017008,1329,13,18,9,13,1382
E01017009,1180,21,34,4,9,1248
E01017010,1362,21,44,8,3,1438
E01017011,1017,15,23,8,6,1069
E01017012,1344,32,33,14,7,1430
E01017013,1161,17,26,5,3,1212
E01017014,1217,10,11,5,2,1245
E01017015,1126,16,20,7,2,1171
E01017016,1183,12,15,6,2,1218
E01017017,1185,4,28,6,3,1226
E01017018,1245,12,10,6,4,1277
E01017019,1459,30,71,27,14,1601
E01017020,1681,27,42,25,11,1786
E01017021,1236,11,29,8,3,1287
E01017022,1117,29,98,34,22,1300
E01017023,1303,22,40,36,7,1408
E01017024,1372,63,157,50,16,1658
E01017025,1520,64,170,45,16,1815
E01017026,1476,65,105,32,10,1688
E01017027,1379,58,153,26,17,1633
E01017028,1536,59,272,92,24,1983
E01017029,1343,30,72,36,10,1491
E01017030,1411,41,190,46,13,1701
E01017031,1307,41,147,46,20,1561
E01017032,2002,60,220,108,41,2431
E01017034,1487,23,66,68,31,1675
E01017035,927,22,120,55,62,1186
E01017036,1002,26,86,22,7,1143
E01017037,957,34,91,24,12,1118
E01017038,1138,15,73,40,20,1286
E01017039,1047,27,226,26,34,1360
E01017040,926,14,110,34,23,1107
E01017041,1022,15,45,4,8,1094
E01017042,989,14,35,15,10,1063
E01017043,996,17,62,7,5,1087
E01017044,1116,12,64,8,8,1208
E01017045,957,13,54,12,1,1037
E01017046,1383,9,81,6,5,1484
E01017047,1228,8,31,3,3,1273
E01017048,1215,18,8,3,1,1245
E01017049,1197,15,23,7,4,1246
E01017050,1198,24,61,13,12,1308
E01017051,1364,12,73,17,6,1472
E01017052,1026,9,41,7,9,1092
E01017053,950,9,39,8,2,1008
E01017054,1111,7,44,5,0,1167
E01017055,1210,9,49,6,7,1281
E01017056,1015,9,19,5,4,1052
E01017057,1158,7,39,5,1,1210
E01017058,1244,9,30,37,4,1324
E01017059,1226,7,23,1,3,1260
E01017060,1165,17,15,4,0,1201
E01017061,1394,7,22,2,3,1428
E01017062,1227,9,17,1,2,1256
E01017063,1282,6,28,9,5,1330
E01017064,1318,10,55,4,3,1390
E01017066,1424,12,29,8,7,1480
E01017067,1140,7,19,19,7,1192
E01017068,1416,27,47,18,3,1511
E01017069,1320,18,95,7,8,1448
E01017070,1211,29,64,24,8,1336
E01017071,1149,73,119,32,18,1391
E01017072,1212,26,89,19,19,1365
E01017073,1373,31,91,27,29,1551
E01017074,1248,22,54,45,9,1378
E01017075,1093,21,76,24,7,1221
E01017076,1224,17,56,17,1,1315
E01017077,1242,22,77,35,15,1391
E01017078,1074,33,59,32,21,1219
E01017079,1080,35,130,43,19,1307
E01017080,1329,50,208,65,30,1682
E01017081,1158,19,94,44,17,1332
E01017082,1167,34,86,34,4,1325
E01017083,1256,16,50,18,4,1344
E01017084,1072,12,57,9,7,1157
E01017085,1115,5,91,9,5,1225
E01017086,1010,8,20,10,4,1052
E01017087,1072,32,78,5,2,1189
E01017088,1282,12,60,15,11,1380
E01017089,1116,15,28,26,8,1193
E01017090,1088,33,63,15,7,1206
E01017091,1087,25,57,50,8,1227
E01017092,1182,15,48,11,3,1259
E01017093,1274,21,111,54,5,1465
E01017094,1162,18,45,16,6,1247
E01017095,1371,28,57,37,2,1495
E01017096,1116,7,26,8,6,1163
E01017097,1199,25,62,30,11,1327
E01017098,1043,21,60,10,5,1139
E01017099,1191,25,89,19,10,1334
E01017100,1062,17,35,1,8,1123
E01017101,1153,17,44,11,4,1229
E01017102,1110,16,102,26,14,1268
E01017103,771,18,65,24,26,904
E01017104,900,10,7,4,1,922
E01017105,1071,13,30,16,1,1131
E01017106,1095,12,31,19,4,1161
E01017107,1100,12,89,17,2,1220
E01017108,1181,12,42,16,4,1255
E01017109,992,13,21,10,5,1041
E01017110,1020,22,96,10,6,1154
E01017111,1039,19,43,15,13,1129
E01017112,1313,11,37,5,2,1368
E01017113,1169,5,15,4,4,1197
E01017114,1125,15,44,14,0,1198
E01017115,975,10,23,5,1,1014
E01017116,1065,9,33,18,5,1130
E01017117,1119,14,19,13,0,1165
E01017118,1094,17,41,3,0,1155
E01017119,1253,13,28,3,0,1297
E01017120,1129,17,23,5,3,1177
E01017121,1316,15,94,30,26,1481
E01017122,1370,33,91,36,14,1544
E01017123,1650,42,95,30,36,1853
E01017124,1328,32,107,24,15,1506
E01017125,1317,29,158,40,28,1572
E01017126,1340,52,132,16,14,1554
E01017127,1482,57,138,47,43,1767
E01017128,1193,61,222,38,21,1535
E01017129,1374,66,221,73,20,1754
E01017130,1058,35,264,43,40,1440
E01017131,1416,33,187,35,29,1700
E01017132,1442,65,347,86,73,2013
E01017133,1254,46,254,45,31,1630
E01017135,1285,32,146,34,30,1527
E01017136,1346,45,133,33,12,1569
E01017137,1489,59,58,69,8,1683
E01017138,1877,59,150,59,52,2197
E01017139,1545,62,312,90,60,2069
E01017140,1085,37,160,55,20,1357
E01017142,1891,50,155,48,110,2254
E01017144,782,29,200,26,28,1065
E01017145,996,7,199,14,40,1256
E01017146,1547,32,291,39,57,1966
E01017147,1084,11,90,32,16,1233
E01017148,1473,41,412,54,62,2042
E01017149,783,17,294,26,38,1158
E01017150,1112,16,143,11,26,1308
E01017151,1192,13,82,23,11,1321
E01017152,1094,20,123,27,17,1281
E01017153,355,37,692,108,30,1222
E01017154,924,63,355,187,48,1577
E01017155,521,34,600,103,37,1295
E01017156,363,29,768,126,16,1302
E01017157,1280,45,131,24,27,1507
E01017158,1465,42,174,49,32,1762
E01017159,1268,41,173,26,30,1538
E01017160,1116,36,130,38,24,1344
E01017162,1175,10,10,5,4,1204
E01017163,1041,19,22,24,4,1110
E01017164,1189,24,24,15,1,1253
E01017165,1148,17,14,8,0,1187
E01017166,1068,24,18,16,1,1127
E01017167,1013,28,35,13,8,1097
E01017168,1277,15,32,16,2,1342
E01017169,1107,15,20,7,6,1155
E01017170,1200,21,14,9,2,1246
E01017171,1372,27,104,34,8,1545
E01017172,1231,26,145,43,21,1466
E01017173,1082,27,37,20,3,1169
E01017174,1018,13,44,5,2,1082
E01017175,1161,16,36,5,3,1221
E01017176,1252,16,17,24,5,1314
E01017177,1202,22,54,19,7,1304
E01017178,1121,23,33,16,4,1197
E01017179,1040,19,35,20,10,1124
E01017180,1095,14,66,13,6,1194
E01017181,1037,8,37,12,4,1098
E01017182,1156,11,35,5,6,1213
E01017183,1210,14,60,13,8,1305
E01017184,1065,18,24,15,5,1127
E01017185,1225,25,90,21,5,1366
E01017186,1200,12,52,21,7,1292
E01017187,1150,6,67,30,17,1270
E01017188,1112,28,107,21,10,1278
E01017189,1097,33,147,57,16,1350
E01017190,1421,34,94,31,16,1596
E01017191,1202,41,153,61,14,1471
E01017192,1385,30,171,61,12,1659
E01017193,1254,43,85,35,12,1429
E01017194,1333,36,120,43,10,1542
E01017195,1442,50,92,46,18,1648
E01017196,1520,68,172,35,20,1815
E01017197,1061,18,98,16,13,1206
E01017198,1197,20,12,7,1,1237
E01017199,1290,22,35,21,2,1370
E01017200,1445,12,48,19,2,1526
E01017201,985,15,35,17,4,1056
E01017202,1186,28,22,13,8,1257
E01017203,1192,18,47,17,7,1281
E01017204,1219,9,34,16,3,1281
E01017205,956,22,21,8,2,1009
E01017206,1221,20,48,13,2,1304
E01017207,1139,12,18,15,7,1191
E01017208,975,17,28,23,6,1049
E01017209,1013,18,51,35,9,1126
E01017210,1030,20,32,13,8,1103
E01017211,1381,15,78,44,13,1531
E01017212,993,26,63,12,7,1101
E01017213,1148,31,88,28,11,1306
E01017214,989,18,107,12,11,1137
E01017215,1262,13,82,19,7,1383
E01017216,1065,20,64,14,3,1166
E01017217,1157,10,59,11,10,1247
E01017218,985,19,8,11,2,1025
E01017219,1332,23,47,28,5,1435
E01017220,1423,16,25,22,8,1494
E01017221,1224,13,32,15,7,1291
E01017222,1140,19,31,19,1,1210
E01017223,1278,19,47,14,10,1368
E01017224,1072,9,27,10,0,1118
E01017225,1132,11,27,12,8,1190
E01017226,1158,16,130,12,46,1362
E01017227,1080,29,111,22,12,1254
E01017228,1100,36,99,44,16,1295
E01017231,1201,38,271,37,27,1574
E01017232,966,22,71,4,20,1083
E01017233,1177,31,105,25,7,1345
E01017234,1371,47,186,33,25,1662
E01017235,1196,43,151,37,33,1460
E01017236,1018,16,11,9,5,1059
E01017237,1053,15,24,15,4,1111
E01017238,1045,14,15,14,5,1093
E01017239,1144,12,24,9,1,1190
E01017240,925,9,10,2,3,949
E01017241,1059,7,15,13,7,1101
E01017242,1152,15,32,18,2,1219
E01017243,1286,10,66,29,8,1399
E01017244,963,16,24,20,1,1024
E01017245,1009,8,36,8,2,1063
E01017246,1342,24,154,37,11,1568
E01017247,1168,14,92,21,19,1314
E01017248,1060,17,122,8,12,1219
E01017249,1006,9,74,11,3,1103
E01017250,1068,15,45,25,3,1156
E01017251,905,24,252,23,13,1217
E01017252,1138,17,126,4,13,1298
E01017253,1135,13,89,39,9,1285
E01017254,1103,27,119,20,25,1294
E01017255,1250,18,19,8,1,1296
E01017256,1605,18,22,10,14,1669
E01017257,1252,9,19,22,4,1306
E01017258,1189,19,8,9,2,1227
E01017259,1140,18,12,4,1,1175
E01017260,1154,8,8,6,4,1180
E01017261,1346,17,17,16,4,1400
E01017262,1007,14,10,8,1,1040
E01017263,1105,17,18,7,6,1153
E01017264,1693,81,508,54,31,2367
E01017265,1225,13,38,13,7,1296
E01017266,878,24,195,38,12,1147
E01017267,822,19,186,38,11,1076
E01017270,1064,15,84,27,2,1192
E01017271,826,8,67,20,4,925
E01017272,941,14,59,10,11,1035
E01017273,1152,16,18,20,0,1206
E01017274,1090,13,2,9,3,1117
E01017275,1305,18,14,8,2,1347
E01017276,1248,30,49,33,4,1364
E01017277,1108,16,11,8,7,1150
E01017278,1047,12,8,15,6,1088
E01017279,1324,19,24,17,3,1387
E01017280,1046,15,14,10,3,1088
E01017281,1147,19,11,11,9,1197
E01017282,1112,8,2,3,0,1125
E01017283,1297,7,9,3,0,1316
E01017284,1520,7,16,1,0,1544
E01017285,1695,6,6,3,1,1711
E01017286,1313,8,16,6,6,1349
E01017287,1366,5,10,3,3,1387
E01017288,1026,8,8,0,0,1042
E01017289,1720,9,4,0,1,1734
E01017290,1171,3,4,1,1,1180
E01017291,1033,0,1,1,0,1035
E01017292,1263,13,14,0,2,1292
E01017293,1508,8,14,0,0,1530
E01017294,1309,2,4,1,1,1317
E01017295,982,6,8,0,5,1001
E01017296,1096,8,6,0,0,1110
E01017297,1178,4,6,0,2,1190
E01017298,1278,7,1,0,1,1287
E01017299,1045,2,4,0,1,1052
E01017300,1867,18,60,0,3,1948
E01017301,890,2,12,1,4,909
E01017302,1332,10,19,3,1,1365
E01017303,972,10,24,1,5,1012
E01017304,1070,5,4,1,1,1081
E01017305,1093,11,15,0,0,1119
E01017306,1026,5,6,0,2,1039
E01017307,1646,9,10,2,3,1670
E01017308,1406,7,12,0,3,1428
E01017309,1271,6,18,1,1,1297
E01017310,1204,6,19,2,1,1232
E01017311,1267,4,3,3,3,1280
E01017312,1303,16,2,2,0,1323
E01017315,1228,5,2,2,1,1238
E01017316,1418,4,6,1,3,1432
E01017317,1259,4,6,1,0,1270
E01017318,937,7,6,0,3,953
E01017319,1127,3,4,2,2,1138
E01017320,961,4,10,0,4,979
E01017321,1014,3,7,1,1,1026
E01017322,1144,10,20,2,2,1178
E01017323,1008,3,2,1,3,1017
E01017324,1219,7,7,1,2,1236
E01017325,1024,9,28,2,4,1067
E01017326,1272,10,27,3,3,1315
E01017327,1271,6,20,5,1,1303
E01017328,1103,6,26,1,2,1138
E01017329,1901,16,11,1,2,1931
E01017331,1154,8,27,1,0,1190
E01017332,983,6,11,0,0,1000
E01017333,2264,57,58,98,13,2490
E01017334,1424,29,42,48,5,1548
E01017335,1240,10,24,2,2,1278
E01017336,1334,26,28,6,2,1396
E01017337,1308,22,44,3,0,1377
E01017338,1168,7,14,1,3,1193
E01017339,1296,8,19,2,3,1328
E01017340,1338,16,15,3,1,1373
E01017341,1226,5,7,4,0,1242
E01017342,1316,14,15,1,2,1348
E01017343,1045,7,3,1,1,1057
E01017344,1385,10,15,3,1,1414
E01017345,1377,22,39,3,0,1441
E01017346,1235,12,9,3,0,1259
E01017347,1329,5,9,0,12,1355
E01017348,1208,11,13,1,0,1233
E01017349,1713,21,40,2,5,1781
E01017350,1442,15,17,2,1,1477
E01017351,1164,12,23,2,1,1202
E01017352,1028,2,6,2,0,1038
E01017353,1045,3,6,0,3,1057
E01017354,996,5,3,1,1,1006
E01017355,1257,15,15,0,2,1289
E01017356,1256,12,11,1,4,1284
E01017357,1243,14,5,1,2,1265
E01017358,1108,10,1,0,2,1121
E01017359,1301,5,10,3,0,1319
E01017360,1408,22,16,1,4,1451
E01017361,1259,5,15,2,1,1282
E01017362,1222,5,29,1,0,1257
E01017363,1295,10,12,4,2,1323
E01017364,1244,8,24,0,0,1276
E01017365,1325,12,2,0,1,1340
E01017366,1162,5,1,2,1,1171
E01017367,1653,5,21,5,3,1687
E01017368,1239,8,17,7,2,1273
E01017369,1203,6,6,1,2,1218
E01017370,1497,11,3,2,2,1515
E01017371,1027,11,6,3,1,1048
E01017372,1164,11,11,4,1,1191
E01017373,1103,10,17,2,1,1133
E01017374,1109,9,47,2,0,1167
E01017375,1122,23,15,6,7,1173
E01017376,1404,25,47,7,10,1493
E01017377,1496,35,48,7,7,1593
E01017378,1387,11,34,10,3,1445
E01017379,926,12,22,10,0,970
E01017380,990,7,21,11,6,1035
E01017381,1205,6,12,5,1,1229
E01017382,1116,10,33,12,1,1172
E01017383,1456,13,38,20,1,1528
E01017384,1189,16,9,13,2,1229
E01017385,1336,25,33,14,6,1414
E01017386,1361,12,34,14,5,1426
E01017387,1035,8,8,5,1,1057
E01017388,1062,12,10,13,2,1099
E01017389,1418,12,37,9,4,1480
E01017390,1526,14,35,11,1,1587
E01017391,1022,16,21,8,2,1069
E01017392,1238,5,19,9,1,1272
E01017393,1383,11,15,7,2,1418
E01017394,1116,18,61,15,14,1224
E01017397,1182,15,104,30,20,1351
E01017398,1869,22,27,9,5,1932
E01017399,1086,24,19,11,3,1143
E01017400,1120,20,12,11,1,1164
E01017401,961,16,30,12,0,1019
E01017402,1288,14,19,8,0,1329
E01017403,1114,11,15,7,1,1148
E01017404,1096,7,15,2,1,1121
E01017405,1145,20,23,9,4,1201
E01017406,1201,12,6,14,4,1237
E01017407,1271,12,52,8,0,1343
E01017408,833,7,13,4,0,857
E01017409,992,14,14,2,2,1024
E01017410,959,6,25,4,1,995
E01017411,1193,9,35,1,2,1240
E01017412,1222,6,15,7,1,1251
E01017413,1419,8,23,2,2,1454
E01017414,1369,9,19,5,3,1405
E01017415,1432,8,25,9,2,1476
E01017416,1506,19,38,7,4,1574
E01017417,1698,26,62,15,5,1806
E01017418,1212,5,43,15,5,1280
E01017419,1241,12,19,3,1,1276
E01017420,1206,5,19,6,1,1237
E01017421,1351,14,23,5,2,1395
E01017422,1225,5,8,7,5,1250
E01017423,1216,11,12,7,3,1249
E01017424,1117,12,21,7,2,1159
E01017425,881,2,13,0,1,897
E01017426,1125,12,0,3,2,1142
E01017427,1377,14,21,1,2,1415
E01017428,1259,8,28,1,3,1299
E01017429,1125,8,10,3,2,1148
E01017430,1097,11,8,5,0,1121
E01017431,1188,19,15,15,0,1237
E01017432,1223,3,26,5,2,1259
E01017433,1138,23,22,16,1,1200
E01017434,1294,18,43,10,4,1369
E01017435,1250,13,28,18,4,1313
E01017436,1701,13,36,24,5,1779
E01017437,1189,12,25,13,0,1239
E01017438,1254,12,37,9,2,1314
E01017439,1222,9,23,6,1,1261
E01017440,1059,8,27,11,3,1108
E01017441,1399,20,22,16,3,1460
E01017442,1513,26,64,24,1,1628
E01017443,1319,8,51,15,9,1402
E01017444,1474,12,11,6,0,1503
E01017445,1443,11,25,13,2,1494
E01017446,1344,30,14,4,1,1393
E01017447,1566,21,49,20,10,1666
E01017449,1194,2,22,6,0,1224
E01017450,1784,16,38,17,2,1857
E01017451,1102,18,18,2,4,1144
E01017452,966,9,23,4,9,1011
E01017453,932,31,65,62,8,1098
E01017454,1035,19,118,32,8,1212
E01017455,1115,20,65,26,15,1241
E01017456,1115,20,72,18,16,1241
E01017457,788,31,82,33,1,935
E01017458,907,20,54,29,3,1013
E01017459,1253,7,53,9,8,1330
E01017460,1143,7,115,18,20,1303
E01017461,1278,21,145,34,4,1482
E01017462,1215,7,40,5,5,1272
E01017463,1074,10,29,15,2,1130
E01017464,1182,12,5,3,3,1205
E01017465,1177,11,6,2,6,1202
E01017466,828,44,532,130,22,1556
E01017467,1001,19,38,25,4,1087
E01017468,988,19,47,26,5,1085
E01017469,1331,31,85,57,12,1516
E01017470,936,19,36,24,9,1024
E01017471,879,54,207,130,21,1291
E01017472,639,30,279,80,12,1040
E01017473,1072,71,516,131,19,1809
E01017474,690,49,445,100,7,1291
E01017475,735,26,331,67,13,1172
E01017476,842,31,223,76,10,1182
E01017477,730,32,100,68,8,938
E01017478,1374,12,19,7,4,1416
E01017479,1026,13,33,3,1,1076
E01017480,1300,33,123,132,8,1596
E01017481,889,15,17,17,2,940
E01017482,998,26,88,34,11,1157
E01017483,1541,40,90,97,7,1775
E01017484,909,27,123,32,4,1095
E01017485,972,30,74,44,8,1128
E01017486,1223,9,49,33,6,1320
E01017487,1125,43,78,57,8,1311
E01017488,1123,24,67,14,7,1235
E01017489,894,66,70,102,8,1140
E01017490,837,39,63,100,8,1047
E01017491,1095,24,55,58,19,1251
E01017492,831,52,76,114,9,1082
E01017493,986,50,57,105,3,1201
E01017495,1522,17,29,17,0,1585
E01017496,1222,2,20,2,0,1246
E01017497,876,42,132,90,12,1152
E01017498,863,29,101,50,4,1047
E01017499,946,34,101,68,11,1160
E01017500,801,27,109,62,5,1004
E01017501,1005,20,120,69,10,1224
E01017502,1105,63,187,147,25,1527
E01017503,993,12,24,8,0,1037
E01017504,1471,16,25,8,8,1528
E01017505,1008,9,197,44,5,1263
E01017506,971,29,171,41,9,1221
E01017507,737,27,257,24,8,1053
E01017508,1054,26,152,54,15,1301
E01017509,766,29,106,54,3,958
E01017510,1071,18,123,31,3,1246
E01017511,792,12,166,42,8,1020
E01017512,762,30,294,57,10,1153
E01017513,905,24,184,35,17,1165
E01017514,962,45,177,65,16,1265
E01017515,1051,23,101,68,3,1246
E01017516,967,10,139,50,8,1174
E01017517,988,36,177,45,14,1260
E01017518,920,44,126,83,13,1186
E01017519,956,41,148,61,8,1214
E01017520,963,28,127,59,6,1183
E01017521,948,26,128,94,8,1204
E01017522,1167,26,167,71,27,1458
E01017523,755,51,160,99,7,1072
E01017524,1117,23,62,28,19,1249
E01017525,796,20,67,55,11,949
E01017526,980,20,81,39,7,1127
E01017527,840,20,57,29,3,949
E01017528,1879,7,29,10,5,1930
E01017529,958,16,62,25,0,1061
E01017530,1116,13,51,19,2,1201
E01017531,906,27,85,49,3,1070
E01017532,967,16,45,10,5,1043
E01017533,922,10,70,40,11,1053
E01017534,1194,16,34,15,9,1268
E01017535,664,21,339,45,15,1084
E01017536,767,51,767,159,38,1782
E01017537,489,42,362,83,24,1000
E01017538,436,15,772,62,30,1315
E01017539,501,22,477,81,29,1110
E01017540,1206,10,6,0,0,1222
E01017541,1026,6,6,1,0,1039
E01017542,1137,8,15,4,2,1166
E01017543,1178,10,12,14,1,1215
E01017544,1134,8,14,3,1,1160
E01017545,1120,14,31,3,7,1175
E01017546,971,9,10,12,0,1002
E01017547,1224,15,40,12,9,1300
E01017548,1371,33,49,24,3,1480
E01017549,1140,2,29,20,6,1197
E01017550,1516,50,417,81,15,2079
E01017551,1073,17,54,6,2,1152
E01017552,883,10,20,4,1,918
E01017553,944,12,32,11,1,1000
E01017554,1147,5,27,10,0,1189
E01017555,1496,24,50,21,15,1606
E01017556,1217,14,29,9,8,1277
E01017557,1417,14,40,14,2,1487
E01017558,1301,15,48,16,4,1384
E01017559,1326,12,22,10,7,1377
E01017560,1204,5,20,2,2,1233
E01017561,1216,9,14,18,2,1259
E01017562,1189,15,21,10,1,1236
E01017563,1288,6,13,7,2,1316
E01017564,1110,13,24,21,1,1169
E01017565,1237,3,17,7,1,1265
E01017566,1216,13,42,5,3,1279
E01017567,1203,23,44,19,8,1297
E01017568,1345,20,60,43,22,1490
E01017569,1199,29,50,36,3,1317
E01017570,1421,34,92,45,12,1604
E01017571,1006,12,12,5,1,1036
E01017572,1085,9,21,4,1,1120
E01017573,1176,8,14,9,1,1208
E01017575,1825,23,58,21,9,1936
E01017576,1095,8,17,8,1,1129
E01017577,1746,22,22,9,2,1801
E01017578,1300,26,60,26,3,1415
E01017579,1081,23,37,31,1,1173
E01017580,1380,28,57,86,9,1560
E01017581,1394,33,37,29,0,1493
E01017582,1130,10,75,28,5,1248
E01017583,1252,34,109,61,13,1469
E01017584,1437,34,77,49,2,1599
E01017585,1093,9,64,17,1,1184
E01017586,1163,10,21,11,3,1208
E01017587,1318,13,17,10,2,1360
E01017588,1016,7,2,2,1,1028
E01017589,1279,27,50,15,6,1377
E01017590,1251,16,20,11,0,1298
E01017591,1373,15,19,11,2,1420
E01017592,1153,21,48,37,12,1271
E01017593,1177,7,16,36,2,1238
E01017594,1349,28,43,81,4,1505
E01017595,888,8,25,14,1,936
E01017596,1098,10,23,22,3,1156
E01017597,1110,9,15,11,1,1146
E01017598,815,13,13,12,6,859
E01017599,1442,29,83,62,13,1629
E01017600,1305,26,50,112,14,1507
E01017601,858,23,25,109,10,1025
E01017602,1030,25,57,80,5,1197
E01017603,1217,8,21,3,0,1249
E01017604,1306,14,14,6,2,1342
E01017605,972,14,20,14,5,1025
E01017606,1284,11,10,2,4,1311
E01017607,1162,12,16,7,0,1197
E01017608,1354,9,23,11,6,1403
E01017609,1192,13,36,8,4,1253
E01017610,928,10,8,1,1,948
E01017611,1011,8,9,8,4,1040
E01017612,1009,7,18,8,3,1045
E01017613,1093,16,22,6,3,1140
E01017614,1160,15,15,5,6,1201
E01017615,1747,14,20,5,2,1788
E01017616,1615,25,106,50,10,1806
E01017617,962,16,27,36,1,1042
E01017618,1024,26,46,83,8,1187
E01017619,1395,34,45,83,9,1566
E01017620,1413,19,25,3,1,1461
E01017621,1277,6,22,2,1,1308
E01017622,1253,11,49,12,6,1331
E01017623,1200,21,107,37,4,1369
E01017624,1367,12,68,65,0,1512
E01017625,1332,6,14,11,1,1364
E01017626,1406,14,11,6,7,1444
E01017627,1247,5,14,10,3,1279
E01017628,1379,13,44,11,1,1448
E01017629,1263,7,27,6,2,1305
E01017630,1231,6,16,3,2,1258
E01017631,1216,17,53,6,3,1295
E01017632,1247,6,23,2,1,1279
E01017634,902,14,259,55,5,1235
E01017635,1047,8,49,24,9,1137
E01017636,1184,10,47,8,9,1258
E01017637,971,16,63,22,5,1077
E01017638,982,3,63,10,1,1059
E01017639,1203,18,89,10,4,1324
E01017640,1177,11,65,9,4,1266
E01017641,1374,12,25,7,9,1427
E01017642,1000,4,12,2,3,1021
E01017643,1055,8,18,3,0,1084
E01017644,1162,7,19,17,8,1213
E01017645,951,29,192,125,29,1326
E01017646,1408,8,29,23,5,1473
E01017647,1260,5,17,5,5,1292
E01017648,1384,12,37,7,8,1448
E01017649,1508,25,82,85,11,1711
E01017650,1176,12,50,15,4,1257
E01017651,1210,11,13,3,0,1237
E01017652,1159,9,9,4,0,1181
E01017653,1070,19,81,30,10,1210
E01017654,696,30,249,55,9,1039
E01017655,1399,29,62,57,5,1552
E01017657,1108,5,24,3,6,1146
E01017658,1122,9,15,3,6,1155
E01017659,894,22,224,60,17,1217
E01017660,1207,20,64,24,6,1321
E01017661,923,38,167,35,17,1180
E01017662,747,31,191,53,6,1028
E01017663,702,20,423,64,23,1232
E01017664,1065,17,70,21,3,1176
E01017665,996,37,135,37,3,1208
E01017666,1061,23,208,73,14,1379
E01017667,785,31,116,38,7,977
E01017668,1062,18,74,56,5,1215
E01017669,1217,9,15,1,2,1244
E01017670,1242,14,16,4,1,1277
E01017671,1226,13,14,8,4,1265
E01017672,1147,5,15,9,1,1177
E01017673,1005,4,10,2,0,1021
E01017674,1406,50,45,66,4,1571
E01017675,1142,5,7,4,3,1161
E01017676,1163,12,5,0,2,1182
E01017677,1119,8,12,3,2,1144
E01017678,1065,14,35,11,4,1129
E01017679,1200,21,39,12,8,1280
E01017680,821,3,5,1,1,831
E01017681,979,10,5,3,4,1001
E01017682,931,2,6,3,2,944
E01017683,1377,9,12,4,1,1403
E01017684,899,3,3,0,4,909
E01017687,1216,38,195,112,11,1572
E01017688,834,16,67,32,8,957
E01017689,1040,11,68,13,6,1138
E01017690,857,17,64,14,7,959
E01017691,1060,10,35,20,3,1128
E01017692,1081,14,107,63,14,1279
E01017693,867,4,10,1,3,885
E01017694,1668,14,22,10,7,1721
E01017695,986,11,12,6,1,1016
E01017696,1002,5,11,7,2,1027
E01017697,1020,22,67,32,1,1142
E01017698,916,25,107,41,6,1095
E01017699,918,58,109,104,13,1202
E01017700,1181,15,53,22,2,1273
E01017701,1598,11,12,3,3,1627
E01017702,1186,6,7,3,3,1205
E01017703,1011,3,8,3,0,1025
E01017704,974,8,3,5,3,993
E01017705,880,22,38,34,4,978
E01017706,906,28,69,59,5,1067
E01017707,710,27,175,44,4,960
E01017708,863,29,167,88,3,1150
E01017709,940,24,246,31,20,1261
E01017710,936,39,151,40,3,1169
E01017711,945,31,160,40,11,1187
E01017712,1123,45,292,76,15,1551
E01017713,1141,7,2,4,1,1155
E01017714,1068,11,9,5,1,1094
E01017715,928,5,1,0,0,934
E01017716,1425,10,10,10,2,1457
E01017717,1316,11,13,6,4,1350
E01017718,1224,14,15,3,2,1258
E01017719,924,10,19,10,3,966
E01017720,1001,6,15,4,2,1028
E01017721,1121,22,80,41,8,1272
E01017722,1065,13,61,46,6,1191
E01017723,779,25,147,49,12,1012
E01017724,711,33,170,73,16,1003
E01017726,968,9,6,4,0,987
E01017727,1310,11,10,6,0,1337
E01017728,1508,16,63,11,6,1604
E01017729,1291,9,26,4,0,1330
E01017730,1224,15,13,8,0,1260
E01017731,1043,6,9,4,1,1063
E01017732,1150,10,15,3,1,1179
E01017733,964,5,7,7,1,984
E01017734,1099,11,13,4,3,1130
E01017735,1047,7,8,5,4,1071
E01017736,1204,14,14,5,3,1240
E01017737,1140,6,4,3,1,1154
E01017738,1235,12,15,9,4,1275
E01017739,903,12,56,6,8,985
E01017740,929,15,90,7,3,1044
E01017741,1205,14,50,14,1,1284
E01017742,1216,23,68,13,7,1327
E01017743,1161,18,78,5,2,1264
E01017744,1095,7,42,9,1,1154
E01017745,1326,20,83,15,4,1448
E01017746,1102,11,73,4,7,1197
E01017747,886,22,174,9,1,1092
E01017748,1108,12,228,37,6,1391
E01017749,1249,12,47,13,10,1331
E01017750,1742,19,24,2,6,1793
E01017751,1633,11,78,8,8,1738
E01017752,1722,18,32,3,2,1777
E01017753,918,16,34,6,10,984
E01017754,1181,13,61,11,5,1271
E01017755,1140,18,68,4,2,1232
E01017756,1141,16,46,3,4,1210
E01017757,903,5,38,1,3,950
E01017758,909,7,88,5,3,1012
E01017759,1376,16,25,5,4,1426
E01017760,1268,14,56,8,6,1352
E01017761,1609,21,29,4,2,1665
E01017762,1039,15,66,6,3,1129
E01017763,1242,16,97,10,5,1370
E01017764,1270,15,55,5,2,1347
E01017765,1274,8,53,3,2,1340
E01017766,1838,5,17,1,0,1861
E01017767,1659,29,66,2,9,1765
E01017768,1840,19,25,8,1,1893
E01017769,1249,9,45,5,5,1313
E01017770,946,27,191,9,3,1176
E01017771,1172,11,45,1,0,1229
E01017773,1214,8,16,4,0,1242
E01017774,1021,7,16,5,4,1053
E01017775,1140,17,90,6,6,1259
E01017776,1115,17,112,9,6,1259
E01017777,1172,11,95,11,5,1294
E01017778,1009,12,14,4,6,1045
E01017779,866,5,23,8,1,903
E01017780,894,14,88,7,5,1008
E01017781,632,9,234,16,5,896
E01017782,1076,14,34,2,3,1129
E01017783,1174,9,14,2,4,1203
E01017784,1219,19,48,6,6,1298
E01017785,1380,7,15,6,0,1408
E01017786,1199,6,28,4,2,1239
E01017787,1255,5,16,2,1,1279
E01017788,1318,10,27,4,4,1363
E01017789,926,9,47,5,8,995
E01017790,871,7,106,22,3,1009
E01017791,1090,20,44,16,1,1171
E01017792,1441,19,75,16,9,1560
E01017793,1176,12,44,8,1,1241
E01017794,1744,16,35,3,4,1802
E01017795,1436,24,188,15,5,1668
E01017796,1388,16,102,3,2,1511
E01017797,1105,11,43,2,7,1168
E01017798,1338,17,64,5,15,1439
E01017799,1409,21,103,8,14,1555
E01017800,1277,9,70,21,5,1382
E01017801,1068,19,124,10,7,1228
E01017802,1154,15,68,5,4,1246
E01017803,964,13,101,5,9,1092
E01017804,1180,15,81,10,6,1292
E01017805,1311,26,52,30,3,1422
E01017806,1263,17,83,15,12,1390
E01017807,1061,7,96,27,14,1205
E01017808,1048,13,101,12,7,1181
E01017809,1066,9,64,21,2,1162
E01017810,1352,21,74,31,4,1482
E01017811,962,9,94,7,1,1073
E01017812,1155,31,97,28,11,1322
E01017813,1354,23,184,10,6,1577
E01017814,1066,19,169,14,14,1282
E01017815,1262,25,176,6,12,1481
E01017816,1188,19,137,8,9,1361
E01017817,1264,30,204,17,10,1525
E01017818,1221,25,246,12,9,1513
E01017819,1003,21,173,4,7,1208
E01017820,1288,11,55,7,10,1371
E01017821,988,21,240,8,26,1283
E01017822,1042,24,382,18,52,1518
E01017823,1025,9,46,5,6,1091
E01017824,1113,17,220,12,31,1393
E01017825,1217,11,145,12,14,1399
E01017826,1094,12,100,13,6,1225
E01017827,1168,25,132,26,20,1371
E01017828,1217,16,77,9,6,1325
E01017829,1021,21,553,17,40,1652
E01017830,1349,12,123,11,12,1507
E01017831,1086,15,250,13,10,1374
E01017832,1038,31,295,22,37,1423
E01017833,1340,8,72,12,12,1444
E01017834,912,21,302,18,23,1276
E01017835,1245,25,153,21,8,1452
E01017836,683,40,442,93,4,1262
E01017837,1262,62,413,149,8,1894
E01017838,678,27,428,77,9,1219
E01017839,958,33,231,73,8,1303
E01017840,1060,33,294,73,11,1471
E01017841,895,13,217,20,14,1159
E01017842,2368,26,38,22,3,2457
E01017843,1188,19,88,27,2,1324
E01017844,1052,45,227,106,6,1436
E01017845,1030,25,190,143,13,1401
E01017846,1081,21,57,5,0,1164
E01017847,1220,17,26,5,1,1269
E01017848,989,6,17,3,1,1016
E01017849,1115,19,36,10,3,1183
E01017850,566,39,302,97,11,1015
E01017851,875,45,315,118,10,1363
E01017852,723,24,939,157,12,1855
E01017853,972,7,78,23,4,1084
E01017854,1005,12,7,5,1,1030
E01017855,1118,15,17,10,6,1166
E01017856,980,12,39,39,5,1075
E01017857,654,43,304,104,10,1115
E01017858,994,45,203,90,2,1334
E01017859,835,27,214,50,7,1133
E01017860,755,22,221,80,1,1079
E01017861,1172,18,96,27,6,1319
E01017862,1280,23,97,26,5,1431
E01017863,1212,26,104,27,0,1369
E01017864,1076,7,14,7,3,1107
E01017865,1227,19,21,2,0,1269
E01017866,1162,5,17,7,2,1193
E01017867,1085,27,47,19,3,1181
E01017868,1222,10,17,11,5,1265
E01017869,1070,9,18,4,2,1103
E01017870,980,12,27,4,2,1025
E01017871,1233,11,31,2,5,1282
E01017872,1341,12,23,10,1,1387
E01017873,1093,9,23,5,1,1131
E01017874,798,7,53,9,2,869
E01017875,1068,9,20,8,2,1107
E01017876,1547,14,42,11,3,1617
E01017877,1207,17,46,15,11,1296
E01017878,2045,15,29,24,8,2121
E01017880,1078,6,18,4,0,1106
E01017881,1406,23,67,15,4,1515
E01017882,1213,18,41,3,4,1279
E01017883,1140,16,84,21,10,1271
E01017884,1098,11,21,6,9,1145
E01017885,1339,11,19,4,3,1376
E01017886,1164,9,16,11,0,1200
E01017887,897,12,11,2,4,926
E01017888,1242,13,19,12,0,1286
E01017889,978,13,24,16,11,1042
E01017890,1030,0,12,5,2,1049
E01017891,1127,5,27,4,3,1166
E01017892,1198,12,16,3,0,1229
E01017893,1281,13,45,16,5,1360
E01017894,1242,19,20,11,0,1292
E01017895,985,22,27,19,4,1057
E01017896,1114,14,23,4,4,1159
E01017897,1200,6,41,10,7,1264
E01017898,903,19,27,26,3,978
E01017899,952,25,155,147,13,1292
E01017900,791,27,118,76,7,1019
E01017901,706,41,74,69,5,895
E01017902,822,46,164,147,6,1185
E01017903,446,43,628,97,17,1231
E01017904,638,38,540,130,4,1350
E01017905,875,59,668,160,25,1787
E01017906,341,39,807,102,16,1305
E01017907,626,28,535,132,18,1339
E01017908,1582,83,149,143,13,1970
E01017909,1382,57,141,80,18,1678
E01017910,1669,52,212,71,10,2014
E01017911,883,50,273,74,6,1286
E01017912,829,31,204,55,6,1125
E01017913,871,55,354,88,4,1372
E01017914,889,17,139,36,2,1083
E01017915,1024,18,15,20,8,1085
E01017916,978,3,29,3,1,1014
E01017917,1119,7,36,10,1,1173
E01017918,1179,15,28,17,4,1243
E01017919,926,20,132,58,10,1146
E01017920,833,19,91,32,3,978
E01017921,1144,32,171,94,5,1446
E01017922,973,34,233,77,3,1320
E01017923,882,41,236,110,15,1284
E01017924,1002,28,141,44,19,1234
E01017925,1190,46,261,107,13,1617
E01017926,784,53,101,132,14,1084
E01017927,921,18,223,44,3,1209
E01017928,941,27,137,80,6,1191
E01017929,1333,14,33,16,4,1400
E01017930,1400,11,32,6,5,1454
E01017931,1116,14,15,10,3,1158
E01017932,1270,16,30,5,1,1322
E01017933,1341,23,17,13,2,1396
E01017934,1229,26,60,40,2,1357
E01017935,1512,18,36,14,7,1587
E01017936,1239,11,24,9,7,1290
E01017937,1110,14,48,7,7,1186
E01017938,1009,11,37,11,1,1069
E01017939,992,7,79,16,1,1095
E01017940,1145,17,53,17,8,1240
E01017941,1063,18,52,44,4,1181
E01017942,1153,11,31,7,2,1204
E01017943,1209,39,140,32,69,1489
E01017944,988,20,71,31,20,1130
E01017945,1201,42,129,27,53,1452
E01017946,1101,23,79,46,22,1271
E01017947,1189,34,101,26,35,1385
E01017948,1116,26,110,40,5,1297
E01017949,1202,36,166,14,10,1428
E01017950,1019,31,86,9,18,1163
E01017951,1044,24,116,45,19,1248
E01017952,1021,28,108,34,12,1203
E01017953,1048,24,257,22,12,1363
E01017954,1067,31,92,22,12,1224
E01017955,1111,21,109,7,14,1262
E01017956,1205,33,181,12,11,1442
E01017957,1151,52,146,12,20,1381
E01017958,3843,211,886,49,55,5044
E01017959,1111,32,225,25,28,1421
E01017960,829,12,151,19,26,1037
E01017961,823,20,118,23,15,999
E01017962,1119,20,129,17,14,1299
E01017963,1042,20,179,20,21,1282
E01017964,901,6,161,16,13,1097
E01017965,1245,35,138,20,32,1470
E01017966,1808,56,358,56,88,2366
E01017967,1149,37,201,30,15,1432
E01017968,1116,26,151,21,38,1352
E01017969,1045,32,175,26,18,1296
E01017971,1133,22,142,22,17,1336
E01017972,1173,24,96,15,21,1329
E01017973,1341,31,44,24,29,1469
E01017974,1260,15,114,21,20,1430
E01017975,1149,22,117,33,11,1332
E01017976,1213,23,121,32,13,1402
E01017977,1098,40,155,28,10,1331
E01017978,1013,35,124,40,17,1229
E01017979,1057,30,131,41,19,1278
E01017980,815,16,81,13,10,935
E01017983,1469,45,103,17,30,1664
E01017984,1130,24,172,7,23,1356
E01017985,1888,58,264,27,25,2262
E01017986,2689,128,575,33,58,3483
E01017987,1221,43,171,31,28,1494
E01017988,1253,38,165,22,21,1499
E01017989,1599,42,196,38,39,1914
E01017990,941,30,81,3,22,1077
E01017991,1036,42,175,20,43,1316
E01017992,1203,26,236,22,15,1502
E01017993,1441,38,264,57,23,1823
E01017994,1084,24,165,15,37,1325
E01017995,1037,15,129,10,17,1208
E01017996,1510,50,152,16,18,1746
E01017997,1548,48,268,55,27,1946
E01017998,1342,32,99,24,28,1525
E01017999,1327,24,129,26,20,1526
E01018000,1357,39,95,30,23,1544
E01018001,1333,36,98,25,24,1516
E01018002,1137,33,124,13,9,1316
E01018003,1119,28,100,6,10,1263
E01018005,1376,38,237,38,30,1719
E01018006,1282,29,116,16,21,1464
E01018007,1208,17,69,10,3,1307
E01018008,1187,27,86,27,20,1347
E01018009,1496,33,121,24,22,1696
E01018010,1383,46,113,11,12,1565
E01018011,2117,9,27,2,1,2156
E01018012,1050,10,60,6,5,1131
E01018013,1420,7,6,3,5,1441
E01018014,1351,12,35,2,8,1408
E01018015,1072,6,5,3,2,1088
E01018016,1091,7,3,3,0,1104
E01018017,1049,8,6,3,1,1067
E01018019,819,11,8,8,5,851
E01018020,1222,5,10,0,2,1239
E01018021,1192,5,5,7,1,1210
E01018022,1145,8,7,3,4,1167
E01018023,1775,7,18,8,1,1809
E01018024,908,9,8,7,2,934
E01018025,1153,19,91,8,8,1279
E01018026,1177,13,32,4,4,1230
E01018027,1361,17,23,3,3,1407
E01018029,1941,26,37,33,9,2046
E01018030,784,11,19,10,1,825
E01018032,1967,16,36,17,12,2048
E01018033,1586,9,28,6,9,1638
E01018034,1223,10,14,5,9,1261
E01018035,1762,22,13,7,4,1808
E01018036,1308,4,15,4,1,1332
E01018037,1112,9,5,1,0,1127
E01018038,1198,10,11,9,3,1231
E01018039,1039,5,13,1,2,1060
E01018040,991,14,9,12,1,1027
E01018041,854,11,5,1,1,872
E01018042,1173,12,13,5,4,1207
E01018043,1622,24,30,15,6,1697
E01018044,1370,14,31,4,3,1422
E01018045,1064,9,12,3,6,1094
E01018046,1535,11,17,17,6,1586
E01018047,1499,13,4,2,5,1523
E01018049,1296,21,19,3,5,1344
E01018050,1088,9,6,6,2,1111
E01018051,1346,14,12,10,1,1383
E01018052,1445,21,17,13,6,1502
E01018053,1356,12,18,7,2,1395
E01018054,1772,21,19,8,6,1826
E01018055,1668,16,10,6,5,1705
E01018056,1470,8,18,4,2,1502
E01018057,1597,20,18,3,1,1639
E01018058,1293,3,7,4,0,1307
E01018059,1064,10,18,8,2,1102
E01018060,1467,11,16,0,0,1494
E01018061,988,8,10,4,0,1010
E01018062,1992,12,21,7,3,2035
E01018063,1791,22,44,14,2,1873
E01018064,1595,11,26,4,0,1636
E01018065,1786,7,9,3,2,1807
E01018066,1197,9,5,4,2,1217
E01018067,1453,2,9,6,0,1470
E01018068,1240,10,6,8,2,1266
E01018069,1436,9,10,1,4,1460
E01018070,1333,13,23,8,10,1387
E01018071,1551,5,11,2,3,1572
E01018072,1298,10,16,4,3,1331
E01018073,1881,13,32,9,3,1938
E01018074,1003,5,5,1,3,1017
E01018075,977,8,12,2,2,1001
E01018076,1647,8,6,8,3,1672
E01018077,1438,7,32,7,2,1486
E01018078,1340,5,7,0,0,1352
E01018079,1448,9,0,8,2,1467
E01018080,1838,7,18,5,1,1869
E01018081,1392,41,79,100,8,1620
E01018082,1561,6,19,6,4,1596
E01018083,1419,17,32,14,6,1488
E01018084,1687,15,1,9,1,1713
E01018085,1442,0,5,4,1,1452
E01018086,1368,4,9,3,0,1384
E01018087,1677,9,27,9,2,1724
E01018088,1294,13,15,11,1,1334
E01018090,1403,9,21,1,1,1435
E01018091,1145,8,14,2,0,1169
E01018092,1354,16,12,12,3,1397
E01018093,1907,10,13,11,2,1943
E01018094,1441,6,9,4,4,1464
E01018095,1294,5,9,2,0,1310
E01018096,1350,8,12,3,0,1373
E01018097,1210,1,7,3,1,1222
E01018098,1050,6,7,1,3,1067
E01018099,1046,4,9,0,0,1059
E01018100,979,7,6,4,1,997
E01018101,1118,7,6,6,0,1137
E01018102,2012,10,16,15,4,2057
E01018103,898,5,7,2,6,918
E01018104,1036,2,3,1,3,1045
E01018105,932,6,11,3,1,953
E01018106,1261,4,20,9,0,1294
E01018107,1256,10,22,8,2,1298
E01018108,1454,22,24,5,11,1516
E01018109,1470,8,13,8,4,1503
E01018110,2097,13,21,12,2,2145
E01018111,1780,15,30,4,1,1830
E01018113,1135,13,24,9,2,1183
E01018115,1887,58,86,174,18,2223
E01018116,975,4,20,6,1,1006
E01018117,1341,9,27,3,1,1381
E01018118,1486,10,21,21,6,1544
E01018119,1235,7,10,1,1,1254
E01018120,1427,5,6,4,4,1446
E01018121,1083,7,11,4,0,1105
E01018122,936,6,7,1,0,950
E01018123,1301,3,22,4,1,1331
E01018124,1568,9,7,3,2,1589
E01018125,1214,13,12,8,6,1253
E01018126,1265,6,9,0,3,1283
E01018127,1228,9,14,2,3,1256
E01018128,947,2,15,1,3,968
E01018129,1208,17,33,9,1,1268
E01018130,1345,11,16,5,1,1378
E01018131,1174,14,25,7,3,1223
E01018132,1336,21,39,12,3,1411
E01018133,1243,15,17,21,8,1304
E01018134,1371,16,27,13,6,1433
E01018135,2078,45,60,29,6,2218
E01018136,1378,11,3,9,1,1402
E01018137,1329,9,16,3,2,1359
E01018138,1503,24,71,18,8,1624
E01018139,1163,22,56,10,0,1251
E01018140,978,26,42,14,2,1062
E01018141,1252,18,41,13,12,1336
E01018142,1193,10,33,18,4,1258
E01018143,1246,13,32,19,0,1310
E01018144,946,31,75,29,11,1092
E01018145,851,17,91,37,1,997
E01018146,1409,26,129,53,2,1619
E01018147,1093,16,98,47,9,1263
E01018148,1615,23,127,39,23,1827
E01018149,1038,12,41,23,10,1124
E01018150,1216,16,70,34,13,1349
E01018151,1290,35,118,49,23,1515
E01018152,1180,8,6,3,0,1197
E01018153,1437,13,26,11,0,1487
E01018154,1397,15,11,7,3,1433
E01018155,1245,3,12,4,3,1267
E01018156,1390,6,9,1,2,1408
E01018157,1584,14,13,12,3,1626
E01018158,1373,10,28,17,5,1433
E01018159,1123,11,13,1,1,1149
E01018160,1307,10,24,6,2,1349
E01018161,1084,11,39,4,0,1138
E01018162,1240,12,26,11,2,1291
E01018163,1011,15,36,19,1,1082
E01018164,960,16,46,18,3,1043
E01018165,974,5,47,14,4,1044
E01018166,1168,6,77,3,3,1257
E01018167,1120,13,61,6,4,1204
E01018168,1566,31,107,12,16,1732
E01018169,1164,7,81,5,3,1260
E01018170,1100,9,44,2,1,1156
E01018171,1155,17,45,7,2,1226
E01018172,1165,3,9,11,1,1189
E01018173,920,7,22,6,1,956
E01018174,1258,15,18,7,1,1299
E01018175,1099,5,14,6,1,1125
E01018176,1015,10,16,1,0,1042
E01018177,1251,7,8,2,2,1270
E01018178,1206,10,26,8,2,1252
E01018179,1074,11,20,7,0,1112
E01018180,1030,9,8,4,1,1052
E01018181,2125,21,32,12,0,2190
E01018182,1161,9,10,6,1,1187
E01018183,1191,4,11,10,1,1217
E01018184,956,18,26,9,1,1010
E01018185,1356,11,30,8,2,1407
E01018186,1372,18,17,13,2,1422
E01018187,1560,25,36,25,8,1654
E01018188,1152,10,29,4,4,1199
E01018189,1009,14,21,2,2,1048
E01018190,1194,13,29,6,0,1242
E01018191,919,6,3,2,3,933
E01018192,1165,18,20,4,2,1209
E01018193,971,13,10,5,0,999
E01018194,1133,10,13,4,4,1164
E01018195,988,14,6,4,1,1013
E01018196,1053,4,6,1,1,1065
E01018197,1178,10,8,3,4,1203
E01018198,1293,12,12,9,5,1331
E01018199,1227,6,10,2,2,1247
E01018200,1330,5,9,6,0,1350
E01018201,1111,9,4,2,2,1128
E01018202,1190,6,8,3,4,1211
E01018203,1121,9,17,3,3,1153
E01018204,1069,6,10,4,1,1090
E01018205,1531,17,20,8,5,1581
E01018206,1303,18,53,14,1,1389
E01018207,1238,3,10,2,4,1257
E01018208,1296,6,12,5,4,1323
E01018209,1164,6,31,6,1,1208
E01018210,1115,7,9,5,2,1138
E01018211,1463,7,15,7,4,1496
E01018212,1270,18,29,19,0,1336
E01018213,1416,13,26,16,4,1475
E01018214,1478,18,32,17,3,1548
E01018215,1084,12,22,10,1,1129
E01018216,1815,19,43,24,6,1907
E01018217,1336,8,20,10,7,1381
E01018218,1409,7,19,3,3,1441
E01018219,1097,7,6,3,2,1115
E01018220,1213,8,8,8,3,1240
E01018221,1272,10,83,12,8,1385
E01018222,1230,6,37,9,7,1289
E01018223,1451,20,39,15,7,1532
E01018224,1073,12,31,3,5,1124
E01018225,881,7,24,1,0,913
E01018226,1102,16,27,19,9,1173
E01018227,1452,11,20,8,2,1493
E01018228,1322,15,7,2,1,1347
E01018231,1835,16,77,11,11,1950
E01018232,1786,21,32,13,3,1855
E01018233,1269,10,23,1,1,1304
E01018234,1316,9,33,8,2,1368
E01018235,1258,12,27,16,4,1317
E01018236,1205,11,39,11,4,1270
E01018237,1178,11,22,5,8,1224
E01018238,1126,3,14,1,4,1148
E01018239,1053,5,10,2,4,1074
E01018240,966,11,12,2,1,992
E01018241,921,9,18,4,1,953
E01018242,972,13,60,15,7,1067
E01018243,1081,20,262,26,6,1395
E01018244,1320,12,26,5,3,1366
E01018245,1358,8,14,4,4,1388
E01018246,1322,16,4,10,2,1354
E01018247,1289,7,11,1,4,1312
E01018248,1722,41,164,16,16,1959
E01018249,812,6,29,6,2,855
E01018250,906,11,52,8,16,993
E01018251,914,11,41,5,3,974
E01018252,1074,17,37,2,14,1144
E01018253,823,9,36,8,2,878
E01018254,1011,12,40,6,3,1072
E01018255,891,7,11,0,0,909
E01018256,1190,10,11,8,2,1221
E01018257,1029,11,44,7,6,1097
E01018258,1264,11,16,6,6,1303
E01018259,995,13,60,3,6,1077
E01018260,1451,7,25,12,5,1500
E01018262,1152,10,29,6,5,1202
E01018263,1156,9,24,5,2,1196
E01018264,1290,6,10,2,1,1309
E01018265,1365,5,16,9,1,1396
E01018266,1969,23,88,15,4,2099
E01018267,1871,11,18,10,3,1913
E01018268,1468,13,16,5,3,1505
E01018269,1118,4,16,5,2,1145
E01018270,893,13,11,6,0,923
E01018271,1124,12,18,3,9,1166
E01018272,948,11,64,9,5,1037
E01018273,1253,23,36,10,3,1325
E01018274,1205,25,149,21,4,1404
E01018275,1866,15,11,8,3,1903
E01018276,956,5,126,24,8,1119
E01018277,1367,5,16,3,6,1397
E01018278,1197,12,82,11,11,1313
E01018279,1219,9,33,9,4,1274
E01018280,1216,7,43,7,2,1275
E01018281,1210,15,52,15,3,1295
E01018282,1009,9,29,6,2,1055
E01018283,990,12,21,8,7,1038
E01018284,977,12,12,7,8,1016
E01018285,915,7,19,8,4,953
E01018286,1074,28,136,11,19,1268
E01018287,808,19,207,23,18,1075
E01018288,929,7,12,4,3,955
E01018289,896,11,19,10,2,938
E01018290,1915,11,13,7,8,1954
E01018291,931,13,22,2,5,973
E01018292,1029,8,70,4,14,1125
E01018293,1135,16,28,5,5,1189
E01018294,1318,12,51,17,5,1403
E01018295,1212,14,37,2,5,1270
E01018296,857,10,22,5,3,897
E01018297,1345,14,21,7,4,1391
E01018298,1270,24,40,63,22,1419
E01018299,1292,11,28,13,5,1349
E01018300,960,9,19,6,5,999
E01018301,1090,13,22,16,2,1143
E01018302,1162,14,19,14,0,1209
E01018303,949,3,17,2,1,972
E01018304,1425,17,15,7,1,1465
E01018305,1074,4,5,1,0,1084
E01018306,1149,4,12,7,8,1180
E01018307,1701,15,39,8,1,1764
E01018308,1505,13,12,3,2,1535
E01018309,1294,9,14,1,0,1318
E01018310,1138,16,8,1,0,1163
E01018311,1053,10,9,1,1,1074
E01018312,1133,10,8,4,4,1159
E01018313,1146,5,4,1,1,1157
E01018314,1248,15,19,4,0,1286
E01018315,939,7,3,1,0,950
E01018316,1044,7,23,4,1,1079
E01018317,1146,11,7,15,1,1180
E01018319,1692,12,28,7,2,1741
E01018320,1180,6,15,1,0,1202
E01018321,963,8,15,3,1,990
E01018322,935,8,21,2,3,969
E01018323,1133,4,9,2,4,1152
E01018324,1050,2,12,5,0,1069
E01018325,1166,10,18,5,0,1199
E01018326,1823,22,47,10,5,1907
E01018327,1726,27,47,16,18,1834
E01018328,1674,33,34,11,6,1758
E01018329,1892,46,53,36,17,2044
E01018330,1098,9,18,5,2,1132
E01018331,1466,23,41,13,1,1544
E01018332,815,8,18,1,1,843
E01018333,1261,9,26,4,2,1302
E01018334,1233,11,37,1,6,1288
E01018335,1695,11,15,4,1,1726
E01018336,1023,0,4,2,2,1031
E01018337,1118,10,9,2,3,1142
E01018338,1410,10,13,4,0,1437
E01018339,1656,1,1,0,2,1660
E01018340,1162,11,24,1,2,1200
E01018341,913,9,20,5,2,949
E01018342,1307,17,35,12,4,1375
E01018343,1419,26,37,16,5,1503
E01018344,1550,25,29,10,5,1619
E01018345,991,7,28,3,5,1034
E01018346,1096,6,7,2,0,1111
E01018347,1102,8,26,5,1,1142
E01018348,1661,15,26,1,1,1704
E01018349,1328,6,11,1,2,1348
E01018350,1580,10,6,0,4,1600
E01018351,1112,9,8,2,0,1131
E01018352,1392,14,30,11,9,1456
E01018353,1224,14,27,5,1,1271
E01018354,1176,14,24,7,3,1224
E01018355,1033,3,2,2,0,1040
E01018356,1211,3,1,1,0,1216
E01018357,1080,4,4,2,2,1092
E01018358,916,8,28,11,5,968
E01018359,869,3,10,0,2,884
E01018360,1574,9,33,21,14,1651
E01018361,1167,13,31,15,5,1231
E01018362,1189,9,40,2,0,1240
E01018363,872,4,16,1,3,896
E01018364,1158,10,64,5,5,1242
E01018365,1568,11,21,0,5,1605
E01018366,1263,11,11,9,1,1295
E01018367,1613,7,18,1,2,1641
E01018368,1113,5,3,4,0,1125
E01018369,1362,5,4,1,0,1372
E01018370,1063,4,5,4,1,1077
E01018371,1461,5,9,2,0,1477
E01018372,1573,10,7,0,0,1590
E01018373,1636,8,2,5,0,1651
E01018374,1452,24,64,21,7,1568
E01018375,1501,19,38,20,15,1593
E01018376,1249,6,23,9,4,1291
E01018377,1258,7,14,7,0,1286
E01018378,928,4,37,5,5,979
E01018379,1096,7,17,4,2,1126
E01018380,935,6,39,2,3,985
E01018381,958,7,21,4,0,990
E01018382,1287,11,17,4,3,1322
E01018383,1194,5,16,1,0,1216
E01018384,1175,8,13,10,2,1208
E01018385,1676,7,17,0,2,1702
E01018386,1190,8,14,8,2,1222
E01018387,1443,12,12,2,1,1470
E01018388,1222,14,18,4,2,1260
E01018389,1307,15,13,2,2,1339
E01018390,1386,5,19,2,0,1412
E01018391,1482,8,9,0,1,1500
E01018392,1557,7,14,0,0,1578
E01018393,1686,4,5,1,2,1698
E01018394,1677,10,8,1,0,1696
E01018395,1332,8,9,4,4,1357
E01018396,1160,5,12,3,1,1181
E01018397,1420,7,10,5,3,1445
E01018398,1209,1,13,1,0,1224
E01018399,1206,5,34,4,3,1252
E01018400,1681,6,11,1,1,1700
E01018401,1192,4,6,2,4,1208
E01018402,1595,9,34,5,3,1646
E01018403,1594,8,13,2,6,1623
E01018404,1250,3,6,2,2,1263
E01018405,1160,4,8,0,1,1173
E01018406,1173,4,12,0,0,1189
E01018407,1225,1,3,0,0,1229
E01018408,1490,4,13,2,2,1511
E01018409,1528,4,14,2,0,1548
E01018410,1304,5,16,5,5,1335
E01018411,1876,6,7,1,6,1896
E01018412,1275,6,10,0,0,1291
E01018413,967,9,16,2,0,994
E01018414,1182,6,12,2,0,1202
E01018415,1344,9,10,1,2,1366
E01018416,1050,7,12,3,1,1073
E01018417,1421,6,7,5,6,1445
E01018418,1296,4,5,1,2,1308
E01018419,1070,4,8,1,0,1083
E01018420,1374,13,14,0,0,1401
E01018421,1031,7,14,1,0,1053
E01018422,1005,2,8,2,1,1018
E01018423,1153,5,1,0,1,1160
E01018424,1365,8,8,1,1,1383
E01018425,1384,7,4,3,2,1400
E01018426,1355,7,7,0,1,1370
E01018427,1096,6,2,2,1,1107
E01018428,1174,5,2,0,0,1181
E01018429,1254,1,4,0,4,1263
E01018430,1160,2,1,0,0,1163
E01018431,990,2,5,3,0,1000
E01018432,1240,9,16,0,1,1266
E01018433,1097,1,1,2,0,1101
E01018434,1118,6,6,1,1,1132
E01018435,1104,3,15,1,1,1124
E01018436,1213,6,10,2,5,1236
E01018437,1287,7,16,4,3,1317
E01018438,1215,0,2,2,1,1220
E01018439,1124,0,7,1,1,1133
E01018440,1366,8,21,6,5,1406
E01018441,1246,3,15,1,1,1266
E01018442,1414,10,11,5,4,1444
E01018443,1241,2,10,2,0,1255
E01018444,1746,7,13,3,1,1770
E01018445,1412,32,23,16,4,1487
E01018446,1015,15,14,8,1,1053
E01018447,1279,23,51,7,12,1372
E01018448,1342,17,16,17,5,1397
E01018449,1455,6,6,0,0,1467
E01018450,1828,10,11,2,1,1852
E01018451,1149,6,6,2,1,1164
E01018452,922,4,3,2,1,932
E01018454,1237,6,12,3,1,1259
E01018455,1116,3,6,2,7,1134
E01018456,1154,3,7,2,0,1166
E01018457,1212,10,11,9,1,1243
E01018458,1739,1,3,0,1,1744
E01018459,959,8,19,7,2,995
E01018460,1136,6,10,7,2,1161
E01018461,1100,12,8,4,3,1127
E01018462,1098,21,44,31,10,1204
E01018463,1116,12,15,10,2,1155
E01018464,1145,14,6,5,0,1170
E01018465,2292,5,27,5,0,2329
E01018466,1747,22,26,17,3,1815
E01018467,1609,43,64,28,5,1749
E01018468,1287,6,12,6,1,1312
E01018469,1340,4,1,4,2,1351
E01018470,1201,8,3,2,3,1217
E01018471,1225,4,4,0,2,1235
E01018472,1148,6,9,7,0,1170
E01018473,1256,8,17,3,4,1288
E01018474,1400,14,35,6,6,1461
E01018475,1332,11,28,4,2,1377
E01018476,984,13,10,12,1,1020
E01018477,1159,20,6,3,1,1189
E01018478,1079,7,7,7,0,1100
E01018479,1294,9,9,3,0,1315
E01018480,1824,4,8,3,3,1842
E01018481,1630,5,3,3,0,1641
E01018482,1136,9,8,4,0,1157
E01018483,1169,4,10,4,0,1187
E01018484,1609,30,30,6,2,1677
E01018485,1107,18,11,5,6,1147
E01018486,1146,15,70,30,6,1267
E01018487,1093,43,102,30,14,1282
E01018488,1189,13,7,18,1,1228
E01018489,973,9,95,19,2,1098
E01018490,1222,4,8,5,2,1241
E01018491,1184,6,5,0,2,1197
E01018492,926,3,1,1,0,931
E01018493,1090,1,2,2,3,1098
E01018494,1127,4,10,2,1,1144
E01018495,1042,5,8,3,2,1060
E01018496,1284,13,20,12,5,1334
E01018497,908,9,21,14,4,956
E01018498,1117,38,16,21,7,1199
E01018499,1254,6,7,6,4,1277
E01018500,1067,3,3,8,0,1081
E01018501,1356,13,17,9,2,1397
E01018502,1741,38,79,66,2,1926
E01018503,1349,8,12,8,0,1377
E01018504,1466,7,12,6,2,1493
E01018505,893,4,12,1,0,910
E01018506,1166,4,12,2,3,1187
E01018507,1184,10,7,4,1,1206
E01018508,973,5,1,3,0,982
E01018509,901,1,3,2,1,908
E01018510,1265,10,4,2,3,1284
E01018511,1150,10,16,2,3,1181
E01018512,1297,20,22,1,5,1345
E01018513,1271,14,15,6,0,1306
E01018514,1633,9,15,1,0,1658
E01018515,1788,16,30,5,0,1839
E01018516,1188,4,4,3,0,1199
E01018518,1298,10,5,0,0,1313
E01018519,1101,8,28,3,3,1143
E01018520,785,6,26,9,0,826
E01018521,955,7,8,0,2,972
E01018522,1102,7,4,1,1,1115
E01018523,1039,6,7,0,0,1052
E01018524,1036,3,1,2,1,1043
E01018525,998,9,3,2,1,1013
E01018526,1344,8,12,1,0,1365
E01018527,1391,7,17,1,4,1420
E01018528,980,4,9,0,0,993
E01018529,1287,8,4,2,1,1302
E01018530,1143,9,12,1,2,1167
E01018531,1277,4,15,7,4,1307
E01018532,1528,14,4,1,5,1552
E01018533,1279,2,6,0,1,1288
E01018534,1974,18,25,4,8,2029
E01018535,1250,6,12,1,2,1271
E01018536,1385,7,9,0,1,1402
E01018537,1676,11,20,3,5,1715
E01018538,920,10,6,2,0,938
E01018539,843,4,11,2,0,860
E01018540,1166,7,6,6,0,1185
E01018541,1150,6,5,2,1,1164
E01018542,914,6,9,2,0,931
E01018543,1042,3,5,1,2,1053
E01018544,1269,4,3,1,3,1280
E01018545,1641,7,1,3,0,1652
E01018546,1191,6,2,4,0,1203
E01018547,1153,5,2,2,0,1162
E01018548,1297,7,10,3,1,1318
E01018549,1198,6,10,3,2,1219
E01018550,800,7,12,4,5,828
E01018551,1165,16,17,9,2,1209
E01018552,1186,9,14,7,1,1217
E01018553,1200,6,16,1,3,1226
E01018554,1959,5,15,4,3,1986
E01018555,967,2,4,0,2,975
E01018556,1197,3,8,4,0,1212
E01018557,1182,2,12,0,1,1197
E01018558,1019,8,12,0,0,1039
E01018559,959,5,8,0,0,972
E01018560,957,3,13,3,0,976
E01018561,979,5,15,1,0,1000
E01018562,1068,3,25,1,1,1098
E01018563,1661,17,16,6,0,1700
E01018564,1797,9,20,2,1,1829
E01018565,1271,5,20,0,4,1300
E01018566,1155,4,6,0,0,1165
E01018567,1206,3,10,2,5,1226
E01018568,1112,10,44,2,0,1168
E01018569,1074,4,1,5,0,1084
E01018570,1021,10,1,2,1,1035
E01018571,1141,4,4,1,3,1153
E01018572,1445,12,27,5,3,1492
E01018573,1200,15,33,12,10,1270
E01018574,1541,15,48,19,10,1633
E01018575,866,2,5,4,0,877
E01018576,1444,4,19,3,0,1470
E01018577,2018,8,10,3,2,2041
E01018578,983,6,4,3,0,996
E01018579,891,4,2,3,1,901
E01018580,1259,5,28,6,5,1303
E01018581,993,4,10,0,4,1011
E01018582,1349,24,86,8,9,1476
E01018583,1327,32,98,12,12,1481
E01018584,1314,17,120,18,23,1492
E01018585,1152,7,10,2,1,1172
E01018586,1296,7,6,2,1,1312
E01018587,1287,10,9,2,9,1317
E01018588,1199,7,16,1,3,1226
E01018589,1214,5,25,3,4,1251
E01018590,1401,5,24,3,3,1436
E01018591,2005,6,14,0,3,2028
E01018592,1264,8,68,12,10,1362
E01018593,1299,18,62,8,19,1406
E01018594,1340,16,39,8,5,1408
E01018595,1211,10,40,7,5,1273
E01018596,1372,20,79,14,14,1499
E01018597,1999,10,5,6,4,2024
E01018598,1284,4,9,2,1,1300
E01018599,936,8,12,2,4,962
E01018600,1146,16,131,3,14,1310
E01018601,1369,14,40,6,13,1442
E01018602,1342,13,56,11,7,1429
E01018603,1004,9,14,1,4,1032
E01018604,1082,1,13,0,1,1097
E01018605,893,3,6,2,2,906
E01018606,1228,12,20,6,5,1271
E01018607,1024,9,13,1,5,1052
E01018608,1079,8,9,4,2,1102
E01018609,1403,3,29,5,5,1445
E01018610,1498,12,31,7,4,1552
E01018611,1258,11,40,8,4,1321
E01018612,932,13,19,12,1,977
E01018613,1172,13,24,11,7,1227
E01018614,1398,20,77,8,0,1503
E01018615,944,5,21,4,3,977
E01018616,1068,9,23,5,3,1108
E01018617,1224,1,11,0,3,1239
E01018618,1023,9,63,12,3,1110
E01018619,1099,3,9,6,0,1117
E01018620,1088,9,58,9,3,1167
E01018621,1069,5,12,6,0,1092
E01018622,1072,7,50,4,4,1137
E01018623,1204,11,16,4,1,1236
E01018624,1421,21,110,14,3,1569
E01018625,1119,9,35,4,4,1171
E01018626,1770,16,21,7,1,1815
E01018627,1275,13,55,13,1,1357
E01018628,1300,7,4,10,2,1323
E01018629,1381,16,47,8,0,1452
E01018630,1061,8,9,3,3,1084
E01018631,1131,6,8,1,2,1148
E01018632,1260,5,14,9,6,1294
E01018633,1278,1,9,2,5,1295
E01018634,1515,12,16,3,1,1547
E01018635,1022,10,18,1,3,1054
E01018636,1102,6,23,2,1,1134
E01018637,1353,5,16,8,2,1384
E01018638,1257,11,11,1,1,1281
E01018639,1093,12,55,2,3,1165
E01018640,1006,5,27,5,3,1046
E01018641,1034,6,10,7,1,1058
E01018642,1038,2,38,2,1,1081
E01018643,1450,6,30,2,6,1494
E01018644,1099,5,49,0,3,1156
E01018645,1430,8,20,22,0,1480
E01018646,1366,11,17,4,1,1399
E01018647,1250,10,17,4,1,1282
E01018648,1764,20,39,3,7,1833
E01018649,1180,8,8,1,1,1198
E01018650,1374,10,17,4,2,1407
E01018651,1261,24,55,17,13,1370
E01018652,1169,12,37,3,15,1236
E01018653,1577,13,25,5,4,1624
E01018654,1906,12,12,6,2,1938
E01018655,1311,1,13,2,0,1327
E01018656,1306,3,19,1,0,1329
E01018657,869,1,4,1,3,878
E01018658,1011,6,15,2,0,1034
E01018659,1064,3,8,0,6,1081
E01018660,820,3,5,1,0,829
E01018661,1057,2,3,2,1,1065
E01018662,923,8,14,2,0,947
E01018663,1250,1,15,0,1,1267
E01018664,1193,6,25,1,9,1234
E01018665,917,3,3,0,1,924
E01018666,1387,13,33,9,7,1449
E01018667,1326,13,11,3,4,1357
E01018668,1453,5,7,3,3,1471
E01018669,2143,13,8,0,3,2167
E01018670,1964,12,7,1,0,1984
E01018671,1036,3,6,1,0,1046
E01018672,1255,4,6,0,0,1265
E01018673,977,2,2,3,0,984
E01018674,1260,6,5,3,1,1275
E01018675,1749,10,0,4,1,1764
E01018676,1235,7,6,1,0,1249
E01018677,1243,2,2,0,1,1248
E01018678,1116,5,8,2,2,1133
E01018679,1342,7,15,2,1,1367
E01018680,1312,5,9,4,0,1330
E01018681,1170,4,3,3,1,1181
E01018682,884,2,1,0,0,887
E01018683,1255,6,0,2,1,1264
E01018684,1870,4,5,2,1,1882
E01018685,992,10,4,0,0,1006
E01018686,1079,7,7,2,1,1096
E01018687,1139,11,3,2,1,1156
E01018688,1261,7,26,5,1,1300
E01018689,1202,8,18,1,0,1229
E01018690,1733,7,12,1,0,1753
E01018691,1263,5,11,2,3,1284
E01018692,1568,4,27,3,10,1612
E01018693,1265,7,23,1,0,1296
E01018694,1268,8,11,0,0,1287
E01018695,1348,6,26,2,0,1382
E01018696,1228,7,4,0,3,1242
E01018697,1474,7,3,3,5,1492
E01018698,1660,7,9,2,3,1681
E01018699,1245,8,8,3,0,1264
E01018700,1439,15,23,5,3,1485
E01018701,1160,3,7,1,0,1171
E01018702,929,2,11,2,3,947
E01018703,1455,10,18,3,3,1489
E01018704,981,4,17,1,0,1003
E01018705,1234,6,7,5,0,1252
E01018706,1108,13,33,0,0,1154
E01018707,1447,3,18,0,3,1471
E01018708,1768,5,9,3,1,1786
E01018709,1175,2,18,2,1,1198
E01018710,1138,5,15,4,1,1163
E01018711,1257,11,11,2,5,1286
E01018712,1293,11,11,3,5,1323
E01018713,2129,8,35,2,4,2178
E01018714,1471,10,29,12,2,1524
E01018715,1351,8,28,0,6,1393
E01018716,1223,10,6,2,2,1243
E01018717,1349,15,27,7,2,1400
E01018718,1344,3,11,0,0,1358
E01018719,1212,10,9,4,3,1238
E01018720,1243,6,7,1,2,1259
E01018721,1872,4,2,0,1,1879
E01018722,1879,10,10,2,2,1903
E01018723,915,2,2,4,1,924
E01018724,1248,4,4,3,0,1259
E01018725,1068,2,4,3,0,1077
E01018726,1196,7,2,0,0,1205
E01018727,1417,6,4,1,3,1431
E01018728,1206,7,21,1,4,1239
E01018729,1346,6,3,2,1,1358
E01018730,1181,7,13,6,0,1207
E01018731,1234,5,8,4,0,1251
E01018732,1171,9,8,1,2,1191
E01018733,1256,3,9,2,1,1271
E01018734,1054,5,6,4,0,1069
E01018735,1057,9,6,3,0,1075
E01018736,1277,6,13,6,1,1303
E01018737,1076,15,5,1,3,1100
E01018738,976,7,9,1,0,993
E01018739,1012,17,15,3,1,1048
E01018740,1131,6,9,2,2,1150
E01018741,1030,7,30,2,0,1069
E01018742,1273,9,10,1,0,1293
E01018743,1213,6,2,2,1,1224
E01018744,1274,16,24,2,0,1316
E01018745,1223,7,2,0,2,1234
E01018746,1342,4,19,1,0,1366
E01018747,1226,6,13,2,1,1248
E01018748,946,7,2,0,0,955
E01018749,1790,11,38,7,1,1847
E01018750,1811,5,11,1,0,1828
E01018751,1219,7,23,4,0,1253
E01018752,1619,7,14,4,2,1646
E01018753,1351,5,1,0,1,1358
E01018754,1247,8,3,4,0,1262
E01018755,1252,9,6,1,1,1269
E01018756,1344,9,3,0,2,1358
E01018757,1751,16,5,2,5,1779
E01018758,1968,6,3,7,3,1987
E01018759,1255,8,1,0,1,1265
E01018760,1021,4,0,0,0,1025
E01018761,1289,8,1,0,0,1298
E01018762,1015,4,5,0,0,1024
E01018763,897,5,4,0,0,906
E01018764,1210,1,3,0,0,1214
E01018765,1272,11,4,0,0,1287
E01018766,1562,5,4,1,4,1576
E01018767,1159,6,9,2,0,1176
E01018768,1492,7,6,2,1,1508
E01018769,1487,8,3,3,4,1505
E01018770,987,5,9,1,0,1002
E01018771,1104,3,19,3,1,1130
E01018772,1327,3,5,0,0,1335
E01018773,1273,1,18,4,0,1296
E01018774,1164,10,3,3,1,1181
E01018775,1226,5,14,1,0,1246
E01018776,1009,5,16,2,1,1033
E01018777,1698,8,4,0,2,1712
E01018778,1411,9,0,2,5,1427
E01018779,1841,6,4,0,0,1851
E01018780,1826,11,11,7,2,1857
E01018781,1568,6,7,0,1,1582
E01018782,1184,11,6,1,2,1204
E01018783,1293,7,2,1,1,1304
E01018784,1219,3,6,0,1,1229
E01018785,1591,10,2,2,2,1607
E01018786,1067,4,9,3,1,1084
E01018787,1211,2,6,1,0,1220
E01018788,1223,9,8,2,0,1242
E01018789,1201,5,3,1,0,1210
E01018790,952,4,3,0,1,960
E01018791,1015,5,3,5,3,1031
E01018792,2215,17,9,2,1,2244
E01018793,1389,6,13,2,1,1411
E01018794,1142,6,1,1,0,1150
E01018795,1021,3,5,1,2,1032
E01018796,949,2,1,3,1,956
E01018797,891,6,4,0,1,902
E01018798,1235,11,6,0,0,1252
E01018799,947,3,10,0,1,961
E01018800,1241,4,6,4,2,1257
E01018803,1561,20,24,3,1,1609
E01018804,1582,30,37,19,14,1682
E01018805,1246,12,15,3,2,1278
E01018806,1286,23,9,5,5,1328
E01018807,1107,11,22,0,1,1141
E01018808,1159,12,16,0,8,1195
E01018809,1628,24,53,2,7,1714
E01018810,1096,8,14,0,0,1118
E01018811,1207,7,4,0,0,1218
E01018812,1078,17,10,1,2,1108
E01018813,1149,2,4,0,0,1155
E01018814,1166,8,14,0,1,1189
E01018815,1615,4,2,2,0,1623
E01018816,1417,8,15,2,7,1449
E01018817,1706,8,16,1,0,1731
E01018818,1383,1,5,0,5,1394
E01018819,1186,9,20,8,2,1225
E01018820,1447,11,10,1,3,1472
E01018821,986,7,4,0,0,997
E01018822,1007,3,10,2,0,1022
E01018823,1244,12,16,0,3,1275
E01018824,1925,21,28,4,6,1984
E01018825,1255,4,7,3,1,1270
E01018826,1748,7,19,1,3,1778
E01018827,1287,7,7,5,4,1310
E01018828,1272,4,1,4,2,1283
E01018829,1123,3,5,5,1,1137
E01018830,1247,2,1,3,0,1253
E01018831,1035,6,1,2,0,1044
E01018832,1102,6,5,0,0,1113
E01018833,1186,2,14,0,0,1202
E01018834,1444,3,3,0,2,1452
E01018835,1402,19,15,8,3,1447
E01018836,1277,18,11,2,10,1318
E01018837,1641,21,8,4,1,1675
E01018838,1263,20,11,4,7,1305
E01018839,1019,14,12,5,4,1054
E01018840,1395,31,27,3,3,1459
E01018841,1109,15,10,1,2,1137
E01018842,1171,4,2,0,0,1177
E01018843,1101,2,1,1,1,1106
E01018844,1009,10,22,3,1,1045
E01018845,1252,6,9,1,0,1268
E01018846,1130,3,4,1,1,1139
E01018847,1210,2,4,3,4,1223
E01018848,1310,4,1,3,2,1320
E01018849,1620,9,6,0,7,1642
E01018850,1119,5,0,1,2,1127
E01018851,1161,13,12,1,1,1188
E01018852,2042,14,6,1,1,2064
E01018853,1922,18,33,4,3,1980
E01018854,1062,11,6,1,7,1087
E01018855,1775,26,102,7,8,1918
E01018856,1175,11,20,2,4,1212
E01018857,954,7,8,0,0,969
E01018858,1192,12,15,0,5,1224
E01018859,1496,12,15,0,2,1525
E01018860,1512,16,14,0,3,1545
E01018861,1207,3,1,1,2,1214
E01018862,1203,7,3,3,0,1216
E01018863,1307,6,6,3,3,1325
E01018864,1335,3,6,3,0,1347
E01018865,1473,7,16,4,1,1501
E01018866,1346,6,6,1,0,1359
E01018867,1518,6,5,0,4,1533
E01018868,1340,6,32,4,0,1382
E01018869,1241,12,2,2,3,1260
E01018870,920,19,11,0,2,952
E01018871,1368,10,8,1,4,1391
E01018872,1010,6,1,1,5,1023
E01018873,967,11,3,0,3,984
E01018874,1104,8,6,0,1,1119
E01018875,1055,12,6,2,0,1075
E01018876,1110,6,6,2,1,1125
E01018877,1249,6,3,0,0,1258
E01018878,1141,13,15,1,3,1173
E01018879,1540,10,5,3,1,1559
E01018880,1742,6,5,0,6,1759
E01018881,1565,8,3,1,1,1578
E01018882,1216,4,10,2,1,1233
E01018883,1273,2,2,1,1,1279
E01018884,1311,11,5,1,0,1328
E01018885,1227,10,2,2,3,1244
E01018886,1390,5,6,10,9,1420
E01018887,1169,15,13,4,0,1201
E01018888,1513,16,6,1,0,1536
E01018889,1098,2,0,0,1,1101
E01018890,1211,9,6,1,0,1227
E01018891,1066,4,2,1,0,1073
E01018892,1105,7,5,0,1,1118
E01018893,1131,7,3,0,3,1144
E01018894,1456,3,3,1,0,1463
E01018895,1343,5,18,2,1,1369
E01018896,1243,4,21,2,0,1270
E01018897,1131,6,13,7,1,1158
E01018898,985,3,5,2,0,995
E01018899,2274,40,30,35,6,2385
E01018900,1247,8,9,0,0,1264
E01018901,1352,8,15,3,7,1385
E01018902,997,3,6,1,1,1008
E01018903,1545,17,2,24,7,1595
E01018904,1746,9,3,3,6,1767
E01018905,1107,4,1,0,2,1114
E01018906,1021,4,2,1,0,1028
E01018907,1012,9,4,1,1,1027
E01018908,1376,5,5,0,0,1386
E01018909,1255,6,3,1,0,1265
E01018910,1374,10,9,2,2,1397
E01018911,1393,9,19,1,5,1427
E01018912,1223,5,2,1,0,1231
E01018913,1447,13,17,1,3,1481
E01018914,1525,10,5,2,1,1543
E01018915,1628,10,4,9,9,1660
E01018916,1070,6,3,1,0,1080
E01018917,1134,3,7,1,0,1145
E01018918,1434,8,7,0,2,1451
E01018919,1147,2,5,2,0,1156
E01018920,1709,8,4,0,0,1721
E01018921,1721,9,14,4,0,1748
E01018922,1934,2,4,0,0,1940
E01018923,1032,2,2,0,1,1037
E01018924,937,6,4,0,8,955
E01018925,1822,6,8,3,10,1849
E01018926,2012,12,3,1,0,2028
E01018927,1241,6,8,3,4,1262
E01018928,1380,13,13,5,5,1416
E01018929,1040,1,16,3,2,1062
E01018930,1180,11,7,0,1,1199
E01018931,964,7,1,1,2,975
E01018932,1350,9,11,3,1,1374
E01018933,1135,15,35,3,1,1189
E01018934,1632,4,15,3,2,1656
E01018935,1732,6,11,4,0,1753
E01018936,1263,5,21,2,4,1295
E01018937,1455,7,9,0,2,1473
E01018938,1411,13,7,3,3,1437
E01018940,1316,2,0,0,2,1320
E01018941,1258,4,3,0,1,1266
E01018942,1295,6,8,4,0,1313
E01018943,1751,8,1,4,1,1765
E01018944,997,6,3,0,0,1006
E01018945,1089,10,0,2,0,1101
E01018946,1238,10,12,2,1,1263
E01018947,2317,12,19,5,0,2353
E01018948,1343,7,11,3,3,1367
E01018949,1015,5,5,2,2,1029
E01018950,1328,19,55,4,1,1407
E01018951,1868,5,5,6,2,1886
E01018952,973,6,4,2,0,985
E01018953,998,5,3,0,0,1006
E01018954,927,10,0,2,2,941
E01018955,1339,5,3,6,1,1354
E01018956,922,2,5,0,0,929
E01018957,1050,3,5,0,0,1058
E01018958,1150,4,6,0,5,1165
E01018959,1275,4,7,1,3,1290
E01018960,1523,5,4,0,0,1532
E01018961,1234,14,13,1,0,1262
E01018962,1840,11,22,1,1,1875
E01018965,2089,8,11,3,1,2112
E01018966,957,3,6,0,1,967
E01018967,1130,3,7,1,0,1141
E01018968,2110,6,1,2,2,2121
E01018969,1920,10,7,3,2,1942
E01018970,1240,1,6,3,1,1251
E01018971,1673,8,12,5,0,1698
E01018972,1492,1,6,2,0,1501
E01018973,1141,8,4,1,0,1154
E01018974,2150,8,3,2,1,2164
E01018975,1595,7,18,0,0,1620
E01018976,1807,11,8,0,0,1826
E01018977,1122,5,1,0,0,1128
E01018978,1199,4,16,0,1,1220
E01018979,1137,4,8,1,1,1151
E01018980,1157,4,7,1,1,1170
E01018981,1721,9,12,1,4,1747
E01018982,1681,11,7,2,3,1704
E01018983,1351,7,25,0,1,1384
E01018984,1661,11,10,2,1,1685
E01018985,1952,10,18,4,5,1989
E01018986,1362,10,1,0,2,1375
E01018987,1752,11,5,1,1,1770
E01018988,1305,4,3,0,0,1312
E01018989,1480,6,0,0,10,1496
E01018990,1513,11,7,0,2,1533
E01018991,1253,9,2,0,0,1264
E01018992,1390,9,8,1,4,1412
E01018993,1381,13,6,0,3,1403
E01018994,1364,15,17,2,2,1400
E01018995,1708,30,25,0,2,1765
E01018996,1281,14,8,1,1,1305
E01018997,1064,10,3,0,2,1079
E01018998,1152,10,9,0,8,1179
E01018999,1218,12,13,2,4,1249
E01019000,1220,10,4,4,1,1239
E01019001,1415,10,36,14,13,1488
E01019002,1204,6,7,0,2,1219
E01019003,1461,11,5,0,0,1477
E01019004,1289,6,11,3,4,1313
E01019005,1706,15,11,1,7,1740
E01019006,1382,4,1,1,1,1389
E01019007,1786,11,8,2,1,1808
E01019008,1204,3,1,1,1,1210
E01019009,1158,11,12,0,2,1183
E01019010,1122,7,9,2,1,1141
E01019011,1256,12,8,1,2,1279
E01019012,1574,6,25,4,6,1615
E01019013,1766,8,13,4,0,1791
E01019014,1169,7,6,0,1,1183
E01019015,1192,3,2,2,4,1203
E01019016,1381,5,6,1,3,1396
E01019017,1986,10,14,3,11,2024
E01019018,1347,4,2,1,1,1355
E01019019,1202,7,10,4,4,1227
E01019020,1170,17,19,2,13,1221
E01019021,1230,8,5,1,0,1244
E01019022,1388,5,18,7,0,1418
E01019023,1207,3,22,2,2,1236
E01019024,1196,4,1,1,1,1203
E01019025,1243,5,3,0,1,1252
E01019026,1216,6,4,2,1,1229
E01019027,1280,18,8,1,2,1309
E01019028,1665,26,38,3,2,1734
E01019029,1222,12,6,3,3,1246
E01019030,1448,7,4,2,1,1462
E01019031,1289,13,10,1,9,1322
E01019032,1229,6,8,1,0,1244
E01019033,1099,21,9,6,4,1139
E01019034,1213,5,10,1,1,1230
E01019035,1298,6,10,2,1,1317
E01019036,1425,5,4,3,1,1438
E01019037,1220,7,2,0,2,1231
E01019038,961,8,7,0,7,983
E01019039,1198,5,1,1,2,1207
E01019040,1026,10,0,0,0,1036
E01019041,1371,8,9,3,11,1402
E01019042,1365,10,33,3,3,1414
E01019043,1329,10,8,0,3,1350
E01019044,1297,7,3,1,0,1308
E01019045,1755,11,6,2,1,1775
E01019046,1113,3,5,1,1,1123
E01019047,990,15,9,4,0,1018
E01019048,1561,12,9,5,10,1597
E01019049,1466,14,4,1,3,1488
E01019050,1183,6,7,2,0,1198
E01019051,1295,14,2,1,1,1313
E01019052,1459,9,5,2,1,1476
E01019053,1559,8,12,1,1,1581
E01019054,1468,8,3,3,0,1482
E01019055,1123,7,3,1,0,1134
E01019056,1200,9,1,2,1,1213
E01019057,1542,7,5,1,4,1559
E01019058,1428,4,6,1,2,1441
E01019059,1269,6,4,1,1,1281
E01019060,1407,18,5,1,3,1434
E01019061,1391,5,1,1,0,1398
E01019062,1509,5,7,5,2,1528
E01019063,1605,10,1,0,1,1617
E01019064,1528,5,9,3,0,1545
E01019065,1038,7,8,1,1,1055
E01019066,1008,8,1,1,1,1019
E01019067,973,1,0,1,2,977
E01019068,1373,0,0,0,0,1373
E01019069,1013,9,7,1,0,1030
E01019070,1585,9,7,6,0,1607
E01019071,1263,3,7,1,1,1275
E01019072,1189,7,2,1,2,1201
E01019073,1150,5,7,2,3,1167
E01019074,1390,13,4,1,3,1411
E01019075,1383,11,3,1,1,1399
E01019076,1394,12,10,1,9,1426
E01019077,1839,11,2,2,3,1857
E01019078,1255,2,5,1,1,1264
E01019079,1215,2,4,0,0,1221
E01019080,1451,6,18,1,1,1477
E01019081,1512,4,0,1,0,1517
E01019082,1271,6,2,3,1,1283
E01019083,1564,8,9,1,3,1585
E01019084,1176,7,5,1,1,1190
E01019085,1228,2,25,4,2,1261
E01019086,928,2,11,1,0,942
E01019087,1369,2,6,0,1,1378
E01019088,1455,10,31,4,0,1500
E01019089,1335,4,3,1,1,1344
E01019090,1347,6,4,0,1,1358
E01019091,1532,2,0,0,1,1535
E01019092,1366,11,17,5,3,1402
E01019093,1265,2,6,1,0,1274
E01019094,1388,5,1,1,0,1395
E01019095,1217,7,9,0,1,1234
E01019096,1917,3,4,0,1,1925
E01019097,1366,2,7,2,1,1378
E01019098,1325,4,1,0,0,1330
E01019099,1400,9,3,0,0,1412
E01019100,1403,1,4,2,3,1413
E01019101,1281,4,1,1,0,1287
E01019102,1415,2,6,1,3,1427
E01019103,1037,2,13,4,1,1057
E01019104,1150,5,5,6,2,1168
E01019105,964,9,29,2,4,1008
E01019106,1248,1,12,3,0,1264
E01019107,1338,3,2,1,1,1345
E01019108,1170,1,9,1,0,1181
E01019109,1405,1,15,3,2,1426
E01019110,1380,1,0,0,0,1381
E01019111,1219,3,1,0,1,1224
E01019112,1340,4,6,2,0,1352
E01019113,1339,5,5,2,4,1355
E01019114,1229,4,4,3,0,1240
E01019115,1363,4,12,2,1,1382
E01019116,1055,3,8,0,0,1066
E01019117,1108,2,2,0,1,1113
E01019118,1117,5,9,1,0,1132
E01019119,1332,2,0,0,1,1335
E01019120,1465,8,7,2,3,1485
E01019121,1648,7,19,2,0,1676
E01019122,1114,3,9,0,1,1127
E01019123,1253,9,6,0,0,1268
E01019124,1698,4,10,0,1,1713
E01019125,1284,4,3,0,0,1291
E01019126,1406,9,3,0,0,1418
E01019127,1372,3,5,0,0,1380
E01019128,1362,3,1,0,1,1367
E01019129,1430,4,1,1,2,1438
E01019130,1396,2,0,0,2,1400
E01019131,1642,1,4,0,0,1647
E01019132,1520,2,0,0,0,1522
E01019133,1278,6,5,0,0,1289
E01019134,1279,3,4,0,0,1286
E01019135,1270,5,0,0,0,1275
E01019136,1276,3,6,1,0,1286
E01019137,914,4,7,1,0,926
E01019138,1052,3,3,1,1,1060
E01019139,1145,8,7,2,0,1162
E01019140,798,4,5,3,0,810
E01019141,986,2,25,3,2,1018
E01019142,1096,5,8,0,2,1111
E01019143,1278,11,23,4,3,1319
E01019144,1201,8,4,0,3,1216
E01019145,1601,5,5,0,0,1611
E01019146,1108,3,3,3,1,1118
E01019147,1240,7,4,1,5,1257
E01019148,1171,9,2,2,0,1184
E01019149,1220,2,11,0,0,1233
E01019150,1253,5,3,4,0,1265
E01019151,1193,0,9,0,1,1203
E01019152,997,8,36,2,1,1044
E01019153,901,2,8,0,0,911
E01019154,1100,4,25,0,6,1135
E01019155,1255,3,23,1,0,1282
E01019156,1146,7,24,0,1,1178
E01019157,1132,2,37,1,2,1174
E01019158,916,4,12,3,3,938
E01019159,846,2,9,0,2,859
E01019160,1083,4,6,1,0,1094
E01019161,1355,5,10,1,5,1376
E01019162,1209,2,10,0,1,1222
E01019163,1071,5,12,3,5,1096
E01019164,1043,8,2,0,4,1057
E01019165,1159,6,15,2,0,1182
E01019166,1127,3,6,1,1,1138
E01019167,1214,3,8,2,0,1227
E01019168,1153,4,12,0,2,1171
E01019169,1075,10,10,2,0,1097
E01019170,993,3,11,4,0,1011
E01019171,1049,6,14,3,1,1073
E01019172,1118,6,8,0,1,1133
E01019173,1041,6,9,0,0,1056
E01019174,901,2,12,0,1,916
E01019175,1131,2,7,0,1,1141
E01019176,1419,3,7,0,2,1431
E01019177,1058,5,9,3,7,1082
E01019178,1281,5,8,2,0,1296
E01019179,1028,5,8,0,2,1043
E01019180,1635,5,4,0,1,1645
E01019182,1154,6,4,0,0,1164
E01019184,1102,1,2,1,1,1107
E01019185,1178,1,2,1,0,1182
E01019186,1047,5,3,0,0,1055
E01019187,1064,3,3,1,0,1071
E01019188,1172,2,27,0,0,1201
E01019189,1177,4,30,4,2,1217
E01019190,1330,0,26,0,0,1356
E01019191,1269,5,26,1,2,1303
E01019192,1194,1,5,0,0,1200
E01019193,1108,5,11,3,1,1128
E01019194,1580,7,16,0,5,1608
E01019195,1173,4,7,1,3,1188
E01019196,1437,8,19,4,4,1472
E01019197,1458,7,18,1,6,1490
E01019198,1061,3,3,1,1,1069
E01019199,818,4,3,0,0,825
E01019200,1294,5,4,1,2,1306
E01019201,1181,1,5,6,0,1193
E01019202,1287,3,4,2,0,1296
E01019203,1766,5,6,0,2,1779
E01019204,1098,10,31,6,1,1146
E01019205,1312,16,64,13,9,1414
E01019206,1244,9,59,5,2,1319
E01019207,1092,7,15,9,5,1128
E01019208,1159,1,9,0,0,1169
E01019209,1154,6,10,1,1,1172
E01019210,1092,2,10,3,0,1107
E01019211,1448,7,25,3,3,1486
E01019212,1221,2,53,3,0,1279
E01019213,2230,3,19,1,2,2255
E01019214,1509,2,4,0,2,1517
E01019215,1238,4,11,2,1,1256
E01019216,1337,7,27,1,0,1372
E01019217,1425,11,31,1,1,1469
E01019218,1251,6,11,1,0,1269
E01019219,1790,6,9,3,1,1809
E01019220,1295,5,12,2,0,1314
E01019221,1510,4,11,3,1,1529
E01019222,1262,7,7,0,4,1280
E01019223,1296,7,6,0,5,1314
E01019224,1721,3,6,2,2,1734
E01019225,1641,10,3,1,0,1655
E01019226,981,5,4,1,3,994
E01019227,1182,4,3,0,0,1189
E01019228,1312,3,11,3,2,1331
E01019229,1642,2,2,0,1,1647
E01019230,1298,3,5,0,0,1306
E01019231,1248,3,5,1,0,1257
E01019232,1246,3,7,1,0,1257
E01019233,1162,3,6,0,0,1171
E01019234,1340,14,57,4,1,1416
E01019235,1249,1,11,3,0,1264
E01019236,1281,7,66,3,4,1361
E01019237,1248,6,16,3,0,1273
E01019238,1080,2,13,1,0,1096
E01019239,1263,1,4,0,0,1268
E01019240,1423,5,7,3,4,1442
E01019241,1284,6,24,3,0,1317
E01019242,1107,10,18,2,1,1138
E01019243,1269,7,13,0,1,1290
E01019244,1202,4,5,1,0,1212
E01019245,1155,4,17,1,2,1179
E01019246,1030,2,2,0,0,1034
E01019247,1225,5,13,2,0,1245
E01019248,839,4,6,1,0,850
E01019249,1256,1,7,1,0,1265
E01019250,1146,5,11,0,0,1162
E01019251,1448,5,8,0,2,1463
E01019252,1191,7,0,0,1,1199
E01019253,1477,6,12,2,0,1497
E01019254,1150,2,1,0,1,1154
E01019255,1135,4,2,0,0,1141
E01019256,1253,5,8,2,3,1271
E01019257,1235,5,2,2,0,1244
E01019258,1304,2,4,2,0,1312
E01019259,1115,6,1,4,2,1128
E01019260,1212,2,15,1,0,1230
E01019261,1412,6,16,0,1,1435
E01019262,1409,4,20,2,3,1438
E01019263,929,2,7,0,0,938
E01019264,1360,7,1,0,1,1369
E01019265,1093,4,9,0,1,1107
E01019266,1219,3,8,0,3,1233
E01019267,1080,5,4,0,0,1089
E01019268,976,2,3,1,1,983
E01019269,1251,3,8,0,4,1266
E01019270,1100,3,5,0,0,1108
E01019271,1059,0,7,1,0,1067
E01019272,1151,2,2,1,0,1156
E01019273,1325,5,5,2,1,1338
E01019274,1284,16,12,3,1,1316
E01019275,1820,4,2,4,2,1832
E01019276,864,3,5,0,2,874
E01019277,971,5,2,0,1,979
E01019278,1123,6,3,2,1,1135
E01019279,1224,3,3,0,0,1230
E01019280,1409,10,38,2,0,1459
E01019281,1050,4,13,1,0,1068
E01019282,1064,5,10,1,0,1080
E01019283,1570,19,52,23,2,1666
E01019284,993,1,10,2,1,1007
E01019285,1133,4,67,8,6,1218
E01019286,1106,2,9,1,3,1121
E01019287,990,1,7,0,0,998
E01019288,1169,1,7,1,4,1182
E01019289,1124,2,4,1,0,1131
E01019290,887,0,3,0,1,891
E01019291,1072,7,1,0,0,1080
E01019292,953,3,4,0,0,960
E01019293,1183,5,2,0,0,1190
E01019294,1208,0,2,0,1,1211
E01019295,1109,9,6,0,0,1124
E01019296,1228,7,4,0,2,1241
E01019297,1180,2,5,1,0,1188
E01019298,1260,4,1,1,1,1267
E01019299,1616,5,7,1,1,1630
E01019300,1413,3,53,1,0,1470
E01019301,1069,8,13,0,2,1092
E01019302,851,4,7,0,1,863
E01019303,1250,3,7,5,1,1266
E01019304,1120,0,9,2,1,1132
E01019305,1780,0,6,2,5,1793
E01019306,1107,2,8,0,0,1117
E01019307,1430,5,3,2,0,1440
E01019308,1183,11,1,1,2,1198
E01019309,1902,3,5,2,0,1912
E01019310,1140,3,1,2,0,1146
E01019311,1213,1,7,0,1,1222
E01019312,1241,3,9,0,2,1255
E01019313,1176,2,2,0,0,1180
E01019314,1060,1,2,1,0,1064
E01019315,1410,1,6,1,0,1418
E01019316,1233,4,7,1,0,1245
E01019317,1111,3,5,0,0,1119
E01019318,1031,3,8,0,0,1042
E01019319,1252,2,3,0,0,1257
E01019320,1189,4,6,0,1,1200
E01019321,1294,3,1,0,0,1298
E01019322,1169,2,2,0,3,1176
E01019323,1001,5,3,0,0,1009
E01019324,1048,5,6,0,0,1059
E01019325,1116,0,11,0,2,1129
E01019326,1295,2,3,1,2,1303
E01019327,1099,5,12,0,0,1116
E01019328,1110,2,5,0,0,1117
E01019329,944,6,6,1,6,963
E01019330,1194,3,21,2,0,1220
E01019331,1253,3,10,0,1,1267
E01019332,1182,2,6,0,0,1190
E01019333,938,3,15,0,0,956
E01019334,1129,1,2,1,2,1135
E01019335,1209,5,11,0,0,1225
E01019336,1406,5,24,0,3,1438
E01019337,1154,5,4,0,0,1163
E01019338,1243,2,7,1,0,1253
E01019339,1196,11,9,3,0,1219
E01019340,1126,1,3,1,1,1132
E01019341,1383,6,11,0,1,1401
E01019342,921,1,3,1,0,926
E01019343,1297,6,3,3,1,1310
E01019344,890,4,1,1,0,896
E01019345,1007,2,1,0,0,1010
E01019346,1619,6,0,2,1,1628
E01019347,1425,5,9,0,2,1441
E01019348,1004,0,1,0,2,1007
E01019349,1599,4,2,0,1,1606
E01019350,1435,3,3,0,0,1441
E01019351,1502,1,4,2,1,1510
E01019352,1876,2,2,3,0,1883
E01019353,1270,1,8,4,0,1283
E01019354,1200,5,11,3,0,1219
E01019355,1215,1,3,1,0,1220
E01019356,1260,5,6,1,0,1272
E01019357,1579,4,10,3,1,1597
E01019358,1516,5,4,1,2,1528
E01019359,1659,9,4,0,1,1673
E01019360,1758,17,21,6,6,1808
E01019361,1528,4,11,6,3,1552
E01019362,1638,6,7,1,0,1652
E01019363,1579,10,31,4,4,1628
E01019364,1461,10,32,3,4,1510
E01019365,1858,13,7,1,1,1880
E01019366,1561,6,5,2,3,1577
E01019367,1946,10,22,9,2,1989
E01019368,1671,4,9,1,6,1691
E01019369,1602,5,5,0,3,1615
E01019370,1802,10,5,3,1,1821
E01019371,1711,10,9,4,0,1734
E01019372,917,11,4,0,1,933
E01019373,1086,6,48,4,1,1145
E01019374,1252,7,26,6,0,1291
E01019375,1316,7,7,3,0,1333
E01019376,1274,4,6,6,0,1290
E01019377,1494,4,6,0,0,1504
E01019378,1324,5,6,0,0,1335
E01019379,1237,4,4,2,0,1247
E01019380,908,2,1,2,0,913
E01019381,1763,10,4,3,2,1782
E01019382,1751,14,15,6,3,1789
E01019383,1692,2,0,0,0,1694
E01019384,2057,9,45,0,3,2114
E01019385,963,3,6,0,1,973
E01019386,1498,11,5,1,2,1517
E01019387,1782,5,5,5,0,1797
E01019388,1606,7,15,1,1,1630
E01019389,1798,7,11,2,2,1820
E01019390,1641,6,15,2,4,1668
E01019391,1417,4,2,1,0,1424
E01019392,1543,10,19,2,0,1574
E01019393,1693,5,13,4,1,1716
E01019394,1894,7,4,1,2,1908
E01019395,1751,13,33,7,2,1806
E01019396,1720,9,14,6,0,1749
E01019397,1642,9,40,13,2,1706
E01019398,917,7,12,3,0,939
E01019399,847,3,11,11,0,872
E01019400,1253,7,9,0,3,1272
E01019401,1384,11,17,3,4,1419
E01019402,1244,11,18,3,1,1277
E01019403,1208,6,5,0,2,1221
E01019404,1366,10,16,3,2,1397
E01019405,1225,2,12,2,0,1241
E01019406,871,8,3,1,0,883
E01019407,1733,21,26,8,3,1791
E01019408,1202,9,10,4,3,1228
E01019409,1427,12,12,3,1,1455
E01019410,1194,15,4,1,1,1215
E01019411,1208,6,14,2,0,1230
E01019412,1184,13,6,6,3,1212
E01019413,1044,6,6,1,4,1061
E01019414,1378,3,6,0,3,1390
E01019415,1449,31,14,6,3,1503
E01019416,1218,3,1,1,2,1225
E01019417,1560,9,26,5,1,1601
E01019418,1372,7,4,4,1,1388
E01019419,1630,15,12,4,4,1665
E01019420,1148,4,7,6,1,1166
E01019421,1633,4,2,0,2,1641
E01019422,1291,2,1,3,2,1299
E01019423,1026,1,0,2,3,1032
E01019424,981,5,0,2,0,988
E01019425,1257,11,26,0,1,1295
E01019426,1238,11,21,4,4,1278
E01019427,1344,9,23,5,5,1386
E01019428,1231,7,3,1,0,1242
E01019429,1350,4,7,2,2,1365
E01019430,1578,5,5,3,1,1592
E01019431,1182,5,9,2,0,1198
E01019432,1645,6,0,1,2,1654
E01019433,1473,4,2,1,1,1481
E01019434,977,3,6,3,2,991
E01019435,1262,11,13,2,3,1291
E01019436,1053,10,12,3,0,1078
E01019437,1194,4,11,1,2,1212
E01019438,1313,5,12,6,0,1336
E01019439,1106,5,2,7,1,1121
E01019440,1235,14,13,7,0,1269
E01019441,1175,7,11,3,0,1196
E01019442,1271,8,7,6,0,1292
E01019443,1314,4,3,0,0,1321
E01019444,1025,6,1,3,0,1035
E01019445,1151,5,20,1,0,1177
E01019446,1013,6,6,1,0,1026
E01019447,1261,8,19,3,2,1293
E01019448,1370,3,7,3,0,1383
E01019449,1438,11,1,7,1,1458
E01019450,1184,5,10,0,0,1199
E01019451,1546,8,17,7,1,1579
E01019452,1289,3,6,4,0,1302
E01019453,1396,5,13,6,0,1420
E01019454,1211,7,3,2,3,1226
E01019455,1157,1,13,2,2,1175
E01019456,1438,6,19,7,0,1470
E01019457,1093,5,5,1,0,1104
E01019458,1249,11,19,5,2,1286
E01019459,1100,10,2,2,1,1115
E01019460,1309,7,6,2,0,1324
E01019461,1210,6,1,1,5,1223
E01019462,1097,1,0,0,0,1098
E01019463,1167,10,8,3,1,1189
E01019464,1620,12,5,1,2,1640
E01019465,952,8,10,2,0,972
E01019467,1245,10,4,4,0,1263
E01019468,1218,16,2,4,0,1240
E01019469,1215,8,5,4,0,1232
E01019470,1342,5,6,1,1,1355
E01019471,1069,7,13,5,5,1099
E01019472,2204,13,43,9,3,2272
E01019473,1107,2,7,2,1,1119
E01019474,1039,3,4,2,1,1049
E01019475,975,6,2,1,4,988
E01019476,1194,3,1,0,0,1198
E01019477,1889,2,3,0,1,1895
E01019478,1208,15,6,12,0,1241
E01019479,1287,11,60,12,0,1370
E01019480,1280,13,4,1,0,1298
E01019481,1028,2,8,2,0,1040
E01019482,1258,3,8,2,0,1271
E01019483,1543,13,19,22,0,1597
E01019484,1647,9,7,3,1,1667
E01019485,1016,3,1,1,0,1021
E01019486,918,2,4,0,0,924
E01019487,1261,4,6,0,0,1271
E01019488,1099,6,8,2,2,1117
E01019489,1027,1,3,2,1,1034
E01019490,926,1,2,2,1,932
E01019491,1755,14,10,20,0,1799
E01019492,1437,5,8,11,0,1461
E01019493,1307,3,1,0,1,1312
E01019494,1732,6,7,8,0,1753
E01019495,1342,3,5,2,0,1352
E01019496,1103,8,16,5,0,1132
E01019497,1196,6,9,6,0,1217
E01019498,1323,6,23,3,0,1355
E01019499,1053,10,21,6,1,1091
E01019500,1148,12,6,5,0,1171
E01019501,1233,6,5,5,0,1249
E01019502,1258,1,9,4,0,1272
E01019503,1894,12,10,6,1,1923
E01019504,1099,4,3,2,0,1108
E01019505,1222,7,2,1,0,1232
E01019506,1106,5,1,0,0,1112
E01019507,1361,9,6,2,0,1378
E01019508,1594,5,2,4,0,1605
E01019509,922,1,1,3,1,928
E01019510,1073,4,1,5,1,1084
E01019511,1676,9,20,8,0,1713
E01019512,2078,7,18,9,1,2113
E01019513,1021,5,12,28,0,1066
E01019514,1218,16,8,3,0,1245
E01019515,1260,9,13,1,0,1283
E01019516,1218,9,6,4,0,1237
E01019517,1250,5,19,5,0,1279
E01019518,1266,6,15,2,2,1291
E01019519,1436,13,8,4,1,1462
E01019520,1400,8,18,5,0,1431
E01019521,1258,6,1,2,0,1267
E01019522,1193,7,13,7,0,1220
E01019523,879,1,3,1,0,884
E01019524,1127,7,5,4,0,1143
E01019525,1232,4,4,1,0,1241
E01019526,1124,5,5,4,4,1142
E01019527,1106,3,18,10,1,1138
E01019528,1296,11,6,5,0,1318
E01019529,1187,11,9,4,0,1211
E01019530,1153,9,11,5,1,1179
E01019531,1169,8,5,8,0,1190
E01019532,1007,2,7,4,0,1020
E01019533,1182,6,5,4,0,1197
E01019534,1269,7,16,4,1,1297
E01019535,1202,7,17,2,3,1231
E01019536,1355,8,15,6,2,1386
E01019537,1195,11,16,5,0,1227
E01019538,1320,22,51,35,3,1431
E01019539,1345,7,13,16,1,1382
E01019540,1173,5,9,6,1,1194
E01019541,1227,11,25,9,2,1274
E01019542,1282,21,27,5,5,1340
E01019543,1221,13,14,18,1,1267
E01019544,1263,11,14,7,3,1298
E01019545,1146,9,18,4,0,1177
E01019546,1225,7,24,5,0,1261
E01019547,1096,8,18,7,0,1129
E01019548,1822,7,28,11,3,1871
E01019549,1037,9,3,14,1,1064
E01019550,1292,5,2,9,4,1312
E01019551,1372,5,2,1,2,1382
E01019552,1049,7,1,8,2,1067
E01019553,1351,7,8,2,4,1372
E01019554,1097,11,38,16,1,1163
E01019555,1231,12,19,10,0,1272
E01019556,1125,15,51,13,4,1208
E01019557,1145,9,15,9,2,1180
E01019558,1201,5,9,5,3,1223
E01019559,966,3,7,8,6,990
E01019560,1108,6,8,6,1,1129
E01019561,1100,5,8,14,1,1128
E01019562,1006,7,15,8,1,1037
E01019563,1225,11,16,15,3,1270
E01019564,1265,5,7,5,3,1285
E01019565,1137,6,4,8,1,1156
E01019566,1245,12,8,9,2,1276
E01019567,1349,13,5,4,3,1374
E01019568,1080,6,4,14,0,1104
E01019569,1329,16,28,16,5,1394
E01019570,1084,7,4,8,1,1104
E01019571,1144,21,16,4,1,1186
E01019572,1064,9,1,8,0,1082
E01019573,1269,13,4,13,2,1301
E01019574,1103,4,13,2,0,1122
E01019575,1219,16,17,16,3,1271
E01019576,1243,14,31,18,3,1309
E01019577,1294,5,12,18,0,1329
E01019578,1209,16,18,16,0,1259
E01019579,1277,14,77,13,2,1383
E01019580,1144,4,4,19,1,1172
E01019581,1085,19,23,21,0,1148
E01019582,1164,9,15,10,1,1199
E01019583,1135,6,17,4,2,1164
E01019585,1804,13,85,14,14,1930
E01019586,1121,14,15,3,5,1158
E01019587,1192,5,16,12,6,1231
E01019588,1204,9,10,5,9,1237
E01019589,1173,7,12,3,1,1196
E01019590,1563,11,4,6,0,1584
E01019591,1227,13,10,4,0,1254
E01019592,1366,8,10,2,2,1388
E01019593,921,3,12,2,1,939
E01019594,1385,4,15,7,1,1412
E01019595,1690,8,18,0,2,1718
E01019596,1288,6,5,2,2,1303
E01019597,1175,6,2,1,0,1184
E01019598,1315,5,9,3,5,1337
E01019599,1244,4,3,0,1,1252
E01019600,1378,7,4,1,0,1390
E01019601,1413,2,3,2,1,1421
E01019602,1553,5,3,0,0,1561
E01019603,1356,3,4,2,1,1366
E01019604,1538,6,10,2,4,1560
E01019605,1515,10,0,1,0,1526
E01019606,1385,6,12,0,0,1403
E01019607,1507,7,4,0,1,1519
E01019608,1372,7,10,0,0,1389
E01019609,1841,8,4,2,2,1857
E01019610,1278,16,5,0,0,1299
E01019611,1447,5,0,0,2,1454
E01019612,2010,50,88,43,9,2200
E01019613,1404,2,2,1,1,1410
E01019614,1397,4,3,0,1,1405
E01019615,1791,12,10,0,1,1814
E01019616,1474,6,4,1,1,1486
E01019617,1352,5,6,0,1,1364
E01019618,1388,4,4,1,0,1397
E01019619,1244,10,5,1,0,1260
E01019620,1297,9,15,1,3,1325
E01019621,1049,0,6,0,1,1056
E01019622,1279,3,6,0,2,1290
E01019623,1116,4,6,0,0,1126
E01019624,1014,7,7,0,0,1028
E01019625,1204,13,9,2,0,1228
E01019626,1245,4,6,3,0,1258
E01019627,1035,1,0,0,0,1036
E01019628,971,9,8,1,0,989
E01019629,1365,1,4,1,0,1371
E01019630,1512,4,5,0,0,1521
E01019631,1477,5,4,4,0,1490
E01019632,1452,6,7,0,0,1465
E01019633,1264,2,2,0,0,1268
E01019634,1229,6,4,0,0,1239
E01019635,1033,7,2,1,1,1044
E01019636,1259,8,8,2,1,1278
E01019638,1103,6,4,1,0,1114
E01019639,855,4,2,2,0,863
E01019640,1142,1,4,1,0,1148
E01019641,1201,4,6,13,0,1224
E01019642,1208,8,8,1,3,1228
E01019643,1330,7,15,9,1,1362
E01019644,1197,14,6,2,1,1220
E01019645,1269,4,24,7,2,1306
E01019646,1155,5,1,1,1,1163
E01019647,1452,20,32,33,4,1541
E01019648,1195,22,12,20,0,1249
E01019649,1330,17,35,28,0,1410
E01019650,1256,25,14,5,0,1300
E01019651,1147,12,21,6,1,1187
E01019652,1297,17,28,13,3,1358
E01019653,1115,6,73,21,7,1222
E01019654,1270,9,12,3,1,1295
E01019655,1207,16,14,4,0,1241
E01019656,1031,0,5,5,0,1041
E01019657,1386,11,12,0,5,1414
E01019658,1412,8,4,7,3,1434
E01019659,1391,4,10,3,1,1409
E01019660,1560,1,12,7,0,1580
E01019661,1072,11,7,5,4,1099
E01019662,1243,7,6,1,0,1257
E01019663,1125,8,9,2,6,1150
E01019664,923,8,6,2,0,939
E01019665,1135,8,4,4,3,1154
E01019666,1148,11,1,3,1,1164
E01019667,1272,12,6,3,3,1296
E01019668,1223,6,1,0,0,1230
E01019669,1350,10,1,4,0,1365
E01019670,1442,8,10,5,0,1465
E01019671,1513,10,16,4,3,1546
E01019672,1393,13,15,5,2,1428
E01019673,1102,3,12,2,0,1119
E01019674,1003,4,4,4,0,1015
E01019675,1211,16,21,12,8,1268
E01019676,1150,13,18,20,0,1201
E01019677,1181,11,16,5,6,1219
E01019678,1231,9,19,15,1,1275
E01019679,1332,12,17,11,3,1375
E01019680,1209,8,18,9,2,1246
E01019681,1275,7,15,5,2,1304
E01019682,1214,12,30,12,4,1272
E01019683,1074,8,8,2,2,1094
E01019684,1352,12,14,1,0,1379
E01019685,1239,8,12,1,0,1260
E01019686,1140,4,31,1,0,1176
E01019687,1193,10,10,2,4,1219
E01019688,1198,2,2,1,0,1203
E01019689,1202,7,9,1,1,1220
E01019690,956,2,20,2,0,980
E01019691,1262,3,19,4,0,1288
E01019692,1163,5,12,6,1,1187
E01019693,1397,14,47,5,3,1466
E01019694,997,3,20,2,0,1022
E01019695,1153,12,18,7,1,1191
E01019696,1139,4,5,5,0,1153
E01019697,1170,11,7,5,0,1193
E01019698,1124,12,5,11,0,1152
E01019699,1169,15,20,10,0,1214
E01019700,1859,8,14,9,2,1892
E01019701,1756,6,8,4,0,1774
E01019702,1613,5,1,3,0,1622
E01019703,1304,6,5,3,1,1319
E01019704,1234,8,4,1,1,1248
E01019705,1381,21,28,10,4,1444
E01019706,980,8,19,10,0,1017
E01019707,1150,16,39,8,0,1213
E01019708,1204,17,85,8,3,1317
E01019709,925,20,31,10,0,986
E01019710,1604,14,9,6,3,1636
E01019711,1087,5,15,0,1,1108
E01019712,1207,9,3,0,0,1219
E01019713,940,8,2,0,2,952
E01019714,1976,12,7,0,2,1997
E01019715,1262,9,22,7,1,1301
E01019716,1018,10,7,2,0,1037
E01019717,1188,19,43,6,6,1262
E01019718,1792,7,17,10,6,1832
E01019719,1255,3,10,0,3,1271
E01019720,1240,10,2,0,0,1252
E01019721,928,5,2,2,1,938
E01019722,1440,11,18,10,5,1484
E01019723,1611,17,22,6,3,1659
E01019724,950,3,2,3,0,958
E01019725,1134,6,1,1,1,1143
E01019726,1037,5,5,0,0,1047
E01019727,1477,11,14,4,2,1508
E01019728,855,8,14,5,0,882
E01019729,955,10,3,9,0,977
E01019730,1547,17,13,7,2,1586
E01019731,1016,11,6,0,0,1033
E01019732,1198,20,7,3,1,1229
E01019733,1230,7,13,3,4,1257
E01019734,1663,14,5,2,2,1686
E01019735,1275,4,5,0,1,1285
E01019736,991,6,6,0,1,1004
E01019737,975,7,6,3,1,992
E01019738,1071,13,12,2,2,1100
E01019739,1348,9,20,5,6,1388
E01019740,949,10,11,6,2,978
E01019741,897,5,8,3,0,913
E01019742,891,7,6,0,0,904
E01019743,1056,13,15,0,0,1084
E01019744,1205,12,17,1,2,1237
E01019745,898,5,1,1,0,905
E01019746,1290,8,8,1,4,1311
E01019747,971,8,13,2,0,994
E01019748,1215,7,6,0,2,1230
E01019749,1014,6,8,1,0,1029
E01019750,1037,7,4,2,2,1052
E01019751,1675,12,13,11,4,1715
E01019752,990,14,10,1,3,1018
E01019753,1169,29,6,3,1,1208
E01019754,1493,9,8,3,0,1513
E01019755,1669,16,9,2,1,1697
E01019756,1348,9,18,6,1,1382
E01019757,1083,4,4,2,0,1093
E01019758,1273,7,8,1,1,1290
E01019759,1204,7,10,3,2,1226
E01019760,1178,6,5,5,0,1194
E01019761,1071,14,14,6,0,1105
E01019762,1495,11,13,2,0,1521
E01019763,1679,14,5,4,1,1703
E01019764,1267,5,11,1,2,1286
E01019765,1476,5,5,2,0,1488
E01019766,1195,7,2,0,2,1206
E01019767,1291,8,8,0,2,1309
E01019768,1773,9,13,3,4,1802
E01019769,1617,4,9,1,0,1631
E01019770,1582,8,9,4,1,1604
E01019771,1807,9,6,2,1,1825
E01019772,1260,7,11,2,1,1281
E01019773,1913,15,25,6,1,1960
E01019774,1417,4,2,0,6,1429
E01019775,1428,10,9,5,0,1452
E01019776,1161,13,18,4,2,1198
E01019777,1876,17,11,4,2,1910
E01019778,1432,4,8,2,4,1450
E01019779,1369,10,11,0,4,1394
E01019780,1111,6,10,0,0,1127
E01019781,1201,6,12,0,0,1219
E01019782,1060,6,10,1,3,1080
E01019783,1038,5,0,2,1,1046
E01019784,989,6,7,2,1,1005
E01019785,1057,6,2,1,1,1067
E01019786,1252,8,6,2,1,1269
E01019787,1464,3,3,1,3,1474
E01019788,1394,10,3,6,3,1416
E01019790,1630,15,16,5,4,1670
E01019791,1450,11,7,3,2,1473
E01019792,1657,10,8,2,0,1677
E01019793,1235,11,0,7,1,1254
E01019794,1185,9,18,0,1,1213
E01019795,1787,11,10,10,3,1821
E01019796,873,4,12,0,0,889
E01019797,1089,6,6,0,6,1107
E01019798,1180,5,22,2,1,1210
E01019799,1551,8,15,1,0,1575
E01019800,1424,16,15,1,0,1456
E01019801,924,10,0,1,1,936
E01019802,1134,7,17,0,2,1160
E01019803,992,5,8,0,0,1005
E01019804,1095,6,14,0,0,1115
E01019805,1079,3,12,3,1,1098
E01019806,1266,10,9,2,3,1290
E01019807,1167,10,4,11,2,1194
E01019808,1234,2,16,1,1,1254
E01019809,989,4,3,0,0,996
E01019810,1211,5,10,4,0,1230
E01019811,1295,4,6,8,1,1314
E01019812,1479,10,3,7,1,1500
E01019813,1326,10,7,1,2,1346
E01019814,1441,4,26,6,0,1477
E01019815,2093,19,26,6,5,2149
E01019816,1480,7,1,1,1,1490
E01019817,961,1,3,1,1,967
E01019818,1193,5,3,3,2,1206
E01019819,1206,6,5,2,2,1221
E01019820,1195,3,4,4,3,1209
E01019821,1125,8,21,45,4,1203
E01019822,1284,6,17,8,4,1319
E01019823,896,7,17,6,0,926
E01019824,986,9,5,3,0,1003
E01019825,1118,11,14,4,0,1147
E01019826,1128,9,2,1,2,1142
E01019827,1523,8,17,5,3,1556
E01019828,1260,8,18,0,2,1288
E01019829,1199,4,3,1,4,1211
E01019830,1057,3,1,3,1,1065
E01019831,1114,4,4,1,1,1124
E01019832,1449,9,17,3,0,1478
E01019833,1436,4,11,6,3,1460
E01019834,1216,3,14,0,3,1236
E01019835,1170,13,79,20,3,1285
E01019837,1444,14,30,4,4,1496
E01019838,1309,3,13,6,1,1332
E01019839,1411,19,55,20,1,1506
E01019840,1246,9,23,9,6,1293
E01019841,1240,3,20,6,7,1276
E01019842,1272,6,8,1,0,1287
E01019843,1280,5,9,2,3,1299
E01019844,1262,3,8,0,1,1274
E01019845,1043,5,6,2,2,1058
E01019846,1016,2,5,1,0,1024
E01019847,1090,7,15,2,1,1115
E01019848,1505,29,35,5,6,1580
E01019850,1323,4,5,3,1,1336
E01019851,1319,10,8,2,0,1339
E01019852,1421,4,19,4,3,1451
E01019853,1230,7,1,2,0,1240
E01019854,1423,11,9,5,2,1450
E01019855,1244,5,9,6,0,1264
E01019856,1158,12,6,3,7,1186
E01019857,980,2,6,1,1,990
E01019858,1193,8,17,4,1,1223
E01019859,1388,10,3,1,3,1405
E01019860,1061,9,1,2,2,1075
E01019861,1436,6,8,6,3,1459
E01019862,1245,3,6,2,1,1257
E01019863,1227,12,8,1,0,1248
E01019864,1161,14,12,1,0,1188
E01019865,1013,9,7,3,1,1033
E01019866,1933,18,34,16,2,2003
E01019867,1286,15,35,7,3,1346
E01019868,1293,14,12,4,2,1325
E01019869,1212,20,29,9,4,1274
E01019870,1328,4,18,3,2,1355
E01019871,1400,1,20,5,1,1427
E01019872,1560,8,9,2,1,1580
E01019873,844,16,192,41,13,1106
E01019874,890,15,258,28,19,1210
E01019875,604,13,439,33,29,1118
E01019876,1515,2,24,4,6,1551
E01019877,1282,12,18,7,6,1325
E01019878,1267,1,8,2,2,1280
E01019879,1532,5,26,2,2,1567
E01019880,1265,10,14,4,4,1297
E01019881,1139,7,12,4,0,1162
E01019882,1276,4,8,2,1,1291
E01019883,2105,13,16,8,4,2146
E01019885,1358,7,15,3,1,1384
E01019886,2102,8,10,1,7,2128
E01019887,1143,4,10,6,1,1164
E01019888,1386,6,35,3,1,1431
E01019889,1238,3,3,0,1,1245
E01019890,1569,3,6,1,0,1579
E01019891,1206,8,7,2,0,1223
E01019892,1233,9,10,2,3,1257
E01019893,1448,6,5,2,2,1463
E01019894,1271,6,11,1,0,1289
E01019895,1207,3,1,2,0,1213
E01019896,1431,2,6,0,1,1440
E01019897,1222,0,5,1,1,1229
E01019898,1995,11,5,2,4,2017
E01019899,1110,1,7,0,2,1120
E01019900,1583,3,3,0,1,1590
E01019901,1096,7,12,1,1,1117
E01019902,1684,12,1,1,1,1699
E01019903,1683,10,10,2,2,1707
E01019904,1097,3,5,2,0,1107
E01019905,1655,8,5,1,2,1671
E01019906,1201,6,9,1,2,1219
E01019907,1257,3,2,0,0,1262
E01019908,1328,7,6,0,0,1341
E01019909,1512,9,9,2,1,1533
E01019910,1349,8,7,1,0,1365
E01019911,1387,6,4,0,1,1398
E01019912,1465,2,8,0,4,1479
E01019913,1455,3,9,2,2,1471
E01019914,1767,10,8,0,2,1787
E01019915,1440,4,6,8,3,1461
E01019916,1490,15,29,8,9,1551
E01019917,1217,9,19,4,0,1249
E01019918,1605,16,14,5,2,1642
E01019919,1358,12,29,2,0,1401
E01019920,1181,12,7,4,1,1205
E01019921,1261,4,4,0,2,1271
E01019922,1166,5,3,0,1,1175
E01019923,996,1,6,2,1,1006
E01019924,1175,5,6,1,1,1188
E01019925,1033,3,3,0,2,1041
E01019927,1015,6,11,3,2,1037
E01019928,1158,3,4,1,0,1166
E01019929,1159,4,1,2,1,1167
E01019930,1168,5,7,3,0,1183
E01019931,1069,4,6,2,1,1082
E01019932,1363,11,30,2,2,1408
E01019933,1006,6,11,2,2,1027
E01019934,1599,6,7,1,1,1614
E01019935,1083,1,8,0,0,1092
E01019936,960,2,5,0,0,967
E01019937,1761,5,4,0,2,1772
E01019938,1859,6,4,0,3,1872
E01019939,1220,4,9,0,1,1234
E01019940,1316,9,12,3,0,1340
E01019942,1416,8,10,1,1,1436
E01019943,1258,4,10,2,0,1274
E01019944,1231,5,10,1,0,1247
E01019945,1777,5,9,0,1,1792
E01019946,1267,4,4,0,0,1275
E01019947,1520,13,57,1,4,1595
E01019948,1104,6,5,0,1,1116
E01019949,1239,9,7,1,5,1261
E01019950,1035,4,4,2,4,1049
E01019951,1916,2,6,1,0,1925
E01019952,1487,4,1,2,1,1495
E01019953,1337,5,8,2,4,1356
E01019954,1202,5,9,2,1,1219
E01019955,1366,7,10,1,2,1386
E01019956,1440,11,22,2,0,1475
E01019957,1585,10,20,0,0,1615
E01019958,1533,5,21,1,0,1560
E01019959,932,2,6,1,0,941
E01019960,1086,1,5,1,1,1094
E01019961,2139,6,10,0,1,2156
E01019962,1944,6,6,2,3,1961
E01019963,1267,5,2,3,0,1277
E01019964,1676,20,5,11,3,1715
E01019965,1401,6,6,2,1,1416
E01019966,901,0,2,0,0,903
E01019967,1074,2,2,0,2,1080
E01019968,1270,12,27,2,4,1315
E01019969,1100,7,3,5,3,1118
E01019970,1074,3,16,2,6,1101
E01019971,1332,16,52,7,11,1418
E01019972,1075,11,31,1,2,1120
E01019973,1184,8,5,3,3,1203
E01019974,1187,10,5,1,3,1206
E01019975,991,3,21,4,1,1020
E01019976,1160,6,13,1,0,1180
E01019977,1187,9,13,1,1,1211
E01019980,1261,10,28,2,13,1314
E01019981,1109,6,12,0,0,1127
E01019982,1215,27,40,5,6,1293
E01019983,1178,13,13,3,7,1214
E01019984,1086,7,10,6,5,1114
E01019985,1022,12,8,1,4,1047
E01019986,1179,16,18,6,5,1224
E01019987,1350,28,122,16,12,1528
E01019988,1125,13,22,9,8,1177
E01019989,904,6,23,9,2,944
E01019990,1005,11,17,1,10,1044
E01019991,1076,15,26,4,14,1135
E01019992,1188,7,25,2,6,1228
E01019993,985,7,16,1,3,1012
E01019994,1202,32,95,24,15,1368
E01019995,1129,22,78,15,16,1260
E01019996,1119,38,70,6,11,1244
E01019997,1234,26,111,7,29,1407
E01019998,1057,12,70,8,20,1167
E01019999,1023,17,53,4,14,1111
E01020000,1000,18,53,8,3,1082
E01020001,1074,10,44,6,9,1143
E01020002,1159,6,10,3,1,1179
E01020003,1305,9,13,3,10,1340
E01020004,1206,4,8,4,1,1223
E01020005,1343,11,13,18,6,1391
E01020006,1528,22,99,12,20,1681
E01020007,1201,31,80,13,36,1361
E01020008,1440,32,96,21,10,1599
E01020009,1140,18,45,10,6,1219
E01020010,1289,9,55,9,2,1364
E01020011,1017,8,4,2,8,1039
E01020012,1131,12,16,3,7,1169
E01020013,1013,27,45,15,6,1106
E01020014,1165,16,19,12,9,1221
E01020015,1306,11,19,6,5,1347
E01020016,1692,23,209,23,42,1989
E01020017,1762,49,335,20,66,2232
E01020018,1630,29,144,13,42,1858
E01020019,1564,38,91,9,12,1714
E01020020,1436,39,129,17,15,1636
E01020021,1330,50,120,18,16,1534
E01020022,1299,35,186,9,38,1567
E01020023,1706,14,50,17,17,1804
E01020024,1198,14,32,2,8,1254
E01020025,1216,24,24,12,10,1286
E01020026,1440,6,11,2,4,1463
E01020027,1283,6,25,6,1,1321
E01020029,1257,10,34,2,7,1310
E01020030,1426,20,49,9,7,1511
E01020031,1222,12,32,7,4,1277
E01020032,1191,13,27,3,10,1244
E01020033,1338,8,7,0,2,1355
E01020035,1260,7,28,3,11,1309
E01020036,1157,9,17,5,3,1191
E01020037,1058,11,12,7,3,1091
E01020038,1179,5,13,1,10,1208
E01020039,1434,12,18,8,10,1482
E01020040,1052,15,8,5,6,1086
E01020041,1736,2,12,4,3,1757
E01020042,1359,5,13,5,1,1383
E01020043,1561,6,1,0,1,1569
E01020044,1303,6,4,0,0,1313
E01020045,1336,3,3,0,0,1342
E01020046,1263,10,6,2,0,1281
E01020047,1780,6,9,1,2,1798
E01020048,1662,9,22,5,3,1701
E01020049,1107,6,0,0,1,1114
E01020050,1793,4,4,3,0,1804
E01020051,1557,5,2,1,1,1566
E01020052,1433,8,10,4,2,1457
E01020053,1121,5,4,3,0,1133
E01020054,1657,4,8,3,0,1672
E01020055,1526,6,35,0,3,1570
E01020056,1656,7,10,1,1,1675
E01020057,1365,11,9,9,2,1396
E01020058,1585,3,8,3,0,1599
E01020059,1629,16,4,2,1,1652
E01020060,1416,4,16,3,6,1445
E01020061,1683,6,11,2,1,1703
E01020062,1288,2,1,1,1,1293
E01020063,1968,8,9,2,2,1989
E01020064,1414,10,10,1,0,1435
E01020065,1454,9,39,3,0,1505
E01020066,2136,7,20,3,0,2166
E01020067,1421,6,9,1,1,1438
E01020068,1253,8,14,5,1,1281
E01020069,1229,5,3,1,0,1238
E01020070,1540,10,8,0,0,1558
E01020071,1530,6,4,0,2,1542
E01020072,1350,6,3,1,1,1361
E01020073,1396,7,3,0,1,1407
E01020074,1720,11,3,1,2,1737
E01020075,1525,6,7,1,1,1540
E01020076,1374,13,2,1,0,1390
E01020077,1294,5,5,0,0,1304
E01020078,1092,3,8,2,3,1108
E01020079,1072,3,0,2,0,1077
E01020080,1062,3,3,1,0,1069
E01020081,1002,7,5,1,0,1015
E01020082,962,4,1,1,1,969
E01020083,1829,13,6,0,0,1848
E01020084,1200,3,10,2,1,1216
E01020085,1161,10,6,2,0,1179
E01020086,1240,9,15,0,4,1268
E01020087,1639,2,2,2,1,1646
E01020088,1702,5,3,0,2,1712
E01020089,1852,13,11,0,4,1880
E01020090,1444,10,1,2,0,1457
E01020091,1081,6,2,1,0,1090
E01020092,1228,6,6,0,5,1245
E01020093,1158,9,6,2,1,1176
E01020094,1439,12,42,14,7,1514
E01020095,1150,14,20,4,6,1194
E01020096,1363,17,36,8,3,1427
E01020097,1869,11,5,1,2,1888
E01020098,1754,8,1,0,3,1766
E01020099,1175,5,4,0,0,1184
E01020100,930,2,3,0,0,935
E01020101,1213,5,4,0,0,1222
E01020102,1278,8,16,3,2,1307
E01020103,1079,8,9,1,2,1099
E01020104,1035,7,8,1,0,1051
E01020105,1210,3,4,0,0,1217
E01020106,1012,1,0,0,0,1013
E01020107,1426,6,8,3,0,1443
E01020108,1900,8,8,1,1,1918
E01020109,1186,2,2,1,3,1194
E01020110,2016,8,51,22,15,2112
E01020111,1130,8,14,1,1,1154
E01020112,1329,14,18,2,9,1372
E01020113,1149,20,16,3,0,1188
E01020114,981,6,2,3,2,994
E01020115,1007,6,7,3,0,1023
E01020116,1339,8,7,1,1,1356
E01020117,1267,6,5,1,1,1280
E01020118,1045,5,7,3,0,1060
E01020119,1297,2,7,2,2,1310
E01020120,1493,8,28,0,4,1533
E01020121,1571,5,6,1,2,1585
E01020122,1421,10,6,1,1,1439
E01020123,1190,3,5,4,0,1202
E01020124,1166,9,8,4,0,1187
E01020125,1118,4,6,4,1,1133
E01020126,1427,16,7,3,0,1453
E01020127,1551,4,3,0,0,1558
E01020128,1074,9,14,3,1,1101
E01020129,930,9,9,3,5,956
E01020130,1194,8,18,2,2,1224
E01020131,1779,5,26,2,0,1812
E01020132,1483,4,14,2,4,1507
E01020133,1155,7,21,7,6,1196
E01020134,899,5,36,0,2,942
E01020135,1249,7,5,2,0,1263
E01020136,1444,5,7,1,2,1459
E01020137,1284,5,23,4,4,1320
E01020138,1899,11,7,2,2,1921
E01020139,1133,9,24,0,3,1169
E01020140,988,10,10,3,2,1013
E01020141,1294,9,11,1,0,1315
E01020142,1826,7,7,4,0,1844
E01020143,1826,18,6,1,4,1855
E01020144,1167,9,16,5,7,1204
E01020145,1698,9,11,3,2,1723
E01020146,967,8,15,4,3,997
E01020147,1703,10,4,1,1,1719
E01020148,914,4,1,0,0,919
E01020149,978,9,9,2,0,998
E01020150,1445,15,5,3,3,1471
E01020151,1414,5,6,6,1,1432
E01020152,1307,6,14,0,2,1329
E01020153,1091,1,4,0,0,1096
E01020154,1217,9,4,3,40,1273
E01020155,827,4,4,2,3,840
E01020156,1565,6,7,1,0,1579
E01020157,1899,14,11,1,2,1927
E01020158,1382,2,7,1,0,1392
E01020159,1177,8,8,0,0,1193
E01020160,1501,10,1,2,0,1514
E01020161,1980,17,26,3,3,2029
E01020162,1300,8,3,2,2,1315
E01020163,1393,4,4,3,1,1405
E01020164,1241,5,4,0,1,1251
E01020165,1177,6,7,1,0,1191
E01020166,1184,0,3,2,0,1189
E01020167,1062,4,1,1,3,1071
E01020168,1742,5,7,2,1,1757
E01020169,1853,13,27,0,3,1896
E01020170,1800,7,3,2,1,1813
E01020171,1589,5,5,0,1,1600
E01020172,1547,6,7,2,2,1564
E01020173,1390,4,1,0,0,1395
E01020174,1319,5,3,0,0,1327
E01020175,1688,0,2,1,1,1692
E01020176,973,7,3,0,1,984
E01020177,1153,3,7,2,0,1165
E01020178,1647,3,5,1,2,1658
E01020179,1640,7,5,2,2,1656
E01020180,1487,16,15,9,1,1528
E01020181,1398,13,5,2,3,1421
E01020182,1167,7,5,2,0,1181
E01020183,1173,25,5,6,6,1215
E01020184,1351,12,13,3,5,1384
E01020185,1119,5,2,2,3,1131
E01020186,1272,3,6,2,0,1283
E01020187,1381,8,7,0,0,1396
E01020188,1629,4,11,1,0,1645
E01020189,1705,5,17,1,1,1729
E01020190,1668,15,5,4,0,1692
E01020191,1491,23,10,16,0,1540
E01020192,1296,4,0,2,2,1304
E01020193,1193,7,5,1,2,1208
E01020194,1183,4,2,3,0,1192
E01020195,1399,15,4,1,0,1419
E01020196,1374,20,9,0,0,1403
E01020197,1076,11,9,0,0,1096
E01020198,1088,7,1,0,0,1096
E01020199,1287,14,14,1,1,1317
E01020200,965,3,4,1,2,975
E01020201,1292,4,4,2,0,1302
E01020202,1315,7,8,2,0,1332
E01020203,1389,8,8,0,4,1409
E01020204,1162,11,15,0,0,1188
E01020205,1238,4,4,0,1,1247
E01020206,1240,5,2,0,0,1247
E01020207,945,3,7,0,5,960
E01020208,991,7,9,0,1,1008
E01020209,1156,4,4,0,1,1165
E01020210,1030,3,5,0,0,1038
E01020211,1183,4,9,1,1,1198
E01020212,959,5,2,1,0,967
E01020213,1182,5,4,0,0,1191
E01020214,1309,6,6,2,1,1324
E01020215,1187,3,4,0,1,1195
E01020216,1241,8,6,3,1,1259
E01020217,1357,10,33,0,2,1402
E01020218,1183,12,39,2,6,1242
E01020219,1631,13,11,3,1,1659
E01020220,1100,9,6,0,3,1118
E01020221,1409,5,9,0,2,1425
E01020222,988,4,4,1,2,999
E01020223,1428,3,10,0,1,1442
E01020224,952,7,14,0,3,976
E01020225,996,6,15,5,0,1022
E01020226,1063,5,15,0,3,1086
E01020227,1221,6,11,2,0,1240
E01020228,1536,8,37,3,4,1588
E01020229,1460,5,8,0,0,1473
E01020230,1443,10,7,1,1,1462
E01020231,1196,8,12,1,0,1217
E01020232,1254,7,6,0,1,1268
E01020233,1522,9,6,1,3,1541
E01020234,1168,2,6,1,0,1177
E01020235,1498,12,10,0,4,1524
E01020236,1080,4,1,0,0,1085
E01020237,1279,4,3,0,0,1286
E01020238,982,3,3,1,0,989
E01020239,1060,2,4,3,2,1071
E01020240,1287,9,5,2,2,1305
E01020241,1379,9,18,5,2,1413
E01020242,1119,3,9,0,0,1131
E01020243,985,2,5,1,3,996
E01020244,1134,3,11,1,0,1149
E01020245,1365,7,6,1,1,1380
E01020246,906,4,6,2,0,918
E01020247,1316,8,6,1,3,1334
E01020248,1350,7,9,1,0,1367
E01020249,1144,5,8,2,2,1161
E01020250,1335,6,1,1,1,1344
E01020251,1186,6,9,1,1,1203
E01020252,1140,3,4,0,1,1148
E01020253,1122,13,9,1,1,1146
E01020254,1065,7,3,0,1,1076
E01020255,1066,7,1,0,1,1075
E01020256,1078,9,35,1,2,1125
E01020257,1002,2,7,1,2,1014
E01020258,1430,7,12,0,2,1451
E01020259,944,3,1,1,1,950
E01020260,1096,6,1,0,2,1105
E01020261,995,5,5,1,1,1007
E01020262,1083,2,8,2,2,1097
E01020263,1281,2,0,0,1,1284
E01020264,1327,6,15,0,1,1349
E01020265,1449,1,3,0,0,1453
E01020266,1353,11,58,2,5,1429
E01020267,1248,4,10,4,4,1270
E01020268,1265,8,8,2,1,1284
E01020269,1662,7,18,8,2,1697
E01020270,1318,10,5,0,2,1335
E01020271,1210,4,12,0,2,1228
E01020272,1407,10,12,2,1,1432
E01020273,1128,7,3,0,1,1139
E01020274,1067,2,2,0,0,1071
E01020275,1118,7,1,3,0,1129
E01020276,1275,6,3,2,0,1286
E01020277,1516,13,4,1,3,1537
E01020278,1367,5,5,0,0,1377
E01020279,1822,9,3,3,2,1839
E01020280,1753,18,17,0,20,1808
E01020281,1549,7,38,0,3,1597
E01020282,1340,6,5,1,1,1353
E01020283,1172,3,5,1,0,1181
E01020284,1532,12,8,4,4,1560
E01020285,1528,17,9,1,0,1555
E01020286,1346,2,3,0,2,1353
E01020287,1316,9,0,0,1,1326
E01020288,1362,3,5,1,0,1371
E01020289,1342,3,3,0,0,1348
E01020290,1446,5,3,1,2,1457
E01020291,1296,3,9,0,0,1308
E01020292,1210,1,9,0,8,1228
E01020293,1807,7,6,0,2,1822
E01020294,1426,4,4,4,2,1440
E01020295,1403,7,3,3,2,1418
E01020296,1228,5,0,2,1,1236
E01020297,1264,6,3,2,0,1275
E01020298,1769,6,6,1,1,1783
E01020299,1592,7,6,1,0,1606
E01020300,1496,7,5,1,1,1510
E01020301,1623,2,20,0,2,1647
E01020302,1422,6,1,1,0,1430
E01020303,1408,6,0,0,2,1416
E01020304,1400,4,7,1,0,1412
E01020305,881,9,11,4,2,907
E01020306,997,2,1,0,1,1001
E01020307,1267,2,6,2,1,1278
E01020308,1431,5,3,0,2,1441
E01020309,1411,4,6,3,0,1424
E01020310,1890,13,7,1,0,1911
E01020311,1734,12,3,1,1,1751
E01020312,1345,10,2,0,1,1358
E01020313,1158,5,3,1,0,1167
E01020314,1340,4,4,1,2,1351
E01020315,1248,5,6,1,0,1260
E01020316,1500,3,7,0,4,1514
E01020317,1240,2,3,1,0,1246
E01020318,1220,9,5,3,1,1238
E01020319,1350,9,4,1,2,1366
E01020320,1442,11,4,3,1,1461
E01020321,1833,6,15,2,2,1858
E01020322,1701,5,2,1,2,1711
E01020323,1683,30,30,30,7,1780
E01020324,1344,4,3,0,2,1353
E01020325,1319,4,5,0,3,1331
E01020326,1646,4,5,1,0,1656
E01020327,1488,5,8,0,0,1501
E01020328,1715,11,13,1,1,1741
E01020329,1338,9,11,1,3,1362
E01020330,1460,8,28,3,4,1503
E01020331,1314,4,2,0,1,1321
E01020332,1506,14,20,1,2,1543
E01020333,1564,8,14,1,2,1589
E01020334,1573,14,10,0,4,1601
E01020335,1310,8,3,0,0,1321
E01020336,1170,4,3,2,0,1179
E01020337,1050,10,11,0,2,1073
E01020338,1828,4,12,1,1,1846
E01020339,1401,9,3,0,0,1413
E01020340,1399,7,2,0,0,1408
E01020341,1365,10,2,1,0,1378
E01020342,1211,7,5,0,0,1223
E01020343,1291,7,3,1,0,1302
E01020344,1111,11,8,1,1,1132
E01020345,1042,6,10,0,0,1058
E01020346,1270,8,17,4,2,1301
E01020347,1268,9,18,3,3,1301
E01020348,1250,11,12,2,7,1282
E01020349,1616,9,18,8,4,1655
E01020350,1554,5,9,0,4,1572
E01020351,1031,6,11,2,0,1050
E01020352,1057,9,19,3,1,1089
E01020353,1315,8,28,5,5,1361
E01020354,1248,4,13,0,0,1265
E01020355,1697,4,10,0,2,1713
E01020356,1427,7,2,2,1,1439
E01020357,1723,11,18,6,0,1758
E01020358,1300,6,1,4,2,1313
E01020359,956,14,18,5,2,995
E01020360,1186,20,17,4,1,1228
E01020361,1225,10,26,5,3,1269
E01020362,1272,5,5,0,0,1282
E01020363,931,5,2,2,1,941
E01020364,1307,14,19,1,2,1343
E01020365,1351,5,9,2,5,1372
E01020366,1742,8,19,2,6,1777
E01020367,1563,12,26,5,2,1608
E01020368,1957,22,36,4,3,2022
E01020369,1159,2,1,2,2,1166
E01020370,1207,5,15,1,1,1229
E01020371,1376,3,8,0,0,1387
E01020372,1069,5,5,0,0,1079
E01020373,990,3,4,1,0,998
E01020374,1261,10,8,0,3,1282
E01020375,1171,10,10,2,2,1195
E01020376,960,1,2,0,0,963
E01020377,1318,2,7,6,0,1333
E01020378,1260,10,2,1,0,1273
E01020379,1212,7,2,1,1,1223
E01020380,903,2,6,1,0,912
E01020381,1020,4,4,3,1,1032
E01020382,1238,3,12,0,0,1253
E01020383,1486,2,4,1,1,1494
E01020384,1325,6,14,0,1,1346
E01020385,979,1,5,1,3,989
E01020386,984,4,4,1,0,993
E01020387,939,3,11,0,0,953
E01020388,1172,6,18,1,0,1197
E01020389,1784,9,4,5,1,1803
E01020390,1231,9,10,3,2,1255
E01020391,1267,7,14,0,0,1288
E01020392,1365,5,21,4,4,1399
E01020393,1096,3,30,11,2,1142
E01020394,1465,10,19,2,3,1499
E01020395,1679,8,18,3,3,1711
E01020396,890,2,2,1,0,895
E01020397,1180,8,6,0,0,1194
E01020398,1927,6,5,1,1,1940
E01020399,2040,8,20,3,1,2072
E01020400,1401,4,8,0,1,1414
E01020401,1339,4,11,1,0,1355
E01020402,1278,6,10,0,5,1299
E01020403,1348,5,10,1,11,1375
E01020404,1370,1,24,2,1,1398
E01020405,1281,12,23,2,2,1320
E01020406,2063,5,12,2,2,2084
E01020407,1022,3,8,0,2,1035
E01020408,988,5,3,1,0,997
E01020409,1030,6,9,1,0,1046
E01020410,1059,1,5,0,0,1065
E01020411,903,3,13,2,3,924
E01020412,1098,12,11,1,1,1123
E01020413,1151,5,5,1,2,1164
E01020414,1546,6,21,3,2,1578
E01020415,1261,1,5,1,1,1269
E01020416,1164,4,5,2,1,1176
E01020417,874,5,4,3,0,886
E01020418,1264,7,11,1,1,1284
E01020419,1521,5,5,3,0,1534
E01020420,1052,5,11,2,2,1072
E01020421,1132,4,12,1,0,1149
E01020422,1486,9,6,2,2,1505
E01020423,1269,5,2,0,1,1277
E01020424,1212,5,4,0,1,1222
E01020425,1446,2,8,2,0,1458
E01020426,1531,12,12,1,2,1558
E01020427,1284,7,10,0,0,1301
E01020428,1658,11,10,1,3,1683
E01020429,1347,12,10,2,1,1372
E01020430,1192,3,2,1,2,1200
E01020431,943,4,9,5,1,962
E01020432,1027,8,3,1,1,1040
E01020433,1462,6,5,2,1,1476
E01020434,1493,1,11,7,1,1513
E01020435,1496,6,10,1,3,1516
E01020436,1573,15,28,0,2,1618
E01020437,1518,7,18,1,1,1545
E01020438,1697,11,49,0,3,1760
E01020439,1795,10,38,3,3,1849
E01020440,1636,4,6,2,0,1648
E01020441,1539,0,5,0,1,1545
E01020442,1686,2,4,5,2,1699
E01020443,1979,16,24,2,0,2021
E01020444,1434,7,7,0,1,1449
E01020445,1043,4,16,1,2,1066
E01020446,1258,5,5,0,2,1270
E01020447,1527,4,3,4,0,1538
E01020448,1616,7,6,0,0,1629
E01020449,1717,6,4,1,0,1728
E01020450,1804,18,7,5,1,1835
E01020452,1819,11,22,5,2,1859
E01020453,1425,7,2,0,3,1437
E01020454,1709,17,28,3,6,1763
E01020455,1464,11,22,7,0,1504
E01020456,1404,7,7,0,1,1419
E01020457,1269,6,27,11,1,1314
E01020458,1807,7,8,0,0,1822
E01020459,2057,15,17,2,2,2093
E01020460,1907,32,19,32,1,1991
E01020462,1487,6,6,2,2,1503
E01020463,1366,7,10,4,1,1388
E01020464,1297,6,5,3,0,1311
E01020465,1642,5,4,0,0,1651
E01020466,1527,3,3,4,0,1537
E01020467,1480,3,6,1,0,1490
E01020468,1304,1,2,0,0,1307
E01020469,1537,9,3,0,0,1549
E01020470,1530,1,3,0,1,1535
E01020471,1030,5,7,3,1,1046
E01020472,1121,9,2,1,0,1133
E01020473,1210,8,9,3,0,1230
E01020474,1442,5,4,0,0,1451
E01020475,1653,11,8,1,2,1675
E01020476,1069,4,5,0,0,1078
E01020477,1226,7,4,2,1,1240
E01020478,911,1,4,0,1,917
E01020479,1045,7,13,1,3,1069
E01020480,1344,6,3,1,0,1354
E01020481,1324,12,5,4,4,1349
E01020482,1341,15,23,2,1,1382
E01020483,1020,3,2,0,0,1025
E01020484,1165,7,15,2,1,1190
E01020485,1283,6,5,0,1,1295
E01020486,1127,9,6,0,0,1142
E01020487,1050,4,7,0,1,1062
E01020488,1206,4,12,0,0,1222
E01020489,1201,7,8,1,0,1217
E01020490,1360,8,9,1,0,1378
E01020491,1274,7,2,2,1,1286
E01020492,987,6,2,0,1,996
E01020493,1825,16,14,13,4,1872
E01020494,939,1,2,0,0,942
E01020495,1182,0,3,3,1,1189
E01020496,1334,5,1,2,1,1343
E01020497,1581,2,2,6,1,1592
E01020498,1711,6,9,4,1,1731
E01020499,1092,4,1,4,1,1102
E01020500,1383,15,10,3,3,1414
E01020501,1162,11,4,2,0,1179
E01020502,1366,3,1,6,0,1376
E01020503,1505,5,9,1,2,1522
E01020504,2058,7,4,2,1,2072
E01020505,1587,2,11,0,1,1601
E01020506,1507,1,3,1,1,1513
E01020507,1657,11,7,1,2,1678
E01020508,1689,8,19,0,1,1717
E01020509,2266,15,7,2,4,2294
E01020510,1633,3,9,2,0,1647
E01020511,1455,4,7,0,0,1466
E01020512,1771,7,9,0,1,1788
E01020513,1230,5,6,2,1,1244
E01020514,1014,3,10,0,0,1027
E01020515,969,6,7,0,0,982
E01020516,1271,6,6,0,0,1283
E01020517,1515,6,3,0,5,1529
E01020518,1234,5,13,5,3,1260
E01020519,1376,9,21,3,6,1415
E01020520,1175,10,16,2,1,1204
E01020523,1017,6,14,0,2,1039
E01020524,1211,8,9,2,1,1231
E01020525,1067,2,9,1,0,1079
E01020526,1096,10,8,4,0,1118
E01020527,1157,18,27,8,2,1212
E01020528,1520,14,42,3,1,1580
E01020529,1829,6,5,3,0,1843
E01020530,1569,6,7,2,4,1588
E01020531,1437,6,3,2,2,1450
E01020532,1446,11,5,3,3,1468
E01020533,1687,11,23,1,1,1723
E01020534,1699,5,9,2,1,1716
E01020535,1440,6,6,0,1,1453
E01020536,1662,10,10,1,3,1686
E01020537,1655,9,4,2,0,1670
E01020538,1528,6,11,0,0,1545
E01020539,1637,9,13,1,1,1661
E01020540,1994,9,11,0,0,2014
E01020541,1666,4,6,3,0,1679
E01020542,1134,9,8,0,0,1151
E01020543,1088,4,17,4,1,1114
E01020544,1344,8,86,6,3,1447
E01020546,1261,14,60,11,5,1351
E01020547,915,3,4,1,0,923
E01020549,1768,3,13,0,1,1785
E01020550,1342,3,5,1,1,1352
E01020551,1460,4,13,1,0,1478
E01020552,1333,10,6,2,0,1351
E01020553,1076,6,30,5,0,1117
E01020554,1492,31,37,13,3,1576
E01020555,1130,16,19,6,4,1175
E01020556,1270,4,24,5,1,1304
E01020557,1361,6,16,0,5,1388
E01020558,1482,2,3,2,1,1490
E01020559,1424,2,9,0,0,1435
E01020560,1609,9,14,3,1,1636
E01020561,1509,9,34,4,6,1562
E01020562,1646,7,8,1,0,1662
E01020563,1250,52,13,69,7,1391
E01020564,1214,10,1,2,0,1227
E01020565,1200,10,3,0,0,1213
E01020566,1729,10,3,8,0,1750
E01020569,1117,9,1,1,0,1128
E01020570,1339,6,16,0,0,1361
E01020571,1609,6,16,2,1,1634
E01020572,1570,20,15,2,2,1609
E01020573,1534,7,10,2,3,1556
E01020574,1495,11,17,2,0,1525
E01020575,1284,9,13,2,0,1308
E01020576,1442,11,16,2,1,1472
E01020577,1245,7,23,2,3,1280
E01020578,1757,6,1,0,2,1766
E01020579,1654,8,12,2,0,1676
E01020580,1201,8,7,2,0,1218
E01020581,1749,11,19,7,3,1789
E01020582,1230,12,24,6,6,1278
E01020583,1595,10,10,5,0,1620
E01020584,1377,10,6,0,1,1394
E01020585,1194,5,1,1,1,1202
E01020586,1050,4,7,0,0,1061
E01020587,1151,3,4,1,0,1159
E01020588,1076,6,8,0,0,1090
E01020589,1187,6,9,2,2,1206
E01020590,1139,7,6,0,0,1152
E01020591,1203,6,6,0,0,1215
E01020592,1108,7,21,3,1,1140
E01020593,1052,4,3,1,1,1061
E01020594,1372,6,18,1,3,1400
E01020595,1447,6,8,2,2,1465
E01020596,1323,2,4,1,1,1331
E01020597,1267,5,5,0,1,1278
E01020598,1456,12,24,2,0,1494
E01020599,1415,5,3,0,2,1425
E01020600,1265,4,14,3,0,1286
E01020601,1258,2,8,2,1,1271
E01020602,1541,7,12,0,2,1562
E01020603,1460,5,18,2,1,1486
E01020604,1175,5,14,1,1,1196
E01020605,1439,2,5,4,2,1452
E01020606,1261,1,7,1,1,1271
E01020607,1350,7,10,1,3,1371
E01020608,1366,13,12,1,0,1392
E01020609,1154,5,2,0,1,1162
E01020610,1206,6,11,0,1,1224
E01020611,1131,7,13,0,0,1151
E01020612,1341,7,29,0,0,1377
E01020613,1115,1,22,1,0,1139
E01020614,1171,3,12,0,2,1188
E01020615,1428,2,6,0,0,1436
E01020616,1331,1,13,1,0,1346
E01020617,1554,0,4,1,1,1560
E01020618,1269,3,14,2,1,1289
E01020619,1259,2,13,0,3,1277
E01020620,1258,3,13,2,2,1278
E01020621,1519,5,12,2,1,1539
E01020622,1381,6,4,0,1,1392
E01020623,1227,3,9,0,0,1239
E01020624,1274,5,7,3,0,1289
E01020625,1267,0,31,2,7,1307
E01020626,1288,0,4,1,0,1293
E01020627,1267,6,8,3,4,1288
E01020628,1365,6,6,1,0,1378
E01020629,1190,4,2,0,1,1197
E01020630,1094,4,3,3,0,1104
E01020631,1339,2,6,0,0,1347
E01020632,1505,5,8,0,0,1518
E01020633,1300,4,0,4,2,1310
E01020634,1305,3,4,1,2,1315
E01020635,1171,4,9,0,0,1184
E01020636,1388,8,5,1,3,1405
E01020637,1389,2,1,0,0,1392
E01020638,1292,3,18,1,1,1315
E01020639,1161,1,1,0,2,1165
E01020640,1851,8,20,1,3,1883
E01020641,1792,9,10,2,1,1814
E01020642,1153,3,3,0,0,1159
E01020643,1760,10,14,3,0,1787
E01020644,1895,7,14,0,3,1919
E01020645,1138,5,7,1,1,1152
E01020646,1288,2,1,1,0,1292
E01020647,1551,5,10,0,1,1567
E01020648,1412,2,11,1,0,1426
E01020649,1217,2,5,2,1,1227
E01020650,1706,4,10,1,1,1722
E01020651,1428,6,24,0,2,1460
E01020652,1604,7,10,0,0,1621
E01020653,1247,6,3,2,2,1260
E01020654,1441,4,7,0,2,1454
E01020655,1660,7,8,2,1,1678
E01020656,1250,3,7,0,2,1262
E01020657,1275,1,6,3,0,1285
E01020658,1452,2,5,1,1,1461
E01020659,1280,4,8,2,0,1294
E01020660,1334,1,2,2,1,1340
E01020661,1534,3,11,1,2,1551
E01020662,1448,4,12,1,2,1467
E01020663,1546,6,5,1,0,1558
E01020664,1218,5,7,0,0,1230
E01020665,1124,4,9,1,1,1139
E01020666,1227,1,7,4,1,1240
E01020667,1333,6,0,0,0,1339
E01020668,1208,1,10,0,0,1219
E01020669,1217,3,5,1,1,1227
E01020670,1300,8,2,0,0,1310
E01020671,1062,3,3,0,0,1068
E01020672,1390,5,0,1,0,1396
E01020673,1355,2,7,3,1,1368
E01020674,1282,1,6,1,0,1290
E01020675,1435,6,1,0,1,1443
E01020676,1276,4,6,1,0,1287
E01020677,1265,5,2,1,0,1273
E01020678,1124,1,2,0,3,1130
E01020679,1278,6,14,0,4,1302
E01020680,1355,4,8,1,4,1372
E01020681,1208,3,8,0,1,1220
E01020682,1629,8,11,2,0,1650
E01020683,1355,3,13,1,1,1373
E01020684,1808,9,38,9,7,1871
E01020685,1374,9,6,5,1,1395
E01020686,1270,7,9,2,5,1293
E01020687,1229,3,3,2,2,1239
E01020688,1196,10,4,1,5,1216
E01020689,1149,7,8,2,6,1172
E01020690,1136,3,7,5,1,1152
E01020691,1096,6,13,2,0,1117
E01020692,1229,4,23,3,2,1261
E01020693,1084,12,37,5,7,1145
E01020694,1191,2,15,0,8,1216
E01020695,1449,3,12,1,0,1465
E01020696,1062,10,11,0,4,1087
E01020697,1207,7,54,1,9,1278
E01020698,1260,2,13,1,0,1276
E01020699,922,2,1,0,5,930
E01020700,1288,3,6,0,0,1297
E01020701,1094,5,17,0,2,1118
E01020702,1767,33,90,19,36,1945
E01020703,1847,50,88,8,13,2006
E01020704,1559,26,61,9,8,1663
E01020705,1221,4,5,3,0,1233
E01020706,1561,4,1,1,0,1567
E01020708,933,11,30,2,8,984
E01020709,2030,66,63,34,13,2206
E01020710,1258,12,46,7,14,1337
E01020711,1380,17,56,4,4,1461
E01020712,1283,21,49,8,9,1370
E01020713,1528,14,89,5,9,1645
E01020714,1317,3,22,0,2,1344
E01020715,1911,7,18,2,0,1938
E01020716,1318,5,6,2,4,1335
E01020717,1402,7,29,1,4,1443
E01020718,1113,7,13,1,5,1139
E01020719,1000,4,14,0,6,1024
E01020720,1121,9,27,6,4,1167
E01020721,966,3,21,2,2,994
E01020722,1604,13,59,8,11,1695
E01020723,1434,22,64,10,16,1546
E01020724,1156,10,41,2,10,1219
E01020725,1227,0,3,0,1,1231
E01020726,1035,1,11,2,0,1049
E01020727,865,5,9,2,1,882
E01020729,1660,8,13,6,0,1687
E01020730,1397,2,7,0,2,1408
E01020731,1192,0,10,0,2,1204
E01020732,1431,6,35,3,4,1479
E01020733,967,4,10,1,1,983
E01020734,956,1,0,0,0,957
E01020735,1156,0,0,0,0,1156
E01020736,960,4,3,0,2,969
E01020737,1179,1,2,1,1,1184
E01020738,888,3,1,2,0,894
E01020739,1088,4,7,0,3,1102
E01020740,1131,4,13,3,0,1151
E01020741,999,6,17,1,1,1024
E01020742,1340,3,11,0,4,1358
E01020743,1006,7,8,1,1,1023
E01020744,843,6,4,2,0,855
E01020745,1090,2,5,2,0,1099
E01020746,998,2,12,0,0,1012
E01020747,964,2,2,0,0,968
E01020748,999,0,11,0,4,1014
E01020749,1238,3,3,1,5,1250
E01020750,1079,0,14,1,0,1094
E01020751,1496,5,6,0,0,1507
E01020752,946,2,2,0,3,953
E01020753,1598,4,4,2,0,1608
E01020754,1115,2,7,0,0,1124
E01020756,1110,3,3,1,0,1117
E01020757,903,4,1,1,1,910
E01020758,1082,7,5,2,0,1096
E01020759,824,5,9,0,1,839
E01020760,1344,5,5,0,0,1354
E01020761,1011,3,13,2,4,1033
E01020762,1089,0,9,1,0,1099
E01020763,1498,4,8,0,1,1511
E01020764,1134,5,3,0,1,1143
E01020765,1331,4,6,2,0,1343
E01020766,1247,6,6,3,0,1262
E01020767,1527,11,35,0,0,1573
E01020768,1255,6,3,0,0,1264
E01020769,974,5,6,0,0,985
E01020770,967,6,1,1,0,975
E01020771,835,5,5,0,0,845
E01020772,1623,15,17,2,3,1660
E01020773,1175,8,4,1,1,1189
E01020775,1361,9,3,2,0,1375
E01020776,1596,6,1,0,1,1604
E01020777,1183,7,6,1,0,1197
E01020778,1015,1,16,1,0,1033
E01020779,1384,4,16,3,2,1409
E01020780,928,8,4,0,2,942
E01020781,967,3,7,0,0,977
E01020782,1047,2,6,1,3,1059
E01020783,1101,7,9,1,2,1120
E01020784,1220,5,10,2,4,1241
E01020786,1384,1,6,0,1,1392
E01020787,1501,5,8,0,1,1515
E01020788,1239,4,12,0,0,1255
E01020789,1181,4,13,1,1,1200
E01020790,1040,7,2,0,0,1049
E01020791,1076,6,4,3,0,1089
E01020792,1199,4,6,1,2,1212
E01020793,1360,5,11,4,0,1380
E01020794,1446,1,7,0,1,1455
E01020795,1400,2,10,0,2,1414
E01020796,1055,2,3,5,2,1067
E01020797,2083,7,15,3,1,2109
E01020798,1249,2,3,1,0,1255
E01020799,1213,5,2,4,0,1224
E01020801,1288,4,6,1,2,1301
E01020802,1701,10,5,4,1,1721
E01020803,1622,13,3,1,5,1644
E01020805,1578,2,1,0,0,1581
E01020806,1153,7,7,0,0,1167
E01020807,1071,5,13,1,5,1095
E01020808,1231,6,4,4,0,1245
E01020809,1158,1,0,0,0,1159
E01020810,1065,10,0,0,0,1075
E01020811,996,6,11,2,0,1015
E01020812,1263,3,5,1,1,1273
E01020813,999,7,4,0,1,1011
E01020814,1166,12,18,3,0,1199
E01020815,1002,0,3,0,0,1005
E01020816,1080,6,12,3,5,1106
E01020817,1106,3,1,0,2,1112
E01020818,1209,3,4,0,0,1216
E01020819,878,4,3,1,2,888
E01020820,1225,1,1,5,0,1232
E01020821,1471,5,8,0,1,1485
E01020822,1555,3,4,2,0,1564
E01020823,1449,7,7,1,2,1466
E01020824,1284,7,7,2,0,1300
E01020825,1303,5,0,1,0,1309
E01020826,1254,4,4,0,0,1262
E01020827,1484,3,5,2,0,1494
E01020828,1398,7,0,1,2,1408
E01020829,1911,14,12,3,5,1945
E01020830,1287,5,2,1,0,1295
E01020831,1176,1,0,1,0,1178
E01020832,1181,7,5,1,1,1195
E01020833,1002,4,2,0,1,1009
E01020834,1027,2,5,1,0,1035
E01020835,1335,3,6,2,1,1347
E01020836,1587,4,5,1,2,1599
E01020837,1470,1,3,0,0,1474
E01020838,1442,3,0,0,0,1445
E01020839,1356,5,8,2,0,1371
E01020840,1266,5,3,0,1,1275
E01020841,1367,4,6,2,0,1379
E01020842,1567,3,10,8,1,1589
E01020843,1328,8,16,0,2,1354
E01020844,1175,7,1,3,1,1187
E01020845,1127,5,5,2,0,1139
E01020846,1056,3,3,4,2,1068
E01020847,1111,8,1,0,0,1120
E01020848,924,4,6,2,3,939
E01020849,997,5,3,1,0,1006
E01020850,1464,3,26,0,0,1493
E01020851,1206,6,9,1,0,1222
E01020852,1370,3,17,0,1,1391
E01020853,1303,2,4,0,0,1309
E01020854,2223,34,27,13,9,2306
E01020855,1025,3,6,0,0,1034
E01020856,1279,6,3,1,1,1290
E01020857,1230,2,0,1,1,1234
E01020858,880,0,1,0,0,881
E01020859,1035,1,6,0,0,1042
E01020860,864,5,2,1,0,872
E01020861,1001,2,3,0,1,1007
E01020862,2018,7,7,3,1,2036
E01020863,1183,1,4,0,0,1188
E01020864,1748,1,6,0,1,1756
E01020865,1133,5,2,0,2,1142
E01020866,862,10,0,0,2,874
E01020867,1810,6,4,3,0,1823
E01020868,1512,7,19,0,3,1541
E01020869,1140,8,8,3,2,1161
E01020870,1174,4,18,1,1,1198
E01020871,1124,4,7,2,1,1138
E01020872,1501,3,7,6,1,1518
E01020873,1152,3,3,2,0,1160
E01020874,1197,4,7,1,1,1210
E01020875,1081,5,2,0,1,1089
E01020876,1389,2,7,1,1,1400
E01020877,1334,9,9,1,0,1353
E01020878,1324,6,9,4,0,1343
E01020879,1773,1,10,0,0,1784
E01020880,1234,14,9,0,0,1257
E01020881,1116,4,20,0,0,1140
E01020882,1209,7,3,0,0,1219
E01020883,1395,2,13,1,2,1413
E01020884,1185,5,0,0,2,1192
E01020885,940,4,7,3,1,955
E01020886,989,9,2,0,1,1001
E01020887,1564,1,1,0,0,1566
E01020888,1595,1,4,1,0,1601
E01020889,1279,4,4,0,0,1287
E01020890,1489,5,3,3,1,1501
E01020891,1390,7,5,2,0,1404
E01020892,900,5,5,0,1,911
E01020893,1398,5,4,1,1,1409
E01020894,963,4,4,0,0,971
E01020895,1193,7,13,1,0,1214
E01020896,1127,4,5,1,0,1137
E01020897,1895,16,15,3,0,1929
E01020898,1188,4,9,0,1,1202
E01020899,1121,2,2,3,0,1128
E01020900,1124,1,4,0,0,1129
E01020901,1182,5,9,1,2,1199
E01020902,1137,5,2,0,0,1144
E01020903,943,5,1,0,0,949
E01020904,1390,3,12,1,5,1411
E01020905,1272,0,5,0,1,1278
E01020906,1366,3,14,0,0,1383
E01020907,1273,3,10,0,6,1292
E01020908,1106,6,5,0,2,1119
E01020909,1204,7,4,0,1,1216
E01020910,1334,27,54,16,11,1442
E01020911,1463,57,145,40,36,1741
E01020912,1562,47,102,29,38,1778
E01020913,1588,21,41,13,10,1673
E01020914,1455,25,47,12,5,1544
E01020915,1324,8,25,16,5,1378
E01020916,1263,21,71,8,10,1373
E01020917,1027,21,34,14,4,1100
E01020918,1124,19,44,15,9,1211
E01020919,1139,7,27,4,1,1178
E01020920,1150,11,15,16,3,1195
E01020921,1214,9,15,8,0,1246
E01020922,1121,13,23,9,4,1170
E01020923,982,11,45,15,5,1058
E01020924,1094,8,22,5,7,1136
E01020925,1112,19,27,9,6,1173
E01020926,1284,10,18,8,1,1321
E01020927,1077,17,27,14,6,1141
E01020928,1333,7,13,5,3,1361
E01020929,1187,15,31,11,13,1257
E01020930,1048,16,20,3,9,1096
E01020931,1639,27,41,13,2,1722
E01020932,1286,10,15,2,4,1317
E01020933,772,8,94,6,6,886
E01020934,1082,19,9,6,7,1123
E01020935,1544,21,64,17,18,1664
E01020936,1514,29,58,18,9,1628
E01020937,1318,16,49,15,6,1404
E01020938,1185,11,23,4,5,1228
E01020939,1181,18,20,3,3,1225
E01020940,1191,11,17,3,5,1227
E01020941,1196,15,33,6,14,1264
E01020942,1208,12,20,4,6,1250
E01020943,1251,19,15,4,2,1291
E01020944,1255,10,29,4,2,1300
E01020945,1504,17,47,9,14,1591
E01020946,1476,4,25,4,8,1517
E01020947,1221,13,23,4,6,1267
E01020948,1083,18,148,20,11,1280
E01020949,1265,18,34,4,4,1325
E01020950,1351,14,24,9,3,1401
E01020951,1171,12,12,6,9,1210
E01020952,1370,16,24,5,6,1421
E01020953,1174,5,24,4,1,1208
E01020954,1321,18,14,3,1,1357
E01020955,1169,9,21,1,2,1202
E01020956,1398,7,19,6,0,1430
E01020957,1164,8,26,4,3,1205
E01020959,1137,6,21,6,2,1172
E01020960,1921,27,56,20,5,2029
E01020961,1201,4,23,11,9,1248
E01020962,1643,9,34,16,5,1707
E01020963,1326,11,29,18,18,1402
E01020964,1384,14,17,12,8,1435
E01020965,1607,17,53,22,4,1703
E01020966,1524,27,39,16,2,1608
E01020967,1600,15,29,12,9,1665
E01020968,1415,26,37,28,11,1517
E01020969,1259,14,20,2,3,1298
E01020970,2079,20,38,6,7,2150
E01020971,1551,14,29,19,9,1622
E01020972,1061,20,22,16,6,1125
E01020973,1294,35,15,7,8,1359
E01020974,1290,7,12,11,0,1320
E01020975,1433,32,19,12,9,1505
E01020976,1506,37,35,30,5,1613
E01020977,1167,23,19,11,9,1229
E01020978,1492,37,68,34,8,1639
E01020979,1489,33,69,20,8,1619
E01020980,1224,28,21,10,9,1292
E01020981,1210,28,18,14,4,1274
E01020982,1264,39,132,42,26,1503
E01020983,1280,45,78,42,18,1463
E01020984,1520,36,85,49,22,1712
E01020985,1402,35,63,28,17,1545
E01020986,1168,20,36,8,7,1239
E01020987,1251,22,98,12,16,1399
E01020988,1420,9,21,5,6,1461
E01020989,1348,30,70,32,15,1495
E01020990,1189,23,42,20,6,1280
E01020991,1070,30,29,14,6,1149
E01020992,1347,32,58,36,16,1489
E01020993,1019,17,8,9,1,1054
E01020994,1064,19,11,11,3,1108
E01020995,1053,18,15,9,2,1097
E01020996,1266,25,25,12,2,1330
E01020997,1232,20,24,9,7,1292
E01020998,1524,28,48,11,3,1614
E01020999,1566,16,42,11,7,1642
E01021000,1127,14,9,12,2,1164
E01021001,942,9,4,6,4,965
E01021002,1145,25,12,12,5,1199
E01021003,1433,17,12,12,11,1485
E01021004,1451,7,11,8,3,1480
E01021005,1170,22,24,9,4,1229
E01021006,1400,18,16,20,6,1460
E01021007,1256,11,6,2,4,1279
E01021008,1287,21,18,5,14,1345
E01021009,1546,7,21,2,11,1587
E01021010,1234,26,25,5,4,1294
E01021011,1141,26,31,10,5,1213
E01021012,1314,29,27,14,9,1393
E01021013,1365,15,14,4,5,1403
E01021014,1333,36,21,11,6,1407
E01021015,1088,13,14,14,5,1134
E01021016,1311,10,31,10,1,1363
E01021017,1246,20,24,11,7,1308
E01021018,1521,16,10,19,6,1572
E01021019,1283,15,22,14,7,1341
E01021020,1351,13,19,7,1,1391
E01021021,1488,12,30,23,6,1559
E01021022,1632,16,9,1,2,1660
E01021023,1560,10,16,1,1,1588
E01021024,954,3,12,5,0,974
E01021025,1440,18,12,4,2,1476
E01021026,1991,17,12,2,4,2026
E01021027,1229,21,16,4,5,1275
E01021028,1216,16,37,3,7,1279
E01021029,1225,8,22,8,7,1270
E01021030,992,15,24,7,5,1043
E01021031,1229,12,37,7,3,1288
E01021032,1653,11,21,6,7,1698
E01021033,1394,14,18,2,1,1429
E01021034,1026,7,19,6,1,1059
E01021035,1427,19,37,3,5,1491
E01021036,1144,14,13,5,1,1177
E01021037,1177,9,30,6,4,1226
E01021038,1370,28,37,13,2,1450
E01021039,1090,19,38,3,2,1152
E01021040,1364,30,32,14,12,1452
E01021041,1188,19,20,9,3,1239
E01021042,1010,6,16,2,2,1036
E01021043,1150,13,17,0,2,1182
E01021044,1356,15,21,4,8,1404
E01021045,1504,8,9,2,1,1524
E01021046,1222,9,9,0,3,1243
E01021047,1164,9,8,3,3,1187
E01021048,1220,15,34,18,7,1294
E01021049,1114,20,7,10,3,1154
E01021050,1028,9,17,0,2,1056
E01021051,970,5,5,7,2,989
E01021052,1038,5,3,0,3,1049
E01021053,952,10,2,1,1,966
E01021054,1199,6,12,0,0,1217
E01021055,1399,12,6,11,2,1430
E01021056,1408,10,16,3,1,1438
E01021057,1231,7,4,6,3,1251
E01021058,1497,11,32,9,5,1554
E01021059,1268,19,16,15,7,1325
E01021060,1286,19,14,9,10,1338
E01021061,1199,13,20,10,5,1247
E01021062,1110,11,27,8,11,1167
E01021063,1337,8,23,19,7,1394
E01021064,1374,14,18,11,3,1420
E01021065,968,12,17,15,2,1014
E01021066,1267,5,24,1,4,1301
E01021067,922,5,18,2,0,947
E01021068,944,5,2,0,3,954
E01021069,1318,9,16,3,3,1349
E01021070,1297,10,41,0,1,1349
E01021071,1443,21,51,6,7,1528
E01021072,1382,6,3,1,1,1393
E01021073,1218,5,10,2,0,1235
E01021074,1350,11,11,1,0,1373
E01021075,1419,3,17,5,1,1445
E01021076,1462,16,14,7,3,1502
E01021077,1259,4,9,6,1,1279
E01021078,1073,13,13,2,0,1101
E01021079,1280,11,39,4,7,1341
E01021080,1176,6,13,5,5,1205
E01021081,1407,7,25,3,1,1443
E01021082,1449,8,12,8,0,1477
E01021083,1159,1,14,4,3,1181
E01021084,1500,7,20,8,1,1536
E01021085,1327,15,16,5,2,1365
E01021086,1386,8,9,4,0,1407
E01021087,1389,11,9,8,4,1421
E01021088,1346,8,4,1,3,1362
E01021089,1248,6,2,1,2,1259
E01021090,1203,26,68,10,6,1313
E01021091,1618,24,23,15,8,1688
E01021092,1681,18,53,17,4,1773
E01021093,1339,10,13,3,4,1369
E01021094,1396,12,14,1,4,1427
E01021095,1152,7,9,7,0,1175
E01021096,1051,9,5,1,0,1066
E01021097,1111,16,15,3,1,1146
E01021098,1415,6,9,2,4,1436
E01021099,1375,8,10,1,2,1396
E01021100,1423,8,13,2,2,1448
E01021101,1460,9,13,3,1,1486
E01021102,1342,5,5,1,2,1355
E01021103,1251,6,6,2,2,1267
E01021104,1106,9,12,2,1,1130
E01021105,990,7,27,17,1,1042
E01021106,1478,10,12,5,2,1507
E01021107,1369,10,8,2,2,1391
E01021108,1209,9,13,0,4,1235
E01021109,1396,13,25,11,9,1454
E01021110,2031,15,11,2,3,2062
E01021111,893,6,8,3,4,914
E01021112,1214,7,29,5,5,1260
E01021113,1062,7,9,13,2,1093
E01021114,1276,3,6,1,2,1288
E01021115,1362,6,13,0,1,1382
E01021116,1274,4,5,0,1,1284
E01021117,1337,17,26,0,2,1382
E01021118,1327,5,11,5,1,1349
E01021119,857,5,9,0,0,871
E01021120,1184,8,21,3,5,1221
E01021121,1348,23,37,5,2,1415
E01021122,1361,10,36,10,7,1424
E01021123,1336,7,12,2,2,1359
E01021124,1452,15,25,5,1,1498
E01021125,1132,10,10,1,4,1157
E01021126,1286,10,28,14,9,1347
E01021127,1243,9,21,5,3,1281
E01021128,1505,11,23,7,1,1547
E01021129,1513,10,16,2,5,1546
E01021130,1211,10,13,0,1,1235
E01021131,1219,13,15,0,3,1250
E01021132,1128,8,16,3,2,1157
E01021133,1298,14,18,2,0,1332
E01021134,1163,6,10,3,1,1183
E01021135,1256,17,21,6,4,1304
E01021136,960,8,3,3,1,975
E01021137,1116,20,12,6,1,1155
E01021138,947,8,4,1,2,962
E01021139,992,4,6,2,1,1005
E01021140,1444,16,6,1,2,1469
E01021141,1179,7,7,4,1,1198
E01021142,1027,3,4,1,0,1035
E01021143,1025,11,6,2,1,1045
E01021144,1425,9,11,2,2,1449
E01021145,1660,3,12,4,2,1681
E01021146,1386,14,7,4,7,1418
E01021147,1339,5,9,0,4,1357
E01021148,1238,13,15,6,4,1276
E01021149,1053,11,18,3,0,1085
E01021150,949,12,15,3,1,980
E01021151,1373,13,14,8,0,1408
E01021152,1265,20,25,7,9,1326
E01021153,1538,10,21,8,0,1577
E01021154,1162,4,18,0,1,1185
E01021155,909,5,7,3,2,926
E01021156,1372,14,23,9,2,1420
E01021157,1453,9,38,1,7,1508
E01021158,1673,12,14,5,13,1717
E01021159,1978,9,28,1,5,2021
E01021160,1394,4,26,6,1,1431
E01021161,1261,13,9,1,0,1284
E01021162,1348,7,16,3,1,1375
E01021163,1806,16,19,10,1,1852
E01021164,1515,6,19,0,6,1546
E01021165,949,9,6,3,2,969
E01021166,1945,13,12,7,1,1978
E01021167,1670,30,46,4,4,1754
E01021168,1347,13,8,4,1,1373
E01021169,1052,10,13,4,3,1082
E01021170,2232,12,7,3,7,2261
E01021171,1581,15,15,0,13,1624
E01021172,1401,4,5,2,4,1416
E01021173,1102,9,4,3,3,1121
E01021174,1295,8,7,4,4,1318
E01021175,1204,5,15,0,0,1224
E01021176,1168,2,20,8,0,1198
E01021177,939,5,26,5,2,977
E01021178,1011,8,20,4,0,1043
E01021179,1136,6,11,5,1,1159
E01021180,1105,2,9,3,1,1120
E01021181,1019,4,11,2,5,1041
E01021182,1286,4,12,2,2,1306
E01021183,946,13,13,7,2,981
E01021184,1254,5,17,2,0,1278
E01021185,1088,14,21,3,4,1130
E01021186,979,1,7,0,3,990
E01021187,1188,9,8,4,3,1212
E01021188,932,5,4,2,2,945
E01021189,1123,4,4,5,0,1136
E01021190,1267,7,3,1,0,1278
E01021191,1367,12,38,5,1,1423
E01021192,1283,1,8,4,0,1296
E01021193,1365,6,17,2,1,1391
E01021194,1232,6,10,2,1,1251
E01021195,1664,7,9,2,0,1682
E01021196,1570,9,9,5,0,1593
E01021197,1518,15,56,11,3,1603
E01021198,1205,8,2,1,2,1218
E01021199,1129,4,5,1,2,1141
E01021200,911,4,9,0,0,924
E01021201,1242,11,9,3,0,1265
E01021202,899,5,22,6,5,937
E01021203,1226,6,7,0,1,1240
E01021204,953,5,4,1,2,965
E01021205,1065,6,3,0,0,1074
E01021206,1229,6,10,1,0,1246
E01021207,1148,4,15,0,2,1169
E01021208,1464,10,12,4,3,1493
E01021209,1327,2,10,3,6,1348
E01021210,1135,10,29,7,5,1186
E01021211,1347,5,16,3,3,1374
E01021212,1564,8,10,3,1,1586
E01021213,1389,10,39,6,1,1445
E01021214,1385,8,6,1,4,1404
E01021215,1079,4,11,4,0,1098
E01021216,993,9,8,0,0,1010
E01021217,1040,3,7,3,5,1058
E01021218,945,5,3,2,2,957
E01021219,1104,5,3,2,0,1114
E01021220,1349,10,38,3,1,1401
E01021221,1001,4,16,3,0,1024
E01021222,1188,8,26,2,2,1226
E01021223,910,5,8,0,1,924
E01021224,1153,8,13,1,0,1175
E01021225,1232,3,19,5,2,1261
E01021226,1022,5,18,0,1,1046
E01021227,1307,11,13,1,2,1334
E01021228,1172,6,13,2,3,1196
E01021229,1323,11,24,2,8,1368
E01021230,1353,10,5,1,2,1371
E01021231,1390,13,19,3,5,1430
E01021232,1389,5,31,3,1,1429
E01021233,1181,10,20,2,0,1213
E01021234,1236,6,3,0,0,1245
E01021235,1170,11,10,1,2,1194
E01021236,1282,5,11,1,0,1299
E01021237,1051,3,35,5,2,1096
E01021238,1065,11,31,5,1,1113
E01021239,1105,7,29,4,0,1145
E01021240,1277,13,40,13,3,1346
E01021241,1182,8,12,24,9,1235
E01021242,980,10,13,7,0,1010
E01021243,1332,8,13,7,7,1367
E01021244,1145,6,33,2,0,1186
E01021245,1113,13,20,12,1,1159
E01021246,1192,10,29,9,1,1241
E01021247,1176,8,27,9,8,1228
E01021248,1104,10,32,5,0,1151
E01021249,1194,14,18,7,5,1238
E01021250,1214,10,27,7,1,1259
E01021251,1224,6,31,2,2,1265
E01021252,1133,7,21,2,5,1168
E01021253,1315,10,40,4,1,1370
E01021254,1150,7,19,10,10,1196
E01021255,1122,12,29,7,3,1173
E01021256,1184,9,16,2,1,1212
E01021257,1218,12,5,13,1,1249
E01021258,1302,10,19,4,3,1338
E01021259,1207,14,22,6,0,1249
E01021260,1785,4,16,13,4,1822
E01021261,1293,9,31,12,2,1347
E01021262,1253,12,21,14,5,1305
E01021263,1357,14,27,37,4,1439
E01021264,1142,5,28,6,0,1181
E01021265,1145,17,26,46,6,1240
E01021266,1240,11,41,26,4,1322
E01021267,1311,12,17,36,1,1377
E01021268,1326,13,21,20,3,1383
E01021269,1184,22,14,61,3,1284
E01021270,1086,16,19,32,7,1160
E01021271,1088,16,54,106,2,1266
E01021272,1173,11,18,21,2,1225
E01021273,1294,17,32,28,3,1374
E01021274,1457,13,48,20,4,1542
E01021275,1292,19,45,44,10,1410
E01021276,1100,11,51,40,7,1209
E01021277,1105,17,19,20,4,1165
E01021278,1247,14,22,36,4,1323
E01021279,1174,28,19,28,5,1254
E01021280,1091,9,49,25,2,1176
E01021281,1195,10,54,17,4,1280
E01021282,1217,9,44,8,2,1280
E01021283,1179,14,32,36,5,1266
E01021284,1125,12,43,20,2,1202
E01021285,997,7,47,7,3,1061
E01021286,1136,25,46,106,16,1329
E01021287,1072,14,72,32,0,1190
E01021288,970,20,25,71,7,1093
E01021289,1255,21,28,54,5,1363
E01021290,1157,20,18,42,4,1241
E01021291,1179,17,87,48,4,1335
E01021292,1114,9,55,27,0,1205
E01021293,1156,10,107,64,3,1340
E01021294,1244,17,51,19,0,1331
E01021295,1239,10,27,46,3,1325
E01021296,1267,17,85,32,5,1406
E01021297,1046,20,191,56,18,1331
E01021298,1190,13,48,21,1,1273
E01021299,1194,13,90,13,2,1312
E01021300,1517,34,39,70,1,1661
E01021301,1069,7,20,41,2,1139
E01021302,1007,18,16,43,2,1086
E01021303,1008,13,20,37,2,1080
E01021304,1100,7,13,40,1,1161
E01021305,1079,6,18,63,1,1167
E01021306,1092,12,18,44,4,1170
E01021307,967,19,29,39,4,1058
E01021308,987,12,14,16,4,1033
E01021309,982,12,22,46,5,1067
E01021310,1088,10,29,50,2,1179
E01021311,1034,9,20,53,3,1119
E01021312,1330,10,6,13,1,1360
E01021313,1216,6,20,22,5,1269
E01021314,969,11,28,39,3,1050
E01021315,1133,12,14,39,5,1203
E01021316,1123,17,34,30,5,1209
E01021317,1091,22,55,69,7,1244
E01021318,1389,23,134,87,3,1636
E01021319,1117,19,75,67,7,1285
E01021320,1138,18,40,88,2,1286
E01021321,1100,23,50,61,6,1240
E01021322,1069,21,15,73,0,1178
E01021323,1130,16,34,85,1,1266
E01021324,1137,22,28,31,4,1222
E01021325,950,26,32,101,10,1119
E01021326,1286,15,22,71,7,1401
E01021327,1253,25,22,37,2,1339
E01021328,1112,12,24,73,9,1230
E01021329,1234,9,31,7,2,1283
E01021330,1260,8,41,18,5,1332
E01021331,1196,8,51,15,1,1271
E01021332,1176,8,15,2,2,1203
E01021333,1288,9,23,14,1,1335
E01021334,1386,10,20,6,1,1423
E01021335,1090,8,28,8,4,1138
E01021336,1322,10,20,16,2,1370
E01021337,1177,8,15,6,1,1207
E01021338,1118,18,13,19,1,1169
E01021339,1093,6,24,17,5,1145
E01021340,1274,16,16,11,1,1318
E01021341,1261,7,16,14,1,1299
E01021342,1232,14,14,13,5,1278
E01021343,1258,6,30,7,2,1303
E01021344,1596,16,37,28,4,1681
E01021345,1379,13,39,16,8,1455
E01021346,1487,20,38,16,9,1570
E01021347,1864,14,7,7,3,1895
E01021348,1263,15,11,6,2,1297
E01021349,1076,14,26,4,1,1121
E01021350,1342,22,35,14,3,1416
E01021351,1121,10,45,15,9,1200
E01021352,1279,9,24,9,1,1322
E01021353,1427,9,20,7,6,1469
E01021354,961,10,18,7,3,999
E01021355,1662,22,17,2,1,1704
E01021356,1159,5,14,3,0,1181
E01021357,1218,10,9,5,3,1245
E01021358,1561,11,47,30,1,1650
E01021359,1583,19,18,11,3,1634
E01021360,1523,7,12,9,2,1553
E01021361,1262,7,10,7,0,1286
E01021362,1176,13,21,5,0,1215
E01021364,1279,9,23,3,3,1317
E01021365,1843,27,34,25,6,1935
E01021366,1216,10,33,1,5,1265
E01021367,1109,9,25,10,3,1156
E01021368,1193,11,29,4,6,1243
E01021369,1954,16,82,36,3,2091
E01021370,1202,10,21,14,3,1250
E01021371,1348,14,20,3,11,1396
E01021372,1405,13,20,14,3,1455
E01021373,1830,27,44,18,3,1922
E01021374,1127,10,27,16,5,1185
E01021375,914,4,9,0,0,927
E01021376,1138,7,9,2,0,1156
E01021377,1410,7,6,2,1,1426
E01021378,1316,7,9,7,1,1340
E01021379,1432,8,6,2,0,1448
E01021380,1886,14,17,8,0,1925
E01021381,989,11,5,1,0,1006
E01021382,1093,4,4,0,0,1101
E01021383,1468,13,29,16,1,1527
E01021384,1673,19,20,4,5,1721
E01021385,938,10,13,4,3,968
E01021386,1188,13,18,4,0,1223
E01021387,1592,14,36,9,4,1655
E01021388,1291,11,8,3,2,1315
E01021389,1361,6,11,1,8,1387
E01021390,1297,5,16,2,2,1322
E01021391,1228,5,9,4,2,1248
E01021392,1379,9,9,4,3,1404
E01021393,1175,7,7,4,4,1197
E01021394,1179,8,19,5,3,1214
E01021395,1181,5,6,4,1,1197
E01021396,1236,9,2,1,1,1249
E01021397,1430,6,9,3,2,1450
E01021398,1252,6,3,4,1,1266
E01021399,1306,3,4,2,5,1320
E01021400,1356,4,18,3,0,1381
E01021401,1221,14,4,2,1,1242
E01021402,1576,11,30,3,2,1622
E01021403,1231,7,4,5,3,1250
E01021404,1727,16,10,1,2,1756
E01021405,1798,10,24,13,3,1848
E01021406,1815,9,1,1,6,1832
E01021407,1750,9,7,1,2,1769
E01021408,1466,11,10,8,1,1496
E01021409,1412,4,4,1,0,1421
E01021410,1283,5,24,1,2,1315
E01021411,1018,2,3,1,0,1024
E01021412,1184,3,4,1,3,1195
E01021413,1058,6,2,2,0,1068
E01021414,1771,6,19,5,1,1802
E01021415,1219,14,29,10,0,1272
E01021416,1356,13,26,7,0,1402
E01021417,1187,19,11,11,1,1229
E01021418,1063,8,9,11,5,1096
E01021419,1315,12,25,9,0,1361
E01021420,1297,10,34,20,3,1364
E01021422,1333,13,12,7,3,1368
E01021423,1078,18,27,20,1,1144
E01021424,1491,15,49,26,5,1586
E01021425,1117,13,7,9,0,1146
E01021426,1014,11,23,5,1,1054
E01021427,1017,23,21,11,1,1073
E01021428,1207,10,10,6,1,1234
E01021429,1015,13,8,10,4,1050
E01021430,1665,13,12,6,3,1699
E01021431,1146,5,52,24,3,1230
E01021432,1186,10,73,22,10,1301
E01021433,1490,22,67,24,6,1609
E01021434,988,13,20,10,5,1036
E01021435,1368,31,60,21,4,1484
E01021436,1725,24,98,42,12,1901
E01021437,1225,22,34,42,8,1331
E01021438,1480,23,91,22,4,1620
E01021439,1725,34,114,37,14,1924
E01021441,1215,8,9,7,2,1241
E01021442,1091,3,11,4,0,1109
E01021443,1205,10,8,10,2,1235
E01021444,1310,7,5,8,1,1331
E01021445,1716,20,20,6,9,1771
E01021446,1273,7,24,2,6,1312
E01021447,1881,17,75,8,14,1995
E01021448,1100,17,18,12,6,1153
E01021449,1214,9,28,30,4,1285
E01021450,1565,12,47,45,3,1672
E01021451,1046,30,40,37,3,1156
E01021452,1182,8,26,7,1,1224
E01021453,950,6,55,10,1,1022
E01021454,974,16,16,13,3,1022
E01021455,1041,2,57,10,6,1116
E01021456,953,6,50,8,0,1017
E01021457,1172,4,4,5,0,1185
E01021458,1342,9,20,5,7,1383
E01021459,1070,5,17,5,2,1099
E01021460,1287,4,32,6,2,1331
E01021461,1103,17,27,19,2,1168
E01021462,1110,13,22,10,1,1156
E01021463,1241,12,27,8,6,1294
E01021464,1271,13,40,10,3,1337
E01021465,1435,17,64,5,13,1534
E01021466,1365,11,46,6,18,1446
E01021467,1302,10,47,13,7,1379
E01021468,1410,22,69,30,3,1534
E01021469,928,5,10,5,1,949
E01021470,862,6,5,4,0,877
E01021471,1287,11,5,7,1,1311
E01021472,1170,31,60,28,13,1302
E01021473,1056,12,51,24,4,1147
E01021474,1228,7,26,7,1,1269
E01021475,1049,16,100,19,8,1192
E01021476,1510,9,40,17,2,1578
E01021477,1251,12,31,3,0,1297
E01021478,1356,13,34,12,8,1423
E01021479,1203,7,15,9,1,1235
E01021480,1429,15,27,10,1,1482
E01021481,1235,5,4,18,3,1265
E01021482,1325,13,18,9,2,1367
E01021483,1394,5,26,15,0,1440
E01021484,1137,6,10,22,1,1176
E01021485,974,8,13,2,3,1000
E01021486,913,5,5,1,4,928
E01021487,1139,9,10,9,5,1172
E01021488,1204,7,5,7,1,1224
E01021489,1194,8,2,4,4,1212
E01021490,1201,20,17,7,13,1258
E01021491,1369,11,3,1,3,1387
E01021492,1411,1,9,11,0,1432
E01021493,1309,7,12,0,0,1328
E01021494,1197,11,11,12,1,1232
E01021495,1844,2,9,3,1,1859
E01021496,1130,6,10,16,0,1162
E01021497,1227,7,7,16,0,1257
E01021498,1290,10,8,4,0,1312
E01021499,1432,11,6,5,3,1457
E01021500,1369,3,6,13,3,1394
E01021501,1172,7,16,14,0,1209
E01021502,1756,11,15,25,3,1810
E01021503,1077,12,11,5,2,1107
E01021504,1144,10,30,12,2,1198
E01021505,1103,5,6,27,5,1146
E01021506,1009,5,8,11,5,1038
E01021507,1168,11,26,21,1,1227
E01021508,968,12,6,8,1,995
E01021509,1151,4,20,6,0,1181
E01021510,1208,7,18,10,0,1243
E01021511,1049,5,35,17,1,1107
E01021512,1268,5,19,6,3,1301
E01021513,1335,5,17,9,0,1366
E01021514,1191,19,7,11,5,1233
E01021515,1049,6,12,4,2,1073
E01021516,1084,12,26,5,5,1132
E01021517,1353,12,12,3,2,1382
E01021518,1568,17,21,9,3,1618
E01021519,1266,9,5,1,2,1283
E01021520,1231,17,22,18,2,1290
E01021521,1161,13,3,10,1,1188
E01021522,1375,16,19,10,5,1425
E01021523,1143,7,28,6,2,1186
E01021524,1322,4,6,6,0,1338
E01021525,1200,16,23,14,1,1254
E01021526,1323,7,8,3,1,1342
E01021527,1357,14,11,8,3,1393
E01021528,1339,4,13,7,4,1367
E01021529,1157,22,27,15,4,1225
E01021530,1186,6,6,3,2,1203
E01021531,1118,4,9,8,3,1142
E01021532,1248,7,4,1,3,1263
E01021533,1812,9,10,6,2,1839
E01021535,1401,7,13,9,7,1437
E01021536,1259,11,26,10,2,1308
E01021537,1532,13,74,16,2,1637
E01021538,1999,22,36,8,4,2069
E01021539,1030,5,10,1,1,1047
E01021540,1243,11,10,8,5,1277
E01021541,1167,5,30,13,4,1219
E01021542,1513,23,85,24,28,1673
E01021543,1363,12,29,3,3,1410
E01021544,1009,6,31,14,1,1061
E01021545,1167,7,36,8,4,1222
E01021546,1097,8,44,8,3,1160
E01021547,1194,23,43,24,5,1289
E01021548,1037,10,34,11,1,1093
E01021550,1129,10,11,1,7,1158
E01021551,1108,4,5,2,1,1120
E01021552,1269,16,13,8,1,1307
E01021553,1076,8,28,13,1,1126
E01021554,1109,11,13,20,4,1157
E01021555,1088,12,8,6,0,1114
E01021556,1226,13,58,19,2,1318
E01021557,992,5,14,7,3,1021
E01021558,1010,9,26,3,3,1051
E01021559,1200,9,16,12,2,1239
E01021560,1339,7,25,14,4,1389
E01021561,1422,10,27,3,15,1477
E01021562,1384,20,22,10,2,1438
E01021563,1243,17,69,33,8,1370
E01021564,1227,10,29,5,1,1272
E01021565,1193,13,18,8,2,1234
E01021566,1342,16,19,12,0,1389
E01021568,1272,5,7,3,12,1299
E01021569,1279,8,15,7,7,1316
E01021570,1544,12,37,5,4,1602
E01021571,1255,5,24,12,8,1304
E01021572,1167,13,20,10,2,1212
E01021573,1213,19,92,42,12,1378
E01021574,1701,53,206,131,26,2117
E01021575,1269,18,88,34,13,1422
E01021576,1055,18,67,12,5,1157
E01021577,1088,7,70,19,4,1188
E01021578,1304,25,65,42,6,1442
E01021579,1173,23,60,24,7,1287
E01021580,1030,21,41,7,5,1104
E01021582,1476,31,67,25,13,1612
E01021583,1135,7,52,20,3,1217
E01021584,965,5,30,5,4,1009
E01021585,993,6,36,5,3,1043
E01021586,1202,9,31,13,1,1256
E01021587,1161,8,45,8,6,1228
E01021588,1051,10,59,13,2,1135
E01021589,1105,8,49,32,3,1197
E01021590,1117,9,49,13,9,1197
E01021591,1163,15,47,17,8,1250
E01021592,1108,13,84,38,1,1244
E01021593,1374,10,9,12,4,1409
E01021594,1358,14,14,6,1,1393
E01021595,1453,6,23,3,2,1487
E01021596,1075,14,69,38,4,1200
E01021597,1063,20,29,32,5,1149
E01021598,1125,13,18,23,2,1181
E01021599,1378,18,54,10,11,1471
E01021600,916,8,33,23,4,984
E01021601,1169,16,42,15,4,1246
E01021602,1385,10,14,6,2,1417
E01021604,1770,9,8,2,2,1791
E01021605,1014,7,9,3,4,1037
E01021606,1334,11,22,15,0,1382
E01021607,1173,10,14,3,2,1202
E01021608,907,4,18,3,2,934
E01021609,1100,7,17,11,2,1137
E01021610,1041,11,17,11,1,1081
E01021611,1143,6,17,0,8,1174
E01021612,1193,8,32,2,5,1240
E01021613,1464,9,13,10,3,1499
E01021614,1394,7,18,6,2,1427
E01021615,1168,7,13,4,1,1193
E01021616,1134,5,28,12,3,1182
E01021617,1071,13,34,7,0,1125
E01021618,1099,15,38,10,7,1169
E01021619,1154,7,49,7,3,1220
E01021620,1124,17,34,22,3,1200
E01021621,1110,14,47,17,4,1192
E01021622,1204,12,25,7,7,1255
E01021623,944,6,38,26,4,1018
E01021624,1010,3,16,6,5,1040
E01021625,1134,12,36,12,3,1197
E01021626,1095,15,24,10,12,1156
E01021627,1230,34,41,57,3,1365
E01021628,1228,25,48,25,0,1326
E01021629,1231,13,47,23,4,1318
E01021631,1356,23,56,20,17,1472
E01021632,1196,14,16,4,0,1230
E01021633,1187,18,20,10,6,1241
E01021634,1226,11,24,3,2,1266
E01021635,1159,18,9,5,2,1193
E01021636,893,13,14,11,2,933
E01021637,919,4,23,14,0,960
E01021638,951,4,22,13,4,994
E01021639,1501,24,30,33,6,1594
E01021640,926,8,13,5,4,956
E01021641,1089,10,21,12,2,1134
E01021642,1400,26,101,28,19,1574
E01021643,1914,8,9,5,1,1937
E01021644,1385,6,6,3,0,1400
E01021645,1209,5,5,3,4,1226
E01021646,1573,38,114,26,19,1770
E01021647,1335,36,79,14,24,1488
E01021648,1780,44,112,42,33,2011
E01021649,1463,48,68,28,38,1645
E01021650,1386,24,151,41,30,1632
E01021651,1124,38,59,19,16,1256
E01021652,1140,20,51,15,13,1239
E01021653,992,9,19,5,8,1033
E01021654,1486,13,24,9,3,1535
E01021655,1122,13,22,7,3,1167
E01021656,1289,6,4,6,1,1306
E01021657,1248,16,14,4,4,1286
E01021658,795,21,18,6,2,842
E01021659,1629,11,27,5,2,1674
E01021660,1177,9,6,1,1,1194
E01021661,1384,18,22,6,1,1431
E01021662,1283,8,6,1,3,1301
E01021663,895,4,9,1,4,913
E01021664,1555,24,42,29,22,1672
E01021665,1036,17,9,16,11,1089
E01021666,1039,11,41,12,11,1114
E01021667,1118,18,27,8,7,1178
E01021668,1186,18,53,33,26,1316
E01021669,1084,20,42,13,12,1171
E01021670,1051,14,68,22,9,1164
E01021671,1131,16,50,12,9,1218
E01021673,1174,8,29,7,22,1240
E01021674,974,11,43,7,3,1038
E01021675,980,1,41,11,4,1037
E01021676,1133,15,49,8,11,1216
E01021677,1005,4,6,1,0,1016
E01021678,1059,12,7,7,0,1085
E01021679,1595,36,151,33,30,1845
E01021680,1974,28,144,29,12,2187
E01021681,1995,27,80,39,16,2157
E01021682,1829,51,188,57,40,2165
E01021683,2041,37,39,67,14,2198
E01021684,1146,15,36,21,7,1225
E01021685,1331,50,70,29,44,1524
E01021686,1331,30,96,20,57,1534
E01021687,1202,26,51,25,12,1316
E01021688,1048,12,33,14,7,1114
E01021689,1155,3,40,6,1,1205
E01021690,1011,5,24,2,3,1045
E01021691,1197,24,35,3,1,1260
E01021692,1195,11,55,1,4,1266
E01021693,1326,16,39,2,2,1385
E01021694,1185,7,14,2,4,1212
E01021695,946,7,12,0,0,965
E01021696,1144,23,52,24,3,1246
E01021697,1229,21,67,16,5,1338
E01021698,1056,36,68,67,19,1246
E01021699,1089,24,80,55,4,1252
E01021700,991,34,61,34,20,1140
E01021702,1006,16,49,17,12,1100
E01021703,850,9,51,5,5,920
E01021704,1140,15,43,18,4,1220
E01021705,1619,17,22,23,2,1683
E01021706,962,18,81,28,59,1148
E01021707,1079,12,38,8,2,1139
E01021708,1189,15,34,8,4,1250
E01021709,1191,10,14,10,6,1231
E01021710,1573,6,37,17,9,1642
E01021711,956,17,12,18,3,1006
E01021713,921,19,22,11,3,976
E01021714,1140,28,75,49,10,1302
E01021715,1087,12,18,22,1,1140
E01021717,1299,15,26,15,24,1379
E01021718,1155,17,39,16,7,1234
E01021719,1211,22,38,5,1,1277
E01021720,1246,13,30,6,7,1302
E01021721,1570,13,25,4,5,1617
E01021722,1305,13,29,5,6,1358
E01021723,1383,8,14,3,1,1409
E01021724,1390,3,8,0,0,1401
E01021725,1110,0,3,0,0,1113
E01021726,1219,4,11,6,5,1245
E01021727,1234,3,3,3,0,1243
E01021728,1318,7,13,3,2,1343
E01021729,1331,10,13,1,2,1357
E01021730,1389,6,29,2,2,1428
E01021731,1212,3,6,4,1,1226
E01021732,1222,4,9,4,1,1240
E01021733,1245,7,5,0,0,1257
E01021734,1195,2,3,2,2,1204
E01021735,1171,4,9,1,1,1186
E01021736,2067,85,624,293,110,3179
E01021737,973,10,33,10,7,1033
E01021738,1647,26,51,4,23,1751
E01021739,1244,7,29,9,15,1304
E01021740,1363,15,37,8,18,1441
E01021741,1590,15,22,6,7,1640
E01021742,922,26,60,22,14,1044
E01021743,1301,24,57,29,13,1424
E01021744,1134,18,77,26,3,1258
E01021745,1086,28,80,35,13,1242
E01021746,1296,21,103,12,19,1451
E01021747,1315,18,79,20,8,1440
E01021748,1233,34,91,20,15,1393
E01021749,1624,24,158,50,25,1881
E01021750,829,6,193,25,8,1061
E01021751,769,7,306,23,15,1120
E01021752,947,22,200,31,26,1226
E01021753,1141,9,7,2,4,1163
E01021754,1238,13,15,6,1,1273
E01021755,926,7,2,1,1,937
E01021756,1160,15,35,7,1,1218
E01021757,1346,19,48,17,5,1435
E01021758,1271,14,40,17,1,1343
E01021759,1125,10,22,13,1,1171
E01021760,1212,21,26,7,1,1267
E01021761,1411,13,44,21,6,1495
E01021762,1082,18,16,12,3,1131
E01021763,1149,26,27,10,4,1216
E01021764,975,24,152,95,9,1255
E01021765,862,37,308,86,29,1322
E01021766,676,23,422,41,49,1211
E01021767,1040,13,336,43,30,1462
E01021768,1681,14,15,13,10,1733
E01021769,1791,8,15,4,1,1819
E01021770,1593,22,20,15,5,1655
E01021771,1083,13,35,46,6,1183
E01021772,1121,9,58,22,9,1219
E01021773,1110,21,34,30,7,1202
E01021774,1054,17,6,28,4,1109
E01021775,1040,22,19,40,6,1127
E01021776,1094,22,35,15,3,1169
E01021777,1052,14,19,26,2,1113
E01021778,1092,13,32,26,5,1168
E01021779,1105,33,51,23,8,1220
E01021780,1002,16,127,5,11,1161
E01021781,1122,16,60,16,10,1224
E01021782,1076,23,56,16,10,1181
E01021783,1165,12,57,23,6,1263
E01021784,1145,26,40,12,4,1227
E01021785,1141,38,41,26,4,1250
E01021786,926,8,53,14,7,1008
E01021787,1214,19,31,16,7,1287
E01021788,1203,19,46,10,11,1289
E01021789,1066,9,166,9,17,1267
E01021790,1014,15,56,20,16,1121
E01021791,1183,18,46,25,10,1282
E01021792,989,11,16,5,8,1029
E01021793,1276,7,15,7,6,1311
E01021794,927,9,16,3,3,958
E01021795,1625,15,20,13,6,1679
E01021796,1722,8,5,6,3,1744
E01021797,1063,9,15,3,2,1092
E01021798,1220,9,22,13,5,1269
E01021799,1274,15,27,9,4,1329
E01021800,1747,14,72,8,13,1854
E01021801,1765,16,25,9,19,1834
E01021802,1681,15,19,12,9,1736
E01021803,1064,9,11,3,6,1093
E01021804,1174,9,25,7,2,1217
E01021805,1003,10,4,3,1,1021
E01021806,1791,21,25,43,15,1895
E01021807,1091,12,28,53,6,1190
E01021808,1104,11,22,32,2,1171
E01021809,1105,15,35,28,3,1186
E01021810,1298,26,57,39,14,1434
E01021811,1007,20,21,43,8,1099
E01021812,1028,13,13,14,0,1068
E01021813,1088,20,23,40,7,1178
E01021814,1187,17,11,40,7,1262
E01021815,1090,13,22,67,13,1205
E01021816,1044,18,13,23,6,1104
E01021817,1754,37,58,73,12,1934
E01021818,1324,30,40,57,9,1460
E01021819,1141,19,36,34,2,1232
E01021820,1110,27,39,22,3,1201
E01021821,999,23,35,31,0,1088
E01021822,1167,23,33,32,7,1262
E01021823,1230,8,37,39,2,1316
E01021824,1126,11,69,25,10,1241
E01021825,1071,21,63,25,11,1191
E01021826,1117,13,71,22,7,1230
E01021827,1160,11,58,44,6,1279
E01021828,1517,15,61,51,12,1656
E01021829,1083,20,24,55,1,1183
E01021830,933,4,43,11,11,1002
E01021831,1029,23,56,40,4,1152
E01021832,935,7,33,36,10,1021
E01021833,953,4,32,16,7,1012
E01021834,1118,15,27,21,3,1184
E01021835,1073,16,41,30,2,1162
E01021836,1021,28,49,46,1,1145
E01021837,1113,11,28,22,4,1178
E01021838,1181,6,26,17,1,1231
E01021839,1036,14,135,45,2,1232
E01021840,1038,18,52,44,4,1156
E01021841,981,13,56,30,4,1084
E01021842,969,16,150,43,7,1185
E01021843,1393,35,206,71,12,1717
E01021844,1017,13,47,13,4,1094
E01021845,1056,14,30,26,3,1129
E01021846,958,16,30,48,5,1057
E01021847,1078,13,44,36,2,1173
E01021848,1162,17,54,37,6,1276
E01021849,1144,20,88,48,1,1301
E01021850,1004,15,49,51,7,1126
E01021851,929,20,147,89,3,1188
E01021852,1113,14,61,37,1,1226
E01021853,1029,5,52,31,2,1119
E01021854,1331,6,23,15,5,1380
E01021855,1054,7,24,20,5,1110
E01021856,1124,16,25,14,2,1181
E01021857,1892,17,74,37,9,2029
E01021858,1091,12,41,35,4,1183
E01021859,963,22,52,81,7,1125
E01021860,1062,17,30,45,4,1158
E01021861,937,9,22,35,4,1007
E01021862,990,13,14,107,3,1127
E01021863,1075,17,29,99,6,1226
E01021864,894,19,58,128,5,1104
E01021865,989,15,32,25,8,1069
E01021866,1041,18,15,14,2,1090
E01021867,1132,12,30,25,0,1199
E01021868,1202,17,17,37,11,1284
E01021869,1009,20,30,34,1,1094
E01021870,987,14,27,27,5,1060
E01021871,1075,12,30,59,8,1184
E01021872,1018,26,232,138,8,1422
E01021873,1122,2,5,0,2,1131
E01021874,1075,8,12,0,0,1095
E01021875,1220,6,9,1,2,1238
E01021878,1189,5,6,4,0,1204
E01021879,1105,6,7,1,3,1122
E01021880,1229,12,8,5,2,1256
E01021881,960,3,7,2,1,973
E01021882,1687,12,10,5,1,1715
E01021883,1287,8,5,3,3,1306
E01021884,1144,3,6,1,0,1154
E01021885,927,8,5,2,1,943
E01021886,1196,7,4,4,0,1211
E01021887,1649,7,12,12,6,1686
E01021888,1533,3,7,11,0,1554
E01021889,1713,10,27,0,1,1751
E01021890,1449,16,20,3,2,1490
E01021891,1303,5,10,2,1,1321
E01021892,811,8,24,1,0,844
E01021893,1176,6,11,2,0,1195
E01021894,961,6,20,1,0,988
E01021895,960,4,10,6,2,982
E01021896,1068,4,11,0,1,1084
E01021897,953,2,14,0,2,971
E01021898,1073,4,6,2,0,1085
E01021899,1080,6,16,1,1,1104
E01021900,857,8,6,3,0,874
E01021901,1541,3,14,4,1,1563
E01021902,1458,12,4,5,4,1483
E01021903,1314,10,9,2,1,1336
E01021904,1136,5,10,3,2,1156
E01021905,995,7,4,4,0,1010
E01021906,1212,6,5,3,3,1229
E01021907,1836,5,5,7,3,1856
E01021908,1635,3,2,2,4,1646
E01021909,1121,3,10,3,1,1138
E01021910,1211,6,3,2,0,1222
E01021911,1050,6,1,2,1,1060
E01021912,1646,13,14,8,1,1682
E01021913,1225,3,4,6,2,1240
E01021914,1670,14,16,8,3,1711
E01021915,1083,7,14,5,4,1113
E01021916,817,2,6,1,1,827
E01021917,1477,14,10,7,1,1509
E01021918,1179,10,7,3,1,1200
E01021919,1078,0,7,1,0,1086
E01021920,1562,7,11,15,3,1598
E01021921,1189,7,13,8,1,1218
E01021922,1256,7,3,1,0,1267
E01021923,1073,15,10,7,0,1105
E01021924,1028,10,6,7,0,1051
E01021925,1291,12,28,10,5,1346
E01021926,1562,16,26,4,4,1612
E01021927,1073,13,15,2,2,1105
E01021928,1280,8,19,16,3,1326
E01021929,1246,14,17,7,0,1284
E01021930,1124,9,10,5,2,1150
E01021931,1116,7,11,5,7,1146
E01021932,1227,6,13,7,1,1254
E01021933,1079,5,15,4,0,1103
E01021934,1132,4,5,3,4,1148
E01021935,1108,7,7,3,1,1126
E01021936,1418,15,8,5,3,1449
E01021937,1299,9,15,5,2,1330
E01021938,1235,7,18,4,0,1264
E01021939,1385,13,6,5,1,1410
E01021940,1677,7,17,5,3,1709
E01021941,1663,12,13,16,1,1705
E01021942,1400,7,13,2,0,1422
E01021943,1488,9,1,2,1,1501
E01021944,1359,0,3,7,1,1370
E01021945,1326,4,9,3,1,1343
E01021946,1269,5,18,7,2,1301
E01021947,995,7,6,1,3,1012
E01021948,1034,12,22,2,1,1071
E01021949,1253,6,8,2,2,1271
E01021950,1186,8,8,9,1,1212
E01021951,997,10,15,6,2,1030
E01021952,1132,15,16,3,2,1168
E01021953,1060,21,8,13,0,1102
E01021954,1174,10,21,11,3,1219
E01021955,1421,12,17,15,1,1466
E01021956,1191,6,13,10,3,1223
E01021957,1173,6,11,2,2,1194
E01021958,958,8,15,3,2,986
E01021959,1238,13,27,9,3,1290
E01021960,1714,21,50,57,14,1856
E01021961,1243,7,2,3,0,1255
E01021962,997,8,15,9,6,1035
E01021963,1079,10,15,5,0,1109
E01021964,1283,9,8,9,1,1310
E01021965,1868,6,27,7,4,1912
E01021966,1404,18,24,11,4,1461
E01021967,1651,6,22,4,1,1684
E01021968,1312,22,23,8,4,1369
E01021969,1067,8,13,5,1,1094
E01021970,1292,14,6,7,5,1324
E01021971,865,6,8,3,1,883
E01021972,1009,7,8,1,5,1030
E01021973,922,6,6,1,1,936
E01021974,956,7,8,2,4,977
E01021975,1172,10,10,3,1,1196
E01021976,1154,12,11,4,7,1188
E01021977,1314,12,27,2,3,1358
E01021978,1829,11,9,4,1,1854
E01021979,1184,8,10,5,0,1207
E01021980,1484,10,7,5,1,1507
E01021981,1384,9,4,5,2,1404
E01021982,1391,9,17,2,3,1422
E01021983,1174,3,1,3,3,1184
E01021984,1766,10,19,2,5,1802
E01021985,1143,6,12,8,1,1170
E01021986,1246,15,14,7,8,1290
E01021987,1041,8,11,5,0,1065
E01021988,1489,24,3,11,1,1528
E01021989,1327,4,1,3,0,1335
E01021990,1400,12,7,1,3,1423
E01021991,843,7,7,0,1,858
E01021992,955,3,2,1,0,961
E01021993,1838,7,10,0,2,1857
E01021994,1008,13,3,3,0,1027
E01021995,1168,7,6,2,0,1183
E01021996,1114,7,7,1,2,1131
E01021997,1048,9,22,6,4,1089
E01021998,1065,13,18,5,0,1101
E01021999,1382,14,1,2,0,1399
E01022000,1246,9,3,2,2,1262
E01022001,1288,22,34,8,4,1356
E01022002,1495,13,22,8,0,1538
E01022004,1394,9,4,4,0,1411
E01022005,1396,11,16,10,0,1433
E01022006,1260,13,13,2,0,1288
E01022007,1275,4,16,7,0,1302
E01022008,1811,5,1,8,1,1826
E01022009,1203,2,6,3,1,1215
E01022010,1307,11,3,5,0,1326
E01022011,1444,9,8,1,1,1463
E01022012,1690,4,23,2,0,1719
E01022013,1294,7,5,2,4,1312
E01022014,1107,5,8,6,6,1132
E01022015,1107,12,12,5,1,1137
E01022016,1495,5,9,2,3,1514
E01022017,1167,3,9,4,2,1185
E01022018,1163,10,8,7,1,1189
E01022019,1228,13,15,9,4,1269
E01022020,1441,11,10,4,3,1469
E01022021,1099,4,7,1,3,1114
E01022022,1125,5,15,3,3,1151
E01022023,1162,4,7,1,1,1175
E01022024,1160,7,6,0,0,1173
E01022025,1372,23,24,10,5,1434
E01022026,1143,26,37,20,9,1235
E01022027,1335,24,22,11,8,1400
E01022028,1073,8,5,2,2,1090
E01022030,1327,12,6,1,2,1348
E01022031,958,11,14,1,1,985
E01022032,1336,7,7,3,1,1354
E01022033,1298,3,6,1,1,1309
E01022034,1347,3,6,0,0,1356
E01022035,1297,6,6,2,2,1313
E01022036,1034,4,13,4,0,1055
E01022037,1305,6,17,6,2,1336
E01022038,1190,10,18,3,2,1223
E01022039,1178,6,16,1,2,1203
E01022040,1478,8,7,4,0,1497
E01022041,1269,3,4,4,1,1281
E01022042,1157,9,2,3,2,1173
E01022043,1387,17,23,5,2,1434
E01022044,1368,7,8,4,0,1387
E01022045,1161,8,1,6,5,1181
E01022046,1343,6,9,3,1,1362
E01022047,1062,7,7,1,0,1077
E01022048,1370,16,18,4,0,1408
E01022049,1205,9,15,4,0,1233
E01022050,1425,20,15,6,0,1466
E01022051,1199,8,6,6,0,1219
E01022052,1170,2,12,1,1,1186
E01022053,1476,13,17,5,2,1513
E01022054,1220,5,25,2,2,1254
E01022055,1124,10,8,1,1,1144
E01022056,1273,13,18,10,2,1316
E01022057,1358,7,12,1,3,1381
E01022058,1341,10,8,4,5,1368
E01022059,1263,8,13,5,2,1291
E01022060,1525,8,22,13,2,1570
E01022061,1171,4,4,2,1,1182
E01022062,1633,11,17,5,3,1669
E01022063,1250,16,14,6,5,1291
E01022064,1415,10,1,4,0,1430
E01022067,1484,13,19,17,6,1539
E01022068,1204,9,22,7,1,1243
E01022069,1272,14,22,9,0,1317
E01022070,1439,15,26,10,5,1495
E01022071,1309,6,16,6,0,1337
E01022072,1465,11,9,3,0,1488
E01022073,1266,4,4,1,2,1277
E01022074,1108,13,44,11,2,1178
E01022075,1423,11,22,2,2,1460
E01022076,1427,14,18,12,2,1473
E01022077,1243,8,13,1,2,1267
E01022078,1166,6,16,3,4,1195
E01022079,1351,14,20,8,9,1402
E01022080,1215,9,58,6,3,1291
E01022081,1790,14,28,4,2,1838
E01022082,1335,20,55,12,7,1429
E01022083,1397,8,22,2,0,1429
E01022084,1274,10,9,0,1,1294
E01022085,1239,24,31,5,1,1300
E01022086,1037,15,23,6,1,1082
E01022087,1403,5,22,10,4,1444
E01022088,1271,4,12,2,6,1295
E01022089,1211,3,7,2,2,1225
E01022090,1754,21,48,8,9,1840
E01022091,1765,21,41,27,5,1859
E01022092,1376,5,18,15,2,1416
E01022093,1392,5,6,8,2,1413
E01022094,1309,12,10,0,0,1331
E01022095,1248,9,6,6,3,1272
E01022096,1455,6,17,7,2,1487
E01022097,1480,11,4,1,1,1497
E01022098,1213,5,6,8,2,1234
E01022099,1774,16,49,23,6,1868
E01022100,1442,15,34,10,0,1501
E01022101,1481,19,37,10,6,1553
E01022102,1476,25,101,23,12,1637
E01022103,1841,22,40,8,7,1918
E01022104,1261,12,26,4,3,1306
E01022105,1113,4,13,2,2,1134
E01022106,1418,12,24,6,2,1462
E01022107,1226,7,14,1,7,1255
E01022108,1426,13,29,1,2,1471
E01022109,1164,6,16,3,0,1189
E01022110,1045,9,17,2,5,1078
E01022111,1097,11,10,6,2,1126
E01022112,1003,4,17,3,1,1028
E01022113,1356,6,13,4,5,1384
E01022114,1249,7,16,1,0,1273
E01022115,1320,23,21,3,8,1375
E01022116,1067,28,71,8,9,1183
E01022117,1548,31,39,20,4,1642
E01022118,1056,10,29,2,2,1099
E01022119,1037,11,20,3,4,1075
E01022120,1147,11,25,5,1,1189
E01022121,1232,17,31,11,5,1296
E01022122,990,11,21,8,1,1031
E01022123,1702,29,93,8,7,1839
E01022124,1112,16,18,10,10,1166
E01022125,1069,12,26,7,7,1121
E01022126,1282,25,45,8,8,1368
E01022127,1298,53,175,35,4,1565
E01022128,1260,5,19,2,0,1286
E01022129,1612,12,23,4,3,1654
E01022130,1244,17,28,3,3,1295
E01022131,977,10,14,6,2,1009
E01022132,1057,17,31,11,3,1119
E01022133,1029,12,36,2,3,1082
E01022134,1257,14,40,6,6,1323
E01022135,1219,17,68,12,1,1317
E01022136,1272,7,29,5,0,1313
E01022137,1447,20,33,19,0,1519
E01022138,1437,11,57,11,1,1517
E01022139,1107,15,29,6,3,1160
E01022140,980,8,27,1,0,1016
E01022141,1190,26,36,7,1,1260
E01022142,1232,21,58,16,4,1331
E01022143,1213,4,21,8,12,1258
E01022144,958,5,13,1,4,981
E01022145,986,3,10,0,0,999
E01022146,1177,3,9,4,4,1197
E01022147,1213,18,19,12,4,1266
E01022148,1248,7,21,9,7,1292
E01022149,1057,14,38,1,3,1113
E01022150,1199,16,38,5,7,1265
E01022151,1417,24,108,8,2,1559
E01022152,857,14,58,11,7,947
E01022153,1342,35,73,22,5,1477
E01022154,1555,35,104,22,14,1730
E01022155,1120,6,104,23,7,1260
E01022156,1200,24,66,9,6,1305
E01022157,1100,16,51,8,4,1179
E01022158,1801,29,135,13,6,1984
E01022159,1055,16,52,18,1,1142
E01022160,1545,26,26,9,4,1610
E01022161,1093,11,17,14,0,1135
E01022162,1276,12,13,3,0,1304
E01022163,1134,11,85,3,5,1238
E01022164,1046,14,44,7,5,1116
E01022165,1240,6,25,4,4,1279
E01022166,1027,5,59,2,2,1095
E01022167,981,1,6,5,2,995
E01022168,879,4,14,3,5,905
E01022169,1154,8,34,4,5,1205
E01022170,1117,11,32,4,4,1168
E01022171,1004,5,45,4,2,1060
E01022172,1226,4,14,1,1,1246
E01022173,1068,9,27,4,1,1109
E01022174,1100,12,10,1,1,1124
E01022175,1579,15,9,7,1,1611
E01022176,1569,11,9,1,2,1592
E01022177,1741,8,17,2,5,1773
E01022178,1079,11,5,2,2,1099
E01022179,1644,8,7,3,0,1662
E01022180,1699,14,13,4,1,1731
E01022181,1382,6,17,2,0,1407
E01022182,1265,6,9,5,1,1286
E01022183,1290,3,12,1,0,1306
E01022184,1247,1,2,2,1,1253
E01022185,1180,5,6,2,0,1193
E01022186,1382,5,3,2,2,1394
E01022187,1547,17,38,4,6,1612
E01022188,1075,2,10,2,1,1090
E01022189,1067,5,18,3,0,1093
E01022190,1097,5,9,2,1,1114
E01022191,1108,3,19,11,2,1143
E01022192,1038,4,11,2,0,1055
E01022193,901,4,9,2,0,916
E01022194,1436,20,41,7,2,1506
E01022195,1413,8,14,13,2,1450
E01022196,1377,8,8,5,1,1399
E01022197,1521,5,8,1,4,1539
E01022198,1020,11,29,17,5,1082
E01022199,1483,11,22,2,2,1520
E01022200,1012,6,21,4,0,1043
E01022201,1480,12,7,2,1,1502
E01022202,871,5,1,1,0,878
E01022203,1216,9,8,1,5,1239
E01022204,1158,4,12,2,0,1176
E01022205,1507,3,13,1,2,1526
E01022206,1552,7,13,1,2,1575
E01022207,1462,5,9,2,1,1479
E01022208,1275,8,9,2,2,1296
E01022209,903,1,3,8,0,915
E01022210,1080,7,19,5,0,1111
E01022211,1550,2,9,2,1,1564
E01022212,1358,4,9,2,0,1373
E01022213,1502,5,7,6,0,1520
E01022214,1620,11,25,2,0,1658
E01022215,1476,16,8,1,0,1501
E01022216,1488,7,9,2,1,1507
E01022217,1051,2,5,0,0,1058
E01022218,1018,5,10,2,0,1035
E01022219,1031,4,4,1,1,1041
E01022220,1342,13,29,5,1,1390
E01022221,1523,9,18,3,3,1556
E01022222,1604,7,20,3,1,1635
E01022223,1919,6,11,1,0,1937
E01022224,1309,8,4,0,1,1322
E01022225,1410,13,24,23,5,1475
E01022226,1237,3,2,0,1,1243
E01022227,1292,6,6,3,3,1310
E01022228,1424,7,5,0,0,1436
E01022229,1332,3,7,2,0,1344
E01022230,1433,8,15,1,1,1458
E01022231,1310,4,0,5,1,1320
E01022232,1226,1,5,4,0,1236
E01022233,1602,2,4,1,1,1610
E01022234,1301,4,6,7,0,1318
E01022235,1469,4,7,6,0,1486
E01022236,1678,2,21,4,0,1705
E01022237,1176,4,11,4,0,1195
E01022238,1000,4,9,2,0,1015
E01022239,1342,2,2,1,1,1348
E01022240,1644,9,23,12,0,1688
E01022241,1366,5,18,2,2,1393
E01022242,1171,2,14,1,0,1188
E01022243,971,3,10,0,1,985
E01022244,1169,5,5,0,1,1180
E01022245,1079,2,6,2,0,1089
E01022246,1049,0,3,1,0,1053
E01022247,2182,17,22,17,3,2241
E01022248,1419,9,5,6,0,1439
E01022249,1626,4,9,4,0,1643
E01022250,1432,5,13,1,0,1451
E01022251,1162,4,2,4,1,1173
E01022252,1432,5,1,1,0,1439
E01022253,1349,8,4,1,0,1362
E01022254,1505,0,8,2,2,1517
E01022255,1248,5,3,0,2,1258
E01022256,1308,5,2,0,3,1318
E01022257,1519,10,3,1,4,1537
E01022258,918,1,6,3,0,928
E01022259,1349,5,7,0,0,1361
E01022260,1481,3,4,1,0,1489
E01022261,1520,14,6,3,0,1543
E01022262,1519,2,10,0,2,1533
E01022263,1534,8,2,3,2,1549
E01022264,1224,5,7,0,0,1236
E01022265,1368,15,8,3,2,1396
E01022266,1176,6,6,0,0,1188
E01022267,1357,8,9,2,3,1379
E01022268,1325,1,1,2,0,1329
E01022269,1594,6,7,1,1,1609
E01022270,1525,2,6,2,0,1535
E01022271,1405,6,6,0,0,1417
E01022272,1115,10,5,6,2,1138
E01022273,962,15,22,35,4,1038
E01022274,981,5,1,4,0,991
E01022275,1293,1,4,6,6,1310
E01022276,1319,8,23,12,3,1365
E01022277,1191,10,19,18,2,1240
E01022278,1175,33,24,42,6,1280
E01022279,1058,30,28,48,1,1165
E01022280,1186,20,36,13,3,1258
E01022281,1374,7,17,16,1,1415
E01022282,1974,30,54,37,7,2102
E01022283,1257,7,13,5,2,1284
E01022284,869,40,44,50,5,1008
E01022285,947,50,18,26,1,1042
E01022286,1123,28,40,37,0,1228
E01022287,1311,23,17,15,4,1370
E01022288,900,41,204,116,8,1269
E01022289,639,39,419,98,14,1209
E01022290,642,35,232,89,6,1004
E01022291,647,45,459,102,20,1273
E01022292,503,39,426,112,6,1086
E01022293,856,42,193,165,9,1265
E01022294,1001,32,70,91,3,1197
E01022295,1133,8,15,7,0,1163
E01022296,1074,10,26,11,1,1122
E01022297,1013,7,23,12,1,1056
E01022298,1235,18,36,29,3,1321
E01022299,1155,12,10,4,0,1181
E01022300,1152,6,10,10,2,1180
E01022301,1123,28,15,34,2,1202
E01022302,1235,15,12,12,1,1275
E01022303,1104,14,19,16,5,1158
E01022304,1287,11,15,15,6,1334
E01022305,1137,13,8,4,1,1163
E01022306,1074,9,16,16,2,1117
E01022307,1197,17,33,16,0,1263
E01022308,1194,8,18,5,2,1227
E01022309,1151,21,75,26,4,1277
E01022310,1384,25,41,21,7,1478
E01022311,1386,27,122,63,13,1611
E01022312,1699,41,187,62,10,1999
E01022313,1286,19,34,12,0,1351
E01022314,1200,9,33,4,1,1247
E01022315,1211,4,27,16,1,1259
E01022316,1238,15,20,10,6,1289
E01022317,1213,5,27,6,7,1258
E01022318,1462,10,16,11,4,1503
E01022319,971,32,12,60,2,1077
E01022320,1150,29,22,30,2,1233
E01022321,1085,17,41,52,2,1197
E01022322,980,22,18,46,0,1066
E01022323,1130,53,29,60,8,1280
E01022324,1083,30,19,50,1,1183
E01022325,1057,11,32,22,0,1122
E01022326,933,25,25,23,3,1009
E01022327,1180,22,34,38,0,1274
E01022328,904,39,25,68,3,1039
E01022329,1016,37,39,69,1,1162
E01022330,1020,23,28,38,6,1115
E01022331,993,26,19,29,1,1068
E01022332,1126,25,129,61,3,1344
E01022333,971,42,14,72,1,1100
E01022334,1248,18,18,36,1,1321
E01022335,1179,14,19,6,0,1218
E01022336,929,8,6,10,0,953
E01022338,995,16,14,20,2,1047
E01022339,1249,13,30,9,2,1303
E01022340,1099,12,12,24,1,1148
E01022341,1660,33,24,32,5,1754
E01022342,1247,14,20,10,3,1294
E01022343,1082,22,25,30,1,1160
E01022344,1207,11,8,14,2,1242
E01022345,1196,10,20,8,4,1238
E01022346,1086,28,13,37,2,1166
E01022347,1329,39,86,73,6,1533
E01022348,1940,40,56,49,6,2091
E01022350,1750,4,3,0,2,1759
E01022351,1165,2,2,2,3,1174
E01022352,1104,10,10,0,1,1125
E01022353,1172,6,8,0,2,1188
E01022354,1798,7,11,2,0,1818
E01022355,1297,5,10,2,1,1315
E01022356,1780,20,16,6,3,1825
E01022357,1447,5,5,4,1,1462
E01022358,1240,8,10,5,3,1266
E01022359,1215,8,13,1,0,1237
E01022360,1154,7,5,0,0,1166
E01022361,1033,8,2,4,1,1048
E01022362,970,8,2,2,1,983
E01022363,1430,10,2,3,5,1450
E01022364,897,6,0,2,1,906
E01022365,1763,25,19,8,2,1817
E01022366,1329,8,13,2,0,1352
E01022367,1316,6,1,0,1,1324
E01022368,1167,3,4,3,2,1179
E01022369,1276,4,2,4,2,1288
E01022370,1008,10,6,0,1,1025
E01022371,894,1,2,1,0,898
E01022372,1414,8,12,13,0,1447
E01022373,1346,11,11,4,1,1373
E01022374,1590,17,8,10,3,1628
E01022375,918,5,8,1,1,933
E01022376,1461,7,12,0,1,1481
E01022377,1760,15,8,6,1,1790
E01022378,1442,13,5,3,2,1465
E01022379,1132,14,14,12,0,1172
E01022380,1224,3,3,3,1,1234
E01022381,1605,6,10,1,2,1624
E01022382,1321,8,10,2,0,1341
E01022383,1079,7,6,1,2,1095
E01022384,1197,3,6,1,1,1208
E01022385,1280,12,11,3,2,1308
E01022386,1394,10,5,3,3,1415
E01022387,1273,14,22,2,0,1311
E01022388,1340,9,12,4,1,1366
E01022389,1411,13,10,4,1,1439
E01022390,989,5,7,1,0,1002
E01022391,1217,2,3,1,1,1224
E01022392,1278,8,7,0,1,1294
E01022393,1196,6,5,1,1,1209
E01022394,1206,17,11,7,2,1243
E01022395,1241,14,7,2,6,1270
E01022396,1387,4,3,3,2,1399
E01022397,1505,8,4,1,1,1519
E01022398,931,3,9,1,1,945
E01022399,1662,14,9,15,8,1708
E01022400,1460,11,18,6,1,1496
E01022401,1122,9,11,2,1,1145
E01022402,1263,12,6,5,0,1286
E01022403,1111,4,4,3,2,1124
E01022404,1120,16,23,6,0,1165
E01022405,1146,1,6,1,0,1154
E01022406,1008,14,2,1,0,1025
E01022407,1129,2,2,1,0,1134
E01022408,856,9,5,0,1,871
E01022409,997,6,3,0,1,1007
E01022410,1704,21,18,6,9,1758
E01022411,1785,10,22,8,1,1826
E01022412,2287,18,23,12,2,2342
E01022413,1541,5,6,1,1,1554
E01022414,1931,30,27,14,2,2004
E01022415,1313,9,7,2,1,1332
E01022416,1129,5,2,1,2,1139
E01022417,1399,3,14,2,2,1420
E01022418,1391,1,23,1,5,1421
E01022420,1811,9,8,1,1,1830
E01022421,1392,6,28,6,3,1435
E01022422,1286,10,13,4,0,1313
E01022423,1562,13,23,9,5,1612
E01022424,1286,13,9,10,2,1320
E01022425,978,8,8,3,2,999
E01022426,1226,5,6,5,2,1244
E01022427,1181,4,11,6,1,1203
E01022428,1357,20,32,10,5,1424
E01022429,1259,7,11,5,1,1283
E01022430,1214,3,2,4,1,1224
E01022431,1617,14,25,7,1,1664
E01022432,1649,5,38,4,0,1696
E01022433,1634,14,23,2,1,1674
E01022434,1733,10,12,1,7,1763
E01022435,1805,17,28,3,1,1854
E01022436,1575,6,16,7,0,1604
E01022437,1117,5,15,3,2,1142
E01022438,1061,9,18,4,3,1095
E01022439,1180,7,26,1,1,1215
E01022440,1291,10,10,2,3,1316
E01022441,1284,7,10,0,3,1304
E01022442,1280,8,9,0,0,1297
E01022443,1105,3,6,1,1,1116
E01022444,1235,4,15,1,2,1257
E01022445,1142,5,5,0,0,1152
E01022446,1350,3,19,13,2,1387
E01022447,1055,28,34,27,11,1155
E01022448,1097,2,12,7,0,1118
E01022449,1637,2,8,0,2,1649
E01022450,1628,15,14,10,4,1671
E01022451,1212,7,6,0,2,1227
E01022452,1113,2,14,2,0,1131
E01022453,1324,9,13,0,0,1346
E01022454,1579,8,25,2,2,1616
E01022455,1660,6,11,3,1,1681
E01022456,1041,8,11,1,0,1061
E01022457,1126,8,3,2,1,1140
E01022458,1063,13,18,1,0,1095
E01022459,1318,10,10,2,2,1342
E01022460,1432,7,13,1,0,1453
E01022461,1161,6,6,0,0,1173
E01022462,1408,8,7,0,3,1426
E01022463,1272,1,6,3,1,1283
E01022464,1284,4,18,2,0,1308
E01022465,1240,6,5,1,1,1253
E01022466,1397,6,3,1,0,1407
E01022467,1321,18,23,11,3,1376
E01022468,1453,13,24,7,2,1499
E01022469,1218,12,33,7,0,1270
E01022470,1446,14,47,13,2,1522
E01022471,1157,13,51,10,0,1231
E01022472,1000,8,5,0,2,1015
E01022473,1003,4,14,0,1,1022
E01022474,1048,23,57,27,1,1156
E01022475,1248,10,49,20,10,1337
E01022476,1328,19,61,14,7,1429
E01022477,1012,12,52,11,4,1091
E01022478,1047,19,33,23,3,1125
E01022479,1049,9,21,18,3,1100
E01022480,955,11,37,6,6,1015
E01022481,1334,9,128,13,7,1491
E01022482,1043,24,173,22,20,1282
E01022484,923,12,51,18,1,1005
E01022485,832,11,31,11,5,890
E01022486,1429,29,47,16,5,1526
E01022487,909,12,23,10,2,956
E01022488,889,6,3,3,2,903
E01022489,1136,6,7,1,2,1152
E01022490,1346,15,26,7,1,1395
E01022491,1365,15,24,6,4,1414
E01022492,1292,4,11,4,3,1314
E01022493,1050,6,6,6,0,1068
E01022494,1741,28,78,31,11,1889
E01022495,1067,12,56,19,3,1157
E01022496,1763,22,61,12,7,1865
E01022497,1036,12,42,8,4,1102
E01022498,1138,9,60,14,6,1227
E01022499,1169,7,13,5,0,1194
E01022500,1082,7,14,3,1,1107
E01022502,1140,19,97,17,7,1280
E01022503,1095,18,41,4,14,1172
E01022504,1187,4,68,11,6,1276
E01022505,1167,12,60,20,3,1262
E01022506,992,7,45,7,1,1052
E01022507,1195,10,61,11,5,1282
E01022509,1024,6,49,19,1,1099
E01022510,1163,21,53,11,4,1252
E01022511,923,14,22,6,3,968
E01022512,988,11,38,3,1,1041
E01022513,1237,4,11,3,6,1261
E01022514,1208,13,13,0,2,1236
E01022515,1177,4,18,8,2,1209
E01022516,1198,10,38,5,3,1254
E01022517,1020,6,14,2,1,1043
E01022518,1489,15,35,7,0,1546
E01022519,997,8,32,6,1,1044
E01022520,1341,5,8,3,4,1361
E01022521,1347,7,30,5,2,1391
E01022522,1241,18,4,8,2,1273
E01022523,1388,13,119,48,9,1577
E01022524,1300,18,138,50,5,1511
E01022525,1256,23,69,15,6,1369
E01022526,1203,17,81,19,4,1324
E01022527,1138,17,99,28,8,1290
E01022528,1023,5,3,5,2,1038
E01022529,1224,6,11,6,4,1251
E01022530,1062,7,5,1,0,1075
E01022531,1218,4,10,6,1,1239
E01022532,1064,5,8,2,5,1084
E01022533,1386,12,14,3,1,1416
E01022534,1332,5,11,5,1,1354
E01022535,1252,5,28,1,0,1286
E01022536,1086,7,17,4,1,1115
E01022537,1084,7,9,0,3,1103
E01022539,840,11,76,11,0,938
E01022540,1245,28,103,52,5,1433
E01022542,835,12,72,17,2,938
E01022543,1084,26,76,54,2,1242
E01022546,1115,8,17,3,1,1144
E01022547,1361,8,14,3,2,1388
E01022548,1073,18,38,10,3,1142
E01022549,1239,12,43,19,2,1315
E01022550,1274,19,20,34,0,1347
E01022551,1180,16,58,13,10,1277
E01022552,1106,27,38,9,2,1182
E01022553,1185,2,8,3,2,1200
E01022554,1325,7,7,6,1,1346
E01022555,1188,4,22,6,0,1220
E01022556,1240,6,14,4,3,1267
E01022557,1195,15,16,6,2,1234
E01022558,987,4,13,4,0,1008
E01022559,1028,14,14,2,1,1059
E01022560,936,4,10,6,0,956
E01022561,1170,2,7,6,0,1185
E01022562,1063,6,13,2,2,1086
E01022563,1446,11,12,6,1,1476
E01022564,1411,10,13,3,0,1437
E01022565,1308,8,9,1,1,1327
E01022566,993,8,26,22,0,1049
E01022567,909,18,29,15,2,973
E01022568,1043,16,39,24,6,1128
E01022569,993,10,17,8,2,1030
E01022570,1209,16,53,24,8,1310
E01022571,953,9,7,3,5,977
E01022572,995,7,12,8,3,1025
E01022573,1989,16,30,6,11,2052
E01022574,1106,11,30,3,11,1161
E01022575,1069,7,46,3,2,1127
E01022576,1199,16,40,1,12,1268
E01022577,1201,5,26,8,6,1246
E01022578,2358,18,24,10,4,2414
E01022579,874,3,24,3,1,905
E01022580,995,11,44,3,1,1054
E01022581,1180,6,33,10,3,1232
E01022582,1139,10,5,2,0,1156
E01022583,1326,9,19,12,1,1367
E01022584,1363,11,24,10,2,1410
E01022585,1299,8,16,3,1,1327
E01022586,1331,16,20,7,2,1376
E01022587,1333,18,17,7,0,1375
E01022588,1309,4,16,0,3,1332
E01022589,1399,6,16,0,2,1423
E01022590,1223,7,8,1,1,1240
E01022591,1949,16,12,5,1,1983
E01022592,1843,13,13,3,11,1883
E01022593,1033,3,10,0,1,1047
E01022594,1146,2,9,0,0,1157
E01022595,1517,11,18,0,2,1548
E01022596,1137,9,14,1,4,1165
E01022597,2119,28,22,2,4,2175
E01022599,1039,19,13,2,3,1076
E01022600,1242,14,11,1,2,1270
E01022601,1177,14,4,0,4,1199
E01022602,1055,10,18,3,4,1090
E01022603,1039,9,38,12,4,1102
E01022604,959,4,10,4,1,978
E01022605,1299,16,13,11,1,1340
E01022606,1959,8,11,2,6,1986
E01022607,974,4,15,1,0,994
E01022608,1081,4,9,0,1,1095
E01022610,1117,4,20,2,3,1146
E01022611,1199,6,23,0,4,1232
E01022613,1064,11,17,3,9,1104
E01022614,892,6,7,5,2,912
E01022615,2184,17,32,14,5,2252
E01022616,1300,13,29,21,0,1363
E01022617,1233,18,34,6,0,1291
E01022618,1509,12,9,6,2,1538
E01022619,1049,12,24,6,2,1093
E01022620,890,14,15,1,1,921
E01022621,1064,5,9,3,4,1085
E01022622,1057,9,8,5,0,1079
E01022623,1746,13,19,6,1,1785
E01022624,1885,15,26,6,1,1933
E01022625,2133,15,23,2,5,2178
E01022627,1779,18,8,3,1,1809
E01022628,944,11,2,0,7,964
E01022629,1206,7,7,0,0,1220
E01022630,1845,13,12,4,1,1875
E01022631,992,13,12,2,2,1021
E01022632,945,3,2,1,1,952
E01022633,1055,7,54,3,4,1123
E01022634,793,13,65,16,0,887
E01022635,1044,15,30,12,5,1106
E01022636,999,8,32,12,2,1053
E01022639,1247,23,55,46,6,1377
E01022640,1045,16,24,8,3,1096
E01022641,964,10,13,8,5,1000
E01022642,842,8,17,8,1,876
E01022643,1299,3,19,4,4,1329
E01022644,995,1,18,5,3,1022
E01022645,987,5,18,3,1,1014
E01022646,1229,7,10,1,3,1250
E01022647,1244,8,13,1,4,1270
E01022648,1079,11,11,4,2,1107
E01022649,1183,10,13,4,2,1212
E01022650,913,8,16,0,6,943
E01022651,1450,17,29,4,0,1500
E01022652,1386,25,32,2,1,1446
E01022653,1232,4,10,5,6,1257
E01022654,1065,12,15,2,3,1097
E01022655,1056,5,15,2,0,1078
E01022656,1193,10,7,6,4,1220
E01022657,1323,8,15,11,1,1358
E01022658,1374,7,8,4,1,1394
E01022659,1210,10,41,9,25,1295
E01022660,1168,14,50,4,12,1248
E01022661,1409,8,43,4,2,1466
E01022662,1082,12,43,2,3,1142
E01022663,1217,17,69,1,16,1320
E01022664,1194,11,50,4,3,1262
E01022665,1211,8,47,1,6,1273
E01022666,1530,21,115,20,59,1745
E01022667,1160,9,54,5,2,1230
E01022668,1786,33,171,27,7,2024
E01022669,1243,29,124,29,9,1434
E01022670,1115,23,34,21,18,1211
E01022671,1171,20,40,5,6,1242
E01022672,1197,20,65,1,7,1290
E01022673,1563,27,52,14,11,1667
E01022674,1233,16,84,9,14,1356
E01022675,1132,6,46,7,4,1195
E01022676,1245,12,29,10,2,1298
E01022677,1515,25,35,11,7,1593
E01022678,1392,20,50,8,1,1471
E01022679,1351,16,48,15,7,1437
E01022680,1250,13,46,5,1,1315
E01022681,1169,23,52,3,4,1251
E01022682,1136,4,9,2,2,1153
E01022683,1088,4,6,3,1,1102
E01022684,1203,10,7,1,1,1222
E01022685,984,8,14,2,2,1010
E01022686,1247,8,20,2,3,1280
E01022687,1318,2,21,7,1,1349
E01022688,1825,11,11,9,2,1858
E01022689,1268,7,6,1,2,1284
E01022690,1489,16,22,7,2,1536
E01022691,1115,11,52,1,4,1183
E01022692,1927,19,72,15,2,2035
E01022693,1059,13,50,5,2,1129
E01022694,1290,5,20,5,2,1322
E01022695,1075,11,14,1,0,1101
E01022696,1264,5,18,0,4,1291
E01022697,1303,7,9,0,0,1319
E01022698,1323,6,27,8,1,1365
E01022699,1203,5,22,7,1,1238
E01022700,1180,13,43,3,2,1241
E01022701,891,7,13,2,3,916
E01022702,983,15,26,7,2,1033
E01022703,1171,5,31,7,0,1214
E01022704,1379,12,50,12,7,1460
E01022705,1278,12,36,1,9,1336
E01022706,1281,13,66,0,7,1367
E01022707,1458,14,79,7,8,1566
E01022708,1276,12,92,12,18,1410
E01022709,1330,11,33,10,19,1403
E01022710,1673,21,39,10,0,1743
E01022711,1333,20,17,5,2,1377
E01022712,1285,18,11,6,0,1320
E01022713,1416,12,21,6,3,1458
E01022714,1389,3,28,1,5,1426
E01022715,1258,9,57,6,2,1332
E01022716,1180,27,67,8,3,1285
E01022717,914,16,63,3,11,1007
E01022718,1115,19,58,8,10,1210
E01022719,1311,3,19,4,2,1339
E01022720,1109,3,42,4,3,1161
E01022721,1141,12,22,2,4,1181
E01022722,1341,23,20,4,5,1393
E01022723,1163,26,47,6,8,1250
E01022724,1100,11,20,4,4,1139
E01022725,1113,5,16,2,2,1138
E01022726,1193,9,31,4,3,1240
E01022727,1284,6,17,1,0,1308
E01022728,1386,12,45,11,1,1455
E01022729,899,7,15,0,3,924
E01022730,1222,5,11,5,0,1243
E01022731,1060,7,14,1,1,1083
E01022732,1143,16,14,7,6,1186
E01022733,1343,18,34,2,5,1402
E01022734,1040,13,14,9,6,1082
E01022735,1141,9,23,5,0,1178
E01022736,1252,10,12,2,5,1281
E01022737,1235,9,39,12,8,1303
E01022738,819,8,6,1,1,835
E01022739,1163,10,42,3,5,1223
E01022740,1427,7,12,1,3,1450
E01022741,972,8,23,5,1,1009
E01022742,1554,4,28,5,1,1592
E01022743,1537,13,34,2,2,1588
E01022744,1148,8,11,4,2,1173
E01022745,1268,11,13,5,2,1299
E01022746,1327,10,16,1,1,1355
E01022747,1030,7,7,5,1,1050
E01022748,1186,8,3,1,2,1200
E01022749,1078,10,25,3,0,1116
E01022750,1204,29,20,1,4,1258
E01022751,1278,3,6,1,3,1291
E01022752,1147,10,10,3,0,1170
E01022753,966,12,28,3,1,1010
E01022754,1364,8,33,7,3,1415
E01022755,1201,7,12,3,0,1223
E01022756,1072,3,8,0,4,1087
E01022757,1226,8,24,2,1,1261
E01022758,1241,13,21,6,0,1281
E01022759,1279,7,4,1,2,1293
E01022760,1253,14,9,2,0,1278
E01022761,1246,6,5,2,1,1260
E01022762,1220,15,21,2,1,1259
E01022763,1322,5,28,3,4,1362
E01022764,1356,4,11,1,0,1372
E01022765,1411,6,14,1,3,1435
E01022766,1131,5,16,2,3,1157
E01022767,998,10,15,0,3,1026
E01022768,1148,5,11,4,2,1170
E01022769,1014,6,21,1,2,1044
E01022770,1454,7,12,0,1,1474
E01022771,1150,10,16,4,10,1190
E01022772,1580,14,29,3,2,1628
E01022773,1273,9,12,6,2,1302
E01022774,1501,18,45,7,2,1573
E01022776,1279,10,14,1,1,1305
E01022777,1386,6,10,2,1,1405
E01022778,1259,5,16,1,2,1283
E01022780,1131,17,18,13,2,1181
E01022781,1058,6,5,2,5,1076
E01022782,1196,5,14,6,1,1222
E01022783,1255,15,24,3,2,1299
E01022784,1094,8,23,2,4,1131
E01022785,1202,8,9,2,1,1222
E01022786,1278,7,17,5,0,1307
E01022787,1058,6,30,1,5,1100
E01022788,969,7,14,4,0,994
E01022789,1170,8,14,5,1,1198
E01022790,1404,18,16,10,3,1451
E01022791,1688,21,23,39,1,1772
E01022792,1204,9,14,3,1,1231
E01022793,1403,11,20,6,4,1444
E01022794,1207,7,11,1,1,1227
E01022795,1240,3,23,4,3,1273
E01022796,1055,6,18,2,2,1083
E01022797,968,3,3,4,1,979
E01022798,967,10,37,46,4,1064
E01022799,1151,9,12,3,0,1175
E01022800,1304,8,8,1,0,1321
E01022801,1182,5,3,9,3,1202
E01022802,1220,3,10,3,1,1237
E01022803,1229,10,35,7,0,1281
E01022804,1319,11,4,2,0,1336
E01022805,1173,8,19,10,0,1210
E01022806,1173,9,20,2,0,1204
E01022807,1247,31,13,2,1,1294
E01022810,1219,30,54,8,7,1318
E01022811,1748,15,18,15,9,1805
E01022812,1001,5,10,0,0,1016
E01022813,1113,5,2,2,0,1122
E01022814,1358,4,21,5,1,1389
E01022815,1231,5,25,0,2,1263
E01022816,1166,6,8,1,0,1181
E01022817,1360,18,22,1,1,1402
E01022818,1103,9,13,1,3,1129
E01022819,1118,9,4,16,6,1153
E01022820,1113,3,18,21,4,1159
E01022823,1258,2,7,4,1,1272
E01022824,2082,21,63,10,3,2179
E01022825,1141,5,7,0,3,1156
E01022826,1274,8,9,5,3,1299
E01022828,1168,9,14,3,2,1196
E01022829,1659,7,9,7,10,1692
E01022830,1193,5,13,3,1,1215
E01022831,1152,4,17,0,3,1176
E01022832,1238,18,17,5,1,1279
E01022833,1390,19,12,13,7,1441
E01022834,1112,2,9,6,7,1136
E01022835,1144,5,33,3,1,1186
E01022836,1237,4,5,4,0,1250
E01022837,1299,18,11,2,2,1332
E01022838,1045,7,10,1,0,1063
E01022839,1116,6,15,2,3,1142
E01022840,1227,13,21,7,1,1269
E01022841,1093,14,13,43,1,1164
E01022842,1061,16,27,73,3,1180
E01022843,1175,6,13,9,4,1207
E01022845,1152,13,10,3,6,1184
E01022846,902,20,59,32,17,1030
E01022847,1338,12,57,12,4,1423
E01022848,1213,14,49,21,3,1300
E01022849,1303,12,16,6,2,1339
E01022850,1200,7,26,2,3,1238
E01022851,1306,15,29,4,3,1357
E01022852,1346,17,25,9,5,1402
E01022853,1320,17,20,3,3,1363
E01022854,1281,8,9,4,3,1305
E01022855,959,6,7,5,1,978
E01022856,1193,16,15,2,3,1229
E01022857,903,16,48,17,10,994
E01022858,859,10,8,0,3,880
E01022859,1260,11,17,5,1,1294
E01022860,1598,18,60,2,4,1682
E01022861,1315,17,37,7,1,1377
E01022862,1446,25,124,11,12,1618
E01022863,1238,8,19,2,5,1272
E01022864,1128,16,26,4,11,1185
E01022865,1291,16,14,2,3,1326
E01022867,1091,20,77,6,8,1202
E01022868,1351,10,23,4,3,1391
E01022869,1148,5,18,5,3,1179
E01022870,1168,9,20,3,2,1202
E01022871,1031,17,36,8,5,1097
E01022872,1345,15,50,9,8,1427
E01022873,1424,26,26,8,3,1487
E01022874,1009,11,63,7,3,1093
E01022875,1011,26,39,16,4,1096
E01022876,1029,18,21,10,4,1082
E01022877,1128,8,28,8,3,1175
E01022878,1388,15,19,1,1,1424
E01022879,1373,16,16,4,6,1415
E01022880,1207,12,11,1,2,1233
E01022881,1720,24,56,6,8,1814
E01022882,1172,8,16,5,1,1202
E01022883,1047,13,16,1,0,1077
E01022884,1254,19,38,9,3,1323
E01022885,1096,15,24,9,3,1147
E01022887,1174,21,20,5,2,1222
E01022888,1357,11,20,6,1,1395
E01022889,1170,9,9,5,1,1194
E01022890,1147,14,38,3,2,1204
E01022891,1359,13,34,0,2,1408
E01022892,1543,12,17,7,0,1579
E01022893,1237,12,20,0,2,1271
E01022894,1161,18,16,3,3,1201
E01022895,1438,7,31,3,4,1483
E01022896,1297,6,17,7,6,1333
E01022897,1312,13,30,9,2,1366
E01022898,1199,8,15,6,2,1230
E01022899,1069,9,10,2,2,1092
E01022900,1391,16,18,7,4,1436
E01022901,1257,6,18,1,3,1285
E01022902,1154,12,3,4,2,1175
E01022903,1341,22,7,11,2,1383
E01022904,1533,12,20,9,4,1578
E01022905,1316,16,23,7,2,1364
E01022906,1087,6,0,5,1,1099
E01022907,1263,8,18,5,4,1298
E01022908,1142,7,8,1,1,1159
E01022909,1271,23,29,8,1,1332
E01022910,1136,14,35,5,6,1196
E01022911,1232,5,18,0,4,1259
E01022913,1016,4,4,7,1,1032
E01022914,1007,3,6,5,1,1022
E01022915,1093,12,3,8,3,1119
E01022916,1208,5,7,4,0,1224
E01022917,966,13,2,2,1,984
E01022918,1269,3,4,3,1,1280
E01022919,1315,5,8,4,1,1333
E01022920,1277,10,12,3,2,1304
E01022921,1270,12,16,3,1,1302
E01022922,1168,11,31,2,3,1215
E01022924,1322,30,20,1,0,1373
E01022925,1124,4,13,0,0,1141
E01022926,1217,7,13,0,5,1242
E01022927,1394,3,14,0,2,1413
E01022928,1521,10,12,5,1,1549
E01022929,1358,10,19,3,1,1391
E01022930,1456,6,13,0,1,1476
E01022931,1346,7,27,3,1,1384
E01022933,1196,13,11,8,2,1230
E01022934,1379,9,14,4,5,1411
E01022935,1226,9,9,8,0,1252
E01022936,1276,18,22,5,4,1325
E01022937,1182,6,13,2,3,1206
E01022938,1267,5,4,0,0,1276
E01022939,1356,9,7,3,1,1376
E01022940,1304,14,11,1,0,1330
E01022941,1308,13,6,9,0,1336
E01022942,1318,13,27,4,3,1365
E01022943,1259,9,11,2,1,1282
E01022944,1098,8,14,1,0,1121
E01022945,1909,12,13,3,3,1940
E01022946,1495,14,17,1,0,1527
E01022947,1341,9,8,9,4,1371
E01022948,1309,11,9,3,2,1334
E01022949,1230,5,17,3,4,1259
E01022950,1219,14,16,8,3,1260
E01022951,1142,12,6,4,0,1164
E01022952,1218,10,6,5,2,1241
E01022953,1653,19,44,3,4,1723
E01022954,1291,7,30,3,3,1334
E01022955,1174,7,3,4,7,1195
E01022956,899,10,16,0,5,930
E01022957,1032,9,11,0,1,1053
E01022958,1194,11,12,2,4,1223
E01022959,1063,12,20,1,2,1098
E01022960,1023,23,38,17,3,1104
E01022961,1010,7,23,2,0,1042
E01022962,1164,14,24,6,0,1208
E01022963,1171,14,29,6,1,1221
E01022964,1056,11,21,2,4,1094
E01022965,1103,5,21,4,1,1134
E01022966,986,7,3,3,2,1001
E01022967,871,8,11,2,0,892
E01022968,1019,16,6,5,1,1047
E01022969,1202,14,18,9,4,1247
E01022970,1329,8,11,1,3,1352
E01022971,1261,14,25,2,5,1307
E01022972,1292,8,16,2,1,1319
E01022973,1566,12,53,10,5,1646
E01022974,1184,8,20,1,2,1215
E01022975,1327,3,16,2,0,1348
E01022976,1245,6,15,0,3,1269
E01022977,1233,5,8,1,4,1251
E01022978,1306,6,4,0,1,1317
E01022979,1064,7,2,2,1,1076
E01022980,1341,5,14,2,2,1364
E01022981,1748,21,13,2,4,1788
E01022982,1665,6,16,5,3,1695
E01022983,1469,8,12,1,0,1490
E01022984,1333,7,8,1,3,1352
E01022985,1004,6,6,7,1,1024
E01022986,1238,2,17,4,2,1263
E01022987,1787,9,22,1,0,1819
E01022988,1230,8,15,2,1,1256
E01022989,1456,6,15,5,7,1489
E01022990,1257,7,3,2,1,1270
E01022991,1755,14,20,9,5,1803
E01022992,997,4,6,0,0,1007
E01022993,1164,3,10,1,1,1179
E01022994,1302,14,7,5,1,1329
E01022995,1161,7,8,1,1,1178
E01022996,1025,7,6,3,1,1042
E01022997,1163,12,5,1,0,1181
E01022998,1475,3,18,5,4,1505
E01022999,1784,5,8,2,1,1800
E01023000,1463,9,24,4,4,1504
E01023001,1427,19,28,1,3,1478
E01023002,1345,13,11,2,1,1372
E01023003,1479,8,7,2,2,1498
E01023004,1488,6,9,6,3,1512
E01023005,1283,6,6,0,0,1295
E01023006,1040,5,6,1,0,1052
E01023007,949,7,6,3,2,967
E01023008,1328,15,19,4,22,1388
E01023009,1200,2,14,7,1,1224
E01023010,1150,10,10,10,2,1182
E01023011,1198,1,11,0,3,1213
E01023012,1169,2,4,0,1,1176
E01023013,1231,6,3,0,2,1242
E01023014,1390,7,7,3,4,1411
E01023015,1171,6,19,13,9,1218
E01023016,1203,5,3,0,3,1214
E01023017,1523,14,12,4,1,1554
E01023018,1165,9,13,10,2,1199
E01023019,1128,7,22,3,3,1163
E01023020,1212,5,5,1,2,1225
E01023021,1245,2,4,1,1,1253
E01023022,1494,11,14,1,2,1522
E01023023,1433,2,6,0,2,1443
E01023024,1262,11,0,0,1,1274
E01023025,1170,3,1,1,0,1175
E01023026,940,4,8,1,1,954
E01023027,1147,8,3,6,8,1172
E01023028,1575,14,19,7,7,1622
E01023029,1160,6,1,6,11,1184
E01023030,1017,13,9,2,1,1042
E01023031,1064,9,6,1,1,1081
E01023032,1078,10,6,1,3,1098
E01023033,1009,9,1,4,0,1023
E01023034,1448,5,10,1,0,1464
E01023035,1433,5,3,5,2,1448
E01023036,1725,5,2,5,1,1738
E01023037,1524,14,7,8,6,1559
E01023038,1232,5,13,1,3,1254
E01023039,1206,3,5,2,2,1218
E01023040,1240,4,10,2,2,1258
E01023041,1314,1,7,4,2,1328
E01023042,1346,10,13,5,5,1379
E01023043,1429,9,11,3,3,1455
E01023044,987,3,5,1,0,996
E01023045,1322,10,5,3,3,1343
E01023046,1172,16,33,9,1,1231
E01023047,1032,4,11,21,7,1075
E01023048,1071,6,7,8,8,1100
E01023049,1251,6,20,37,5,1319
E01023050,1269,14,34,51,15,1383
E01023051,1297,11,11,2,1,1322
E01023052,1501,4,10,0,4,1519
E01023053,1488,5,12,0,1,1506
E01023054,1507,11,37,10,9,1574
E01023055,934,8,18,4,3,967
E01023056,1307,9,17,4,4,1341
E01023057,1435,10,69,9,14,1537
E01023058,1136,9,5,0,0,1150
E01023059,1450,6,14,1,5,1476
E01023060,1165,3,4,0,0,1172
E01023061,1193,8,13,0,0,1214
E01023062,1201,4,9,0,3,1217
E01023063,1031,7,10,1,1,1050
E01023064,1081,7,4,2,1,1095
E01023065,1311,10,8,2,4,1335
E01023066,1344,11,7,1,1,1364
E01023067,1182,5,6,3,3,1199
E01023068,1038,8,10,2,2,1060
E01023069,1267,8,6,1,0,1282
E01023070,1471,15,19,4,11,1520
E01023071,1115,1,18,3,4,1141
E01023072,1044,6,7,7,0,1064
E01023073,1100,10,14,3,0,1127
E01023074,1203,7,17,8,1,1236
E01023075,946,14,2,3,2,967
E01023076,1218,12,6,3,5,1244
E01023077,1170,9,36,9,0,1224
E01023078,1205,6,5,1,0,1217
E01023079,1353,12,20,3,0,1388
E01023080,1072,10,24,6,1,1113
E01023081,1469,12,30,7,1,1519
E01023082,1148,8,16,4,2,1178
E01023083,1181,8,15,5,5,1214
E01023084,1250,2,15,5,1,1273
E01023085,1184,14,11,1,0,1210
E01023086,1224,12,13,1,1,1251
E01023087,1154,10,9,4,0,1177
E01023088,1280,14,8,0,6,1308
E01023089,1283,5,17,3,0,1308
E01023090,1457,12,21,9,0,1499
E01023091,1066,29,137,41,12,1285
E01023092,1063,8,52,6,2,1131
E01023093,1063,10,34,10,2,1119
E01023094,1016,19,57,13,0,1105
E01023095,1212,17,144,13,16,1402
E01023096,1539,13,159,22,16,1749
E01023097,1098,19,66,9,4,1196
E01023098,1174,17,100,7,5,1303
E01023099,1205,15,90,15,6,1331
E01023100,827,19,83,34,0,963
E01023101,1008,11,34,14,2,1069
E01023102,1060,8,47,9,3,1127
E01023103,1184,8,117,9,10,1328
E01023104,1022,26,243,17,9,1317
E01023105,986,26,211,24,9,1256
E01023106,891,10,258,15,4,1178
E01023107,1089,11,32,16,6,1154
E01023108,1054,12,31,7,7,1111
E01023109,1127,26,61,17,7,1238
E01023110,1325,11,45,21,7,1409
E01023111,1388,29,84,15,5,1521
E01023112,933,12,29,8,2,984
E01023113,1213,27,64,19,9,1332
E01023114,1016,18,44,13,7,1098
E01023115,999,12,70,5,8,1094
E01023116,1109,28,310,19,16,1482
E01023117,1394,17,30,10,2,1453
E01023118,1050,22,292,28,16,1408
E01023119,721,17,194,20,22,974
E01023120,934,43,357,26,18,1378
E01023121,1447,34,110,13,15,1619
E01023122,854,19,267,23,10,1173
E01023123,1087,13,57,20,4,1181
E01023124,889,23,99,11,3,1025
E01023125,1717,21,67,35,12,1852
E01023128,967,23,120,14,6,1130
E01023129,881,16,129,31,1,1058
E01023130,1088,10,43,8,3,1152
E01023131,1103,14,77,9,7,1210
E01023132,1172,10,70,7,2,1261
E01023133,973,23,51,12,4,1063
E01023134,1339,18,91,4,2,1454
E01023135,1679,13,80,25,10,1807
E01023136,1152,32,122,28,8,1342
E01023137,932,18,64,10,4,1028
E01023138,1041,30,47,21,4,1143
E01023139,968,22,36,15,5,1046
E01023140,807,30,210,80,18,1145
E01023141,1855,51,395,172,34,2507
E01023142,859,24,500,127,31,1541
E01023143,1056,29,149,81,14,1329
E01023144,811,26,475,61,33,1406
E01023145,1210,35,370,44,20,1679
E01023146,864,21,179,12,3,1079
E01023147,1088,11,97,15,4,1215
E01023148,1042,15,111,21,0,1189
E01023149,1026,10,62,7,0,1105
E01023150,1243,8,27,5,2,1285
E01023151,1167,16,54,7,6,1250
E01023152,1451,7,11,5,1,1475
E01023153,1254,16,17,8,5,1300
E01023154,1199,32,22,14,3,1270
E01023155,2099,28,16,13,11,2167
E01023156,945,26,13,12,7,1003
E01023157,1017,19,18,11,1,1066
E01023158,1820,10,35,1,9,1875
E01023159,1857,16,5,1,0,1879
E01023160,1208,5,3,0,3,1219
E01023162,1449,14,26,3,6,1498
E01023163,1375,5,15,0,3,1398
E01023164,1318,9,18,3,3,1351
E01023165,1679,11,11,1,1,1703
E01023166,1201,12,8,3,0,1224
E01023167,1334,11,4,2,1,1352
E01023168,1251,8,3,2,1,1265
E01023169,1646,9,12,2,3,1672
E01023170,1348,12,17,1,10,1388
E01023171,1146,21,193,5,35,1400
E01023172,1246,7,19,3,2,1277
E01023173,1209,7,31,4,5,1256
E01023174,1378,4,26,4,2,1414
E01023175,1315,8,7,2,6,1338
E01023176,1316,6,18,10,0,1350
E01023177,1731,12,19,5,2,1769
E01023178,1784,6,15,5,2,1812
E01023179,1359,10,34,8,0,1411
E01023180,1302,14,27,6,0,1349
E01023181,1035,8,29,5,4,1081
E01023182,1202,15,18,7,2,1244
E01023183,1114,17,38,4,3,1176
E01023184,1071,8,6,4,1,1090
E01023185,980,4,4,1,0,989
E01023186,1321,6,23,8,0,1358
E01023187,1317,15,29,12,1,1374
E01023188,1037,13,10,3,2,1065
E01023189,1220,26,50,7,1,1304
E01023190,1005,15,22,10,5,1057
E01023191,1482,8,21,6,8,1525
E01023192,1355,24,34,1,16,1430
E01023193,1320,7,16,0,3,1346
E01023194,1309,10,13,1,0,1333
E01023195,1607,23,25,10,8,1673
E01023196,1365,15,17,4,2,1403
E01023197,1141,7,6,7,0,1161
E01023198,1180,5,8,5,0,1198
E01023199,1325,14,19,3,3,1364
E01023200,1249,8,21,1,5,1284
E01023201,1284,18,19,13,1,1335
E01023202,1425,20,23,18,22,1508
E01023203,1234,18,39,8,2,1301
E01023204,1287,14,40,13,6,1360
E01023205,931,8,10,4,2,955
E01023206,953,3,12,3,2,973
E01023207,1251,5,12,4,2,1274
E01023208,916,11,13,4,0,944
E01023209,1091,9,24,4,2,1130
E01023210,1048,6,90,10,12,1166
E01023211,1188,20,99,5,25,1337
E01023212,1170,6,41,0,6,1223
E01023213,963,6,69,4,10,1052
E01023214,1023,7,39,4,4,1077
E01023215,1240,17,24,8,6,1295
E01023216,1435,11,61,15,10,1532
E01023217,1292,10,8,5,2,1317
E01023218,1220,14,13,3,3,1253
E01023219,1152,11,22,2,3,1190
E01023220,1577,14,12,1,1,1605
E01023221,1399,7,12,4,1,1423
E01023222,1268,7,23,0,0,1298
E01023223,1157,10,6,1,1,1175
E01023224,1196,9,13,4,1,1223
E01023225,1739,14,18,3,0,1774
E01023226,1223,12,16,1,2,1254
E01023227,1449,15,22,3,3,1492
E01023228,1616,15,20,2,2,1655
E01023229,1541,14,18,4,5,1582
E01023230,1654,13,40,7,7,1721
E01023231,1408,4,12,2,8,1434
E01023232,1537,8,10,4,4,1563
E01023233,1205,3,4,1,1,1214
E01023234,1227,11,18,4,5,1265
E01023235,1640,8,12,3,2,1665
E01023236,1496,19,18,3,4,1540
E01023237,984,6,14,0,3,1007
E01023238,1216,12,14,21,0,1263
E01023239,1283,10,20,8,1,1322
E01023240,1664,20,83,3,7,1777
E01023241,1163,4,11,6,2,1186
E01023242,937,21,22,2,0,982
E01023243,1016,13,40,11,6,1086
E01023244,1286,7,18,1,0,1312
E01023245,1960,9,14,2,1,1986
E01023246,1170,14,11,1,4,1200
E01023247,1219,17,29,4,4,1273
E01023248,1329,15,29,6,4,1383
E01023249,952,19,32,4,0,1007
E01023250,1298,8,59,12,2,1379
E01023251,990,14,28,2,5,1039
E01023252,1443,33,102,15,10,1603
E01023253,1334,9,18,2,1,1364
E01023254,1390,11,30,12,6,1449
E01023255,1373,21,151,12,7,1564
E01023256,1076,12,37,4,2,1131
E01023257,1212,16,32,5,6,1271
E01023258,1086,16,60,9,4,1175
E01023259,1154,13,34,3,9,1213
E01023260,1266,17,68,10,4,1365
E01023261,1289,22,32,14,1,1358
E01023262,1249,8,25,4,10,1296
E01023263,1110,26,36,6,8,1186
E01023264,1335,37,66,7,10,1455
E01023265,1449,19,21,8,8,1505
E01023266,1200,22,43,12,4,1281
E01023267,1009,14,43,6,7,1079
E01023268,951,17,30,6,3,1007
E01023269,1856,30,119,11,7,2023
E01023270,1175,27,27,17,5,1251
E01023271,972,1,17,7,0,997
E01023272,1000,8,7,1,2,1018
E01023273,1168,4,13,1,1,1187
E01023274,1546,9,20,8,5,1588
E01023275,1157,7,6,0,0,1170
E01023276,1211,8,17,8,2,1246
E01023277,1021,6,15,1,2,1045
E01023278,1301,14,6,2,0,1323
E01023279,1199,9,3,0,0,1211
E01023280,1209,4,23,0,2,1238
E01023281,1429,10,14,3,5,1461
E01023282,1509,11,13,2,0,1535
E01023284,2122,34,53,6,6,2221
E01023285,1245,7,6,8,3,1269
E01023286,1158,5,3,5,1,1172
E01023287,2133,13,68,19,8,2241
E01023288,1080,4,11,4,3,1102
E01023289,1127,12,37,13,5,1194
E01023290,1279,9,25,18,4,1335
E01023291,1267,12,20,13,1,1313
E01023292,1192,12,17,9,14,1244
E01023293,1282,18,17,25,11,1353
E01023294,1146,18,20,39,12,1235
E01023295,1082,11,26,40,13,1172
E01023296,1222,20,36,45,10,1333
E01023297,998,22,24,32,8,1084
E01023298,1251,10,15,33,2,1311
E01023299,1226,17,48,56,9,1356
E01023300,948,25,27,101,15,1116
E01023301,1127,26,26,75,9,1263
E01023302,1134,16,27,43,22,1242
E01023303,1071,30,34,84,11,1230
E01023304,1157,20,17,49,17,1260
E01023305,951,11,40,40,21,1063
E01023306,1142,19,20,39,12,1232
E01023307,1134,11,44,35,16,1240
E01023308,1333,17,21,26,5,1402
E01023309,1371,10,9,23,9,1422
E01023310,1417,27,60,92,18,1614
E01023311,1290,25,38,32,10,1395
E01023312,1184,22,78,35,25,1344
E01023313,1315,15,21,14,5,1370
E01023314,994,13,44,28,16,1095
E01023315,1208,20,87,35,19,1369
E01023316,1144,10,7,5,0,1166
E01023317,1838,21,32,27,6,1924
E01023318,1246,12,23,18,4,1303
E01023319,1302,18,6,9,2,1337
E01023320,1550,20,25,22,5,1622
E01023321,1573,14,29,18,5,1639
E01023322,1349,16,20,13,1,1399
E01023323,1273,14,15,20,7,1329
E01023324,1065,10,17,36,9,1137
E01023325,1079,5,35,27,8,1154
E01023326,1165,20,36,52,10,1283
E01023327,1031,16,27,15,6,1095
E01023328,1036,7,16,18,1,1078
E01023329,999,12,14,11,5,1041
E01023330,1083,9,13,22,9,1136
E01023331,1157,10,24,13,5,1209
E01023332,1432,28,43,136,30,1669
E01023333,1252,42,74,97,4,1469
E01023334,1305,15,48,47,4,1419
E01023335,1204,28,48,118,21,1419
E01023336,1193,51,49,265,30,1588
E01023337,996,36,55,216,36,1339
E01023338,1349,39,52,237,24,1701
E01023339,987,25,34,111,22,1179
E01023340,1280,28,26,31,7,1372
E01023341,1386,24,18,33,7,1468
E01023342,1769,35,65,133,14,2016
E01023343,1232,28,13,83,10,1366
E01023344,1319,13,19,39,16,1406
E01023345,1170,17,63,16,3,1269
E01023346,915,20,47,30,1,1013
E01023347,1023,15,50,14,4,1106
E01023348,1192,12,78,33,1,1316
E01023349,1315,27,97,46,6,1491
E01023350,1184,19,55,23,6,1287
E01023351,1126,25,84,28,2,1265
E01023352,1904,13,31,6,5,1959
E01023354,1286,22,43,5,7,1363
E01023355,1236,3,19,1,4,1263
E01023356,886,9,13,3,1,912
E01023357,1077,14,156,46,6,1299
E01023358,823,19,208,39,2,1091
E01023359,1143,25,159,32,6,1365
E01023360,1011,13,72,23,2,1121
E01023361,1362,31,57,9,3,1462
E01023362,1404,11,23,2,3,1443
E01023363,1155,13,29,4,2,1203
E01023364,1004,11,17,1,4,1037
E01023365,1011,9,25,3,1,1049
E01023366,1152,11,14,4,7,1188
E01023367,885,7,6,2,2,902
E01023368,1237,16,29,2,9,1293
E01023369,1085,12,22,7,4,1130
E01023370,1222,20,44,3,3,1292
E01023371,1076,4,40,2,1,1123
E01023372,1123,9,17,2,3,1154
E01023373,1236,88,123,204,20,1671
E01023374,1107,13,28,1,1,1150
E01023375,1221,12,4,3,1,1241
E01023376,974,8,9,2,4,997
E01023377,959,7,9,5,2,982
E01023378,1231,23,70,17,4,1345
E01023379,1254,18,36,5,0,1313
E01023380,897,8,16,5,5,931
E01023381,1070,5,18,1,2,1096
E01023382,1090,14,61,9,4,1178
E01023383,1115,15,43,14,4,1191
E01023384,1414,9,50,27,3,1503
E01023385,1318,12,47,17,4,1398
E01023386,1062,9,98,46,4,1219
E01023387,889,22,109,34,3,1057
E01023388,1112,27,105,20,8,1272
E01023389,1247,17,54,30,6,1354
E01023390,1520,21,40,26,3,1610
E01023391,1202,24,77,20,0,1323
E01023392,1224,14,38,12,5,1293
E01023393,1249,22,73,61,5,1410
E01023394,950,12,64,52,5,1083
E01023395,1089,16,80,56,3,1244
E01023396,1105,14,54,70,11,1254
E01023397,920,16,50,32,1,1019
E01023398,1622,34,210,89,12,1967
E01023399,1265,35,46,22,0,1368
E01023400,1409,28,72,38,10,1557
E01023401,1249,26,95,54,6,1430
E01023402,1071,15,99,80,6,1271
E01023403,1112,18,72,48,2,1252
E01023404,852,23,66,29,9,979
E01023405,958,16,99,61,10,1144
E01023406,1498,21,44,13,2,1578
E01023407,1241,20,36,16,9,1322
E01023408,1228,16,40,7,6,1297
E01023409,1059,24,90,26,7,1206
E01023410,1107,9,42,10,1,1169
E01023411,1060,7,70,19,3,1159
E01023412,1020,11,55,7,2,1095
E01023413,924,15,68,26,5,1038
E01023414,978,16,121,23,6,1144
E01023415,994,18,78,14,4,1108
E01023416,1158,11,26,7,7,1209
E01023417,1046,14,26,8,9,1103
E01023418,1101,15,19,3,2,1140
E01023419,1585,9,26,10,3,1633
E01023420,1197,15,19,1,3,1235
E01023421,1145,13,30,0,9,1197
E01023422,1006,7,7,1,1,1022
E01023423,1089,9,8,7,1,1114
E01023424,1069,8,10,8,1,1096
E01023425,1035,14,6,3,1,1059
E01023426,1188,20,25,9,0,1242
E01023427,1207,9,47,22,3,1288
E01023428,1129,14,54,16,2,1215
E01023429,1373,10,45,24,8,1460
E01023430,936,11,16,6,1,970
E01023431,1039,14,8,6,1,1068
E01023432,1114,10,6,9,1,1140
E01023433,1142,14,18,12,2,1188
E01023434,1069,7,85,69,4,1234
E01023435,981,26,138,72,6,1223
E01023436,861,16,69,38,6,990
E01023437,956,29,79,77,11,1152
E01023438,1067,14,25,21,7,1134
E01023439,1035,13,34,4,3,1089
E01023440,1292,16,30,9,5,1352
E01023441,1003,27,53,21,1,1105
E01023442,1465,33,84,38,5,1625
E01023443,1181,22,32,8,7,1250
E01023444,1237,6,31,14,7,1295
E01023445,1322,11,30,10,7,1380
E01023446,1682,30,77,36,13,1838
E01023447,897,20,15,3,2,937
E01023448,1101,13,33,6,6,1159
E01023449,1246,13,19,6,5,1289
E01023450,1568,19,50,17,9,1663
E01023451,1696,24,29,18,4,1771
E01023452,980,6,29,7,6,1028
E01023453,1042,14,56,15,2,1129
E01023454,974,14,27,8,1,1024
E01023455,1046,12,12,4,2,1076
E01023456,1056,9,24,8,4,1101
E01023457,1122,14,47,10,4,1197
E01023458,1013,13,25,8,7,1066
E01023459,1077,11,51,2,3,1144
E01023460,1089,10,26,13,6,1144
E01023461,1053,10,52,7,1,1123
E01023462,1054,4,2,0,2,1062
E01023463,967,4,4,1,4,980
E01023464,1670,11,17,5,2,1705
E01023465,1140,9,14,0,0,1163
E01023466,1414,10,17,3,7,1451
E01023467,1954,12,4,7,3,1980
E01023468,1061,19,8,1,3,1092
E01023469,1180,8,4,2,1,1195
E01023470,1451,13,29,5,7,1505
E01023471,1053,9,11,4,4,1081
E01023472,1027,14,10,8,1,1060
E01023473,1165,6,10,4,2,1187
E01023474,1186,10,8,2,0,1206
E01023475,1107,5,26,17,5,1160
E01023476,1149,6,30,3,4,1192
E01023477,1582,28,68,12,8,1698
E01023478,1382,16,56,12,5,1471
E01023479,1244,7,38,11,2,1302
E01023480,1277,8,6,3,0,1294
E01023481,1178,21,34,19,3,1255
E01023482,1350,10,30,4,10,1404
E01023483,1446,21,29,8,2,1506
E01023484,1121,24,19,13,1,1178
E01023485,1826,19,23,5,2,1875
E01023486,1976,17,32,7,3,2035
E01023487,1054,9,15,12,1,1091
E01023488,1139,13,16,23,0,1191
E01023489,1053,12,20,8,1,1094
E01023490,937,11,8,4,3,963
E01023491,1000,5,10,4,2,1021
E01023492,1186,11,16,9,4,1226
E01023493,1854,21,27,4,7,1913
E01023494,964,6,3,6,2,981
E01023495,1020,2,1,6,1,1030
E01023496,1008,15,13,7,5,1048
E01023497,1234,17,2,0,5,1258
E01023498,2064,18,19,8,6,2115
E01023499,1360,7,30,17,5,1419
E01023500,1349,11,54,16,3,1433
E01023501,1216,9,14,6,3,1248
E01023502,1361,11,26,5,1,1404
E01023503,1398,10,21,9,4,1442
E01023504,1044,13,20,4,0,1081
E01023505,1366,9,21,10,1,1407
E01023506,1116,4,13,3,1,1137
E01023507,1255,16,37,7,3,1318
E01023508,1164,5,9,6,1,1185
E01023509,1049,8,5,3,3,1068
E01023510,1198,10,24,9,1,1242
E01023511,1217,22,51,15,5,1310
E01023512,1442,15,41,21,9,1528
E01023513,1139,12,27,6,1,1185
E01023514,1428,23,66,18,9,1544
E01023515,1211,10,29,14,4,1268
E01023516,1650,13,29,8,2,1702
E01023517,1238,9,24,4,4,1279
E01023518,1494,19,34,24,9,1580
E01023519,1280,17,26,7,3,1333
E01023520,1257,6,16,6,3,1288
E01023523,1175,20,122,19,11,1347
E01023524,1072,16,53,14,10,1165
E01023525,1253,23,77,8,13,1374
E01023526,1273,25,88,11,21,1418
E01023527,1019,18,66,16,14,1133
E01023528,1175,20,74,50,9,1328
E01023529,972,24,65,77,14,1152
E01023530,732,36,86,97,13,964
E01023531,1322,26,74,76,17,1515
E01023532,1095,21,108,46,28,1298
E01023533,986,29,78,104,11,1208
E01023534,1137,22,64,86,10,1319
E01023535,1162,28,65,76,13,1344
E01023536,992,40,69,114,12,1227
E01023537,1242,22,68,66,16,1414
E01023538,1140,28,88,92,12,1360
E01023539,1761,47,261,178,66,2313
E01023540,1162,20,68,57,7,1314
E01023541,1255,22,96,85,15,1473
E01023542,1150,25,122,101,13,1411
E01023543,912,32,76,91,11,1122
E01023544,816,18,52,29,12,927
E01023545,865,33,67,54,7,1026
E01023546,1158,23,100,82,20,1383
E01023547,1129,26,66,85,18,1324
E01023548,1350,13,140,11,22,1536
E01023549,1252,12,110,16,11,1401
E01023550,1144,23,141,11,20,1339
E01023551,1025,20,147,13,11,1216
E01023552,1122,18,134,31,4,1309
E01023553,1063,20,220,36,10,1349
E01023554,1133,22,111,48,21,1335
E01023555,1179,22,109,40,15,1365
E01023556,1088,21,108,14,11,1242
E01023557,1041,14,93,16,14,1178
E01023558,1174,20,96,36,13,1339
E01023559,1077,30,101,18,5,1231
E01023560,941,22,107,36,9,1115
E01023561,1084,24,83,46,19,1256
E01023562,1035,15,96,25,4,1175
E01023563,1089,21,83,11,5,1209
E01023564,1075,34,146,70,14,1339
E01023565,1099,16,172,26,13,1326
E01023566,981,14,287,27,12,1321
E01023567,1493,33,63,19,13,1621
E01023568,1177,16,53,18,7,1271
E01023569,1129,22,72,28,6,1257
E01023570,1080,16,64,28,12,1200
E01023571,1142,15,75,27,7,1266
E01023572,1107,24,62,28,3,1224
E01023573,866,16,74,37,11,1004
E01023574,1111,26,62,46,8,1253
E01023575,1163,25,101,39,7,1335
E01023576,1194,18,51,18,17,1298
E01023577,1330,24,79,18,16,1467
E01023578,1247,17,92,19,9,1384
E01023579,966,33,129,21,4,1153
E01023580,1275,24,68,33,22,1422
E01023581,891,12,46,16,8,973
E01023582,1101,49,107,26,20,1303
E01023583,1052,17,33,17,7,1126
E01023584,798,8,24,11,3,844
E01023585,894,13,12,3,5,927
E01023586,1206,5,12,3,2,1228
E01023587,838,13,34,7,0,892
E01023588,1036,13,31,2,0,1082
E01023589,1307,14,46,13,10,1390
E01023590,1300,15,46,14,3,1378
E01023591,1184,16,36,7,3,1246
E01023592,1096,12,40,12,5,1165
E01023593,1066,10,25,6,2,1109
E01023594,1766,24,21,17,4,1832
E01023595,1180,9,22,9,2,1222
E01023596,906,5,6,2,1,920
E01023597,970,7,6,3,1,987
E01023598,1038,5,19,12,2,1076
E01023600,1092,10,29,11,3,1145
E01023601,1452,47,240,75,23,1837
E01023602,981,20,168,44,17,1230
E01023603,1081,20,90,42,3,1236
E01023604,850,19,182,31,16,1098
E01023605,961,40,110,69,22,1202
E01023606,1189,16,66,44,12,1327
E01023607,976,18,121,27,14,1156
E01023608,1135,21,63,8,4,1231
E01023609,1192,20,56,10,9,1287
E01023610,937,18,66,18,3,1042
E01023611,1103,40,75,55,7,1280
E01023612,1253,23,99,45,7,1427
E01023613,1072,52,72,103,7,1306
E01023614,1472,29,74,16,8,1599
E01023615,1241,7,40,14,5,1307
E01023616,1624,38,50,40,8,1760
E01023617,1113,17,82,24,0,1236
E01023618,992,38,108,43,10,1191
E01023619,1096,34,185,32,16,1363
E01023620,876,31,60,50,24,1041
E01023621,936,26,68,54,11,1095
E01023622,919,16,24,3,1,963
E01023623,1157,7,16,6,3,1189
E01023624,1021,10,7,4,2,1044
E01023625,862,15,14,3,4,898
E01023626,1686,16,17,8,3,1730
E01023627,1355,17,71,5,10,1458
E01023628,1310,12,37,21,7,1387
E01023629,1375,12,48,6,8,1449
E01023630,1083,33,136,32,2,1286
E01023631,1041,30,180,39,12,1302
E01023632,917,24,167,9,7,1124
E01023633,937,15,79,24,10,1065
E01023634,1033,22,44,16,4,1119
E01023635,1106,14,39,16,3,1178
E01023636,1367,18,52,22,2,1461
E01023637,1289,21,30,40,2,1382
E01023638,1147,25,52,27,8,1259
E01023639,957,13,101,16,15,1102
E01023640,861,26,51,43,5,986
E01023641,916,24,35,61,4,1040
E01023642,907,10,158,19,10,1104
E01023643,861,29,148,36,12,1086
E01023644,1249,21,74,24,7,1375
E01023645,1046,27,122,32,15,1242
E01023646,898,38,52,26,8,1022
E01023647,1138,15,98,11,4,1266
E01023648,918,9,97,23,2,1049
E01023649,935,25,59,25,12,1056
E01023650,982,21,79,39,11,1132
E01023651,745,16,149,48,14,972
E01023652,975,26,69,38,3,1111
E01023653,1658,15,18,10,2,1703
E01023654,1244,14,15,10,4,1287
E01023655,1228,8,18,2,2,1258
E01023656,1740,33,44,18,3,1838
E01023657,1944,12,36,17,4,2013
E01023658,1228,16,4,11,1,1260
E01023659,1053,8,18,4,4,1087
E01023660,1772,17,63,22,4,1878
E01023661,1024,10,25,14,0,1073
E01023662,1128,10,33,30,4,1205
E01023663,1650,19,12,9,1,1691
E01023664,1137,30,93,23,29,1312
E01023665,1023,23,130,25,14,1215
E01023666,1005,37,315,59,12,1428
E01023667,941,31,117,26,10,1125
E01023668,929,21,68,16,9,1043
E01023669,1054,45,80,65,18,1262
E01023670,1521,26,78,25,10,1660
E01023671,1262,35,138,29,19,1483
E01023672,1248,24,145,36,12,1465
E01023673,1017,20,51,11,4,1103
E01023674,1163,45,157,42,18,1425
E01023675,1020,12,36,10,4,1082
E01023676,1532,42,140,36,4,1754
E01023677,706,28,91,33,15,873
E01023678,1257,29,131,33,4,1454
E01023679,1131,10,23,11,7,1182
E01023680,953,13,61,9,7,1043
E01023681,968,39,216,56,36,1315
E01023682,1165,25,153,33,14,1390
E01023683,1072,38,123,40,13,1286
E01023684,1145,21,147,34,13,1360
E01023685,1197,11,26,9,6,1249
E01023686,1113,21,32,6,5,1177
E01023687,1079,14,33,27,3,1156
E01023688,1060,24,26,8,14,1132
E01023689,965,18,26,23,4,1036
E01023690,1131,7,36,8,7,1189
E01023691,1028,11,33,3,6,1081
E01023692,935,18,46,47,8,1054
E01023693,973,17,23,5,6,1024
E01023694,1024,5,29,15,4,1077
E01023695,1185,11,39,2,4,1241
E01023696,1272,15,77,3,1,1368
E01023697,1355,7,56,18,5,1441
E01023698,1199,11,52,8,5,1275
E01023699,1154,11,35,3,3,1206
E01023700,1017,9,10,2,4,1042
E01023701,1343,17,73,12,3,1448
E01023702,1126,24,50,5,4,1209
E01023703,1018,5,16,3,3,1045
E01023704,1131,36,122,29,14,1332
E01023705,995,28,216,35,23,1297
E01023706,1096,44,127,23,16,1306
E01023708,1061,41,84,27,16,1229
E01023709,1222,26,66,30,1,1345
E01023710,1174,11,49,4,5,1243
E01023711,1150,16,62,12,8,1248
E01023712,1211,22,83,47,2,1365
E01023713,1220,18,119,47,2,1406
E01023714,1289,23,48,15,8,1383
E01023715,1048,26,94,15,5,1188
E01023716,1467,21,65,9,6,1568
E01023717,920,18,34,11,4,987
E01023718,1310,20,64,15,8,1417
E01023719,828,17,41,18,4,908
E01023720,1339,18,80,38,20,1495
E01023721,1032,13,52,15,7,1119
E01023722,1112,10,25,8,4,1159
E01023723,1257,9,41,8,5,1320
E01023724,1251,12,32,3,3,1301
E01023725,1138,5,25,8,4,1180
E01023726,1297,42,68,17,6,1430
E01023727,1466,25,118,52,10,1671
E01023728,1664,28,58,29,21,1800
E01023729,1191,33,179,43,19,1465
E01023730,1289,19,49,15,11,1383
E01023731,1070,10,86,11,5,1182
E01023732,1304,13,88,20,3,1428
E01023733,1264,15,52,13,3,1347
E01023734,1256,12,30,11,3,1312
E01023735,1361,24,50,21,3,1459
E01023736,1223,12,27,5,7,1274
E01023737,746,31,205,43,15,1040
E01023738,966,34,164,54,14,1232
E01023739,939,19,124,63,10,1155
E01023740,972,18,75,25,8,1098
E01023741,1092,18,80,30,5,1225
E01023742,1131,23,56,8,4,1222
E01023743,1334,15,40,11,14,1414
E01023744,1173,16,35,15,1,1240
E01023745,1332,7,39,9,4,1391
E01023746,1098,16,21,25,7,1167
E01023747,1334,10,20,16,1,1381
E01023748,1121,6,9,3,1,1140
E01023749,1293,9,18,8,4,1332
E01023750,1044,14,23,18,2,1101
E01023751,857,10,36,15,3,921
E01023752,896,12,69,38,7,1022
E01023753,1127,18,44,21,3,1213
E01023754,884,9,79,37,4,1013
E01023755,1120,18,72,55,4,1269
E01023756,995,21,118,60,8,1202
E01023757,1225,33,133,56,16,1463
E01023758,1334,27,118,52,12,1543
E01023759,999,18,75,49,4,1145
E01023760,1152,24,43,27,3,1249
E01023761,1499,41,60,61,4,1665
E01023762,1095,21,59,46,5,1226
E01023763,1120,24,30,22,4,1200
E01023764,1134,15,29,26,8,1212
E01023765,1111,15,21,28,2,1177
E01023766,1118,10,24,29,7,1188
E01023767,1111,14,62,20,3,1210
E01023768,1211,22,75,37,5,1350
E01023769,1283,18,51,29,1,1382
E01023770,1170,8,51,34,5,1268
E01023771,1185,15,61,39,12,1312
E01023772,1269,18,91,53,6,1437
E01023773,933,19,40,33,7,1032
E01023774,1106,16,115,40,7,1284
E01023775,1452,26,115,31,5,1629
E01023776,1858,41,110,42,13,2064
E01023777,1359,30,56,13,9,1467
E01023778,1164,14,92,18,8,1296
E01023779,1113,20,94,43,9,1279
E01023780,1064,37,52,32,13,1198
E01023781,1230,20,59,45,7,1361
E01023782,1092,19,37,30,1,1179
E01023783,1196,31,51,61,9,1348
E01023784,1262,11,38,14,5,1330
E01023785,1168,12,26,21,2,1229
E01023786,1083,22,58,36,4,1203
E01023787,909,20,90,80,3,1102
E01023788,1014,18,121,59,8,1220
E01023789,1238,17,101,107,13,1476
E01023790,1005,20,158,92,7,1282
E01023791,1180,17,25,35,6,1263
E01023792,1082,40,37,41,6,1206
E01023793,970,31,43,52,6,1102
E01023794,1088,12,54,52,1,1207
E01023795,1190,13,47,23,7,1280
E01023796,1120,22,50,27,3,1222
E01023797,990,21,34,17,4,1066
E01023798,1045,26,93,33,2,1199
E01023799,977,7,94,23,15,1116
E01023800,1357,37,230,44,20,1688
E01023801,1569,35,106,56,4,1770
E01023802,1311,13,33,14,6,1377
E01023803,1175,10,40,9,5,1239
E01023804,1157,17,28,27,4,1233
E01023805,1115,21,79,34,4,1253
E01023806,1503,37,70,78,4,1692
E01023807,1151,11,27,16,3,1208
E01023808,1890,43,74,36,7,2050
E01023809,1201,19,127,45,16,1408
E01023810,1112,16,334,30,15,1507
E01023811,1083,17,138,28,11,1277
E01023812,798,20,327,17,9,1171
E01023813,928,25,240,15,14,1222
E01023814,845,14,124,8,2,993
E01023815,1126,15,52,2,3,1198
E01023816,940,6,27,5,1,979
E01023817,1003,14,69,6,2,1094
E01023818,1024,12,43,2,0,1081
E01023819,1174,14,42,9,7,1246
E01023820,983,17,44,6,3,1053
E01023821,955,11,59,8,5,1038
E01023822,1018,8,41,6,1,1074
E01023823,1077,12,45,7,1,1142
E01023824,1486,10,43,10,1,1550
E01023825,1517,27,213,29,12,1798
E01023826,1010,15,87,13,1,1126
E01023827,1489,17,85,47,7,1645
E01023828,1041,12,69,25,7,1154
E01023829,1176,26,46,42,4,1294
E01023830,1123,13,32,18,10,1196
E01023831,1448,33,50,20,8,1559
E01023832,1094,33,117,53,15,1312
E01023833,1574,20,165,49,5,1813
E01023834,1070,17,94,46,4,1231
E01023835,1036,17,75,10,2,1140
E01023836,1026,16,58,25,4,1129
E01023837,1140,13,62,15,1,1231
E01023838,872,30,36,14,6,958
E01023839,935,28,855,12,25,1855
E01023840,987,19,393,11,6,1416
E01023841,689,15,614,23,11,1352
E01023842,1113,19,35,50,5,1222
E01023843,1290,28,105,73,6,1502
E01023844,1081,34,55,46,6,1222
E01023845,1245,33,87,41,6,1412
E01023846,1108,19,93,13,9,1242
E01023847,1309,21,96,22,9,1457
E01023848,1153,26,57,16,9,1261
E01023849,1060,22,100,6,3,1191
E01023850,1126,18,74,15,10,1243
E01023851,1147,21,164,21,15,1368
E01023852,1087,18,76,19,7,1207
E01023853,1468,25,143,3,6,1645
E01023854,1507,9,32,3,2,1553
E01023855,1143,47,202,77,19,1488
E01023856,1418,51,202,116,13,1800
E01023857,785,31,350,98,9,1273
E01023858,1044,34,213,76,12,1379
E01023859,1269,57,275,120,22,1743
E01023860,1089,52,262,100,32,1535
E01023861,1230,52,483,156,31,1952
E01023862,1225,38,248,115,13,1639
E01023863,819,24,376,137,15,1371
E01023864,819,23,290,88,13,1233
E01023865,773,25,328,70,19,1215
E01023866,777,18,183,89,20,1087
E01023867,1059,49,429,115,27,1679
E01023868,1026,31,173,75,4,1309
E01023869,713,18,293,41,3,1068
E01023870,702,34,257,57,21,1071
E01023871,796,25,106,33,13,973
E01023872,977,20,249,81,13,1340
E01023873,845,19,34,93,3,994
E01023874,874,12,77,56,9,1028
E01023875,1311,28,149,56,6,1550
E01023876,1027,31,113,97,11,1279
E01023877,1063,28,111,76,15,1293
E01023878,1223,31,307,30,18,1609
E01023879,1305,55,347,66,29,1802
E01023880,1276,43,180,54,11,1564
E01023881,1074,13,165,46,5,1303
E01023882,1177,18,63,20,2,1280
E01023883,914,43,237,70,12,1276
E01023884,1248,22,73,20,15,1378
E01023885,1223,14,177,38,7,1459
E01023886,1452,66,484,87,23,2112
E01023887,1108,20,222,11,4,1365
E01023888,876,25,285,46,19,1251
E01023889,1094,27,230,14,10,1375
E01023890,814,25,90,83,5,1017
E01023891,876,30,72,77,8,1063
E01023892,891,24,47,58,5,1025
E01023893,1179,25,141,66,6,1417
E01023894,968,10,113,37,8,1136
E01023895,1043,28,219,43,11,1344
E01023896,812,27,127,70,6,1042
E01023897,1135,12,122,43,7,1319
E01023898,1047,16,163,23,4,1253
E01023899,547,23,487,103,27,1187
E01023900,616,25,589,95,9,1334
E01023901,891,41,356,118,13,1419
E01023902,817,30,254,117,12,1230
E01023903,560,27,450,120,22,1179
E01023904,1359,26,93,79,12,1569
E01023905,1278,37,103,67,10,1495
E01023906,1043,30,66,42,6,1187
E01023907,1189,26,127,50,12,1404
E01023908,1187,25,49,6,7,1274
E01023909,910,16,88,22,26,1062
E01023910,1039,16,56,8,14,1133
E01023911,1238,10,33,9,5,1295
E01023912,1093,7,54,21,0,1175
E01023913,992,10,49,33,7,1091
E01023914,1275,18,41,18,7,1359
E01023915,1047,26,47,43,15,1178
E01023916,1204,23,60,23,10,1320
E01023917,1299,21,66,14,5,1405
E01023918,1359,12,93,23,13,1500
E01023919,1215,24,32,19,0,1290
E01023920,1067,26,147,110,20,1370
E01023921,1236,41,270,195,50,1792
E01023922,1093,35,217,81,12,1438
E01023923,1169,35,287,97,17,1605
E01023924,976,31,310,129,19,1465
E01023925,1006,11,43,8,3,1071
E01023926,1281,22,140,38,19,1500
E01023927,1054,17,129,122,7,1329
E01023929,1144,28,79,39,7,1297
E01023930,1044,30,112,97,20,1303
E01023932,1038,48,223,136,31,1476
E01023933,1001,17,141,103,12,1274
E01023934,818,33,230,150,24,1255
E01023935,907,30,152,71,11,1171
E01023936,1461,38,247,135,28,1909
E01023937,824,21,179,141,20,1185
E01023938,1915,70,378,208,43,2614
E01023939,922,9,36,24,5,996
E01023940,1225,19,72,37,8,1361
E01023941,1745,63,227,100,25,2160
E01023942,1096,11,93,50,8,1258
E01023943,1031,13,73,27,6,1150
E01023944,1442,24,89,40,9,1604
E01023945,1188,14,31,16,8,1257
E01023946,989,14,132,66,31,1232
E01023947,1231,14,44,18,14,1321
E01023948,1252,15,55,27,10,1359
E01023949,1510,15,54,14,12,1605
E01023950,1125,27,85,33,11,1281
E01023951,1174,22,56,56,2,1310
E01023952,1333,12,62,52,7,1466
E01023953,1076,8,61,21,3,1169
E01023954,1174,33,78,65,10,1360
E01023955,919,23,35,33,5,1015
E01023956,901,22,39,58,5,1025
E01023957,976,26,63,45,17,1127
E01023958,926,8,50,36,6,1026
E01023959,1068,11,52,12,4,1147
E01023960,1154,17,53,18,16,1258
E01023961,1046,20,41,37,3,1147
E01023962,1105,8,25,12,2,1152
E01023963,1742,33,64,27,1,1867
E01023964,1211,16,35,13,21,1296
E01023965,1059,14,44,16,3,1136
E01023966,1243,16,45,16,5,1325
E01023967,1072,13,25,16,0,1126
E01023968,1022,7,29,6,4,1068
E01023969,1121,7,25,2,2,1157
E01023970,1059,8,17,11,5,1100
E01023971,1228,20,47,6,12,1313
E01023972,973,3,30,3,2,1011
E01023973,1090,13,86,19,5,1213
E01023974,969,17,28,12,4,1030
E01023975,1135,16,104,10,13,1278
E01023976,1176,11,102,13,10,1312
E01023977,939,9,15,8,1,972
E01023978,1058,3,4,0,1,1066
E01023979,988,8,9,7,3,1015
E01023980,930,4,6,12,4,956
E01023981,902,11,36,17,7,973
E01023983,1132,13,10,11,0,1166
E01023984,811,21,47,18,4,901
E01023985,954,8,6,2,1,971
E01023986,1034,15,6,4,1,1060
E01023987,834,3,16,3,4,860
E01023988,1127,6,4,5,2,1144
E01023989,943,8,11,0,1,963
E01023990,982,11,11,4,2,1010
E01023992,1052,8,110,23,8,1201
E01023993,965,8,119,14,4,1110
E01023995,975,5,39,12,1,1032
E01023996,934,16,49,13,1,1013
E01023997,1184,3,4,0,10,1201
E01023998,907,4,5,2,3,921
E01023999,1727,20,43,24,9,1823
E01024001,1126,13,59,11,4,1213
E01024002,980,18,63,22,7,1090
E01024003,1437,6,47,8,3,1501
E01024004,1272,29,83,25,5,1414
E01024005,1139,9,56,24,2,1230
E01024006,982,10,36,13,5,1046
E01024008,1353,19,51,31,11,1465
E01024009,943,6,4,3,0,956
E01024010,1046,7,9,2,3,1067
E01024011,1020,1,17,3,5,1046
E01024012,851,3,8,5,2,869
E01024013,1352,14,9,1,1,1377
E01024014,1389,4,8,1,0,1402
E01024015,1327,8,9,1,0,1345
E01024016,1055,12,23,18,1,1109
E01024017,1363,17,24,20,1,1425
E01024019,885,25,99,13,2,1024
E01024020,1127,11,87,26,10,1261
E01024021,969,17,75,21,1,1083
E01024022,1067,16,89,9,4,1185
E01024023,1708,22,172,19,5,1926
E01024024,1867,12,16,5,4,1904
E01024025,936,6,6,1,0,949
E01024026,1023,7,1,1,1,1033
E01024027,1106,19,213,16,3,1357
E01024028,1141,18,102,21,7,1289
E01024029,1730,22,89,20,4,1865
E01024031,1224,3,5,1,1,1234
E01024032,1245,3,6,5,4,1263
E01024033,1383,10,4,3,4,1404
E01024034,1906,12,22,2,11,1953
E01024035,868,7,2,1,5,883
E01024036,1057,7,4,0,0,1068
E01024037,1426,9,3,2,1,1441
E01024038,1595,4,7,3,0,1609
E01024039,1199,9,8,3,1,1220
E01024040,942,3,15,6,5,971
E01024041,880,10,18,3,4,915
E01024042,1091,8,4,1,3,1107
E01024043,1134,10,14,3,2,1163
E01024044,1572,32,113,11,19,1747
E01024045,1244,16,60,13,13,1346
E01024046,1352,18,189,30,27,1616
E01024047,854,18,178,26,13,1089
E01024048,1442,51,130,111,17,1751
E01024049,1373,20,63,35,13,1504
E01024052,1587,25,47,10,9,1678
E01024053,1416,17,36,7,5,1481
E01024054,1443,10,12,2,2,1469
E01024055,1291,5,12,1,0,1309
E01024056,1636,12,17,2,5,1672
E01024057,1534,8,11,1,3,1557
E01024058,1267,6,21,0,7,1301
E01024059,1222,12,29,4,2,1269
E01024060,1186,15,22,9,3,1235
E01024061,1109,13,15,5,1,1143
E01024062,1229,12,13,5,1,1260
E01024063,1225,8,14,5,0,1252
E01024064,1861,14,45,3,7,1930
E01024065,1556,7,13,4,3,1583
E01024066,1194,8,15,3,0,1220
E01024067,922,8,19,10,4,963
E01024068,1122,17,93,20,13,1265
E01024069,1016,12,16,5,2,1051
E01024070,1149,7,14,9,0,1179
E01024071,1276,26,11,6,0,1319
E01024072,1046,16,12,6,3,1083
E01024073,1566,5,7,2,1,1581
E01024074,1189,3,6,5,5,1208
E01024075,1326,8,10,6,3,1353
E01024076,1428,3,14,6,1,1452
E01024077,1102,11,20,4,3,1140
E01024078,1298,13,42,3,1,1357
E01024079,1191,3,15,7,1,1217
E01024080,1070,6,17,3,3,1099
E01024081,1297,16,17,5,6,1341
E01024082,1067,10,23,4,8,1112
E01024083,1098,9,6,3,4,1120
E01024084,889,8,17,0,1,915
E01024085,1283,11,5,1,3,1303
E01024086,1464,23,32,18,10,1547
E01024087,1002,7,20,2,2,1033
E01024088,1267,2,22,0,1,1292
E01024089,912,14,10,7,10,953
E01024090,1769,52,174,108,41,2144
E01024091,990,19,72,8,0,1089
E01024092,1277,20,64,48,12,1421
E01024093,1211,41,67,34,17,1370
E01024094,1963,6,16,3,2,1990
E01024095,1208,10,11,6,2,1237
E01024096,1479,11,13,6,0,1509
E01024097,1312,10,9,6,0,1337
E01024098,1355,7,3,2,0,1367
E01024099,1105,33,88,31,18,1275
E01024100,1189,34,109,47,23,1402
E01024101,1392,37,119,60,26,1634
E01024102,1360,44,111,43,15,1573
E01024103,1267,21,65,32,9,1394
E01024104,1580,40,137,33,27,1817
E01024105,1286,11,15,1,0,1313
E01024106,1313,13,11,8,1,1346
E01024107,1169,8,22,1,0,1200
E01024108,911,4,10,3,0,928
E01024109,1793,13,24,10,1,1841
E01024110,1068,6,14,5,1,1094
E01024111,1155,8,13,8,1,1185
E01024112,1287,12,18,12,1,1330
E01024113,993,13,36,3,9,1054
E01024114,1418,8,9,1,6,1442
E01024115,1202,4,9,0,3,1218
E01024116,1207,9,21,11,6,1254
E01024117,1195,8,7,0,1,1211
E01024118,1415,10,23,3,2,1453
E01024119,1162,2,20,3,4,1191
E01024120,1347,4,14,0,1,1366
E01024121,1205,43,48,27,26,1349
E01024122,1083,27,69,27,12,1218
E01024123,1253,18,97,24,12,1404
E01024124,1083,32,59,35,18,1227
E01024126,1062,13,70,37,6,1188
E01024127,1253,15,25,11,3,1307
E01024128,1155,25,34,20,9,1243
E01024129,1400,45,83,45,6,1579
E01024130,1947,36,109,43,9,2144
E01024131,1220,35,73,26,14,1368
E01024132,954,16,21,11,5,1007
E01024133,877,11,100,33,8,1029
E01024134,1254,13,28,17,1,1313
E01024135,1094,8,45,16,1,1164
E01024136,1074,18,118,36,8,1254
E01024137,1027,14,92,39,17,1189
E01024138,1234,16,108,45,13,1416
E01024139,1310,5,110,28,13,1466
E01024140,1762,27,166,83,32,2070
E01024141,1222,19,36,32,4,1313
E01024142,1931,37,93,92,14,2167
E01024143,1571,36,103,69,31,1810
E01024144,1089,9,81,19,2,1200
E01024145,1092,12,154,22,8,1288
E01024146,1110,17,69,19,9,1224
E01024147,1199,15,102,60,0,1376
E01024148,1187,13,40,61,14,1315
E01024149,1817,45,99,194,11,2166
E01024150,1211,10,67,20,5,1313
E01024151,1161,6,47,10,2,1226
E01024152,1644,31,150,101,18,1944
E01024153,1104,7,53,9,0,1173
E01024154,874,10,46,47,3,980
E01024155,935,30,46,51,4,1066
E01024156,1111,25,129,82,7,1354
E01024157,1349,6,35,4,1,1395
E01024158,1275,7,52,6,4,1344
E01024159,1318,9,37,6,0,1370
E01024160,1127,7,48,10,2,1194
E01024161,1331,23,141,36,32,1563
E01024162,1194,25,73,46,36,1374
E01024163,1230,22,108,67,10,1437
E01024164,1227,25,135,59,45,1491
E01024165,1037,17,61,41,11,1167
E01024166,1123,12,86,51,6,1278
E01024167,1282,17,81,58,7,1445
E01024168,915,13,44,27,10,1009
E01024169,1061,13,65,38,8,1185
E01024170,1060,22,49,51,7,1189
E01024171,1134,10,39,34,2,1219
E01024172,1420,42,60,77,12,1611
E01024173,1402,15,33,2,2,1454
E01024174,920,13,16,5,0,954
E01024175,1002,17,11,6,0,1036
E01024176,1237,17,27,21,2,1304
E01024177,1015,12,20,17,5,1069
E01024178,1181,12,15,29,5,1242
E01024179,1845,53,85,148,12,2143
E01024180,1000,18,79,59,7,1163
E01024181,863,11,110,55,1,1040
E01024182,986,34,162,80,30,1292
E01024183,981,15,64,15,7,1082
E01024184,1256,30,146,67,17,1516
E01024185,1365,33,141,73,22,1634
E01024186,931,16,67,13,6,1033
E01024187,892,10,18,11,0,931
E01024188,981,16,37,11,8,1053
E01024189,1243,14,28,10,7,1302
E01024190,1161,7,15,2,6,1191
E01024191,1355,4,11,8,3,1381
E01024192,1234,8,7,4,11,1264
E01024193,1203,6,10,9,0,1228
E01024194,1146,9,9,5,5,1174
E01024195,1091,7,5,3,5,1111
E01024196,1134,5,9,5,2,1155
E01024197,1232,12,9,3,2,1258
E01024198,2041,9,23,0,3,2076
E01024200,1454,12,11,1,2,1480
E01024201,1222,2,9,2,0,1235
E01024202,1500,4,10,5,1,1520
E01024203,1362,6,2,7,3,1380
E01024204,1230,10,18,8,3,1269
E01024205,1255,6,11,1,3,1276
E01024206,1441,7,8,0,5,1461
E01024207,1442,11,11,3,4,1471
E01024208,1299,12,10,2,4,1327
E01024209,1415,11,16,0,1,1443
E01024212,1253,4,19,4,3,1283
E01024213,1135,6,6,4,2,1153
E01024214,1257,14,13,15,7,1306
E01024215,1145,18,67,16,6,1252
E01024216,1165,12,9,1,1,1188
E01024217,1374,6,11,3,3,1397
E01024218,952,6,6,0,3,967
E01024219,1122,3,3,2,0,1130
E01024220,1387,7,7,0,0,1401
E01024221,1284,3,7,5,5,1304
E01024222,1214,11,11,0,1,1237
E01024223,1243,9,10,5,0,1267
E01024224,1257,9,7,3,0,1276
E01024225,1312,4,5,4,2,1327
E01024226,1190,9,7,1,1,1208
E01024227,1168,8,9,3,2,1190
E01024228,1293,12,24,7,4,1340
E01024229,1245,8,8,1,1,1263
E01024230,1192,5,7,7,2,1213
E01024231,1287,14,22,2,2,1327
E01024232,1751,12,7,1,1,1772
E01024233,1307,7,11,1,1,1327
E01024234,1158,6,10,1,1,1176
E01024235,1364,12,5,5,0,1386
E01024236,1361,3,9,1,0,1374
E01024237,1365,5,9,1,1,1381
E01024238,919,9,332,9,25,1294
E01024239,1352,11,75,6,4,1448
E01024240,1110,11,14,6,1,1142
E01024241,1470,12,36,13,5,1536
E01024242,1409,14,37,13,5,1478
E01024243,1378,9,13,3,3,1406
E01024244,1482,19,33,11,9,1554
E01024245,1461,11,9,0,2,1483
E01024246,1460,19,30,7,7,1523
E01024247,1512,21,74,9,10,1626
E01024248,1386,12,28,7,3,1436
E01024249,1598,15,37,40,7,1697
E01024250,1415,11,6,3,1,1436
E01024251,1422,5,4,4,3,1438
E01024252,1993,11,27,6,4,2041
E01024253,1487,5,32,6,1,1531
E01024254,1523,5,65,0,2,1595
E01024255,1366,4,9,2,0,1381
E01024256,1174,2,12,6,1,1195
E01024257,1024,26,387,79,114,1630
E01024258,868,23,295,36,76,1298
E01024259,1157,8,63,12,12,1252
E01024260,1371,16,125,14,36,1562
E01024261,1711,20,68,21,6,1826
E01024262,1132,24,148,25,12,1341
E01024263,1112,20,57,12,5,1206
E01024264,1118,13,56,22,4,1213
E01024265,955,8,84,6,12,1065
E01024266,921,7,20,5,1,954
E01024267,1210,8,18,2,9,1247
E01024268,1304,7,23,2,7,1343
E01024269,1519,14,35,1,1,1570
E01024270,1155,5,32,4,0,1196
E01024271,1128,9,14,2,3,1156
E01024272,1181,10,40,6,0,1237
E01024273,1188,8,34,5,16,1251
E01024274,1229,6,12,8,5,1260
E01024275,1061,9,10,3,1,1084
E01024276,1260,25,473,98,104,1960
E01024277,1199,21,129,59,22,1430
E01024278,1178,31,80,67,22,1378
E01024279,851,21,207,31,26,1136
E01024280,1081,17,113,60,17,1288
E01024281,935,10,146,22,17,1130
E01024282,818,22,314,50,36,1240
E01024283,859,8,107,24,8,1006
E01024284,917,21,198,22,38,1196
E01024285,976,12,124,13,9,1134
E01024286,1150,6,123,27,23,1329
E01024287,1111,11,58,22,1,1203
E01024288,984,8,159,15,18,1184
E01024290,795,28,446,31,63,1363
E01024291,986,37,312,26,71,1432
E01024292,842,26,377,19,61,1325
E01024293,816,16,354,84,26,1296
E01024294,1137,24,233,139,36,1569
E01024295,1154,39,149,46,73,1461
E01024296,1629,41,415,86,74,2245
E01024297,1116,13,78,20,9,1236
E01024298,1083,2,72,23,3,1183
E01024299,1049,12,71,12,9,1153
E01024300,1116,9,71,11,8,1215
E01024301,952,7,73,11,3,1046
E01024302,1203,2,23,3,2,1233
E01024303,1116,11,37,30,12,1206
E01024304,1104,14,65,28,4,1215
E01024305,976,13,43,50,6,1088
E01024306,772,19,15,34,1,841
E01024307,1114,15,41,24,16,1210
E01024308,989,10,35,41,5,1080
E01024309,831,12,43,42,7,935
E01024310,1186,6,27,20,1,1240
E01024311,739,17,121,55,18,950
E01024312,932,14,58,22,11,1037
E01024313,1136,15,98,17,18,1284
E01024314,911,7,68,38,5,1029
E01024315,1052,22,48,65,19,1206
E01024316,1221,12,188,36,14,1471
E01024317,1122,14,168,11,29,1344
E01024318,1092,17,98,17,11,1235
E01024319,997,9,161,29,13,1209
E01024320,939,5,18,9,2,973
E01024321,1339,14,43,3,11,1410
E01024322,943,5,18,0,2,968
E01024323,1078,4,35,3,10,1130
E01024324,1146,7,19,3,5,1180
E01024325,1927,28,22,6,5,1988
E01024326,1525,20,36,2,1,1584
E01024327,1261,16,29,7,3,1316
E01024328,1281,13,13,1,0,1308
E01024329,1197,5,21,6,3,1232
E01024330,1241,9,19,5,3,1277
E01024331,1134,5,21,0,1,1161
E01024332,1001,7,4,0,0,1012
E01024333,1007,12,13,10,0,1042
E01024334,765,7,10,7,4,793
E01024335,1249,9,25,10,1,1294
E01024336,1282,16,31,7,4,1340
E01024337,1130,12,40,3,4,1189
E01024338,1090,6,19,13,3,1131
E01024339,1486,33,60,24,10,1613
E01024340,1726,24,64,31,18,1863
E01024341,1354,16,95,7,8,1480
E01024342,1338,13,26,9,1,1387
E01024343,1115,8,1,1,2,1127
E01024344,1174,4,8,1,2,1189
E01024345,1249,5,12,1,0,1267
E01024346,1066,3,10,4,0,1083
E01024347,1353,15,22,8,1,1399
E01024348,1043,13,35,3,3,1097
E01024349,1023,12,24,12,3,1074
E01024350,1127,9,5,6,0,1147
E01024351,1146,14,104,12,4,1280
E01024352,1322,25,87,17,5,1456
E01024353,1457,12,51,13,1,1534
E01024354,1094,12,44,10,4,1164
E01024355,1477,20,68,7,2,1574
E01024356,1231,28,60,17,4,1340
E01024357,1168,23,90,16,13,1310
E01024358,1271,15,77,8,8,1379
E01024360,1174,10,33,13,2,1232
E01024361,1381,5,4,3,0,1393
E01024362,1365,5,21,3,0,1394
E01024363,1670,10,18,5,3,1706
E01024364,1311,6,16,2,2,1337
E01024365,1422,11,7,3,2,1445
E01024366,1423,18,9,20,1,1471
E01024367,1061,4,83,13,5,1166
E01024369,1146,13,43,6,10,1218
E01024371,1229,15,49,5,5,1303
E01024372,1472,34,73,23,10,1612
E01024373,1346,25,87,32,8,1498
E01024374,1159,28,67,10,1,1265
E01024375,1949,12,21,8,4,1994
E01024376,1870,11,17,5,3,1906
E01024377,1311,5,13,3,1,1333
E01024378,1094,8,1,1,0,1104
E01024379,1337,12,21,1,7,1378
E01024380,1323,11,12,6,1,1353
E01024381,1097,10,5,5,4,1121
E01024382,1522,36,102,113,20,1793
E01024383,1297,26,473,28,11,1835
E01024384,1385,14,35,5,11,1450
E01024385,1221,12,16,11,5,1265
E01024386,1339,19,31,9,5,1403
E01024387,1983,14,19,4,3,2023
E01024388,2137,19,52,5,5,2218
E01024389,1408,23,51,20,9,1511
E01024390,972,6,13,9,2,1002
E01024391,986,6,23,9,0,1024
E01024392,1154,17,84,15,12,1282
E01024393,1177,15,30,12,1,1235
E01024394,1132,6,21,5,0,1164
E01024395,1091,8,32,3,1,1135
E01024396,1140,13,36,5,3,1197
E01024397,1118,21,30,10,5,1184
E01024398,1279,7,13,14,7,1320
E01024399,1065,4,20,6,1,1096
E01024400,1140,11,13,2,1,1167
E01024401,1128,11,21,22,6,1188
E01024402,1202,11,10,6,0,1229
E01024403,1358,14,45,10,6,1433
E01024404,1226,10,18,4,2,1260
E01024405,1619,6,55,15,1,1696
E01024406,1103,8,47,5,0,1163
E01024407,1157,9,22,5,1,1194
E01024408,1123,11,14,5,4,1157
E01024409,1202,7,21,2,2,1234
E01024410,1338,4,5,5,0,1352
E01024411,983,7,27,2,5,1024
E01024413,1277,7,14,6,2,1306
E01024414,1202,6,14,4,3,1229
E01024415,1085,5,13,8,2,1113
E01024416,1305,15,15,2,2,1339
E01024417,1228,6,20,2,0,1256
E01024418,1007,9,30,1,6,1053
E01024419,1393,17,6,4,3,1423
E01024420,1642,14,7,2,1,1666
E01024421,1554,12,11,11,1,1589
E01024422,1360,13,41,9,9,1432
E01024423,1242,17,64,2,13,1338
E01024424,988,7,10,5,4,1014
E01024425,1257,11,15,1,2,1286
E01024426,1430,9,20,10,7,1476
E01024427,986,5,11,3,3,1008
E01024428,997,8,13,0,0,1018
E01024429,1185,19,22,5,1,1232
E01024430,1138,17,14,5,1,1175
E01024431,1467,8,17,5,0,1497
E01024432,1218,13,10,9,1,1251
E01024433,1052,14,15,15,1,1097
E01024434,1584,14,18,12,2,1630
E01024435,1253,11,7,1,0,1272
E01024436,1308,12,13,6,0,1339
E01024437,1247,7,17,4,3,1278
E01024438,1212,4,37,7,2,1262
E01024439,1257,6,12,4,3,1282
E01024440,1514,14,26,1,5,1560
E01024441,1263,8,20,3,1,1295
E01024442,1222,6,17,3,3,1251
E01024443,1299,7,39,0,2,1347
E01024444,965,6,28,4,5,1008
E01024445,1051,2,10,4,0,1067
E01024446,1198,4,33,7,1,1243
E01024447,1083,3,11,4,1,1102
E01024448,975,6,21,3,1,1006
E01024449,1161,8,14,1,2,1186
E01024450,1209,5,1,1,0,1216
E01024451,1731,14,16,3,0,1764
E01024452,1107,5,5,5,1,1123
E01024453,1272,4,15,2,0,1293
E01024454,1180,6,18,2,1,1207
E01024455,924,7,8,0,2,941
E01024456,991,9,7,0,1,1008
E01024457,915,3,13,3,1,935
E01024458,1088,16,15,8,4,1131
E01024459,1225,7,9,4,3,1248
E01024460,1227,11,32,2,1,1273
E01024461,1877,19,46,10,3,1955
E01024462,1263,13,26,5,6,1313
E01024463,1070,8,28,2,0,1108
E01024464,1228,13,29,8,4,1282
E01024465,1099,8,28,4,0,1139
E01024466,1006,8,37,2,4,1057
E01024467,1223,5,42,3,4,1277
E01024468,1115,13,35,0,2,1165
E01024469,1246,26,77,12,5,1366
E01024470,1177,16,34,3,3,1233
E01024471,1331,33,93,11,8,1476
E01024472,1070,3,16,28,9,1126
E01024473,1233,11,35,36,5,1320
E01024474,984,1,18,23,3,1029
E01024475,1134,9,49,22,6,1220
E01024476,1039,21,23,45,0,1128
E01024477,1049,10,24,45,3,1131
E01024478,1073,6,60,29,1,1169
E01024479,1194,11,22,13,0,1240
E01024480,1267,20,17,33,6,1343
E01024481,1182,8,32,27,5,1254
E01024482,1117,19,14,21,7,1178
E01024483,1267,12,30,6,4,1319
E01024484,966,8,8,5,3,990
E01024485,1260,14,14,6,5,1299
E01024486,1736,6,6,2,1,1751
E01024487,1093,8,3,0,3,1107
E01024488,1162,11,8,1,0,1182
E01024489,1511,6,8,3,2,1530
E01024490,1766,6,7,2,0,1781
E01024491,992,11,149,8,7,1167
E01024492,1051,6,162,4,21,1244
E01024493,1033,4,94,1,10,1142
E01024494,1141,11,163,5,2,1322
E01024495,892,18,404,7,21,1342
E01024496,1147,6,27,6,2,1188
E01024497,1254,11,16,3,1,1285
E01024498,1200,12,21,9,0,1242
E01024499,1188,7,13,7,1,1216
E01024500,886,15,24,6,2,933
E01024501,1067,16,37,0,5,1125
E01024502,996,11,33,17,5,1062
E01024503,1357,9,21,5,0,1392
E01024504,1515,24,52,23,14,1628
E01024505,1385,18,19,12,3,1437
E01024507,1499,18,79,23,11,1630
E01024508,1568,24,66,16,18,1692
E01024509,1414,20,26,12,6,1478
E01024510,1390,25,35,14,15,1479
E01024511,1097,27,25,6,9,1164
E01024512,1218,11,128,7,6,1370
E01024513,1185,18,73,9,10,1295
E01024514,988,11,60,5,3,1067
E01024515,1192,8,25,2,3,1230
E01024516,1107,8,25,9,2,1151
E01024517,1334,18,61,27,7,1447
E01024518,1381,8,17,2,2,1410
E01024519,1071,25,283,2,5,1386
E01024520,1057,10,56,4,3,1130
E01024521,1422,11,28,8,4,1473
E01024522,1111,5,27,1,3,1147
E01024523,1291,11,11,2,0,1315
E01024524,1238,5,19,7,1,1270
E01024525,1346,14,25,5,1,1391
E01024526,1326,8,9,2,1,1346
E01024527,1268,6,13,2,3,1292
E01024528,943,8,60,3,2,1016
E01024529,1210,3,4,5,1,1223
E01024530,1194,6,29,1,2,1232
E01024531,1165,6,7,3,0,1181
E01024532,1225,11,7,0,1,1244
E01024533,1021,6,3,2,1,1033
E01024534,1153,9,4,1,0,1167
E01024535,1897,9,11,4,4,1925
E01024536,1638,10,7,3,0,1658
E01024537,1412,8,15,2,2,1439
E01024538,1556,7,16,6,2,1587
E01024539,1576,16,29,4,0,1625
E01024540,1296,4,12,5,1,1318
E01024541,1736,20,61,4,8,1829
E01024542,1561,10,13,2,5,1591
E01024544,1195,7,4,4,0,1210
E01024545,1219,10,3,0,0,1232
E01024546,1287,13,13,4,5,1322
E01024547,1095,11,12,0,2,1120
E01024548,967,15,11,0,0,993
E01024549,905,8,4,1,0,918
E01024550,1659,8,22,0,1,1690
E01024551,1750,12,13,6,3,1784
E01024552,1427,13,12,5,2,1459
E01024553,1657,18,18,3,4,1700
E01024554,1993,16,18,10,0,2037
E01024555,1058,4,13,7,4,1086
E01024556,966,3,5,0,0,974
E01024557,1169,4,4,2,4,1183
E01024558,1313,7,2,3,5,1330
E01024559,1063,9,14,13,1,1100
E01024560,962,9,16,3,3,993
E01024561,1021,12,14,10,2,1059
E01024562,1100,13,17,5,6,1141
E01024563,1197,14,12,3,2,1228
E01024564,849,4,4,1,1,859
E01024565,1046,2,2,0,1,1051
E01024566,1191,7,7,1,0,1206
E01024567,1914,25,45,61,3,2048
E01024568,2051,20,35,24,6,2136
E01024569,1410,8,43,12,0,1473
E01024570,1374,9,9,9,1,1402
E01024571,1295,12,9,3,2,1321
E01024572,911,5,16,4,2,938
E01024573,1069,13,4,1,0,1087
E01024575,941,7,11,2,0,961
E01024576,1239,10,15,26,3,1293
E01024577,1009,7,9,15,1,1041
E01024578,1230,5,15,24,0,1274
E01024579,1826,24,50,125,6,2031
E01024580,1397,4,7,1,1,1410
E01024581,1045,5,8,5,2,1065
E01024582,1285,7,9,15,5,1321
E01024583,1235,6,9,20,1,1271
E01024584,1280,8,22,6,1,1317
E01024585,1118,6,12,3,0,1139
E01024586,1326,7,9,0,0,1342
E01024587,1220,9,22,4,0,1255
E01024588,1230,6,17,4,2,1259
E01024589,1322,11,14,6,0,1353
E01024590,1113,16,17,6,3,1155
E01024591,1357,12,20,23,1,1413
E01024592,1000,10,5,4,2,1021
E01024593,991,10,7,7,1,1016
E01024594,1175,5,9,0,2,1191
E01024595,1188,12,20,9,0,1229
E01024596,1236,13,6,1,0,1256
E01024597,1094,6,6,9,3,1118
E01024598,1180,6,19,10,0,1215
E01024599,1406,16,37,12,3,1474
E01024600,1192,13,11,6,1,1223
E01024601,1351,14,7,1,1,1374
E01024602,1211,6,11,4,7,1239
E01024603,985,7,3,2,1,998
E01024604,834,10,9,1,1,855
E01024605,1112,1,2,2,1,1118
E01024606,1110,8,11,6,1,1136
E01024608,1374,13,37,16,7,1447
E01024609,887,8,21,4,8,928
E01024610,1127,14,12,4,2,1159
E01024611,1082,13,8,3,3,1109
E01024612,1146,10,15,5,5,1181
E01024613,1065,4,16,9,5,1099
E01024614,1097,12,13,3,0,1125
E01024615,1090,9,4,7,1,1111
E01024616,1256,10,7,6,0,1279
E01024618,2353,67,96,158,11,2685
E01024619,1182,8,6,2,1,1199
E01024620,1061,5,5,2,0,1073
E01024621,897,8,0,5,2,912
E01024622,1350,7,13,6,3,1379
E01024623,1497,12,9,3,1,1522
E01024624,1419,7,16,6,3,1451
E01024625,1533,10,15,4,2,1564
E01024626,1230,10,6,4,3,1253
E01024627,1480,9,11,2,4,1506
E01024628,1196,7,9,1,2,1215
E01024629,921,4,4,2,0,931
E01024630,1393,3,15,6,2,1419
E01024631,1391,12,10,6,0,1419
E01024632,1319,8,14,3,4,1348
E01024633,1160,8,20,3,3,1194
E01024634,1009,13,24,8,2,1056
E01024635,1295,13,27,8,0,1343
E01024636,1797,11,21,6,10,1845
E01024637,1423,12,22,2,4,1463
E01024638,1368,7,18,3,3,1399
E01024639,1367,12,28,4,1,1412
E01024640,1339,8,15,3,3,1368
E01024641,1213,9,10,2,2,1236
E01024642,1258,9,12,7,4,1290
E01024643,982,14,16,3,10,1025
E01024644,1140,11,8,1,1,1161
E01024645,1135,9,15,9,0,1168
E01024646,1424,39,50,14,3,1530
E01024647,1151,25,21,17,8,1222
E01024648,1159,20,28,11,2,1220
E01024649,1336,22,44,21,4,1427
E01024650,1189,9,15,4,5,1222
E01024651,1201,14,30,10,3,1258
E01024652,1510,17,12,8,6,1553
E01024653,1314,14,20,2,2,1352
E01024654,1280,8,18,2,0,1308
E01024655,1213,7,9,6,5,1240
E01024656,1361,12,42,8,7,1430
E01024657,1536,36,66,40,14,1692
E01024658,1507,26,25,40,15,1613
E01024659,1169,19,21,15,9,1233
E01024660,1253,23,51,28,15,1370
E01024661,1063,20,21,14,7,1125
E01024662,1194,17,19,4,2,1236
E01024663,1057,6,12,10,2,1087
E01024664,1076,11,19,8,3,1117
E01024665,1124,9,17,1,2,1153
E01024666,1208,15,17,2,5,1247
E01024667,1366,26,42,6,2,1442
E01024668,879,20,55,17,2,973
E01024669,1249,14,25,7,4,1299
E01024670,1165,22,22,5,7,1221
E01024671,1332,13,41,13,4,1403
E01024672,1103,17,9,2,1,1132
E01024673,1456,5,11,3,4,1479
E01024674,1265,11,12,4,1,1293
E01024675,1772,17,30,10,11,1840
E01024676,1272,28,37,16,7,1360
E01024677,1236,19,35,18,3,1311
E01024678,1444,32,40,21,10,1547
E01024679,1122,10,4,1,1,1138
E01024680,1269,13,17,2,2,1303
E01024681,1267,18,22,9,2,1318
E01024682,1233,21,20,1,1,1276
E01024683,1221,12,14,10,3,1260
E01024684,1202,11,14,2,0,1229
E01024685,1410,13,15,7,1,1446
E01024686,1328,8,15,3,4,1358
E01024687,1094,12,7,2,2,1117
E01024688,1294,14,23,3,7,1341
E01024689,1018,3,35,2,0,1058
E01024690,1233,11,19,6,2,1271
E01024691,1016,7,22,4,2,1051
E01024692,1310,12,11,5,3,1341
E01024693,1084,6,17,7,1,1115
E01024694,1267,13,97,25,17,1419
E01024695,874,18,24,9,3,928
E01024696,1129,8,10,12,0,1159
E01024697,862,16,20,11,1,910
E01024698,1154,11,18,3,3,1189
E01024699,1327,13,15,6,3,1364
E01024700,1340,21,13,5,4,1383
E01024701,1630,14,8,1,0,1653
E01024702,1088,9,9,0,1,1107
E01024703,1397,8,13,3,0,1421
E01024704,1327,4,7,0,2,1340
E01024705,1077,13,36,2,1,1129
E01024706,1102,23,31,6,4,1166
E01024707,1080,9,6,3,2,1100
E01024708,1279,17,30,5,3,1334
E01024709,1128,6,20,7,0,1161
E01024710,873,19,32,17,5,946
E01024711,1169,11,25,6,2,1213
E01024712,1257,11,16,3,2,1289
E01024713,1280,15,8,0,4,1307
E01024714,1276,27,17,9,5,1334
E01024715,1509,25,30,14,3,1581
E01024716,1568,15,15,6,2,1606
E01024717,1310,8,20,0,7,1345
E01024718,1104,6,22,0,4,1136
E01024719,1531,15,25,4,6,1581
E01024720,1086,9,40,7,2,1144
E01024721,1023,5,23,10,0,1061
E01024722,1057,8,23,10,5,1103
E01024723,1207,12,10,3,2,1234
E01024724,1525,15,15,10,0,1565
E01024725,1291,8,30,2,3,1334
E01024726,1347,15,39,3,5,1409
E01024727,2130,17,39,11,3,2200
E01024728,1294,14,11,5,1,1325
E01024729,1298,10,33,5,12,1358
E01024730,1037,14,8,3,4,1066
E01024731,959,10,9,2,4,984
E01024732,1274,21,125,9,5,1434
E01024733,1320,11,54,6,8,1399
E01024734,1308,6,14,3,1,1332
E01024735,1227,13,30,1,1,1272
E01024736,1300,12,13,10,7,1342
E01024737,1683,19,56,20,5,1783
E01024740,1425,13,19,2,4,1463
E01024741,1079,10,22,5,5,1121
E01024742,1282,12,15,4,8,1321
E01024743,1479,2,13,2,3,1499
E01024744,1657,1,12,0,2,1672
E01024745,1520,10,20,2,4,1556
E01024746,854,6,4,6,0,870
E01024747,1195,5,17,9,2,1228
E01024748,1148,4,9,1,5,1167
E01024749,1131,6,13,1,11,1162
E01024750,1202,3,4,2,3,1214
E01024751,1261,7,16,0,1,1285
E01024752,1266,6,18,2,1,1293
E01024753,1260,5,17,5,1,1288
E01024754,1282,12,21,6,7,1328
E01024755,1549,9,23,3,2,1586
E01024756,1192,11,34,11,9,1257
E01024757,1198,10,69,1,12,1290
E01024758,1194,13,39,1,2,1249
E01024760,1073,11,27,9,5,1125
E01024761,1684,19,30,16,4,1753
E01024762,1606,25,26,11,5,1673
E01024763,1085,1,7,8,0,1101
E01024764,1020,9,17,5,6,1057
E01024765,1115,7,4,2,4,1132
E01024766,1579,15,63,7,4,1668
E01024767,1139,8,16,2,3,1168
E01024768,1299,12,55,5,10,1381
E01024771,1402,9,13,6,0,1430
E01024772,1304,4,19,1,4,1332
E01024773,1474,9,4,3,1,1491
E01024774,1915,25,26,6,2,1974
E01024775,1126,16,28,3,5,1178
E01024776,1003,9,15,1,2,1030
E01024777,990,1,32,2,1,1026
E01024778,1179,18,39,4,3,1243
E01024779,1388,20,74,9,8,1499
E01024780,1162,10,41,2,2,1217
E01024781,1633,13,24,5,1,1676
E01024782,1006,4,14,0,2,1026
E01024783,1388,19,22,7,1,1437
E01024784,1100,8,12,0,4,1124
E01024785,1144,10,9,4,1,1168
E01024786,1456,8,20,2,2,1488
E01024787,980,10,9,0,2,1001
E01024788,1131,8,3,3,0,1145
E01024789,1669,17,55,14,1,1756
E01024790,956,13,17,8,2,996
E01024791,1072,8,13,1,1,1095
E01024792,1471,15,5,1,4,1496
E01024793,1358,10,9,4,4,1385
E01024794,1269,12,7,0,0,1288
E01024795,991,15,47,20,9,1082
E01024796,1081,17,33,10,3,1144
E01024797,1347,10,39,4,9,1409
E01024798,1902,15,13,5,1,1936
E01024799,1600,32,62,8,5,1707
E01024800,1280,17,23,1,10,1331
E01024801,1983,27,243,30,15,2298
E01024802,1571,42,84,34,23,1754
E01024803,1762,6,3,0,4,1775
E01024804,1090,8,15,4,9,1126
E01024805,1294,13,13,5,0,1325
E01024806,1385,10,28,24,1,1448
E01024807,1242,11,15,3,2,1273
E01024808,1292,11,5,1,2,1311
E01024809,1179,5,5,2,2,1193
E01024810,1290,5,6,4,6,1311
E01024811,991,14,7,7,1,1020
E01024812,1020,8,9,2,0,1039
E01024813,1330,13,31,7,8,1389
E01024814,1064,3,11,2,2,1082
E01024815,1027,11,8,1,0,1047
E01024816,1016,10,5,7,1,1039
E01024817,1407,21,15,5,4,1452
E01024818,1375,16,10,4,2,1407
E01024819,1414,24,40,7,9,1494
E01024820,1214,22,37,3,7,1283
E01024821,1655,18,27,6,3,1709
E01024822,1500,11,64,21,3,1599
E01024823,1409,29,73,14,18,1543
E01024824,1209,19,14,4,7,1253
E01024825,1214,9,24,7,4,1258
E01024826,1166,5,20,0,7,1198
E01024827,1175,8,28,7,1,1219
E01024828,1161,9,30,2,5,1207
E01024829,1271,16,12,2,9,1310
E01024830,1398,11,135,5,2,1551
E01024831,1071,15,25,2,5,1118
E01024832,1225,21,48,10,1,1305
E01024833,1788,14,148,19,12,1981
E01024834,1630,34,46,16,8,1734
E01024835,1526,29,53,19,7,1634
E01024836,1252,28,48,5,8,1341
E01024837,1323,22,50,16,4,1415
E01024838,1234,22,51,11,4,1322
E01024839,1313,22,54,4,1,1394
E01024840,1324,21,47,10,4,1406
E01024841,1391,21,55,20,12,1499
E01024842,1217,16,53,8,13,1307
E01024843,1073,13,20,6,4,1116
E01024844,1205,20,34,10,5,1274
E01024845,1020,7,31,3,4,1065
E01024846,1225,15,32,6,0,1278
E01024847,1213,16,34,8,9,1280
E01024848,1083,9,25,4,2,1123
E01024849,1280,13,13,9,4,1319
E01024850,1038,8,8,1,0,1055
E01024851,1296,16,24,1,1,1338
E01024852,1042,11,14,12,4,1083
E01024853,1101,12,12,2,0,1127
E01024854,1247,19,12,5,2,1285
E01024855,1196,9,26,0,3,1234
E01024856,685,17,433,8,5,1148
E01024857,992,11,197,2,4,1206
E01024858,740,16,253,11,15,1035
E01024859,1240,10,8,1,1,1260
E01024860,1046,4,4,0,2,1056
E01024861,1032,14,40,5,1,1092
E01024862,1262,2,23,4,0,1291
E01024863,1088,8,30,5,0,1131
E01024864,1298,9,14,0,1,1322
E01024865,1193,4,20,8,1,1226
E01024866,1472,7,19,1,0,1499
E01024867,1212,2,3,1,1,1219
E01024868,998,4,5,0,0,1007
E01024869,1240,4,6,0,1,1251
E01024870,971,1,5,0,1,978
E01024871,1129,1,9,2,0,1141
E01024872,1027,14,23,3,1,1068
E01024873,1128,8,5,1,0,1142
E01024874,874,5,9,0,0,888
E01024875,190,13,702,2,16,923
E01024876,299,17,677,4,8,1005
E01024877,316,25,727,9,4,1081
E01024878,126,9,863,8,8,1014
E01024879,1032,9,15,1,0,1057
E01024880,1210,1,9,1,1,1222
E01024881,1117,7,12,3,0,1139
E01024882,1160,6,9,6,1,1182
E01024883,1184,5,19,2,0,1210
E01024884,1305,6,6,1,3,1321
E01024885,1320,4,14,1,0,1339
E01024886,1069,2,19,2,1,1093
E01024887,1165,2,11,2,0,1180
E01024888,1393,4,14,1,1,1413
E01024889,1083,6,11,3,2,1105
E01024890,1091,6,6,4,1,1108
E01024891,1058,14,200,6,7,1285
E01024892,1079,12,85,4,6,1186
E01024893,857,11,257,3,10,1138
E01024894,1046,12,31,1,0,1090
E01024895,656,12,340,4,9,1021
E01024896,977,14,115,1,13,1120
E01024897,884,5,272,1,2,1164
E01024898,938,21,251,1,10,1221
E01024899,1199,11,25,6,11,1252
E01024900,1166,11,15,5,3,1200
E01024901,1472,6,13,3,2,1496
E01024902,1197,2,11,1,1,1212
E01024903,933,8,16,1,1,959
E01024904,1381,17,46,2,0,1446
E01024905,1022,8,11,0,1,1042
E01024906,1220,11,20,4,1,1256
E01024907,967,14,18,2,0,1001
E01024908,845,12,8,0,0,865
E01024909,1165,20,56,8,0,1249
E01024910,1143,9,29,1,2,1184
E01024911,1391,15,22,1,7,1436
E01024912,1148,3,32,2,4,1189
E01024913,1007,6,38,3,2,1056
E01024914,1226,4,29,2,0,1261
E01024915,1708,6,12,3,2,1731
E01024916,1405,9,7,0,0,1421
E01024917,1358,5,25,1,1,1390
E01024918,1453,4,10,4,0,1471
E01024919,1936,15,48,13,15,2027
E01024920,1668,11,20,5,2,1706
E01024921,1800,7,6,4,3,1820
E01024922,1123,5,10,3,0,1141
E01024923,1048,3,5,4,0,1060
E01024924,1201,1,8,0,0,1210
E01024925,1128,9,139,7,9,1292
E01024926,1406,17,75,10,7,1515
E01024927,1301,5,24,7,0,1337
E01024928,1207,13,31,2,0,1253
E01024929,1000,7,24,0,0,1031
E01024930,1107,6,26,9,0,1148
E01024931,1121,9,44,8,5,1187
E01024932,852,1,12,0,1,866
E01024933,1104,11,23,5,2,1145
E01024934,1258,8,15,3,2,1286
E01024935,1193,3,3,6,2,1207
E01024936,1269,10,24,5,3,1311
E01024937,1217,11,33,6,3,1270
E01024938,1323,9,6,4,1,1343
E01024939,1407,9,9,3,0,1428
E01024940,1342,6,61,7,1,1417
E01024941,1234,9,25,3,0,1271
E01024942,1281,4,9,1,5,1300
E01024943,1658,18,10,16,0,1702
E01024944,1305,8,13,3,2,1331
E01024945,2104,19,37,9,6,2175
E01024946,974,10,13,1,5,1003
E01024947,1000,10,7,8,2,1027
E01024948,1186,8,1,4,0,1199
E01024949,1779,15,20,12,3,1829
E01024950,1042,10,17,1,0,1070
E01024951,877,15,8,5,3,908
E01024952,1075,9,12,8,5,1109
E01024953,1067,12,12,22,2,1115
E01024954,1149,13,9,15,2,1188
E01024955,1240,4,20,4,0,1268
E01024956,1207,7,12,1,1,1228
E01024957,1184,9,11,1,1,1206
E01024958,1040,4,8,5,0,1057
E01024959,1355,6,15,0,1,1377
E01024960,1244,7,5,2,5,1263
E01024961,1335,5,0,2,0,1342
E01024962,1314,7,6,3,1,1331
E01024963,1263,2,4,1,0,1270
E01024964,1209,8,3,0,1,1221
E01024965,1177,4,1,2,1,1185
E01024966,1256,7,8,1,1,1273
E01024967,1076,9,9,2,1,1097
E01024968,1380,3,11,4,5,1403
E01024969,1115,7,8,8,1,1139
E01024970,1094,3,11,3,3,1114
E01024971,1073,5,13,1,2,1094
E01024972,1071,5,4,2,2,1084
E01024973,1761,8,16,0,0,1785
E01024974,1246,4,6,1,2,1259
E01024975,2629,66,120,75,15,2905
E01024976,1256,5,9,4,1,1275
E01024977,1763,8,22,4,2,1799
E01024978,1035,2,7,3,1,1048
E01024979,1129,2,11,0,0,1142
E01024980,1113,2,9,0,3,1127
E01024981,1186,4,14,3,4,1211
E01024982,1188,10,12,5,5,1220
E01024983,1132,8,8,3,3,1154
E01024984,1230,10,5,4,0,1249
E01024985,1146,5,16,3,2,1172
E01024986,1331,12,26,3,9,1381
E01024987,1023,25,29,8,7,1092
E01024988,1377,11,18,3,3,1412
E01024989,1203,7,4,3,2,1219
E01024990,1325,10,20,3,5,1363
E01024991,890,4,18,2,2,916
E01024992,1197,3,10,1,4,1215
E01024993,1208,3,4,1,0,1216
E01024994,1346,7,9,2,4,1368
E01024995,1209,11,14,1,2,1237
E01024996,1044,11,14,4,3,1076
E01024997,1243,1,3,1,3,1251
E01024998,1356,6,8,3,2,1375
E01024999,1271,3,4,0,0,1278
E01025000,1110,2,2,0,1,1115
E01025001,1312,4,12,0,4,1332
E01025002,1137,10,9,0,4,1160
E01025003,1378,4,19,1,0,1402
E01025004,1067,6,11,2,1,1087
E01025005,1271,8,4,2,1,1286
E01025006,1030,8,16,1,0,1055
E01025007,1019,4,14,1,0,1038
E01025008,966,3,0,3,1,973
E01025009,1233,3,5,3,2,1246
E01025010,1469,43,60,19,4,1595
E01025011,1183,7,14,4,2,1210
E01025012,1566,11,20,2,2,1601
E01025013,1223,9,33,1,5,1271
E01025014,1365,5,4,1,0,1375
E01025015,1261,4,6,0,0,1271
E01025016,1885,19,47,1,8,1960
E01025017,1236,6,14,2,1,1259
E01025018,1025,5,18,0,7,1055
E01025019,1170,4,11,1,1,1187
E01025020,987,8,12,2,2,1011
E01025021,1180,12,18,2,4,1216
E01025022,1449,15,14,3,2,1483
E01025023,1116,3,2,1,4,1126
E01025024,1165,8,6,4,6,1189
E01025025,1198,12,9,0,2,1221
E01025026,1119,7,6,7,3,1142
E01025027,1300,17,36,14,2,1369
E01025028,1105,7,4,5,1,1122
E01025029,1680,7,6,2,3,1698
E01025030,1220,13,20,3,2,1258
E01025031,1018,5,13,1,2,1039
E01025032,1126,4,22,0,3,1155
E01025033,1640,5,51,1,4,1701
E01025034,1318,0,46,0,3,1367
E01025035,1154,2,84,0,3,1243
E01025036,1091,9,130,2,7,1239
E01025037,1097,5,49,5,2,1158
E01025038,1112,6,16,2,0,1136
E01025039,995,6,10,0,2,1013
E01025040,1187,5,29,1,2,1224
E01025041,675,9,535,0,6,1225
E01025042,366,11,1054,2,5,1438
E01025044,792,9,140,1,3,945
E01025045,892,4,15,0,2,913
E01025046,950,4,43,3,1,1001
E01025048,1282,4,27,3,1,1317
E01025049,1259,5,31,0,0,1295
E01025050,1234,4,20,2,4,1264
E01025051,1085,4,22,2,0,1113
E01025052,1207,2,29,1,0,1239
E01025053,1195,5,24,1,0,1225
E01025054,1413,9,13,0,2,1437
E01025055,1159,4,24,2,1,1190
E01025056,1140,5,9,0,0,1154
E01025057,1203,15,101,3,1,1323
E01025058,1091,4,50,3,1,1149
E01025059,1158,6,37,1,0,1202
E01025060,899,6,206,1,1,1113
E01025061,1144,5,108,1,2,1260
E01025062,990,11,197,1,1,1200
E01025063,1229,6,23,0,4,1262
E01025064,1333,4,28,4,1,1370
E01025065,1296,11,29,2,0,1338
E01025066,1177,14,42,2,3,1238
E01025067,1128,10,59,2,3,1202
E01025068,1044,16,107,6,1,1174
E01025069,1081,3,36,3,0,1123
E01025070,857,6,16,7,0,886
E01025071,1132,1,6,2,5,1146
E01025072,1044,6,28,1,1,1080
E01025073,1063,4,8,0,1,1076
E01025074,1158,6,11,3,0,1178
E01025075,1299,4,41,2,6,1352
E01025076,1054,4,14,2,5,1079
E01025077,1123,5,21,5,0,1154
E01025078,1213,1,26,2,7,1249
E01025079,1376,19,19,2,3,1419
E01025080,1317,3,27,2,1,1350
E01025081,1322,7,16,2,0,1347
E01025082,1013,13,215,3,0,1244
E01025083,1217,19,236,3,13,1488
E01025084,606,7,529,0,2,1144
E01025085,1149,4,4,0,1,1158
E01025086,1213,0,1,1,1,1216
E01025087,1142,12,9,2,1,1166
E01025088,895,1,9,0,0,905
E01025089,1164,3,7,1,0,1175
E01025090,1430,5,4,1,0,1440
E01025091,1143,7,14,0,3,1167
E01025092,942,2,5,1,1,951
E01025093,1425,19,86,16,5,1551
E01025094,1081,13,38,7,4,1143
E01025095,1176,27,33,9,5,1250
E01025096,1258,1,9,9,0,1277
E01025097,1161,1,11,14,2,1189
E01025098,1146,6,8,15,1,1176
E01025099,1270,11,36,22,3,1342
E01025100,1227,15,20,8,4,1274
E01025101,1055,6,17,9,1,1088
E01025102,1020,13,192,7,4,1236
E01025103,1049,3,25,5,2,1084
E01025105,4659,87,1038,67,38,5889
E01025106,1983,25,95,14,7,2124
E01025107,1336,8,18,5,6,1373
E01025108,1011,3,3,3,0,1020
E01025109,841,2,2,0,0,845
E01025110,1118,3,25,5,3,1154
E01025111,1397,10,7,4,1,1419
E01025112,1298,13,24,10,4,1349
E01025113,1249,8,12,0,1,1270
E01025114,1269,6,1,2,1,1279
E01025115,1192,7,9,1,2,1211
E01025116,1195,6,5,1,0,1207
E01025117,1048,4,30,10,1,1093
E01025118,849,7,13,5,3,877
E01025119,1108,6,6,1,3,1124
E01025120,1067,3,18,2,0,1090
E01025121,1375,7,6,4,3,1395
E01025122,1403,11,9,0,2,1425
E01025123,1756,8,11,5,4,1784
E01025124,1141,6,11,7,2,1167
E01025125,1173,23,53,14,5,1268
E01025126,1513,19,36,9,3,1580
E01025127,1137,4,30,1,2,1174
E01025128,1115,17,39,12,1,1184
E01025129,955,9,107,16,5,1092
E01025130,1799,2,2,2,4,1809
E01025131,1259,4,11,0,2,1276
E01025132,1259,1,3,0,1,1264
E01025133,1187,6,7,1,0,1201
E01025136,1147,6,12,3,2,1170
E01025137,1148,8,7,2,4,1169
E01025138,1094,3,16,6,1,1120
E01025139,1257,18,50,27,5,1357
E01025140,1271,19,10,8,2,1310
E01025141,1143,8,29,5,4,1189
E01025142,1231,7,20,10,1,1269
E01025143,1151,10,27,12,6,1206
E01025144,1386,13,240,15,14,1668
E01025145,1120,11,23,5,3,1162
E01025146,1561,19,48,10,4,1642
E01025147,1116,23,39,11,11,1200
E01025148,1750,4,3,8,0,1765
E01025149,1680,12,11,0,2,1705
E01025150,1150,19,20,3,0,1192
E01025151,1223,22,19,14,9,1287
E01025152,1143,3,9,2,0,1157
E01025153,984,1,12,3,1,1001
E01025154,1018,11,11,1,1,1042
E01025155,1015,3,7,3,3,1031
E01025156,775,5,14,0,0,794
E01025157,938,8,12,5,0,963
E01025158,1214,7,6,0,1,1228
E01025159,1223,5,17,0,0,1245
E01025160,1064,5,10,0,3,1082
E01025161,1029,4,2,1,0,1036
E01025162,1175,5,6,1,0,1187
E01025163,1200,4,2,1,0,1207
E01025164,1176,5,6,1,1,1189
E01025165,1127,5,17,4,1,1154
E01025166,1004,7,2,0,0,1013
E01025167,961,2,3,1,1,968
E01025168,910,6,1,0,1,918
E01025169,1049,3,5,0,0,1057
E01025170,1409,4,7,0,1,1421
E01025171,1301,8,11,7,2,1329
E01025172,1221,10,9,1,0,1241
E01025173,1328,8,2,2,0,1340
E01025174,1096,5,121,2,4,1228
E01025175,1297,5,11,2,0,1315
E01025176,1640,7,13,0,1,1661
E01025177,1507,5,21,2,4,1539
E01025178,1514,2,7,1,1,1525
E01025179,1298,7,7,0,0,1312
E01025180,1520,5,8,4,0,1537
E01025181,893,9,223,1,1,1127
E01025182,578,12,617,1,6,1214
E01025183,839,17,423,5,4,1288
E01025184,317,21,803,0,4,1145
E01025185,872,12,614,2,2,1502
E01025186,640,18,452,13,8,1131
E01025187,897,5,239,3,5,1149
E01025188,984,10,530,5,6,1535
E01025189,986,13,260,2,2,1263
E01025190,1100,4,237,3,5,1349
E01025191,996,4,30,0,1,1031
E01025192,1105,4,23,0,0,1132
E01025193,1126,2,4,1,0,1133
E01025194,1077,5,37,1,1,1121
E01025195,985,6,14,1,0,1006
E01025196,1312,6,24,0,7,1349
E01025197,1132,2,7,0,0,1141
E01025198,1081,4,49,2,2,1138
E01025199,1371,8,22,3,0,1404
E01025200,1201,7,27,0,0,1235
E01025201,1278,5,7,1,0,1291
E01025202,1126,9,8,1,1,1145
E01025203,1427,6,11,2,1,1447
E01025204,1384,7,15,0,0,1406
E01025205,1056,5,10,1,0,1072
E01025206,990,1,11,0,1,1003
E01025207,1061,4,29,0,1,1095
E01025208,1083,10,6,2,1,1102
E01025209,1268,7,59,1,1,1336
E01025210,1334,14,74,0,0,1422
E01025211,1218,5,14,1,2,1240
E01025212,831,4,313,1,5,1154
E01025213,521,8,321,5,1,856
E01025214,1046,3,108,2,3,1162
E01025215,522,12,508,4,1,1047
E01025216,1299,10,273,1,11,1594
E01025217,808,18,337,0,5,1168
E01025218,490,20,413,1,2,926
E01025219,695,7,170,5,1,878
E01025220,1119,6,15,2,0,1142
E01025221,981,2,13,0,0,996
E01025222,1187,6,12,0,1,1206
E01025223,1112,8,28,3,1,1152
E01025224,629,19,898,0,0,1546
E01025225,932,13,355,0,2,1302
E01025226,1205,12,45,4,6,1272
E01025227,1460,8,145,5,1,1619
E01025228,1214,17,29,2,1,1263
E01025229,447,18,1114,1,1,1581
E01025230,412,9,768,3,3,1195
E01025231,1128,6,73,4,0,1211
E01025232,1234,30,67,7,7,1345
E01025233,1053,12,45,15,1,1126
E01025234,1066,17,52,7,2,1144
E01025235,1176,15,141,21,4,1357
E01025236,929,25,64,16,7,1041
E01025237,1059,22,91,12,5,1189
E01025238,1096,18,35,7,1,1157
E01025239,1100,11,67,9,1,1188
E01025240,1288,5,37,6,10,1346
E01025241,1104,14,186,10,6,1320
E01025242,1075,13,218,9,8,1323
E01025243,1180,32,332,21,17,1582
E01025244,210,22,929,22,26,1209
E01025245,1279,43,513,27,12,1874
E01025246,244,14,956,18,14,1246
E01025247,590,20,605,27,32,1274
E01025248,796,19,73,18,8,914
E01025249,787,13,33,12,5,850
E01025250,705,30,450,34,1,1220
E01025251,776,14,345,19,13,1167
E01025252,1058,17,97,11,5,1188
E01025253,1144,18,180,18,1,1361
E01025254,877,2,103,8,3,993
E01025255,1021,12,140,12,11,1196
E01025256,1059,9,156,12,3,1239
E01025257,1054,7,65,4,0,1130
E01025258,1129,7,108,6,7,1257
E01025259,1589,10,103,5,1,1708
E01025260,1120,25,18,21,2,1186
E01025261,1155,15,37,12,2,1221
E01025262,1196,20,26,12,0,1254
E01025263,1112,23,27,16,3,1181
E01025264,1073,40,27,11,3,1154
E01025265,1174,15,15,5,1,1210
E01025266,994,2,39,9,0,1044
E01025267,1095,11,45,6,1,1158
E01025268,1284,14,22,7,3,1330
E01025269,1166,18,28,7,2,1221
E01025270,1279,13,24,7,0,1323
E01025271,1188,14,38,6,4,1250
E01025272,1186,8,40,4,8,1246
E01025273,1031,5,39,7,0,1082
E01025274,1410,43,185,15,5,1658
E01025275,1175,29,132,27,3,1366
E01025276,1043,22,292,17,4,1378
E01025277,1399,17,44,1,3,1464
E01025278,1991,7,20,8,1,2027
E01025279,1583,7,5,3,0,1598
E01025280,1442,6,32,1,4,1485
E01025281,1191,6,20,2,5,1224
E01025282,1127,4,14,4,0,1149
E01025283,1066,24,14,19,3,1126
E01025284,1261,26,82,11,1,1381
E01025285,880,29,152,12,0,1073
E01025286,1165,32,24,31,1,1253
E01025287,1440,48,40,28,5,1561
E01025288,1219,33,96,21,16,1385
E01025289,968,34,362,32,65,1461
E01025290,942,34,464,30,19,1489
E01025291,883,18,209,19,4,1133
E01025292,2390,97,370,75,67,2999
E01025293,894,53,617,32,55,1651
E01025294,755,31,568,45,10,1409
E01025295,1690,59,388,43,27,2207
E01025296,923,45,398,34,8,1408
E01025297,1002,37,414,26,21,1500
E01025298,675,32,422,17,23,1169
E01025299,1036,6,140,4,6,1192
E01025300,903,7,112,6,15,1043
E01025301,794,7,80,4,5,890
E01025302,899,7,109,20,2,1037
E01025303,999,9,102,9,5,1124
E01025304,650,23,659,21,7,1360
E01025305,597,25,621,34,8,1285
E01025306,1096,41,352,23,49,1561
E01025308,1187,22,159,22,4,1394
E01025309,851,14,73,5,3,946
E01025310,1140,23,92,30,1,1286
E01025311,1016,20,47,10,5,1098
E01025312,1285,26,35,13,3,1362
E01025313,1532,35,171,51,5,1794
E01025314,2032,64,324,46,16,2482
E01025315,1256,9,29,33,2,1329
E01025316,1195,1,6,0,0,1202
E01025317,867,2,11,1,0,881
E01025318,835,2,1,1,0,839
E01025319,1563,11,21,2,4,1601
E01025320,1083,6,4,0,0,1093
E01025321,1107,1,2,0,0,1110
E01025322,1117,3,4,0,0,1124
E01025323,921,1,16,1,5,944
E01025324,1218,4,10,1,3,1236
E01025325,1238,6,12,0,1,1257
E01025326,1241,9,3,0,0,1253
E01025327,1055,3,3,0,0,1061
E01025328,980,1,6,0,0,987
E01025329,1157,0,18,0,0,1175
E01025330,1092,7,15,0,0,1114
E01025331,1133,4,8,0,0,1145
E01025332,839,2,29,1,3,874
E01025333,993,11,14,1,0,1019
E01025334,1253,4,28,2,0,1287
E01025335,1083,6,36,1,1,1127
E01025336,922,3,13,0,0,938
E01025337,1274,8,14,0,4,1300
E01025338,1277,3,19,2,0,1301
E01025339,1188,10,22,0,0,1220
E01025340,1119,6,12,0,1,1138
E01025341,950,2,9,1,3,965
E01025342,1284,8,4,0,1,1297
E01025343,1133,7,3,0,0,1143
E01025344,1111,3,4,0,0,1118
E01025345,1165,2,4,1,1,1173
E01025346,1167,3,28,2,2,1202
E01025347,1255,5,35,2,0,1297
E01025348,1337,5,0,0,0,1342
E01025349,1153,3,5,0,0,1161
E01025350,1059,3,4,0,0,1066
E01025351,1998,12,48,2,0,2060
E01025352,1169,6,41,2,0,1218
E01025353,857,5,8,1,0,871
E01025354,1074,1,2,2,5,1084
E01025355,1697,8,79,2,2,1788
E01025356,1013,12,171,1,0,1197
E01025357,1054,5,18,4,0,1081
E01025358,1805,6,19,3,0,1833
E01025359,1353,9,16,1,2,1381
E01025360,1605,10,7,5,0,1627
E01025361,1646,6,31,5,4,1692
E01025362,1561,6,11,0,0,1578
E01025363,1074,6,41,1,4,1126
E01025364,1058,10,37,5,0,1110
E01025365,1226,12,23,1,0,1262
E01025366,841,15,277,5,2,1140
E01025367,1394,9,10,2,0,1415
E01025368,1278,4,8,4,0,1294
E01025369,950,4,18,5,0,977
E01025370,1001,4,12,2,1,1020
E01025371,1087,6,26,1,2,1122
E01025373,1186,9,94,2,1,1292
E01025374,1199,7,10,5,0,1221
E01025375,1364,6,15,1,0,1386
E01025376,1675,14,21,3,0,1713
E01025377,1112,4,13,7,4,1140
E01025378,1192,4,18,8,2,1224
E01025379,1151,2,21,0,0,1174
E01025380,1195,3,15,2,1,1216
E01025381,1091,8,15,0,1,1115
E01025382,1344,4,9,4,0,1361
E01025383,1780,12,30,2,0,1824
E01025384,1019,4,24,2,2,1051
E01025385,960,5,25,0,0,990
E01025387,956,11,82,0,0,1049
E01025388,1151,2,21,1,1,1176
E01025389,929,16,16,1,0,962
E01025390,870,1,10,1,1,883
E01025391,1151,6,5,0,2,1164
E01025392,1019,6,5,0,0,1030
E01025393,1197,10,3,1,0,1211
E01025394,1178,4,24,4,3,1213
E01025395,1265,3,31,0,3,1302
E01025396,923,12,153,1,1,1090
E01025397,924,5,318,5,13,1265
E01025398,873,15,118,4,8,1018
E01025399,1146,11,18,4,0,1179
E01025400,1436,8,10,5,2,1461
E01025401,1210,9,16,7,6,1248
E01025402,1087,13,19,6,0,1125
E01025403,1455,8,67,8,3,1541
E01025404,1060,2,4,4,2,1072
E01025405,1008,9,9,8,2,1036
E01025406,1033,5,10,2,1,1051
E01025407,1498,10,34,2,0,1544
E01025408,1218,7,33,5,1,1264
E01025409,1069,9,23,7,3,1111
E01025410,1040,0,65,2,1,1108
E01025411,1580,18,58,4,4,1664
E01025412,1188,6,15,6,0,1215
E01025413,1479,12,10,1,0,1502
E01025414,1362,9,4,0,0,1375
E01025415,1638,11,7,2,6,1664
E01025416,1282,1,1,3,0,1287
E01025417,1205,5,12,1,0,1223
E01025418,1141,3,5,3,0,1152
E01025419,1260,8,13,4,0,1285
E01025420,2182,16,30,4,0,2232
E01025421,1672,20,40,7,5,1744
E01025422,1105,14,10,4,3,1136
E01025423,1004,4,12,1,3,1024
E01025424,995,3,22,1,2,1023
E01025425,1092,9,8,1,0,1110
E01025426,995,2,33,1,0,1031
E01025427,1176,11,21,8,0,1216
E01025428,1212,15,34,3,1,1265
E01025429,1003,9,12,5,0,1029
E01025430,1575,9,10,3,3,1600
E01025431,1334,11,24,5,2,1376
E01025433,1464,9,22,0,4,1499
E01025434,1683,5,9,5,2,1704
E01025435,1248,6,14,2,3,1273
E01025436,1855,5,12,7,2,1881
E01025437,1461,8,11,1,0,1481
E01025438,1108,3,1,2,1,1115
E01025439,1143,5,7,1,2,1158
E01025440,1186,1,3,2,3,1195
E01025441,1201,5,6,1,0,1213
E01025442,849,11,6,3,1,870
E01025443,1158,5,11,2,0,1176
E01025444,1061,3,9,2,1,1076
E01025445,977,18,7,2,4,1008
E01025446,1276,7,6,0,0,1289
E01025447,869,12,16,2,1,900
E01025448,1285,12,32,6,5,1340
E01025449,800,4,32,5,1,842
E01025450,774,11,12,1,2,800
E01025451,1523,12,6,0,0,1541
E01025452,1307,4,15,1,2,1329
E01025453,1350,21,26,2,0,1399
E01025454,1032,5,6,6,1,1050
E01025455,1220,7,12,1,2,1242
E01025456,988,10,15,0,0,1013
E01025457,1116,4,39,4,2,1165
E01025458,1187,9,20,0,2,1218
E01025459,1387,3,5,3,1,1399
E01025460,1646,12,17,4,1,1680
E01025461,1487,17,34,3,2,1543
E01025462,1373,9,17,8,0,1407
E01025463,1120,5,6,1,2,1134
E01025464,1050,2,14,3,1,1070
E01025465,902,9,11,3,4,929
E01025466,1144,8,46,4,4,1206
E01025467,1654,9,58,7,3,1731
E01025468,1314,8,3,1,0,1326
E01025469,1299,11,14,2,1,1327
E01025470,1171,8,17,2,3,1201
E01025471,1102,13,4,3,1,1123
E01025472,1123,9,24,3,0,1159
E01025473,1230,3,4,2,0,1239
E01025474,941,7,6,0,0,954
E01025475,1228,8,11,0,1,1248
E01025476,1122,7,6,1,0,1136
E01025477,1006,2,5,2,1,1016
E01025478,982,1,16,5,0,1004
E01025479,1677,4,12,2,3,1698
E01025480,1063,9,3,1,0,1076
E01025481,1129,7,11,2,0,1149
E01025482,1033,12,4,2,0,1051
E01025483,1766,5,7,2,4,1784
E01025484,1565,6,19,4,1,1595
E01025485,1354,6,20,2,0,1382
E01025486,1300,5,6,4,7,1322
E01025487,1313,2,7,0,3,1325
E01025488,1725,13,41,7,8,1794
E01025489,1090,5,11,3,7,1116
E01025490,1535,23,28,15,0,1601
E01025491,1366,11,35,14,1,1427
E01025492,1003,7,7,0,0,1017
E01025493,1126,7,13,5,0,1151
E01025494,1164,9,8,4,3,1188
E01025495,1728,9,7,2,0,1746
E01025496,961,1,3,1,7,973
E01025497,1203,7,2,0,1,1213
E01025498,1060,6,6,0,0,1072
E01025499,1145,7,10,2,0,1164
E01025500,1225,12,12,5,0,1254
E01025501,955,5,6,2,1,969
E01025502,1295,5,6,3,1,1310
E01025503,947,19,14,3,1,984
E01025504,807,14,9,0,1,831
E01025505,1142,9,5,2,2,1160
E01025506,1666,5,15,0,0,1686
E01025507,1254,8,15,3,3,1283
E01025508,1185,6,5,2,1,1199
E01025509,1003,6,5,0,1,1015
E01025510,1145,5,21,0,1,1172
E01025511,932,7,4,0,2,945
E01025512,1031,6,2,1,1,1041
E01025513,1666,8,8,3,1,1686
E01025514,1868,18,19,0,2,1907
E01025515,1397,5,5,0,1,1408
E01025516,1222,2,17,1,4,1246
E01025517,1209,9,16,2,1,1237
E01025518,1251,12,12,3,0,1278
E01025519,1068,7,11,1,1,1088
E01025520,966,8,3,2,0,979
E01025521,1239,5,5,6,0,1255
E01025522,975,4,10,1,0,990
E01025523,1305,5,6,0,3,1319
E01025524,1208,12,16,0,0,1236
E01025525,1258,10,7,0,3,1278
E01025526,1391,16,8,1,1,1417
E01025527,1054,9,13,0,2,1078
E01025528,1216,15,5,2,2,1240
E01025529,1351,6,12,2,4,1375
E01025530,1220,3,2,1,5,1231
E01025531,968,6,7,0,0,981
E01025532,1222,1,11,1,0,1235
E01025533,1294,8,12,0,3,1317
E01025534,1388,6,3,0,2,1399
E01025535,1188,8,7,0,3,1206
E01025536,1179,7,14,0,2,1202
E01025537,1259,2,1,0,0,1262
E01025538,1271,6,16,0,4,1297
E01025539,1097,3,1,2,2,1105
E01025540,1025,3,3,3,0,1034
E01025541,1328,8,3,0,2,1341
E01025542,1393,9,11,2,0,1415
E01025543,1373,7,8,1,0,1389
E01025544,1288,3,7,1,0,1299
E01025545,1592,13,9,5,5,1624
E01025546,1218,5,7,2,3,1235
E01025547,1639,9,16,1,0,1665
E01025548,1355,4,2,0,1,1362
E01025549,1714,10,16,4,0,1744
E01025550,1257,3,7,1,1,1269
E01025551,1084,5,7,3,1,1100
E01025552,1044,1,7,2,3,1057
E01025553,2090,5,10,6,1,2112
E01025554,1336,6,6,0,0,1348
E01025555,1194,3,6,1,1,1205
E01025556,1212,7,12,4,3,1238
E01025557,1263,2,7,1,2,1275
E01025558,1486,7,10,0,3,1506
E01025559,1496,8,23,0,5,1532
E01025560,1158,7,5,4,1,1175
E01025561,1195,4,8,1,2,1210
E01025562,1750,2,8,5,2,1767
E01025563,1007,3,1,1,1,1013
E01025564,1343,3,13,0,2,1361
E01025565,1272,2,4,0,1,1279
E01025566,1647,9,20,1,1,1678
E01025567,1295,2,14,5,1,1317
E01025568,1436,6,15,2,0,1459
E01025569,1581,7,10,2,2,1602
E01025570,1121,8,12,6,0,1147
E01025571,1100,8,14,2,2,1126
E01025572,1197,7,7,2,0,1213
E01025573,1149,6,3,1,0,1159
E01025574,1203,4,19,0,0,1226
E01025575,867,6,0,0,1,874
E01025576,1924,14,12,5,1,1956
E01025577,1147,12,6,2,1,1168
E01025578,1214,2,2,1,1,1220
E01025579,1003,6,6,0,0,1015
E01025580,1077,4,11,3,3,1098
E01025581,1151,6,11,2,1,1171
E01025582,980,6,17,0,2,1005
E01025583,1009,6,13,1,2,1031
E01025584,1219,17,80,6,8,1330
E01025585,1896,4,1,4,2,1907
E01025586,1344,5,3,1,0,1353
E01025587,1300,4,3,1,0,1308
E01025588,1251,6,13,0,3,1273
E01025589,990,2,12,0,4,1008
E01025590,1194,4,5,1,0,1204
E01025591,1383,7,8,0,0,1398
E01025592,1101,2,7,0,0,1110
E01025593,1366,3,167,3,4,1543
E01025594,1354,4,6,0,0,1364
E01025595,1237,3,1,1,2,1244
E01025596,1593,4,3,3,1,1604
E01025597,871,5,3,2,3,884
E01025598,1257,5,3,2,6,1273
E01025599,833,4,7,2,0,846
E01025600,1261,3,13,1,1,1279
E01025601,1218,1,8,0,0,1227
E01025602,1247,4,15,3,2,1271
E01025603,1305,4,8,1,0,1318
E01025604,1240,6,11,1,0,1258
E01025605,1181,4,3,0,1,1189
E01025606,936,2,4,0,0,942
E01025607,1292,4,6,2,0,1304
E01025608,1339,4,7,0,1,1351
E01025609,1670,6,12,2,3,1693
E01025610,1205,16,15,5,1,1242
E01025611,1188,3,27,4,2,1224
E01025612,1301,10,27,14,8,1360
E01025613,1172,8,5,6,1,1192
E01025614,1361,8,12,4,1,1386
E01025615,1124,10,48,11,1,1194
E01025616,1305,10,16,1,1,1333
E01025617,1388,3,14,2,2,1409
E01025618,1344,3,10,1,0,1358
E01025619,1361,9,11,2,3,1386
E01025620,858,11,3,4,1,877
E01025621,865,6,14,4,0,889
E01025622,1313,8,24,10,8,1363
E01025623,1218,9,58,7,6,1298
E01025624,1241,11,169,12,7,1440
E01025625,943,14,14,7,3,981
E01025626,1023,5,10,6,1,1045
E01025627,1691,15,53,16,6,1781
E01025629,1189,10,27,11,6,1243
E01025630,1268,16,123,14,6,1427
E01025631,877,13,54,6,5,955
E01025632,754,12,296,16,7,1085
E01025633,1260,11,115,19,9,1414
E01025634,985,9,161,10,12,1177
E01025635,977,15,41,9,8,1050
E01025636,888,12,200,24,7,1131
E01025637,833,14,187,19,22,1075
E01025638,1137,4,77,7,0,1225
E01025639,962,3,56,4,0,1025
E01025640,1190,10,56,6,1,1263
E01025641,1410,21,20,6,0,1457
E01025642,1476,10,39,2,1,1528
E01025643,1213,15,31,8,2,1269
E01025644,1115,10,17,1,0,1143
E01025645,907,8,19,1,2,937
E01025646,1283,13,22,4,1,1323
E01025647,1265,8,14,4,1,1292
E01025648,1434,17,69,6,8,1534
E01025649,1286,4,36,4,1,1331
E01025650,1165,12,30,2,1,1210
E01025651,1265,12,31,6,2,1316
E01025652,778,12,272,38,9,1109
E01025653,1083,25,117,30,10,1265
E01025654,829,8,191,12,7,1047
E01025655,921,18,267,42,14,1262
E01025656,684,18,338,28,5,1073
E01025657,1433,20,69,22,7,1551
E01025658,1811,68,58,37,4,1978
E01025659,1475,12,31,16,7,1541
E01025660,1283,18,51,9,1,1362
E01025661,1324,7,6,2,0,1339
E01025662,1256,2,13,1,1,1273
E01025663,1151,4,25,0,1,1181
E01025664,1043,6,11,5,1,1066
E01025665,1251,8,9,6,0,1274
E01025666,1124,18,33,17,2,1194
E01025667,898,13,38,10,3,962
E01025668,1475,29,269,55,13,1841
E01025669,1168,34,345,35,11,1593
E01025670,1039,8,16,7,0,1070
E01025671,1421,19,28,5,0,1473
E01025672,1406,12,19,10,2,1449
E01025673,1264,16,45,12,0,1337
E01025674,1258,5,24,2,7,1296
E01025675,1238,8,8,4,2,1260
E01025676,1607,15,18,2,2,1644
E01025677,1072,8,23,4,0,1107
E01025678,1096,11,266,12,6,1391
E01025679,1557,21,367,18,7,1970
E01025680,1041,9,303,4,3,1360
E01025681,1097,19,231,7,2,1356
E01025682,1170,13,80,5,12,1280
E01025683,1211,13,102,11,2,1339
E01025684,1344,16,117,7,14,1498
E01025685,1102,11,23,3,0,1139
E01025686,1106,6,49,2,2,1165
E01025687,1302,2,41,1,2,1348
E01025688,1518,17,23,6,5,1569
E01025689,1835,41,302,87,23,2288
E01025690,2769,94,572,109,42,3586
E01025692,1352,13,219,19,14,1617
E01025693,1563,6,22,3,3,1597
E01025695,1094,14,167,13,11,1299
E01025696,938,12,173,3,5,1131
E01025697,1041,13,147,11,12,1224
E01025698,1106,11,174,14,13,1318
E01025699,944,13,219,20,12,1208
E01025700,899,28,385,25,26,1363
E01025701,869,22,306,20,13,1230
E01025702,873,8,167,7,7,1062
E01025703,1159,23,460,30,15,1687
E01025704,995,14,182,29,9,1229
E01025705,730,15,294,19,8,1066
E01025706,908,14,386,11,22,1341
E01025707,1219,23,284,29,21,1576
E01025708,896,10,160,2,14,1082
E01025709,1687,51,338,72,20,2168
E01025710,902,5,114,4,7,1032
E01025711,1202,13,69,7,15,1306
E01025712,1080,6,71,3,0,1160
E01025713,1133,16,117,16,8,1290
E01025714,1383,16,186,7,26,1618
E01025715,1074,11,73,5,7,1170
E01025716,1133,17,64,6,7,1227
E01025717,1503,13,65,10,4,1595
E01025718,948,26,167,38,17,1196
E01025719,1163,18,92,12,7,1292
E01025720,1538,41,278,60,24,1941
E01025721,1418,34,125,20,13,1610
E01025722,767,9,83,11,5,875
E01025723,1631,39,236,36,17,1959
E01025724,1169,27,218,35,13,1462
E01025725,979,7,69,8,5,1068
E01025726,1409,11,54,9,0,1483
E01025727,1225,13,18,1,1,1258
E01025728,1435,20,16,3,2,1476
E01025729,1253,8,34,2,5,1302
E01025730,1242,7,20,3,2,1274
E01025731,1267,6,40,0,0,1313
E01025732,1252,1,40,2,5,1300
E01025733,1236,6,19,2,1,1264
E01025734,1247,8,20,4,0,1279
E01025735,1487,5,40,4,4,1540
E01025736,1198,11,29,3,1,1242
E01025737,1368,14,43,5,0,1430
E01025738,1128,5,64,12,8,1217
E01025739,1164,8,27,2,2,1203
E01025740,1237,10,28,2,1,1278
E01025741,1270,6,18,5,0,1299
E01025742,1292,12,16,2,5,1327
E01025743,1485,17,20,3,0,1525
E01025744,1528,15,22,6,0,1571
E01025745,1210,1,12,0,2,1225
E01025746,1458,8,16,3,0,1485
E01025747,1447,10,13,3,4,1477
E01025748,1707,12,29,4,3,1755
E01025749,1251,11,7,1,1,1271
E01025750,1138,4,25,1,2,1170
E01025751,1641,7,24,5,2,1679
E01025752,1500,18,82,6,14,1620
E01025753,1187,5,26,1,8,1227
E01025754,1019,10,35,0,2,1066
E01025755,1192,10,35,1,0,1238
E01025756,1385,15,131,2,2,1535
E01025757,773,12,364,7,2,1158
E01025758,1014,11,382,8,15,1430
E01025759,1139,8,55,4,3,1209
E01025760,1066,3,10,10,1,1090
E01025761,1402,6,7,1,1,1417
E01025762,991,10,202,9,16,1228
E01025763,1172,16,196,14,0,1398
E01025764,674,7,462,7,8,1158
E01025765,635,11,693,23,11,1373
E01025766,1401,23,168,18,7,1617
E01025767,984,12,234,8,4,1242
E01025768,1163,3,13,2,1,1182
E01025769,1187,10,55,3,4,1259
E01025770,1480,14,30,7,1,1532
E01025771,2025,5,18,6,1,2055
E01025772,1670,11,27,2,1,1711
E01025773,1100,8,8,3,0,1119
E01025774,1021,4,9,2,2,1038
E01025775,1446,10,13,3,2,1474
E01025776,1591,6,15,3,2,1617
E01025777,1803,8,15,0,1,1827
E01025778,1462,12,45,3,3,1525
E01025779,1226,10,14,5,0,1255
E01025780,1058,18,6,1,0,1083
E01025781,899,15,287,16,5,1222
E01025782,1051,3,41,3,6,1104
E01025783,1133,7,85,3,2,1230
E01025784,1097,9,11,1,0,1118
E01025785,1644,16,30,4,11,1705
E01025786,1273,8,9,0,0,1290
E01025787,1411,8,10,2,2,1433
E01025788,969,13,25,2,0,1009
E01025789,1394,29,55,57,16,1551
E01025790,1816,8,22,4,1,1851
E01025791,1796,9,24,4,3,1836
E01025792,1894,7,20,1,5,1927
E01025793,1924,11,43,4,2,1984
E01025794,1427,6,25,1,0,1459
E01025795,1406,14,70,34,7,1531
E01025796,1547,8,19,1,6,1581
E01025797,1356,9,1,1,1,1368
E01025798,1471,4,22,6,0,1503
E01025799,1401,18,38,1,2,1460
E01025800,920,4,23,2,1,950
E01025801,1010,6,47,11,6,1080
E01025802,1109,3,11,8,1,1132
E01025803,1180,13,14,7,4,1218
E01025804,1572,6,15,5,0,1598
E01025805,1269,4,6,4,1,1284
E01025806,1165,11,27,5,0,1208
E01025807,1063,10,19,2,6,1100
E01025808,2031,6,25,0,3,2065
E01025809,1798,9,20,2,1,1830
E01025810,1911,10,22,0,6,1949
E01025812,1204,14,182,13,16,1429
E01025813,998,7,270,13,16,1304
E01025814,1173,11,55,6,5,1250
E01025815,1641,8,17,4,0,1670
E01025816,1787,16,11,3,4,1821
E01025817,1632,5,5,2,1,1645
E01025818,1152,7,34,6,7,1206
E01025819,1339,9,8,2,0,1358
E01025820,1298,5,10,2,0,1315
E01025821,1363,15,9,4,0,1391
E01025822,1161,9,3,2,0,1175
E01025823,1192,11,7,2,0,1212
E01025824,1205,12,12,6,1,1236
E01025825,1201,10,12,4,0,1227
E01025826,1124,3,9,5,4,1145
E01025827,1187,6,14,3,1,1211
E01025828,1173,1,17,13,0,1204
E01025829,1128,6,29,2,1,1166
E01025830,1154,3,13,5,0,1175
E01025831,1054,3,12,6,0,1075
E01025832,1189,6,62,1,7,1265
E01025833,1260,11,9,2,0,1282
E01025834,1181,5,13,3,4,1206
E01025835,1341,2,40,2,1,1386
E01025836,1085,8,9,1,3,1106
E01025837,1612,6,5,3,0,1626
E01025838,1293,3,8,2,1,1307
E01025839,1324,6,27,7,2,1366
E01025840,1268,5,15,2,3,1293
E01025841,1440,5,16,7,2,1470
E01025842,1332,16,17,3,4,1372
E01025843,1317,13,14,3,6,1353
E01025844,1293,8,24,4,2,1331
E01025845,1236,9,96,2,1,1344
E01025846,1530,16,99,11,1,1657
E01025847,1177,9,127,7,6,1326
E01025848,1241,6,48,5,1,1301
E01025849,1288,12,79,2,3,1384
E01025850,1155,12,26,5,0,1198
E01025851,1021,6,21,3,0,1051
E01025852,1283,15,91,8,2,1399
E01025853,2074,18,68,1,1,2162
E01025854,1361,5,21,1,4,1392
E01025855,1108,6,21,3,1,1139
E01025856,1037,4,19,4,0,1064
E01025857,1132,6,47,1,0,1186
E01025858,1504,9,40,5,6,1564
E01025859,1145,9,17,2,0,1173
E01025860,1149,7,24,0,2,1182
E01025861,1371,10,32,1,2,1416
E01025862,1254,3,10,2,0,1269
E01025863,1315,8,20,1,2,1346
E01025864,1202,5,16,0,3,1226
E01025865,1378,12,31,3,3,1427
E01025866,1263,15,16,2,6,1302
E01025867,1243,5,13,3,0,1264
E01025868,1224,5,26,1,7,1263
E01025869,1256,2,24,3,2,1287
E01025870,1145,6,61,5,8,1225
E01025871,999,3,15,0,1,1018
E01025872,1304,5,11,1,2,1323
E01025873,1283,11,21,3,4,1322
E01025874,1271,5,14,3,1,1294
E01025875,1208,5,17,1,1,1232
E01025876,1475,4,60,4,7,1550
E01025877,1266,8,24,2,2,1302
E01025878,1957,12,28,10,4,2011
E01025879,974,5,8,3,3,993
E01025880,1229,3,26,3,3,1264
E01025881,1169,2,12,2,1,1186
E01025882,1315,5,8,1,0,1329
E01025883,1324,4,11,1,1,1341
E01025884,1340,4,14,0,0,1358
E01025885,1469,4,5,4,0,1482
E01025886,1460,6,5,4,0,1475
E01025887,1504,5,2,1,0,1512
E01025888,1463,13,10,2,1,1489
E01025889,1434,11,11,2,0,1458
E01025890,1001,1,12,1,1,1016
E01025891,1038,3,1,2,0,1044
E01025892,1269,7,5,0,1,1282
E01025893,1643,11,71,6,2,1733
E01025894,1228,13,48,5,0,1294
E01025895,1353,9,21,2,2,1387
E01025896,1303,5,11,10,0,1329
E01025897,1594,11,19,7,6,1637
E01025898,1046,5,7,3,0,1061
E01025899,911,13,17,10,0,951
E01025900,1145,9,6,5,0,1165
E01025901,1488,5,6,1,0,1500
E01025902,1349,5,13,3,3,1373
E01025903,1410,9,20,1,1,1441
E01025904,1568,9,9,3,0,1589
E01025905,1293,15,13,4,3,1328
E01025906,1376,3,7,1,1,1388
E01025907,1370,8,33,2,1,1414
E01025908,1486,11,19,1,1,1518
E01025909,1596,9,6,2,0,1613
E01025910,1439,9,10,1,0,1459
E01025911,1313,5,1,3,0,1322
E01025912,1261,6,9,2,0,1278
E01025913,1820,11,6,4,3,1844
E01025914,1087,6,2,3,0,1098
E01025915,1001,7,42,8,5,1063
E01025916,1184,8,28,0,0,1220
E01025917,1521,11,54,2,3,1591
E01025918,1192,16,11,2,3,1224
E01025919,1207,10,17,3,0,1237
E01025920,1265,6,10,1,1,1283
E01025921,1346,1,20,0,1,1368
E01025923,1138,1,6,0,4,1149
E01025924,834,5,5,0,6,850
E01025925,2067,21,42,4,7,2141
E01025926,1254,7,13,7,1,1282
E01025927,1275,7,11,1,1,1295
E01025928,1208,6,16,3,0,1233
E01025929,1632,7,42,10,0,1691
E01025930,1292,14,35,8,0,1349
E01025931,1386,17,30,2,1,1436
E01025932,1114,6,12,8,1,1141
E01025933,1096,8,4,1,4,1113
E01025934,1171,10,15,9,3,1208
E01025935,1030,5,5,3,1,1044
E01025936,1052,0,2,0,4,1058
E01025937,1241,2,20,1,2,1266
E01025938,1010,4,9,0,0,1023
E01025939,1497,13,27,7,0,1544
E01025940,1533,13,14,2,2,1564
E01025941,1243,7,6,2,0,1258
E01025942,1430,7,13,6,0,1456
E01025943,1487,5,11,1,1,1505
E01025944,1233,4,9,1,1,1248
E01025945,1281,3,20,3,2,1309
E01025946,1369,8,25,5,4,1411
E01025947,1504,3,10,3,0,1520
E01025948,1264,7,16,4,2,1293
E01025949,1287,11,11,4,0,1313
E01025950,1286,8,6,2,2,1304
E01025951,1416,3,8,0,1,1428
E01025952,1238,5,0,1,3,1247
E01025953,884,4,1,0,0,889
E01025954,1155,7,7,1,1,1171
E01025955,1104,7,6,4,1,1122
E01025956,940,3,4,2,2,951
E01025957,1374,10,34,2,1,1421
E01025958,1260,12,9,5,1,1287
E01025959,1695,7,12,2,2,1718
E01025960,1224,6,11,1,2,1244
E01025961,1229,6,10,1,2,1248
E01025962,1166,3,1,1,2,1173
E01025963,1201,5,10,3,0,1219
E01025964,1327,6,12,1,0,1346
E01025965,1094,3,3,2,0,1102
E01025966,1247,6,7,2,3,1265
E01025967,1435,3,4,2,1,1445
E01025968,1518,5,5,1,2,1531
E01025969,1429,21,17,6,3,1476
E01025970,686,16,415,11,26,1154
E01025971,617,10,359,14,47,1047
E01025972,678,11,351,11,25,1076
E01025973,1174,63,1154,71,42,2504
E01025974,1395,53,465,54,31,1998
E01025975,537,10,577,9,39,1172
E01025976,794,29,236,22,30,1111
E01025977,848,8,279,18,10,1163
E01025978,934,26,298,20,24,1302
E01025979,605,19,416,14,30,1084
E01025980,402,9,697,8,31,1147
E01025981,637,11,621,14,29,1312
E01025982,727,9,670,16,26,1448
E01025983,634,16,313,11,15,989
E01025984,526,14,573,9,40,1162
E01025985,1133,6,26,5,0,1170
E01025986,1202,10,53,7,3,1275
E01025987,1095,19,40,2,9,1165
E01025988,1099,24,56,16,1,1196
E01025989,1265,15,24,17,2,1323
E01025990,1105,5,67,11,0,1188
E01025991,1116,10,82,6,6,1220
E01025992,1310,12,20,7,1,1350
E01025993,1096,11,91,11,4,1213
E01025994,1116,11,41,5,4,1177
E01025995,804,13,353,28,26,1224
E01025997,1083,22,77,12,5,1199
E01025998,1350,14,92,7,8,1471
E01025999,1038,12,62,14,2,1128
E01026000,1045,6,52,9,1,1113
E01026001,1109,7,39,7,2,1164
E01026003,1089,16,214,22,8,1349
E01026004,1190,14,202,5,19,1430
E01026005,1294,19,179,8,9,1509
E01026006,1997,27,69,26,16,2135
E01026007,934,1,2,0,0,937
E01026008,1298,15,17,17,2,1349
E01026009,1051,2,3,1,0,1057
E01026010,1090,16,10,4,10,1130
E01026011,2172,36,39,8,12,2267
E01026012,954,6,0,4,2,966
E01026013,1201,3,17,10,2,1233
E01026014,1553,3,23,5,2,1586
E01026015,1134,16,15,8,3,1176
E01026016,1896,4,10,3,2,1915
E01026017,1318,5,5,3,1,1332
E01026018,1431,1,9,3,2,1446
E01026019,2125,16,12,14,5,2172
E01026020,1813,16,12,1,1,1843
E01026021,1388,15,73,13,8,1497
E01026022,1587,11,132,13,5,1748
E01026023,1205,2,3,3,2,1215
E01026024,1638,2,2,1,2,1645
E01026025,1693,27,63,8,6,1797
E01026026,1474,17,10,6,3,1510
E01026027,1458,16,13,9,0,1496
E01026028,1486,12,10,12,7,1527
E01026029,2023,13,32,15,3,2086
E01026030,1744,22,11,9,6,1792
E01026031,1283,8,0,0,1,1292
E01026032,1593,12,22,2,19,1648
E01026033,1610,2,3,1,2,1618
E01026034,1482,7,2,3,1,1495
E01026035,1709,7,24,10,0,1750
E01026036,1339,13,31,12,3,1398
E01026037,1035,19,5,2,0,1061
E01026038,1041,10,13,4,3,1071
E01026039,990,4,3,2,1,1000
E01026040,999,2,7,4,2,1014
E01026041,1061,5,2,2,1,1071
E01026042,1225,4,6,0,0,1235
E01026043,1322,6,7,2,0,1337
E01026044,1180,3,2,0,0,1185
E01026045,1604,5,4,1,5,1619
E01026046,958,9,5,3,1,976
E01026047,1074,3,2,1,1,1081
E01026048,1354,9,4,0,4,1371
E01026049,1355,7,2,3,1,1368
E01026050,1456,4,3,0,0,1463
E01026051,1037,3,3,4,0,1047
E01026052,1178,2,16,4,0,1200
E01026053,1443,4,10,2,2,1461
E01026054,1810,21,20,6,0,1857
E01026055,952,7,2,0,0,961
E01026056,969,1,3,0,1,974
E01026057,1646,2,8,8,0,1664
E01026058,1794,5,7,2,0,1808
E01026059,988,9,7,3,1,1008
E01026060,1134,10,7,10,1,1162
E01026061,1016,3,2,1,1,1023
E01026062,968,0,9,3,2,982
E01026063,1092,2,3,0,1,1098
E01026064,1155,6,11,1,0,1173
E01026065,1531,5,14,4,1,1555
E01026066,1575,15,11,1,0,1602
E01026067,1563,15,11,6,1,1596
E01026068,1789,7,4,0,0,1800
E01026069,2101,14,17,1,1,2134
E01026070,1625,9,1,2,0,1637
E01026071,1795,6,2,0,1,1804
E01026072,1698,6,4,4,3,1715
E01026073,1684,5,20,2,0,1711
E01026074,1769,6,5,1,0,1781
E01026075,1819,4,8,1,2,1834
E01026076,1851,11,5,2,0,1869
E01026077,909,4,9,0,0,922
E01026078,903,6,4,3,3,919
E01026079,1654,2,6,2,2,1666
E01026080,1645,11,7,1,7,1671
E01026081,1934,24,14,10,1,1983
E01026082,1970,4,6,2,1,1983
E01026083,1364,12,13,3,4,1396
E01026084,1245,8,22,15,0,1290
E01026085,1954,8,8,6,1,1977
E01026087,861,6,2,0,0,869
E01026088,1128,1,5,0,2,1136
E01026089,1699,7,7,0,1,1714
E01026090,1137,3,7,1,0,1148
E01026091,914,4,4,1,0,923
E01026092,1130,13,8,5,1,1157
E01026093,1425,15,26,3,3,1472
E01026094,1393,4,6,3,0,1406
E01026095,993,8,5,5,0,1011
E01026096,1204,3,13,0,0,1220
E01026097,1290,7,10,6,2,1315
E01026098,1628,1,21,8,1,1659
E01026099,1748,7,3,2,0,1760
E01026100,1376,8,14,7,0,1405
E01026101,1030,9,2,2,1,1044
E01026102,1922,10,10,1,0,1943
E01026103,1866,6,16,0,0,1888
E01026104,1989,8,3,1,0,2001
E01026105,1877,6,11,2,0,1896
E01026106,997,3,1,1,1,1003
E01026107,1002,6,9,5,1,1023
E01026108,1848,12,10,3,3,1876
E01026109,1965,5,4,0,0,1974
E01026110,1221,13,5,1,1,1241
E01026111,1277,6,5,1,0,1289
E01026112,918,14,2,1,0,935
E01026113,1726,4,2,0,2,1734
E01026114,1230,14,12,3,4,1263
E01026115,1475,7,3,5,2,1492
E01026116,1360,4,22,5,2,1393
E01026117,1568,5,2,2,0,1577
E01026118,1417,7,9,4,5,1442
E01026119,965,8,5,1,0,979
E01026120,1194,5,16,3,0,1218
E01026121,2049,15,5,6,0,2075
E01026122,1491,30,84,24,16,1645
E01026123,1689,24,45,18,15,1791
E01026124,1200,9,33,14,12,1268
E01026125,1260,20,56,30,10,1376
E01026126,1325,36,74,39,17,1491
E01026127,1041,9,10,7,1,1068
E01026128,2043,17,16,24,4,2104
E01026129,1172,14,19,13,1,1219
E01026130,1100,7,14,11,11,1143
E01026131,1098,8,6,6,0,1118
E01026132,2420,60,107,53,13,2653
E01026133,2844,47,99,71,7,3068
E01026134,1245,12,23,20,4,1304
E01026135,1360,8,9,0,1,1378
E01026136,1174,9,16,3,1,1203
E01026137,966,4,11,2,5,988
E01026138,1180,15,30,3,1,1229
E01026139,991,8,4,3,4,1010
E01026140,1000,2,15,4,1,1022
E01026141,1137,4,16,4,0,1161
E01026142,1002,8,7,0,1,1018
E01026143,1930,41,59,23,13,2066
E01026144,1269,13,34,5,5,1326
E01026145,1295,22,16,7,3,1343
E01026146,1766,42,51,11,2,1872
E01026147,1873,17,39,6,8,1943
E01026148,1535,22,17,11,3,1588
E01026149,1316,11,5,3,1,1336
E01026150,1179,8,4,5,2,1198
E01026151,1481,11,13,13,3,1521
E01026152,1040,12,2,4,10,1068
E01026153,1922,18,67,16,10,2033
E01026154,1062,7,14,5,3,1091
E01026155,1274,7,49,10,14,1354
E01026156,922,9,21,1,3,956
E01026157,1042,6,23,11,3,1085
E01026158,1216,9,14,9,3,1251
E01026159,1174,6,12,7,0,1199
E01026160,1085,6,12,5,2,1110
E01026161,1148,6,4,5,3,1166
E01026162,1215,4,4,14,9,1246
E01026163,1109,7,13,13,0,1142
E01026164,1218,10,32,3,2,1265
E01026165,1138,3,6,6,2,1155
E01026166,947,10,14,9,1,981
E01026167,1312,23,24,10,3,1372
E01026168,1063,10,1,5,2,1081
E01026169,1364,10,17,5,0,1396
E01026170,1110,8,9,5,0,1132
E01026171,1262,5,5,3,2,1277
E01026172,1067,7,9,5,2,1090
E01026173,1097,9,16,10,5,1137
E01026174,1099,17,17,11,4,1148
E01026175,1438,20,21,12,3,1494
E01026176,1385,39,38,22,4,1488
E01026177,1470,33,66,19,8,1596
E01026178,1368,12,26,14,7,1427
E01026179,994,10,4,1,4,1013
E01026180,1196,6,2,1,2,1207
E01026182,1134,4,9,1,0,1148
E01026183,2058,11,7,8,5,2089
E01026184,1377,17,6,5,0,1405
E01026185,1539,5,11,1,0,1556
E01026186,1315,5,19,8,2,1349
E01026187,1432,10,18,15,4,1479
E01026188,1725,15,14,3,4,1761
E01026189,1489,16,11,4,0,1520
E01026190,1222,8,2,3,0,1235
E01026191,1323,2,6,3,1,1335
E01026192,968,6,4,7,2,987
E01026193,1165,5,10,9,2,1191
E01026194,1521,9,9,3,0,1542
E01026195,1533,12,15,0,1,1561
E01026196,1244,3,5,0,7,1259
E01026197,1128,10,1,2,0,1141
E01026198,1031,11,8,5,2,1057
E01026199,1875,15,17,2,2,1911
E01026200,1297,6,11,3,2,1319
E01026201,1606,9,8,1,0,1624
E01026202,1555,1,5,4,2,1567
E01026203,1522,3,6,3,0,1534
E01026204,1415,3,4,2,3,1427
E01026205,1203,7,5,2,0,1217
E01026206,1510,6,7,1,0,1524
E01026207,1026,9,7,3,0,1045
E01026208,1315,3,16,1,1,1336
E01026209,1814,9,6,0,1,1830
E01026210,1883,6,5,3,1,1898
E01026211,1563,3,4,1,1,1572
E01026212,1252,4,8,4,0,1268
E01026213,1457,6,1,0,1,1465
E01026214,940,5,6,0,3,954
E01026215,915,3,6,0,2,926
E01026218,1027,3,5,1,0,1036
E01026219,988,11,13,5,0,1017
E01026220,1962,2,16,4,2,1986
E01026221,1915,6,4,1,2,1928
E01026222,1514,5,8,7,3,1537
E01026223,1723,13,10,3,2,1751
E01026224,1364,7,2,4,3,1380
E01026225,1258,3,3,7,0,1271
E01026226,1646,5,5,1,4,1661
E01026227,1156,20,21,2,0,1199
E01026228,1151,10,16,1,0,1178
E01026229,1169,4,26,1,2,1202
E01026230,958,3,6,3,0,970
E01026231,2062,15,18,9,0,2104
E01026232,1831,13,22,6,3,1875
E01026233,1382,6,7,1,4,1400
E01026234,2107,6,19,9,15,2156
E01026235,1255,9,10,8,0,1282
E01026236,962,2,17,1,1,983
E01026237,932,4,10,2,0,948
E01026238,1048,11,2,5,0,1066
E01026239,1413,8,9,6,0,1436
E01026240,1895,6,18,13,1,1933
E01026241,1526,14,11,1,4,1556
E01026242,1242,2,1,5,0,1250
E01026243,1065,8,5,4,1,1083
E01026244,1123,4,12,2,0,1141
E01026245,1813,10,20,4,2,1849
E01026246,1948,14,17,3,5,1987
E01026247,1626,2,9,4,3,1644
E01026248,1863,8,8,3,1,1883
E01026249,1589,10,7,0,1,1607
E01026250,1447,6,28,5,0,1486
E01026251,1515,2,14,6,1,1538
E01026252,1448,11,10,1,0,1470
E01026253,1423,10,9,3,1,1446
E01026254,1514,8,9,1,2,1534
E01026255,1685,11,8,3,4,1711
E01026256,1336,7,10,3,2,1358
E01026257,1608,3,7,2,0,1620
E01026258,1489,4,18,2,1,1514
E01026259,1419,8,7,0,2,1436
E01026260,1604,7,21,10,3,1645
E01026262,1296,4,12,4,1,1317
E01026263,1529,5,24,6,4,1568
E01026264,1215,16,11,4,0,1246
E01026265,1127,3,11,2,0,1143
E01026266,1618,26,34,15,2,1695
E01026267,2224,17,35,6,7,2289
E01026268,1591,16,10,6,3,1626
E01026269,1849,11,11,9,2,1882
E01026270,1434,18,7,11,5,1475
E01026271,1408,17,22,5,4,1456
E01026272,1017,8,22,3,5,1055
E01026273,1415,8,8,4,3,1438
E01026274,1446,13,14,4,0,1477
E01026275,1641,12,26,4,5,1688
E01026276,1988,8,10,2,0,2008
E01026277,1278,4,5,11,1,1299
E01026278,1161,10,9,5,0,1185
E01026279,1155,3,6,6,1,1171
E01026280,2063,9,11,7,0,2090
E01026281,1088,11,2,2,0,1103
E01026282,1407,6,9,0,1,1423
E01026283,1414,10,7,3,0,1434
E01026284,1584,13,3,7,1,1608
E01026285,1212,2,0,0,0,1214
E01026286,1007,5,5,0,0,1017
E01026287,1182,6,15,4,6,1213
E01026288,1239,12,35,5,3,1294
E01026289,1578,8,20,4,2,1612
E01026290,1857,8,3,6,0,1874
E01026291,1609,10,11,2,0,1632
E01026292,1166,6,2,3,6,1183
E01026293,1610,4,15,5,4,1638
E01026294,1259,9,12,3,1,1284
E01026296,1278,5,11,11,0,1305
E01026297,1135,8,14,2,0,1159
E01026298,1470,9,17,10,3,1509
E01026299,1309,11,10,8,3,1341
E01026300,1246,6,11,8,0,1271
E01026301,1372,10,19,3,3,1407
E01026302,970,6,5,4,1,986
E01026303,1060,8,9,1,0,1078
E01026304,1201,10,5,1,2,1219
E01026305,1093,4,2,3,0,1102
E01026306,1255,6,17,1,1,1280
E01026307,1076,5,5,1,1,1088
E01026308,1006,10,24,13,2,1055
E01026309,1253,9,11,6,0,1279
E01026310,907,6,7,3,0,923
E01026311,1233,11,30,3,0,1277
E01026312,879,9,12,6,1,907
E01026313,1239,5,13,10,0,1267
E01026314,1027,6,3,1,1,1038
E01026315,1710,11,9,1,1,1732
E01026316,1971,10,9,1,2,1993
E01026317,1596,15,59,22,6,1698
E01026318,1409,15,34,21,3,1482
E01026319,1692,15,18,10,2,1737
E01026320,1398,13,46,6,6,1469
E01026321,1056,6,23,8,2,1095
E01026322,942,0,18,3,4,967
E01026323,1510,14,39,5,4,1572
E01026324,1729,6,30,4,6,1775
E01026325,1140,10,13,2,0,1165
E01026326,1238,6,21,2,2,1269
E01026327,1109,10,9,3,1,1132
E01026328,1082,8,12,8,0,1110
E01026329,1505,15,12,7,2,1541
E01026330,1745,12,8,5,2,1772
E01026331,1959,6,7,2,0,1974
E01026332,1811,6,5,3,2,1827
E01026333,2002,4,6,3,0,2015
E01026334,1272,6,14,0,0,1292
E01026335,1306,14,28,9,0,1357
E01026336,1255,16,3,7,0,1281
E01026337,1253,7,15,4,0,1279
E01026338,996,3,0,0,3,1002
E01026339,964,5,9,4,2,984
E01026340,1790,10,5,4,1,1810
E01026341,1213,2,4,2,0,1221
E01026342,1109,8,4,3,1,1125
E01026343,1428,21,25,16,2,1492
E01026344,1224,8,15,4,1,1252
E01026345,1234,11,24,2,0,1271
E01026346,934,10,22,2,4,972
E01026347,1423,14,20,1,0,1458
E01026348,919,2,15,3,0,939
E01026349,1256,6,16,2,3,1283
E01026350,1368,18,33,9,2,1430
E01026351,1244,13,39,9,10,1315
E01026352,1022,8,47,8,4,1089
E01026353,1335,15,37,8,2,1397
E01026354,932,9,54,6,3,1004
E01026355,1926,8,12,2,0,1948
E01026356,1132,3,11,3,2,1151
E01026357,1155,11,4,1,1,1172
E01026358,1193,8,13,3,2,1219
E01026359,1280,5,12,6,0,1303
E01026360,1735,8,8,5,1,1757
E01026361,2137,9,9,11,2,2168
E01026362,1358,10,8,4,1,1381
E01026363,1027,6,9,2,3,1047
E01026364,1365,5,5,5,0,1380
E01026365,1938,9,11,1,0,1959
E01026366,1729,8,3,2,1,1743
E01026367,1391,7,9,7,0,1414
E01026368,1307,4,4,0,0,1315
E01026369,939,3,5,3,0,950
E01026370,1727,5,13,10,0,1755
E01026371,1010,8,10,2,2,1032
E01026372,1991,7,14,4,2,2018
E01026373,1717,11,3,5,0,1736
E01026374,1059,6,8,8,0,1081
E01026375,1210,10,10,5,0,1235
E01026376,1391,14,7,1,0,1413
E01026377,1664,10,7,12,0,1693
E01026378,1287,11,13,1,0,1312
E01026379,1309,10,10,3,1,1333
E01026380,1419,5,15,8,0,1447
E01026381,1359,7,18,0,3,1387
E01026382,1310,8,22,13,3,1356
E01026383,955,12,14,12,4,997
E01026384,1394,15,26,8,1,1444
E01026385,963,4,4,0,0,971
E01026386,1077,3,15,2,2,1099
E01026387,2176,15,12,4,3,2210
E01026388,1820,7,8,2,1,1838
E01026389,1391,6,13,7,3,1420
E01026390,1506,5,3,4,0,1518
E01026391,1577,8,12,9,0,1606
E01026392,2469,6,3,4,1,2483
E01026393,1189,5,18,2,0,1214
E01026394,1553,9,20,4,0,1586
E01026395,1226,3,10,0,0,1239
E01026396,1084,1,2,0,0,1087
E01026397,1914,17,21,8,7,1967
E01026398,1271,2,5,1,1,1280
E01026399,1196,6,7,3,1,1213
E01026400,1260,5,9,0,0,1274
E01026401,1291,2,17,1,2,1313
E01026402,1496,6,14,3,0,1519
E01026403,1108,1,16,1,0,1126
E01026404,1864,4,5,0,1,1874
E01026405,1062,9,23,2,11,1107
E01026406,1008,19,35,7,3,1072
E01026407,1114,3,5,0,0,1122
E01026408,1147,3,0,1,0,1151
E01026409,991,4,3,0,0,998
E01026410,1438,7,2,1,1,1449
E01026411,2042,10,2,1,0,2055
E01026412,1321,12,14,0,3,1350
E01026413,1707,9,18,2,2,1738
E01026414,1377,12,2,0,1,1392
E01026415,836,6,3,1,0,846
E01026416,1077,7,7,1,2,1094
E01026419,1012,4,0,1,0,1017
E01026420,933,2,6,1,0,942
E01026421,1425,8,7,3,2,1445
E01026422,1673,8,8,7,0,1696
E01026423,1411,16,6,7,3,1443
E01026424,1697,11,6,5,2,1721
E01026425,1512,22,15,10,0,1559
E01026426,1916,23,20,7,5,1971
E01026427,1762,7,7,0,0,1776
E01026428,2132,17,12,6,2,2169
E01026429,1219,13,16,5,0,1253
E01026430,1450,13,5,5,0,1473
E01026431,953,5,8,2,0,968
E01026432,1211,7,2,3,0,1223
E01026433,1085,14,10,6,1,1116
E01026434,1643,12,17,2,1,1675
E01026435,1742,19,11,6,3,1781
E01026436,1885,10,4,3,3,1905
E01026437,1017,3,2,0,0,1022
E01026438,847,3,3,1,0,854
E01026439,1308,5,10,1,1,1325
E01026440,926,7,11,2,1,947
E01026441,1294,0,14,3,3,1314
E01026442,1785,11,8,4,0,1808
E01026443,1711,3,4,1,1,1720
E01026444,1686,8,5,7,4,1710
E01026445,1878,7,4,5,1,1895
E01026446,1666,5,5,2,2,1680
E01026447,1195,14,10,8,0,1227
E01026448,1741,7,14,5,1,1768
E01026449,1539,14,34,10,5,1602
E01026450,1434,3,13,3,3,1456
E01026451,1721,3,5,2,0,1731
E01026452,1381,7,4,2,1,1395
E01026453,1319,7,4,2,1,1333
E01026454,1265,8,12,2,1,1288
E01026455,1521,11,38,12,4,1586
E01026456,1010,1,12,0,0,1023
E01026457,1160,1,3,6,2,1172
E01026458,1182,7,11,7,0,1207
E01026459,1170,7,15,8,3,1203
E01026461,1155,2,10,3,0,1170
E01026462,1880,7,3,0,0,1890
E01026464,1024,6,2,1,4,1037
E01026465,1384,25,23,1,4,1437
E01026466,1449,23,23,6,5,1506
E01026467,1398,37,30,11,3,1479
E01026468,1980,29,28,20,10,2067
E01026469,1250,26,22,12,3,1313
E01026470,2057,43,55,20,7,2182
E01026471,964,12,10,9,4,999
E01026472,985,7,11,3,1,1007
E01026473,1106,12,13,6,11,1148
E01026474,1258,31,22,23,1,1335
E01026475,1161,20,25,11,1,1218
E01026476,1127,17,2,14,1,1161
E01026477,1071,15,12,8,6,1112
E01026478,1236,7,3,12,0,1258
E01026479,1264,4,0,1,0,1269
E01026480,1235,6,7,0,1,1249
E01026481,986,3,13,1,0,1003
E01026483,963,0,3,1,4,971
E01026484,1126,1,3,0,0,1130
E01026485,892,7,2,1,0,902
E01026486,1296,7,10,0,1,1314
E01026487,1227,11,5,1,3,1247
E01026488,1000,12,10,2,0,1024
E01026489,1159,10,1,4,1,1175
E01026490,1351,11,3,4,1,1370
E01026491,1790,9,7,4,4,1814
E01026492,1021,11,2,11,3,1048
E01026493,991,14,5,2,1,1013
E01026494,1825,6,5,1,1,1838
E01026495,1063,5,7,0,1,1076
E01026496,935,7,2,2,0,946
E01026497,1236,3,4,1,0,1244
E01026498,1109,2,8,0,6,1125
E01026499,1278,6,12,0,0,1296
E01026500,1381,2,10,0,1,1394
E01026501,1373,14,4,2,0,1393
E01026502,965,1,1,2,1,970
E01026503,1203,5,4,3,0,1215
E01026504,1270,3,5,2,2,1282
E01026505,1118,2,11,5,0,1136
E01026506,1148,2,9,0,2,1161
E01026507,1080,4,11,4,1,1100
E01026508,1195,5,11,0,0,1211
E01026509,1337,8,12,4,3,1364
E01026510,1361,15,21,3,1,1401
E01026511,936,5,3,0,0,944
E01026512,1056,2,9,4,2,1073
E01026513,1075,2,5,1,0,1083
E01026514,1223,8,9,0,3,1243
E01026515,885,3,4,3,2,897
E01026516,1041,6,4,3,2,1056
E01026517,1194,4,6,1,0,1205
E01026518,981,10,16,11,1,1019
E01026519,1310,14,13,4,2,1343
E01026520,977,5,12,3,0,997
E01026521,1092,6,4,6,0,1108
E01026522,1126,12,10,2,0,1150
E01026523,1487,5,2,1,2,1497
E01026524,1197,2,6,1,3,1209
E01026525,901,4,1,0,0,906
E01026526,1223,2,6,4,0,1235
E01026527,1266,8,8,6,0,1288
E01026528,1211,9,8,2,1,1231
E01026529,1283,9,24,3,5,1324
E01026530,1431,11,16,5,8,1471
E01026531,1423,7,28,3,0,1461
E01026532,1461,4,17,6,2,1490
E01026533,1013,5,3,5,0,1026
E01026534,1269,5,3,1,4,1282
E01026535,1350,5,7,2,7,1371
E01026536,1331,10,12,6,1,1360
E01026537,1161,3,15,3,1,1183
E01026538,1268,4,10,3,2,1287
E01026539,1337,3,9,3,1,1353
E01026540,1213,7,18,2,0,1240
E01026541,1843,14,31,6,10,1904
E01026542,1229,8,16,0,2,1255
E01026543,1199,7,12,3,4,1225
E01026544,1363,10,15,9,6,1403
E01026545,1238,10,4,10,0,1262
E01026546,1215,4,12,7,2,1240
E01026547,1149,9,0,2,1,1161
E01026548,1012,2,4,0,2,1020
E01026549,1441,8,6,1,2,1458
E01026550,894,2,3,3,1,903
E01026551,977,1,3,2,1,984
E01026552,1194,8,9,0,1,1212
E01026553,1112,7,25,3,1,1148
E01026554,974,1,13,3,4,995
E01026555,1222,7,14,3,1,1247
E01026556,1149,11,24,6,0,1190
E01026557,1195,7,12,0,1,1215
E01026558,1109,5,8,3,0,1125
E01026559,1238,8,19,1,1,1267
E01026560,1161,1,10,2,0,1174
E01026561,1233,7,17,2,0,1259
E01026562,925,10,25,11,2,973
E01026563,1033,8,31,3,2,1077
E01026564,1259,4,25,3,4,1295
E01026565,878,9,16,1,0,904
E01026566,1199,3,12,2,3,1219
E01026567,1414,5,18,1,0,1438
E01026568,1270,4,12,3,6,1295
E01026569,1217,3,11,0,0,1231
E01026570,1319,7,11,0,3,1340
E01026571,1189,11,19,1,0,1220
E01026572,1198,7,15,4,0,1224
E01026573,1122,7,5,2,0,1136
E01026574,1254,13,42,10,11,1330
E01026575,1375,14,37,6,7,1439
E01026576,1512,17,46,10,0,1585
E01026577,1380,22,19,9,3,1433
E01026578,1512,4,7,3,4,1530
E01026579,1284,6,8,2,1,1301
E01026580,1397,11,4,4,0,1416
E01026581,1310,1,12,2,10,1335
E01026582,1587,7,10,5,4,1613
E01026583,1105,4,5,2,2,1118
E01026584,1274,4,5,0,5,1288
E01026585,1086,5,4,3,0,1098
E01026586,874,5,7,0,0,886
E01026587,1408,11,18,3,0,1440
E01026588,2120,20,17,3,0,2160
E01026589,1163,6,10,3,0,1182
E01026590,1202,10,7,1,3,1223
E01026591,1487,6,19,1,0,1513
E01026592,1307,3,3,1,0,1314
E01026593,1127,6,11,4,0,1148
E01026594,1402,15,10,3,4,1434
E01026595,1369,10,8,5,3,1395
E01026596,1309,14,18,7,5,1353
E01026597,1421,16,21,17,3,1478
E01026598,1245,39,21,24,12,1341
E01026599,1105,14,14,9,4,1146
E01026600,1137,6,2,3,3,1151
E01026601,1185,9,12,2,0,1208
E01026602,1244,12,6,2,1,1265
E01026603,1260,12,3,11,0,1286
E01026604,1224,11,17,7,3,1262
E01026605,1467,5,5,5,0,1482
E01026606,1367,4,2,3,1,1377
E01026607,1317,5,7,3,1,1333
E01026608,1056,10,4,0,2,1072
E01026609,976,2,6,0,0,984
E01026610,1182,16,14,2,5,1219
E01026611,1288,4,29,11,10,1342
E01026612,1896,10,96,20,9,2031
E01026613,1090,4,10,0,4,1108
E01026614,1399,9,6,4,1,1419
E01026615,1131,5,6,1,1,1144
E01026616,971,1,3,1,0,976
E01026617,1034,4,32,2,1,1073
E01026618,1205,17,67,13,24,1326
E01026619,1095,6,24,0,1,1126
E01026620,1133,3,18,2,1,1157
E01026621,1116,5,35,3,1,1160
E01026622,1104,18,10,8,5,1145
E01026623,1170,48,32,14,35,1299
E01026624,1312,42,38,26,14,1432
E01026625,1193,43,33,23,5,1297
E01026626,1473,22,24,10,4,1533
E01026627,1191,0,2,2,1,1196
E01026628,1194,0,5,0,1,1200
E01026629,1225,4,8,1,0,1238
E01026630,1266,5,18,6,4,1299
E01026631,1325,7,20,3,0,1355
E01026632,1339,18,12,5,3,1377
E01026633,1373,19,21,16,2,1431
E01026634,1105,3,19,10,4,1141
E01026635,1675,20,17,11,5,1728
E01026636,1327,5,4,0,0,1336
E01026637,1700,7,3,1,1,1712
E01026638,1230,1,3,1,0,1235
E01026639,1287,6,15,3,2,1313
E01026640,1331,7,9,7,2,1356
E01026641,1149,6,3,1,0,1159
E01026642,1130,8,4,3,0,1145
E01026643,1186,3,4,1,2,1196
E01026644,2080,21,16,9,4,2130
E01026645,1185,3,1,2,0,1191
E01026646,1471,1,4,1,3,1480
E01026647,1840,7,5,8,0,1860
E01026648,1207,11,11,7,3,1239
E01026649,1233,10,12,15,4,1274
E01026650,826,22,34,21,11,914
E01026651,1867,11,10,7,3,1898
E01026652,1057,1,7,4,1,1070
E01026653,1520,3,7,1,1,1532
E01026654,1313,2,1,0,0,1316
E01026655,1175,1,1,1,0,1178
E01026656,1634,3,6,0,0,1643
E01026659,1258,9,6,1,0,1274
E01026660,1363,4,6,5,3,1381
E01026661,1232,2,2,5,0,1241
E01026662,1690,25,58,12,5,1790
E01026663,1256,15,66,12,4,1353
E01026664,1581,17,169,15,4,1786
E01026665,1844,8,10,13,4,1879
E01026666,1405,25,20,8,0,1458
E01026667,1360,21,8,5,2,1396
E01026668,1271,10,14,8,2,1305
E01026669,1400,7,17,6,1,1431
E01026670,1237,6,10,9,4,1266
E01026671,1120,6,16,4,0,1146
E01026672,1236,6,15,4,2,1263
E01026673,1206,8,9,4,1,1228
E01026674,961,4,4,0,2,971
E01026675,1021,1,1,1,0,1024
E01026676,1497,3,9,1,0,1510
E01026677,1277,4,1,4,0,1286
E01026678,1387,0,6,1,2,1396
E01026679,1990,12,3,6,1,2012
E01026680,1317,7,2,2,2,1330
E01026681,1239,5,7,2,0,1253
E01026682,1101,6,6,0,2,1115
E01026683,1116,8,13,1,1,1139
E01026684,990,9,6,0,0,1005
E01026685,1070,1,12,2,3,1088
E01026686,1733,5,11,2,3,1754
E01026687,1208,10,12,10,0,1240
E01026688,1037,12,11,8,0,1068
E01026689,1200,22,19,9,3,1253
E01026690,1090,12,14,6,3,1125
E01026691,910,4,23,6,3,946
E01026692,1003,2,22,0,1,1028
E01026693,1559,9,11,3,0,1582
E01026694,2034,6,14,6,3,2063
E01026695,1815,6,7,2,0,1830
E01026696,952,2,6,1,2,963
E01026697,1078,3,4,2,0,1087
E01026698,1630,34,66,6,8,1744
E01026699,1242,21,25,13,6,1307
E01026700,1160,15,21,8,11,1215
E01026701,1407,3,11,0,0,1421
E01026702,1090,4,7,0,0,1101
E01026703,972,4,7,1,0,984
E01026704,1324,14,21,9,3,1371
E01026705,1215,8,5,1,1,1230
E01026706,1262,13,9,2,3,1289
E01026707,1963,8,6,1,0,1978
E01026708,1068,5,42,5,3,1123
E01026709,1481,9,46,6,5,1547
E01026710,1000,6,19,6,0,1031
E01026711,1174,8,8,4,0,1194
E01026712,1346,5,10,3,3,1367
E01026713,1297,6,6,4,3,1316
E01026714,1505,15,121,25,9,1675
E01026715,1188,4,6,2,0,1200
E01026716,1513,19,12,15,2,1561
E01026717,1243,2,6,0,2,1253
E01026718,1912,3,8,2,3,1928
E01026719,1864,4,9,0,0,1877
E01026720,1081,5,10,1,1,1098
E01026721,1052,5,16,1,0,1074
E01026722,1951,14,9,1,0,1975
E01026723,1338,8,21,3,2,1372
E01026724,1361,12,29,9,3,1414
E01026725,1215,6,17,2,2,1242
E01026726,1726,7,7,2,3,1745
E01026727,2071,10,8,13,8,2110
E01026728,1888,10,7,6,7,1918
E01026729,1841,9,14,2,0,1866
E01026730,2022,12,4,2,1,2041
E01026731,909,2,1,1,0,913
E01026732,1061,4,7,0,1,1073
E01026733,1915,4,5,2,1,1927
E01026734,1008,11,32,1,0,1052
E01026735,1068,12,9,2,2,1093
E01026736,1100,3,2,2,0,1107
E01026737,1975,7,3,2,1,1988
E01026738,2087,6,4,3,1,2101
E01026739,1757,7,10,1,1,1776
E01026740,2051,6,3,2,2,2064
E01026741,1667,1,4,0,0,1672
E01026742,1287,8,25,4,0,1324
E01026743,1898,3,6,4,0,1911
E01026744,1720,2,12,3,0,1737
E01026745,1382,11,15,1,1,1410
E01026746,1401,9,14,2,3,1429
E01026747,1114,2,7,4,2,1129
E01026748,1240,1,3,0,1,1245
E01026749,1210,5,14,1,2,1232
E01026750,1164,2,6,1,0,1173
E01026751,1184,5,2,1,1,1193
E01026752,1224,6,1,1,2,1234
E01026753,1253,8,15,6,1,1283
E01026754,1125,9,6,0,0,1140
E01026755,1078,2,2,1,1,1084
E01026756,947,5,10,1,1,964
E01026757,1303,7,8,1,0,1319
E01026758,1146,5,12,0,2,1165
E01026759,1086,3,4,0,0,1093
E01026760,1133,6,9,0,0,1148
E01026761,1299,9,2,0,0,1310
E01026762,2074,5,11,2,2,2094
E01026763,1140,6,6,2,0,1154
E01026764,1097,6,6,1,0,1110
E01026765,1154,6,3,2,1,1166
E01026766,1913,10,2,0,0,1925
E01026767,1048,7,8,3,2,1068
E01026768,1347,21,22,49,9,1448
E01026769,1855,11,9,2,1,1878
E01026770,1747,6,14,6,0,1773
E01026771,1350,4,3,2,5,1364
E01026772,1457,9,9,2,0,1477
E01026773,1756,9,6,0,0,1771
E01026774,1229,4,1,0,1,1235
E01026775,1020,2,4,0,0,1026
E01026776,1365,11,5,1,0,1382
E01026777,998,1,11,1,0,1011
E01026778,1307,6,6,1,0,1320
E01026779,1133,6,5,2,0,1146
E01026780,2069,11,10,2,2,2094
E01026781,1863,12,9,8,2,1894
E01026782,1848,3,4,4,0,1859
E01026783,1618,0,2,2,0,1622
E01026784,855,2,1,1,1,860
E01026785,1171,5,4,1,3,1184
E01026786,1839,5,8,0,0,1852
E01026787,839,5,0,2,0,846
E01026788,1064,2,3,0,1,1070
E01026789,1028,2,5,3,1,1039
E01026790,962,3,1,0,0,966
E01026791,1063,15,54,25,7,1164
E01026792,1082,6,58,15,6,1167
E01026793,1155,27,52,36,13,1283
E01026794,1540,19,69,18,33,1679
E01026796,1190,25,72,59,4,1350
E01026797,1786,29,67,39,15,1936
E01026798,1106,5,50,13,5,1179
E01026799,1107,8,24,5,2,1146
E01026800,1414,34,37,54,6,1545
E01026801,1353,6,14,12,1,1386
E01026802,1284,15,31,22,6,1358
E01026803,1136,11,12,10,4,1173
E01026804,1137,20,6,11,2,1176
E01026805,1116,7,3,9,4,1139
E01026806,1270,26,27,27,1,1351
E01026807,915,13,21,13,3,965
E01026808,909,11,20,13,4,957
E01026809,1216,12,6,5,4,1243
E01026810,1106,21,53,5,5,1190
E01026811,1286,15,35,5,6,1347
E01026812,1110,13,54,20,4,1201
E01026813,1145,16,68,6,4,1239
E01026814,1162,12,57,12,12,1255
E01026815,1124,17,67,21,6,1235
E01026816,1388,22,61,26,9,1506
E01026817,1131,8,19,13,6,1177
E01026818,1080,19,29,16,3,1147
E01026819,1036,14,26,15,7,1098
E01026820,1249,15,45,24,7,1340
E01026821,1207,8,30,4,5,1254
E01026822,1703,60,84,26,17,1890
E01026823,1604,50,102,27,14,1797
E01026824,1203,23,46,19,15,1306
E01026825,1062,25,38,11,3,1139
E01026826,1171,33,42,12,21,1279
E01026827,1229,15,26,20,13,1303
E01026828,1203,19,30,15,4,1271
E01026829,1518,26,22,42,9,1617
E01026830,1026,30,23,11,6,1096
E01026831,1020,18,20,9,8,1075
E01026832,976,14,15,7,0,1012
E01026833,1033,14,15,14,3,1079
E01026834,1106,17,12,12,6,1153
E01026835,1227,31,38,12,4,1312
E01026836,1235,27,30,7,3,1302
E01026837,1191,30,39,14,9,1283
E01026838,1179,21,57,9,12,1278
E01026839,1330,27,38,8,11,1414
E01026840,1348,22,34,12,10,1426
E01026841,1179,20,42,12,5,1258
E01026842,1335,16,41,22,12,1426
E01026843,1502,16,30,19,9,1576
E01026844,1277,22,36,25,10,1370
E01026845,1279,23,19,10,8,1339
E01026846,1274,17,63,31,10,1395
E01026848,1484,20,35,18,4,1561
E01026849,1447,23,65,17,5,1557
E01026850,1472,23,44,11,8,1558
E01026852,1047,12,35,9,3,1106
E01026853,1407,28,89,8,10,1542
E01026855,1309,31,45,7,3,1395
E01026856,1511,43,46,23,7,1630
E01026857,1280,15,26,6,9,1336
E01026858,1097,25,110,39,10,1281
E01026859,1152,23,36,17,8,1236
E01026860,2804,130,991,163,90,4178
E01026861,1070,23,121,29,10,1253
E01026862,988,19,52,7,8,1074
E01026863,1444,20,74,25,7,1570
E01026864,1162,19,40,3,2,1226
E01026865,1356,34,68,30,4,1492
E01026866,1290,29,26,13,7,1365
E01026867,1062,10,37,34,11,1154
E01026868,1086,11,57,20,8,1182
E01026869,1013,11,36,14,1,1075
E01026870,1294,13,15,2,2,1326
E01026871,1090,9,7,0,0,1106
E01026872,1794,16,12,1,1,1824
E01026873,1031,5,0,1,0,1037
E01026874,1272,5,1,1,2,1281
E01026875,903,8,8,0,3,922
E01026876,1262,6,5,2,1,1276
E01026877,1256,3,4,1,0,1264
E01026878,947,2,1,2,1,953
E01026879,961,6,21,3,2,993
E01026880,1229,5,5,2,0,1241
E01026881,1030,6,45,6,3,1090
E01026882,1545,20,90,18,8,1681
E01026883,1339,11,17,2,2,1371
E01026884,895,6,6,2,2,911
E01026885,1100,7,14,0,1,1122
E01026886,1139,5,7,1,2,1154
E01026887,1177,6,1,2,1,1187
E01026888,1335,3,12,6,3,1359
E01026889,1293,8,19,2,0,1322
E01026891,1334,13,33,14,2,1396
E01026892,1045,8,3,0,1,1057
E01026893,905,2,9,1,0,917
E01026894,2030,7,12,2,3,2054
E01026895,1191,13,25,4,5,1238
E01026896,973,2,4,4,2,985
E01026897,2226,11,12,5,2,2256
E01026898,1152,2,3,3,1,1161
E01026899,1176,10,4,1,4,1195
E01026900,1211,3,7,1,0,1222
E01026901,1096,7,4,1,0,1108
E01026902,1557,7,12,4,2,1582
E01026903,977,5,1,0,2,985
E01026904,1110,5,7,2,0,1124
E01026905,889,5,7,1,0,902
E01026906,1158,8,12,6,3,1187
E01026907,1436,8,17,3,1,1465
E01026908,1086,15,27,15,0,1143
E01026909,1181,2,6,0,0,1189
E01026910,1227,4,3,1,1,1236
E01026911,902,6,10,0,0,918
E01026912,1248,6,3,1,2,1260
E01026913,1330,6,10,1,0,1347
E01026914,1267,4,2,4,3,1280
E01026915,1530,13,8,1,0,1552
E01026916,1712,6,10,4,1,1733
E01026917,1264,9,15,2,3,1293
E01026918,1422,1,21,7,1,1452
E01026919,1175,9,9,0,3,1196
E01026920,939,3,0,1,0,943
E01026921,1152,4,10,1,1,1168
E01026922,1213,7,7,10,1,1238
E01026924,1240,6,19,10,3,1278
E01026925,1598,10,26,22,8,1664
E01026926,1285,12,4,1,0,1302
E01026927,1497,9,11,2,3,1522
E01026928,1179,8,18,0,2,1207
E01026929,1093,2,2,1,0,1098
E01026930,1228,9,4,1,1,1243
E01026931,964,5,9,4,2,984
E01026932,980,5,24,6,1,1016
E01026933,2114,18,21,3,4,2160
E01026934,863,4,1,1,1,870
E01026935,1111,3,0,1,0,1115
E01026936,1161,4,10,2,0,1177
E01026937,1156,3,15,3,2,1179
E01026938,1586,10,8,4,3,1611
E01026939,1376,12,11,2,0,1401
E01026940,1360,6,14,0,0,1380
E01026941,1026,8,8,1,4,1047
E01026942,921,5,3,0,1,930
E01026943,1293,10,5,0,0,1308
E01026944,935,5,4,0,0,944
E01026945,1605,19,29,7,0,1660
E01026946,907,6,14,4,0,931
E01026947,1022,2,10,2,0,1036
E01026948,1257,15,34,3,2,1311
E01026949,1077,10,8,5,4,1104
E01026950,1133,19,5,5,1,1163
E01026951,962,7,6,3,0,978
E01026952,973,11,5,0,0,989
E01026953,1118,9,18,8,1,1154
E01026954,1044,14,13,11,2,1084
E01026955,1178,12,18,5,0,1213
E01026956,1495,15,23,26,0,1559
E01026957,1276,16,19,9,1,1321
E01026958,1334,16,17,7,4,1378
E01026959,1121,14,7,3,5,1150
E01026960,1092,7,25,16,7,1147
E01026961,911,13,25,14,3,966
E01026962,1134,5,3,1,3,1146
E01026963,931,15,21,28,3,998
E01026965,755,13,15,9,6,798
E01026966,1076,4,19,15,2,1116
E01026967,1308,14,10,20,1,1353
E01026968,973,23,17,22,1,1036
E01026969,1350,20,16,4,1,1391
E01026970,1308,14,2,2,2,1328
E01026971,1365,9,9,8,2,1393
E01026972,1392,10,16,2,1,1421
E01026973,1100,8,14,4,1,1127
E01026974,956,6,5,1,1,969
E01026975,1083,15,2,6,12,1118
E01026976,1013,8,14,4,1,1040
E01026977,1577,9,7,2,2,1597
E01026978,1147,7,6,1,0,1161
E01026979,1112,1,3,5,1,1122
E01026980,1318,10,5,2,1,1336
E01026981,990,10,4,5,0,1009
E01026982,1434,24,18,19,2,1497
E01026983,892,6,4,7,2,911
E01026984,1361,14,18,5,2,1400
E01026985,1261,9,3,0,0,1273
E01026986,2058,23,60,10,15,2166
E01026987,994,3,6,3,0,1006
E01026988,1128,10,25,7,3,1173
E01026989,1034,6,38,7,1,1086
E01026990,1932,31,52,22,0,2037
E01026991,1399,7,13,2,0,1421
E01026992,1573,4,49,8,0,1634
E01026993,1653,4,5,5,0,1667
E01026994,853,4,0,2,0,859
E01026997,1415,8,44,8,3,1478
E01026998,1482,2,16,7,0,1507
E01026999,1459,12,7,0,0,1478
E01027000,1159,4,5,4,5,1177
E01027001,1110,14,16,4,3,1147
E01027002,1283,3,8,6,0,1300
E01027003,1147,7,12,9,4,1179
E01027004,1510,4,14,0,1,1529
E01027005,1662,13,11,3,0,1689
E01027006,1468,12,13,6,1,1500
E01027007,1034,7,40,13,2,1096
E01027008,1579,15,26,6,0,1626
E01027009,1056,17,31,7,2,1113
E01027010,981,0,18,3,2,1004
E01027011,1566,7,17,2,2,1594
E01027012,1344,12,27,17,0,1400
E01027013,1246,23,15,10,1,1295
E01027014,1555,17,29,10,0,1611
E01027015,1045,7,7,1,1,1061
E01027016,1214,5,9,2,0,1230
E01027017,1188,9,15,1,0,1213
E01027018,1206,8,21,7,0,1242
E01027019,1267,13,11,5,4,1300
E01027020,1020,12,13,3,0,1048
E01027021,1479,8,5,6,0,1498
E01027022,1449,11,10,6,1,1477
E01027023,1615,10,20,6,0,1651
E01027024,1384,10,22,5,0,1421
E01027025,1302,10,4,9,0,1325
E01027026,1581,5,13,1,2,1602
E01027027,1819,9,22,4,1,1855
E01027028,1670,17,22,6,1,1716
E01027029,1176,12,19,4,3,1214
E01027030,1470,4,4,2,2,1482
E01027031,1672,13,18,1,1,1705
E01027032,1517,5,8,3,1,1534
E01027033,1487,5,8,6,2,1508
E01027034,1330,11,18,15,0,1374
E01027035,1101,11,4,4,1,1121
E01027037,1633,17,23,11,3,1687
E01027038,1273,18,2,10,3,1306
E01027039,1389,10,15,14,0,1428
E01027040,1294,8,11,11,1,1325
E01027041,1236,20,13,5,0,1274
E01027042,1421,9,34,7,1,1472
E01027043,1609,7,10,3,1,1630
E01027044,1663,6,10,7,4,1690
E01027045,1570,4,5,2,2,1583
E01027046,987,9,14,5,2,1017
E01027047,1067,7,9,2,0,1085
E01027048,1459,16,71,8,2,1556
E01027049,794,2,11,3,4,814
E01027050,1501,5,15,3,2,1526
E01027051,1366,10,23,13,2,1414
E01027052,1113,9,8,1,2,1133
E01027053,1250,5,14,2,7,1278
E01027054,1044,3,10,4,1,1062
E01027055,898,9,5,4,1,917
E01027056,1210,7,11,5,2,1235
E01027057,1404,15,16,1,5,1441
E01027058,1114,16,25,5,3,1163
E01027059,1323,21,8,12,4,1368
E01027060,1386,19,18,18,25,1466
E01027061,1342,18,17,20,0,1397
E01027062,1679,23,28,33,5,1768
E01027063,1421,19,25,9,3,1477
E01027064,1323,3,17,14,1,1358
E01027065,1343,22,35,13,9,1422
E01027066,1624,17,45,29,0,1715
E01027067,1305,13,14,14,2,1348
E01027068,2125,21,68,38,5,2257
E01027069,1303,17,14,9,1,1344
E01027070,1289,7,18,13,2,1329
E01027071,1188,3,20,2,1,1214
E01027072,1159,18,8,2,0,1187
E01027073,1596,5,18,17,0,1636
E01027074,1756,7,14,11,2,1790
E01027075,1543,9,13,8,5,1578
E01027076,1669,17,26,4,1,1717
E01027077,1468,12,21,9,2,1512
E01027078,1735,7,6,3,4,1755
E01027079,1347,4,49,5,6,1411
E01027080,1522,17,37,5,2,1583
E01027081,1016,9,34,22,11,1092
E01027082,1161,9,32,27,6,1235
E01027083,1023,17,30,4,7,1081
E01027084,1206,7,12,2,0,1227
E01027085,1014,8,17,7,4,1050
E01027086,1286,8,42,8,5,1349
E01027087,846,11,80,5,4,946
E01027088,851,7,118,4,14,994
E01027089,1504,7,94,20,5,1630
E01027090,1225,5,4,3,10,1247
E01027091,1435,7,18,3,1,1464
E01027092,1211,8,9,1,0,1229
E01027094,1279,13,8,7,1,1308
E01027095,1106,6,24,11,0,1147
E01027096,851,11,47,7,3,919
E01027097,1079,2,57,8,2,1148
E01027098,916,8,22,1,1,948
E01027099,1159,9,46,3,6,1223
E01027100,1209,16,58,16,6,1305
E01027101,1813,18,25,20,3,1879
E01027102,1297,5,17,4,2,1325
E01027103,1308,6,6,3,4,1327
E01027104,1733,25,101,22,5,1886
E01027105,1458,42,124,53,16,1693
E01027106,1347,20,121,26,5,1519
E01027107,1025,8,7,6,2,1048
E01027108,1132,4,3,5,1,1145
E01027109,986,13,8,6,2,1015
E01027110,1420,43,41,31,4,1539
E01027111,1531,27,97,26,21,1702
E01027112,1530,18,65,36,10,1659
E01027113,1695,15,49,26,18,1803
E01027114,1207,21,35,22,4,1289
E01027115,907,6,32,11,3,959
E01027116,1379,19,164,33,13,1608
E01027117,1010,13,128,30,23,1204
E01027119,1357,8,11,7,0,1383
E01027120,990,16,22,8,1,1037
E01027121,1066,3,79,10,10,1168
E01027122,948,4,15,5,6,978
E01027123,1273,5,8,3,0,1289
E01027124,1700,11,32,6,3,1752
E01027125,1456,4,12,7,5,1484
E01027126,1660,15,14,11,0,1700
E01027127,1396,13,26,9,2,1446
E01027128,1189,8,57,25,8,1287
E01027129,1801,10,9,8,1,1829
E01027130,1390,13,49,21,4,1477
E01027131,1539,24,32,29,3,1627
E01027132,1391,46,130,137,2,1706
E01027133,1184,43,94,78,13,1412
E01027134,1153,41,175,65,6,1440
E01027135,1304,28,63,41,6,1442
E01027136,1384,23,53,57,8,1525
E01027137,895,30,64,63,11,1063
E01027138,1079,24,74,28,9,1214
E01027139,963,14,113,68,3,1161
E01027140,720,22,69,56,5,872
E01027141,1013,13,129,31,2,1188
E01027142,934,18,49,66,2,1069
E01027143,1060,4,21,4,4,1093
E01027144,1261,7,23,13,1,1305
E01027145,1033,18,103,28,2,1184
E01027146,1164,14,40,15,6,1239
E01027147,1246,30,83,37,0,1396
E01027148,1110,16,36,10,5,1177
E01027149,1157,18,24,24,9,1232
E01027151,1014,41,166,88,16,1325
E01027152,1202,26,91,87,11,1417
E01027153,1193,61,304,190,19,1767
E01027154,1149,35,88,118,9,1399
E01027155,1213,51,379,142,26,1811
E01027156,834,13,40,41,8,936
E01027158,1083,14,43,29,7,1176
E01027159,986,16,16,30,2,1050
E01027160,1265,37,63,39,4,1408
E01027161,1093,29,33,42,0,1197
E01027162,1081,31,77,37,15,1241
E01027163,1051,27,48,12,3,1141
E01027164,1035,24,70,37,3,1169
E01027165,922,17,45,32,2,1018
E01027166,1129,19,55,31,7,1241
E01027167,1024,13,47,20,15,1119
E01027168,1001,59,63,96,13,1232
E01027169,1080,28,69,43,7,1227
E01027170,918,44,81,70,6,1119
E01027171,1087,27,43,26,11,1194
E01027172,1160,28,58,38,4,1288
E01027173,972,42,114,74,4,1206
E01027174,942,19,76,40,6,1083
E01027175,929,26,55,111,13,1134
E01027176,1101,16,51,67,5,1240
E01027177,938,33,21,89,7,1088
E01027178,1195,38,48,137,3,1421
E01027179,1279,21,85,58,1,1444
E01027180,1157,18,43,41,16,1275
E01027181,1365,10,36,17,2,1430
E01027182,1007,19,123,46,2,1197
E01027183,1145,11,54,21,1,1232
E01027184,1189,24,55,40,19,1327
E01027185,1054,45,57,82,19,1257
E01027186,1288,20,47,49,4,1408
E01027187,964,27,90,43,7,1131
E01027188,1190,40,106,56,8,1400
E01027189,1221,37,52,36,3,1349
E01027190,1265,26,21,13,10,1335
E01027191,1185,44,77,82,13,1401
E01027192,964,29,67,58,1,1119
E01027193,1151,7,19,18,7,1202
E01027194,1129,8,15,12,4,1168
E01027195,854,47,96,150,10,1157
E01027196,748,23,268,113,7,1159
E01027197,929,44,54,63,12,1102
E01027198,851,43,116,142,6,1158
E01027199,727,29,65,91,15,927
E01027200,832,42,54,100,5,1033
E01027201,1491,17,61,36,15,1620
E01027202,1257,4,13,7,3,1284
E01027203,1006,14,87,31,7,1145
E01027204,1227,17,25,34,7,1310
E01027205,1267,21,153,31,7,1479
E01027206,1946,32,160,44,16,2198
E01027207,1135,7,16,14,8,1180
E01027208,1118,16,20,13,3,1170
E01027209,929,9,6,15,3,962
E01027210,869,10,30,17,1,927
E01027211,1165,9,12,6,7,1199
E01027212,1045,12,43,21,6,1127
E01027213,1132,16,51,32,12,1243
E01027214,1165,27,17,35,12,1256
E01027215,1151,8,20,13,0,1192
E01027216,1342,15,52,13,2,1424
E01027217,1713,15,33,15,11,1787
E01027218,1296,17,26,19,7,1365
E01027219,1432,23,27,22,7,1511
E01027220,1083,14,28,29,1,1155
E01027221,1373,11,33,28,10,1455
E01027222,1029,6,19,10,0,1064
E01027223,1452,46,139,92,43,1772
E01027224,1089,74,158,102,23,1446
E01027225,1101,47,145,76,21,1390
E01027226,1202,44,192,68,11,1517
E01027227,888,45,236,82,12,1263
E01027228,1296,34,159,115,47,1651
E01027229,1025,43,72,60,10,1210
E01027230,939,39,78,65,3,1124
E01027231,1195,41,95,79,7,1417
E01027232,1729,53,315,168,17,2282
E01027233,780,29,50,48,3,910
E01027234,941,17,60,32,13,1063
E01027235,924,28,35,67,8,1062
E01027236,1266,23,56,19,6,1370
E01027237,1424,14,126,78,4,1646
E01027238,1352,51,85,95,9,1592
E01027239,828,29,219,101,22,1199
E01027240,847,32,56,60,12,1007
E01027241,1008,64,126,105,9,1312
E01027242,925,34,133,63,6,1161
E01027243,1036,32,30,58,3,1159
E01027244,855,53,38,136,7,1089
E01027245,1082,21,40,97,11,1251
E01027246,1088,41,44,142,7,1322
E01027247,1011,28,62,86,5,1192
E01027248,891,45,54,105,8,1103
E01027249,1079,42,66,107,5,1299
E01027250,1070,11,41,15,8,1145
E01027252,1011,29,46,45,9,1140
E01027253,1324,19,69,43,2,1457
E01027254,1223,17,98,19,8,1365
E01027255,1017,14,57,22,10,1120
E01027256,1171,16,44,12,3,1246
E01027257,1242,19,49,50,11,1371
E01027258,938,11,100,29,12,1090
E01027259,928,24,246,74,7,1279
E01027260,994,9,165,33,12,1213
E01027261,1593,8,14,2,4,1621
E01027262,1313,10,13,1,2,1339
E01027263,1520,4,5,3,0,1532
E01027264,1225,10,13,6,2,1256
E01027265,1203,14,12,3,0,1232
E01027266,1058,6,14,3,1,1082
E01027267,888,6,11,3,2,910
E01027268,1020,5,8,2,1,1036
E01027269,1176,6,11,3,2,1198
E01027270,1157,13,14,6,2,1192
E01027271,1152,12,6,5,2,1177
E01027272,1194,6,8,2,0,1210
E01027273,1407,10,16,1,1,1435
E01027274,1211,10,34,3,7,1265
E01027275,1167,8,13,0,1,1189
E01027276,1944,24,25,7,3,2003
E01027277,1472,5,6,4,3,1490
E01027279,1358,11,22,11,0,1402
E01027280,1803,17,32,13,2,1867
E01027281,1298,12,26,7,6,1349
E01027282,1291,13,10,6,0,1320
E01027283,1284,11,13,1,1,1310
E01027284,1609,9,10,2,1,1631
E01027285,1363,12,8,4,1,1388
E01027286,1279,8,4,1,0,1292
E01027287,1326,3,8,1,1,1339
E01027288,1685,14,10,10,2,1721
E01027289,1389,13,3,5,0,1410
E01027290,1743,21,35,22,6,1827
E01027291,1188,1,10,10,1,1210
E01027292,930,1,1,2,2,936
E01027293,979,3,4,1,0,987
E01027294,1474,9,14,7,2,1506
E01027295,1711,11,12,4,4,1742
E01027296,1606,10,10,6,1,1633
E01027297,1349,7,15,8,1,1380
E01027298,1045,6,12,4,1,1068
E01027299,1178,13,24,3,2,1220
E01027300,1109,7,7,4,2,1129
E01027301,1604,14,30,8,0,1656
E01027302,1111,21,18,0,1,1151
E01027303,1178,7,14,6,3,1208
E01027304,1396,8,3,2,0,1409
E01027305,1552,6,16,3,2,1579
E01027306,1389,5,8,6,3,1411
E01027307,1671,10,24,7,0,1712
E01027308,1283,12,16,3,2,1316
E01027309,1134,12,87,45,5,1283
E01027310,810,71,42,131,2,1056
E01027311,910,20,81,55,0,1066
E01027312,970,23,78,48,7,1126
E01027313,668,14,561,73,4,1320
E01027314,1102,43,373,91,10,1619
E01027315,1557,45,130,93,18,1843
E01027316,863,30,234,57,5,1189
E01027317,1094,23,32,41,1,1191
E01027318,916,33,7,47,1,1004
E01027319,1058,30,33,22,3,1146
E01027320,1402,60,84,129,7,1682
E01027321,1033,19,83,44,2,1181
E01027322,927,7,13,7,4,958
E01027323,1120,15,8,3,0,1146
E01027324,987,6,3,5,0,1001
E01027325,1216,6,5,4,2,1233
E01027326,1218,18,5,5,2,1248
E01027327,1205,26,10,16,6,1263
E01027328,1042,9,5,1,4,1061
E01027329,1464,10,15,2,4,1495
E01027330,958,29,150,88,3,1228
E01027331,881,52,37,87,1,1058
E01027332,1032,14,191,34,4,1275
E01027333,1448,31,238,76,9,1802
E01027334,675,47,45,129,6,902
E01027335,1227,4,14,3,1,1249
E01027336,1166,16,35,3,4,1224
E01027337,1436,8,8,9,1,1462
E01027338,1873,20,12,3,9,1917
E01027339,896,32,11,53,3,995
E01027340,1031,30,47,59,5,1172
E01027341,977,26,21,86,8,1118
E01027342,1002,16,28,54,10,1110
E01027343,1069,14,75,52,3,1213
E01027344,1058,7,88,26,8,1187
E01027345,932,10,95,48,2,1087
E01027346,1006,17,91,34,2,1150
E01027347,1382,19,97,72,2,1572
E01027348,1648,20,7,7,3,1685
E01027349,1127,56,108,63,18,1372
E01027350,1094,25,76,56,1,1252
E01027351,1145,40,59,45,1,1290
E01027352,963,36,136,53,3,1191
E01027353,1450,8,13,4,6,1481
E01027354,1882,14,7,5,5,1913
E01027355,1309,6,12,4,1,1332
E01027356,1502,3,7,1,0,1513
E01027357,1141,3,9,0,2,1155
E01027358,1746,2,8,1,1,1758
E01027359,1738,9,20,3,1,1771
E01027361,1775,7,7,2,2,1793
E01027362,1036,2,4,2,0,1044
E01027363,926,1,0,1,4,932
E01027364,1737,1,2,1,1,1742
E01027365,1875,1,5,0,0,1881
E01027366,1316,6,2,1,1,1326
E01027367,1498,8,8,2,1,1517
E01027368,1458,2,12,2,0,1474
E01027369,1326,5,6,1,1,1339
E01027370,1581,5,6,1,1,1594
E01027371,1447,2,1,0,0,1450
E01027372,1880,4,2,1,0,1887
E01027373,1703,2,3,0,3,1711
E01027374,1765,4,3,2,4,1778
E01027375,1526,3,8,0,2,1539
E01027376,1392,2,8,0,0,1402
E01027377,1458,11,18,3,5,1495
E01027378,880,3,4,0,0,887
E01027379,1171,1,3,4,0,1179
E01027380,1186,3,8,3,0,1200
E01027381,1574,5,1,1,2,1583
E01027382,1444,6,2,3,2,1457
E01027383,1168,2,4,0,0,1174
E01027384,1270,2,2,0,1,1275
E01027385,1009,3,10,2,0,1024
E01027386,1119,1,4,1,0,1125
E01027387,1509,5,25,0,2,1541
E01027388,1145,7,4,2,3,1161
E01027389,1323,2,10,2,1,1338
E01027390,1732,3,2,0,1,1738
E01027391,1149,1,18,0,0,1168
E01027392,1339,4,9,1,1,1354
E01027393,1106,5,8,0,1,1120
E01027394,1006,2,1,0,0,1009
E01027395,1212,12,10,1,0,1235
E01027396,1071,4,8,0,0,1083
E01027397,1122,5,6,0,1,1134
E01027398,1703,8,13,4,0,1728
E01027399,1216,6,4,1,0,1227
E01027400,987,3,4,0,3,997
E01027401,1131,5,7,1,2,1146
E01027402,1051,2,9,3,0,1065
E01027403,968,4,3,4,2,981
E01027404,1277,10,2,0,0,1289
E01027405,1257,6,1,0,0,1264
E01027406,1157,2,4,0,0,1163
E01027407,1134,2,8,1,1,1146
E01027408,1096,2,8,0,0,1106
E01027409,1329,2,5,1,1,1338
E01027410,1327,7,2,0,3,1339
E01027411,1153,1,1,0,0,1155
E01027412,1190,7,2,2,1,1202
E01027413,1497,6,22,1,1,1527
E01027414,1195,2,16,0,1,1214
E01027415,1368,11,24,0,0,1403
E01027416,1175,7,15,4,2,1203
E01027417,1312,3,5,1,0,1321
E01027418,1499,8,10,0,1,1518
E01027419,1361,3,3,3,0,1370
E01027420,1227,1,0,2,0,1230
E01027421,1255,4,0,0,1,1260
E01027422,1437,5,8,2,4,1456
E01027423,1217,1,4,1,0,1223
E01027424,1598,6,16,1,4,1625
E01027425,1823,8,28,1,1,1861
E01027426,1025,3,34,0,1,1063
E01027427,1352,1,10,0,1,1364
E01027428,1260,2,12,1,1,1276
E01027429,1474,6,6,3,0,1489
E01027430,1297,8,4,0,0,1309
E01027431,1396,8,13,1,0,1418
E01027432,1302,5,9,1,1,1318
E01027433,1345,5,13,1,0,1364
E01027434,1171,4,1,1,0,1177
E01027435,1208,2,3,1,0,1214
E01027436,1278,3,6,0,1,1288
E01027437,1536,3,0,0,0,1539
E01027438,1226,0,1,0,1,1228
E01027439,1550,2,8,1,1,1562
E01027440,1198,0,8,0,1,1207
E01027441,1632,5,16,1,1,1655
E01027442,1322,11,22,0,3,1358
E01027443,1159,6,4,0,0,1169
E01027444,2010,51,84,88,9,2242
E01027445,1357,5,5,2,0,1369
E01027446,1192,2,6,0,0,1200
E01027447,1469,4,8,0,1,1482
E01027448,1568,5,12,0,2,1587
E01027449,1321,6,7,0,3,1337
E01027450,1349,8,2,0,1,1360
E01027451,1440,9,6,1,0,1456
E01027452,1199,4,24,7,0,1234
E01027453,1244,5,5,4,4,1262
E01027455,1255,2,5,0,2,1264
E01027456,1119,1,11,0,5,1136
E01027457,1348,5,11,6,2,1372
E01027458,1325,4,10,6,1,1346
E01027460,1357,7,21,0,8,1393
E01027461,1081,8,3,1,0,1093
E01027462,1507,8,7,4,0,1526
E01027463,1370,5,7,3,1,1386
E01027464,1132,5,38,1,5,1181
E01027465,1232,6,18,0,0,1256
E01027466,991,4,17,1,0,1013
E01027468,1047,3,32,0,2,1084
E01027469,1078,7,94,4,7,1190
E01027471,1268,8,98,2,3,1379
E01027472,1376,10,25,9,1,1421
E01027473,1422,7,5,1,1,1436
E01027474,1489,5,13,0,0,1507
E01027475,1221,4,4,1,1,1231
E01027476,1961,10,14,1,4,1990
E01027477,1051,2,3,1,0,1057
E01027478,922,2,7,1,1,933
E01027479,1909,5,6,2,3,1925
E01027480,1033,0,0,0,1,1034
E01027481,1410,8,3,1,1,1423
E01027482,1308,10,6,1,1,1326
E01027483,1094,7,3,0,1,1105
E01027484,1879,3,4,1,3,1890
E01027485,1231,3,2,1,0,1237
E01027486,962,1,1,4,0,968
E01027487,962,0,0,0,0,962
E01027488,1814,4,9,2,0,1829
E01027489,1296,8,10,0,8,1322
E01027490,1473,9,5,0,3,1490
E01027491,1346,9,3,0,0,1358
E01027492,1470,4,1,4,1,1480
E01027493,1326,8,13,0,1,1348
E01027494,1897,12,9,1,2,1921
E01027495,884,5,3,0,0,892
E01027496,979,3,8,1,0,991
E01027497,2038,6,6,1,0,2051
E01027498,2085,11,9,0,1,2106
E01027499,1237,2,4,1,2,1246
E01027500,1350,6,26,1,1,1384
E01027501,914,5,5,1,0,925
E01027502,1028,1,9,0,0,1038
E01027503,1519,6,13,2,0,1540
E01027504,1706,9,9,2,2,1728
E01027505,1173,4,1,1,1,1180
E01027506,939,1,7,0,0,947
E01027507,1139,5,6,0,1,1151
E01027508,901,7,5,0,1,914
E01027509,1148,1,7,0,0,1156
E01027510,952,1,4,0,1,958
E01027511,965,0,1,0,0,966
E01027512,891,4,4,1,0,900
E01027513,1568,7,3,2,2,1582
E01027514,1346,3,7,1,0,1357
E01027515,1188,4,6,0,0,1198
E01027516,1068,0,9,0,0,1077
E01027517,1602,0,9,2,4,1617
E01027518,1133,3,6,0,0,1142
E01027519,1109,6,4,0,1,1120
E01027520,1222,1,5,0,0,1228
E01027521,1238,12,36,0,4,1290
E01027522,1062,3,2,0,0,1067
E01027523,943,6,2,0,1,952
E01027524,1216,3,10,0,1,1230
E01027525,1457,5,5,0,0,1467
E01027526,1074,2,14,2,0,1092
E01027527,1027,14,8,0,5,1054
E01027528,1014,6,29,1,0,1050
E01027529,950,4,8,1,3,966
E01027530,1103,2,5,0,0,1110
E01027531,1328,5,10,0,1,1344
E01027532,1596,5,7,1,1,1610
E01027533,1384,8,8,0,0,1400
E01027534,1505,4,11,3,0,1523
E01027535,1251,4,2,1,0,1258
E01027536,1234,2,1,1,1,1239
E01027537,1144,1,9,1,0,1155
E01027538,1468,3,6,0,1,1478
E01027539,1316,5,54,5,2,1382
E01027540,1451,4,45,1,1,1502
E01027541,1509,0,12,1,1,1523
E01027542,1413,2,4,1,2,1422
E01027543,1005,6,7,1,0,1019
E01027544,1165,5,3,0,2,1175
E01027545,1578,6,21,1,0,1606
E01027546,1344,7,16,2,7,1376
E01027549,1197,2,27,0,5,1231
E01027550,1067,4,1,0,0,1072
E01027551,1136,0,4,0,1,1141
E01027552,1068,2,4,4,2,1080
E01027553,1399,5,10,0,0,1414
E01027554,1162,1,1,0,0,1164
E01027555,1615,4,8,2,0,1629
E01027556,1359,3,4,1,0,1367
E01027557,1370,1,4,1,1,1377
E01027558,1598,7,5,2,0,1612
E01027559,1434,1,4,0,1,1440
E01027560,1831,3,13,0,0,1847
E01027561,1551,0,4,1,0,1556
E01027562,1375,3,12,1,0,1391
E01027563,1197,8,7,0,0,1212
E01027564,1016,5,17,0,0,1038
E01027565,1220,5,17,1,1,1244
E01027566,1017,4,10,1,0,1032
E01027567,1375,4,2,3,1,1385
E01027568,1808,3,0,0,0,1811
E01027569,1134,2,2,3,0,1141
E01027570,2100,8,7,0,1,2116
E01027571,1518,8,33,1,2,1562
E01027572,1695,6,16,3,1,1721
E01027573,1337,5,1,0,2,1345
E01027574,1219,4,12,2,1,1238
E01027575,1607,1,10,0,0,1618
E01027576,1276,3,28,0,6,1313
E01027577,1564,10,37,3,1,1615
E01027578,1208,9,17,5,0,1239
E01027579,873,4,14,1,0,892
E01027580,863,5,10,3,0,881
E01027581,1704,16,282,8,4,2014
E01027582,1199,5,28,7,2,1241
E01027583,1672,8,12,1,1,1694
E01027584,1334,2,4,0,0,1340
E01027585,1618,3,7,0,2,1630
E01027586,1605,6,5,3,1,1620
E01027587,1156,8,1,1,1,1167
E01027588,1274,0,14,3,1,1292
E01027589,1410,2,2,1,1,1416
E01027590,1727,9,15,0,4,1755
E01027591,1420,3,4,0,0,1427
E01027592,1506,4,9,0,0,1519
E01027593,1460,0,1,0,0,1461
E01027594,1232,5,7,0,0,1244
E01027595,1346,5,5,2,2,1360
E01027596,1291,4,6,0,1,1302
E01027597,1293,5,7,1,1,1307
E01027598,1545,3,5,1,0,1554
E01027599,1356,5,8,0,0,1369
E01027600,1541,5,3,3,0,1552
E01027601,1538,4,9,1,2,1554
E01027603,1633,6,14,9,0,1662
E01027604,1469,0,2,3,0,1474
E01027605,1338,11,18,2,0,1369
E01027606,1255,6,18,2,1,1282
E01027607,1076,4,10,3,0,1093
E01027608,1451,22,15,3,4,1495
E01027609,981,4,20,4,1,1010
E01027610,1316,5,22,2,2,1347
E01027611,1679,6,12,5,7,1709
E01027612,1316,2,22,3,3,1346
E01027613,1470,7,5,3,3,1488
E01027614,1063,2,6,4,2,1077
E01027615,1029,11,10,0,1,1051
E01027616,1153,4,6,0,0,1163
E01027617,929,2,2,0,0,933
E01027618,2034,7,3,1,3,2048
E01027619,2081,6,11,8,1,2107
E01027620,1558,3,7,6,0,1574
E01027621,1884,8,17,6,6,1921
E01027622,1576,6,4,1,1,1588
E01027623,1077,2,6,2,0,1087
E01027624,1047,2,3,0,3,1055
E01027625,1308,8,6,1,7,1330
E01027626,1111,3,12,3,2,1131
E01027627,1528,15,4,5,5,1557
E01027628,1517,2,2,2,3,1526
E01027629,1071,3,5,1,2,1082
E01027630,1453,10,24,5,3,1495
E01027631,1182,5,6,1,0,1194
E01027632,1190,5,4,0,1,1200
E01027633,1537,1,4,2,1,1545
E01027634,1635,8,9,3,3,1658
E01027635,2020,17,24,27,18,2106
E01027636,1738,4,7,2,0,1751
E01027637,1587,9,2,1,2,1601
E01027638,1105,6,11,9,5,1136
E01027639,1020,6,7,9,3,1045
E01027640,1183,8,8,7,2,1208
E01027641,1020,3,3,7,7,1040
E01027642,1119,5,1,1,1,1127
E01027643,1183,2,3,5,8,1201
E01027644,1212,5,10,4,2,1233
E01027645,1338,3,14,3,0,1358
E01027646,1251,7,2,1,1,1262
E01027647,1332,4,3,3,1,1343
E01027648,1195,8,33,5,2,1243
E01027649,1365,8,59,15,2,1449
E01027650,1201,12,15,8,4,1240
E01027651,1046,14,77,17,3,1157
E01027652,1236,10,22,14,4,1286
E01027653,1167,12,9,6,11,1205
E01027654,944,9,17,9,1,980
E01027655,1097,17,125,17,3,1259
E01027656,1389,21,20,25,2,1457
E01027657,989,12,20,28,1,1050
E01027658,1192,16,57,12,2,1279
E01027659,1422,19,40,46,5,1532
E01027660,1267,6,8,6,1,1288
E01027661,1147,8,21,9,6,1191
E01027662,994,6,15,2,0,1017
E01027663,1119,6,6,9,4,1144
E01027664,1652,19,9,16,11,1707
E01027665,909,10,8,11,4,942
E01027666,1400,4,1,1,0,1406
E01027667,1114,1,5,1,1,1122
E01027668,1188,7,13,2,0,1210
E01027669,1577,8,14,3,0,1602
E01027670,1275,9,9,0,0,1293
E01027671,1248,1,14,4,1,1268
E01027672,1499,8,17,1,2,1527
E01027673,1454,2,25,12,0,1493
E01027674,1108,5,3,9,1,1126
E01027675,1856,16,5,4,3,1884
E01027676,1336,7,14,0,3,1360
E01027677,1201,16,37,20,3,1277
E01027678,1370,15,91,18,16,1510
E01027679,1322,22,22,20,3,1389
E01027680,1057,15,26,13,12,1123
E01027681,1280,10,9,1,3,1303
E01027682,1304,7,3,9,6,1329
E01027683,1151,1,3,3,3,1161
E01027684,1161,8,4,2,1,1176
E01027685,1031,4,1,0,4,1040
E01027686,925,10,6,2,0,943
E01027687,1230,4,3,2,0,1239
E01027688,1331,3,2,0,2,1338
E01027689,1053,12,55,14,10,1144
E01027690,1187,6,7,7,6,1213
E01027691,1161,15,13,11,6,1206
E01027692,909,9,45,2,5,970
E01027693,1487,12,3,4,0,1506
E01027694,995,11,21,22,13,1062
E01027695,1342,13,6,1,0,1362
E01027696,1290,7,168,4,7,1476
E01027697,1105,6,9,6,1,1127
E01027698,1245,10,7,4,0,1266
E01027699,1108,3,8,1,4,1124
E01027700,943,2,14,3,4,966
E01027701,1289,11,3,13,0,1316
E01027702,958,2,4,5,0,969
E01027703,1560,1,7,1,0,1569
E01027704,958,5,9,3,5,980
E01027705,1323,9,4,7,0,1343
E01027706,1568,12,23,7,1,1611
E01027707,1396,14,8,5,0,1423
E01027708,1171,5,6,5,2,1189
E01027709,1010,3,4,1,1,1019
E01027710,876,4,2,5,1,888
E01027711,979,9,8,6,1,1003
E01027712,1399,21,5,18,8,1451
E01027713,1368,11,14,6,6,1405
E01027714,1324,10,12,13,0,1359
E01027715,808,4,18,27,4,861
E01027716,1153,7,12,7,3,1182
E01027717,1187,7,11,5,2,1212
E01027718,1392,13,34,7,1,1447
E01027719,1131,6,47,12,0,1196
E01027720,1119,10,37,7,1,1174
E01027721,1189,13,7,15,2,1226
E01027722,1005,9,16,22,8,1060
E01027723,1155,9,30,22,6,1222
E01027724,1259,4,7,7,0,1277
E01027725,1221,6,8,0,3,1238
E01027726,1398,15,25,6,1,1445
E01027727,1273,6,26,2,1,1308
E01027728,1108,7,10,6,1,1132
E01027729,1145,15,40,16,2,1218
E01027730,1162,16,17,46,6,1247
E01027731,1106,6,8,13,2,1135
E01027732,1060,13,9,6,3,1091
E01027733,1094,9,18,6,3,1130
E01027734,1248,11,8,2,4,1273
E01027735,1315,3,5,1,3,1327
E01027736,1256,5,6,2,3,1272
E01027737,1374,11,8,5,2,1400
E01027738,1067,6,10,5,1,1089
E01027739,854,12,23,6,2,897
E01027740,1329,4,28,28,0,1389
E01027741,1113,6,14,6,4,1143
E01027742,1156,1,4,3,4,1168
E01027743,1026,4,3,3,1,1037
E01027744,1088,2,2,1,1,1094
E01027745,1293,4,8,2,1,1308
E01027746,1180,7,10,5,1,1203
E01027747,1562,25,44,57,12,1700
E01027748,975,1,1,0,0,977
E01027749,1440,19,17,4,1,1481
E01027750,2144,25,109,13,17,2308
E01027751,1046,1,4,4,1,1056
E01027752,1006,4,0,1,0,1011
E01027753,1098,3,43,6,2,1152
E01027754,910,10,38,16,9,983
E01027756,1353,10,17,3,0,1383
E01027758,1168,1,3,1,1,1174
E01027759,1166,1,6,0,0,1173
E01027760,1086,4,22,2,0,1114
E01027761,987,2,5,4,11,1009
E01027762,1100,4,6,2,0,1112
E01027763,985,0,17,2,0,1004
E01027764,1030,4,9,4,1,1048
E01027765,1307,3,9,1,0,1320
E01027766,1024,7,14,1,0,1046
E01027767,1203,3,11,1,1,1219
E01027768,949,2,2,3,0,956
E01027769,1040,4,12,1,0,1057
E01027770,1328,4,10,5,3,1350
E01027771,2370,74,305,140,21,2910
E01027772,1006,8,77,10,6,1107
E01027773,919,2,8,12,1,942
E01027774,1612,7,18,1,0,1638
E01027775,1613,8,20,1,2,1644
E01027776,1279,7,4,0,0,1290
E01027777,1206,2,1,0,1,1210
E01027778,1891,10,8,0,1,1910
E01027779,941,8,3,0,1,953
E01027780,1547,3,3,1,0,1554
E01027781,1091,0,2,3,1,1097
E01027782,1432,3,3,1,2,1441
E01027783,1513,3,10,4,0,1530
E01027784,1353,7,4,7,0,1371
E01027785,1262,6,11,3,7,1289
E01027786,1337,3,21,5,0,1366
E01027787,1458,1,6,5,0,1470
E01027788,1222,1,1,1,0,1225
E01027789,1940,13,14,7,0,1974
E01027790,1537,6,25,4,2,1574
E01027791,1271,5,3,2,1,1282
E01027792,1569,9,7,0,0,1585
E01027793,1173,7,1,2,0,1183
E01027794,1678,4,5,1,0,1688
E01027795,1279,3,8,1,1,1292
E01027796,1449,2,2,4,0,1457
E01027797,1422,6,6,2,2,1438
E01027798,1613,2,6,0,1,1622
E01027799,1449,3,2,0,1,1455
E01027800,1421,3,6,1,0,1431
E01027801,1415,5,1,0,0,1421
E01027802,1369,1,5,1,0,1376
E01027803,1428,4,0,1,1,1434
E01027804,1260,17,45,11,12,1345
E01027805,1236,8,25,4,7,1280
E01027806,1407,22,35,18,8,1490
E01027807,1229,7,4,0,0,1240
E01027808,1248,3,3,1,2,1257
E01027809,1111,2,6,3,0,1122
E01027810,1215,13,21,5,1,1255
E01027811,1218,6,30,3,5,1262
E01027812,1260,21,67,6,7,1361
E01027813,1741,5,17,4,2,1769
E01027814,1321,3,1,0,3,1328
E01027815,1115,7,7,1,1,1131
E01027816,1315,3,2,1,3,1324
E01027817,1090,5,6,0,2,1103
E01027818,1105,4,2,0,0,1111
E01027819,1036,7,4,0,1,1048
E01027820,968,3,3,1,0,975
E01027821,1236,6,6,0,5,1253
E01027822,1187,1,2,3,1,1194
E01027823,1225,5,0,0,5,1235
E01027824,1208,8,26,1,5,1248
E01027825,1448,7,9,3,4,1471
E01027826,1184,7,22,3,2,1218
E01027827,1421,8,9,0,1,1439
E01027828,1446,2,4,0,1,1453
E01027829,1336,5,1,0,0,1342
E01027830,1411,5,2,1,1,1420
E01027831,909,3,4,0,0,916
E01027832,900,2,17,0,2,921
E01027833,1377,6,10,1,1,1395
E01027834,1326,10,3,1,1,1341
E01027835,1466,4,7,0,1,1478
E01027836,1866,13,12,3,5,1899
E01027837,1147,8,2,0,0,1157
E01027838,1329,4,1,0,0,1334
E01027839,1348,3,6,0,0,1357
E01027840,1772,1,3,0,2,1778
E01027841,1142,3,0,0,1,1146
E01027842,1325,7,14,0,0,1346
E01027843,1137,3,9,1,1,1151
E01027844,1293,5,15,1,1,1315
E01027845,1420,6,19,0,0,1445
E01027846,1468,7,17,4,7,1503
E01027847,1520,20,56,15,16,1627
E01027848,846,5,11,2,0,864
E01027849,1036,3,6,0,1,1046
E01027850,1015,7,16,4,3,1045
E01027851,1231,4,2,2,0,1239
E01027852,1457,14,40,25,23,1559
E01027853,1092,7,15,14,1,1129
E01027854,1284,18,63,18,12,1395
E01027855,1246,9,14,5,1,1275
E01027856,1034,4,7,1,2,1048
E01027857,1115,4,5,1,0,1125
E01027858,1178,1,3,0,1,1183
E01027859,1414,3,5,0,1,1423
E01027860,1222,6,6,3,0,1237
E01027861,1060,5,28,0,3,1096
E01027862,1297,12,30,1,4,1344
E01027863,1239,2,18,2,6,1267
E01027864,1134,4,3,1,1,1143
E01027865,1340,11,11,0,0,1362
E01027866,1272,5,3,1,0,1281
E01027867,1339,11,20,9,2,1381
E01027868,2013,15,41,15,16,2100
E01027869,1010,6,9,1,0,1026
E01027870,1155,1,9,3,0,1168
E01027871,1287,12,5,0,1,1305
E01027872,1136,4,20,2,1,1163
E01027873,1159,13,77,14,7,1270
E01027874,1134,1,7,3,0,1145
E01027875,1464,5,11,7,0,1487
E01027876,1306,4,1,1,0,1312
E01027877,1023,1,13,1,0,1038
E01027878,1006,8,10,1,1,1026
E01027879,1120,2,6,1,1,1130
E01027880,1315,5,6,1,0,1327
E01027881,1081,3,4,1,2,1091
E01027882,1465,4,6,0,0,1475
E01027883,925,5,7,3,0,940
E01027884,1276,9,8,1,0,1294
E01027885,1267,1,8,6,0,1282
E01027886,1076,3,3,1,0,1083
E01027887,1271,4,3,0,1,1279
E01027888,1383,5,1,2,1,1392
E01027889,1402,2,13,4,1,1422
E01027890,1627,5,11,1,0,1644
E01027891,1403,3,8,8,0,1422
E01027892,1519,6,4,2,0,1531
E01027893,1522,5,8,2,1,1538
E01027894,1526,7,4,1,0,1538
E01027895,1332,4,10,0,0,1346
E01027896,1583,8,4,0,0,1595
E01027897,1714,9,7,3,0,1733
E01027898,1906,5,20,7,3,1941
E01027899,1328,5,3,15,2,1353
E01027900,1504,5,4,2,0,1515
E01027901,1276,6,5,3,0,1290
E01027902,1227,13,3,0,0,1243
E01027903,886,7,11,4,2,910
E01027904,1809,4,10,1,1,1825
E01027905,1544,8,37,3,1,1593
E01027906,1109,5,13,0,1,1128
E01027907,1029,5,6,1,0,1041
E01027908,1276,20,21,4,5,1326
E01027909,1648,10,29,7,1,1695
E01027910,2055,10,11,4,0,2080
E01027911,1272,3,9,1,0,1285
E01027912,865,5,2,1,0,873
E01027913,995,2,3,0,0,1000
E01027914,1380,5,9,7,0,1401
E01027915,1314,8,7,1,1,1331
E01027916,1241,7,5,1,0,1254
E01027917,1444,10,10,1,1,1466
E01027918,1177,6,7,7,0,1197
E01027919,943,6,4,2,0,955
E01027920,1009,4,12,4,0,1029
E01027921,1503,2,6,4,0,1515
E01027922,1370,1,5,7,0,1383
E01027923,1859,6,6,0,0,1871
E01027924,1693,6,8,0,3,1710
E01027925,1488,8,8,2,1,1507
E01027926,1224,4,10,4,0,1242
E01027927,1613,6,26,10,1,1656
E01027928,1509,6,12,13,4,1544
E01027929,1882,20,25,18,0,1945
E01027930,1182,12,25,13,1,1233
E01027931,1555,14,34,24,7,1634
E01027932,1594,13,24,16,0,1647
E01027933,1167,7,17,12,1,1204
E01027934,1065,3,12,11,1,1092
E01027935,1029,5,6,3,2,1045
E01027936,1240,4,5,0,0,1249
E01027937,1063,6,5,1,0,1075
E01027938,1027,3,0,2,1,1033
E01027939,1160,12,8,4,1,1185
E01027940,1098,7,6,2,1,1114
E01027941,1058,16,3,7,0,1084
E01027942,997,6,10,6,0,1019
E01027943,1114,12,3,2,0,1131
E01027944,1267,2,5,1,0,1275
E01027945,1366,1,7,5,3,1382
E01027946,1230,2,10,0,1,1243
E01027947,1324,4,11,7,1,1347
E01027948,1495,8,22,6,3,1534
E01027949,1270,2,8,2,2,1284
E01027950,1659,14,13,4,1,1691
E01027951,1122,5,18,2,1,1148
E01027952,1443,8,21,9,2,1483
E01027953,1239,6,9,4,0,1258
E01027954,1258,6,2,6,0,1272
E01027955,986,6,6,5,0,1003
E01027956,1180,6,1,8,0,1195
E01027957,1007,8,10,5,0,1030
E01027958,1065,8,3,3,3,1082
E01027959,1130,4,20,5,4,1163
E01027960,1369,3,5,3,1,1381
E01027961,1564,5,2,3,1,1575
E01027962,1194,6,2,1,1,1204
E01027963,1370,1,1,4,1,1377
E01027964,1222,6,13,8,3,1252
E01027965,1108,7,9,4,4,1132
E01027966,1107,7,3,3,1,1121
E01027967,1279,4,22,5,5,1315
E01027968,967,4,6,8,0,985
E01027969,1117,4,3,0,1,1125
E01027970,1136,6,12,6,1,1161
E01027971,1207,3,2,0,1,1213
E01027972,1684,6,16,7,7,1720
E01027973,1371,10,25,10,0,1416
E01027974,1205,8,11,2,1,1227
E01027975,1312,8,13,5,0,1338
E01027976,1327,4,3,3,3,1340
E01027977,1529,7,9,7,0,1552
E01027978,1365,10,42,8,2,1427
E01027979,1326,3,3,0,0,1332
E01027980,1164,9,2,2,0,1177
E01027981,1287,7,20,1,12,1327
E01027982,1222,1,8,1,2,1234
E01027983,1161,7,20,4,2,1194
E01027984,1211,11,12,6,2,1242
E01027985,1403,8,20,5,0,1436
E01027986,1108,2,2,1,2,1115
E01027987,1332,9,11,5,1,1358
E01027988,1311,4,14,1,1,1331
E01027989,1365,3,5,1,1,1375
E01027990,1477,7,7,5,0,1496
E01027991,1006,5,7,1,0,1019
E01027992,1666,11,37,7,2,1723
E01027993,1265,6,6,1,0,1278
E01027994,1183,4,0,1,2,1190
E01027995,1298,12,13,6,2,1331
E01027996,1645,8,12,3,0,1668
E01027997,1421,5,4,6,1,1437
E01027998,1521,6,9,8,1,1545
E01027999,1912,3,2,10,0,1927
E01028000,1889,8,10,2,0,1909
E01028001,1002,6,0,0,3,1011
E01028002,1189,4,5,1,3,1202
E01028003,1155,2,2,2,0,1161
E01028004,1337,2,8,2,2,1351
E01028005,1610,10,5,2,2,1629
E01028006,1032,6,46,2,2,1088
E01028007,900,2,5,2,2,911
E01028008,1023,13,16,3,1,1056
E01028009,1209,3,14,1,2,1229
E01028010,1114,6,13,2,3,1138
E01028011,1266,4,38,4,0,1312
E01028012,1108,3,12,4,1,1128
E01028013,1489,7,6,7,0,1509
E01028014,1246,3,7,2,3,1261
E01028015,1219,6,21,6,1,1253
E01028016,1135,2,2,1,1,1141
E01028017,1070,1,7,2,0,1080
E01028018,1192,6,13,1,1,1213
E01028019,1119,9,1,0,0,1129
E01028020,1459,14,19,3,1,1496
E01028021,1220,6,5,3,2,1236
E01028022,1188,8,11,1,3,1211
E01028023,1873,3,5,3,3,1887
E01028024,1474,12,17,7,6,1516
E01028025,1161,8,14,1,3,1187
E01028026,1186,11,10,0,0,1207
E01028027,1167,5,19,1,1,1193
E01028028,1243,2,7,2,2,1256
E01028029,973,1,11,0,0,985
E01028030,1020,3,2,0,0,1025
E01028031,902,1,0,1,0,904
E01028032,1098,2,3,1,0,1104
E01028033,1896,18,14,37,4,1969
E01028034,1989,14,6,24,0,2033
E01028035,1866,10,5,6,2,1889
E01028036,2446,83,125,98,17,2769
E01028037,1351,12,2,2,4,1371
E01028038,1189,4,0,4,1,1198
E01028039,975,5,0,0,0,980
E01028040,811,3,2,2,0,818
E01028041,931,2,3,2,1,939
E01028042,1132,6,12,4,2,1156
E01028043,1203,7,10,2,2,1224
E01028044,1237,9,7,5,4,1262
E01028045,1551,13,14,9,1,1588
E01028046,1283,5,13,8,2,1311
E01028047,1560,9,22,7,10,1608
E01028048,1253,5,23,6,0,1287
E01028049,1350,5,20,4,5,1384
E01028050,1463,5,18,10,2,1498
E01028051,1318,9,8,12,0,1347
E01028052,1348,11,20,9,6,1394
E01028053,1265,6,7,12,0,1290
E01028054,1225,6,27,5,1,1264
E01028055,1243,5,11,8,2,1269
E01028056,976,3,7,2,1,989
E01028057,991,5,17,8,3,1024
E01028058,1442,9,9,5,1,1466
E01028059,1332,12,5,8,3,1360
E01028060,1397,10,33,12,7,1459
E01028061,1201,5,10,3,0,1219
E01028062,1584,13,15,8,8,1628
E01028063,1462,5,12,6,0,1485
E01028064,1095,7,35,7,3,1147
E01028065,1219,17,10,11,3,1260
E01028066,1227,11,18,6,6,1268
E01028067,1195,5,10,5,0,1215
E01028068,1409,18,34,21,7,1489
E01028069,963,10,17,9,0,999
E01028070,979,4,7,1,0,991
E01028073,1263,17,80,22,16,1398
E01028074,1149,25,207,46,35,1462
E01028075,1221,33,103,27,23,1407
E01028076,884,17,121,29,12,1063
E01028077,973,19,160,17,14,1183
E01028078,1115,21,121,23,17,1297
E01028079,914,23,195,13,17,1162
E01028080,1405,29,62,12,5,1513
E01028081,983,9,21,7,4,1024
E01028082,998,6,27,9,8,1048
E01028083,975,29,70,18,6,1098
E01028084,1352,13,54,8,8,1435
E01028085,1492,22,116,29,58,1717
E01028086,1194,12,77,19,13,1315
E01028087,1223,14,107,15,11,1370
E01028088,1066,14,150,11,20,1261
E01028089,966,6,128,5,6,1111
E01028090,1076,12,34,16,9,1147
E01028091,1057,15,163,4,3,1242
E01028092,1062,6,6,0,9,1083
E01028093,879,7,2,0,0,888
E01028094,1334,16,72,25,10,1457
E01028095,1162,5,13,9,3,1192
E01028096,1458,13,35,11,11,1528
E01028097,1186,12,41,4,6,1249
E01028098,1244,21,35,30,12,1342
E01028099,1256,15,25,24,5,1325
E01028100,1342,15,44,4,5,1410
E01028101,1035,11,31,13,0,1090
E01028102,1125,9,11,6,0,1151
E01028103,926,6,5,5,0,942
E01028104,1195,5,9,3,0,1212
E01028105,981,11,11,5,2,1010
E01028106,1245,8,6,0,3,1262
E01028107,1303,4,0,2,0,1309
E01028108,1243,10,13,2,1,1269
E01028109,1425,8,10,1,1,1445
E01028110,1136,14,17,0,1,1168
E01028111,1198,8,3,0,0,1209
E01028112,1267,7,6,4,0,1284
E01028113,1156,9,12,2,1,1180
E01028114,1292,2,3,3,0,1300
E01028115,1298,3,10,5,2,1318
E01028116,1260,9,13,6,1,1289
E01028117,1184,5,24,0,1,1214
E01028118,1452,2,5,3,0,1462
E01028119,1297,33,307,34,18,1689
E01028120,1220,15,86,17,1,1339
E01028121,952,19,165,21,12,1169
E01028122,1295,12,14,5,0,1326
E01028123,1521,14,13,12,2,1562
E01028124,1240,13,21,12,3,1289
E01028125,1322,6,24,5,4,1361
E01028126,1081,9,7,7,1,1105
E01028127,1296,16,10,7,2,1331
E01028128,1412,2,30,5,8,1457
E01028129,1165,9,31,20,3,1228
E01028130,1350,22,13,9,6,1400
E01028131,1170,10,23,10,0,1213
E01028132,783,4,20,13,3,823
E01028133,1124,10,31,10,3,1178
E01028134,1143,16,6,6,1,1172
E01028135,1106,9,31,2,6,1154
E01028136,1317,7,38,7,8,1377
E01028137,1725,15,125,26,14,1905
E01028138,1003,8,19,2,2,1034
E01028139,1068,17,35,8,6,1134
E01028142,1595,18,21,18,4,1656
E01028143,1037,9,16,7,7,1076
E01028144,1203,17,29,7,5,1261
E01028146,1130,22,29,54,0,1235
E01028147,663,39,18,73,4,797
E01028148,1618,10,6,7,0,1641
E01028149,1309,12,13,8,2,1344
E01028150,1173,4,6,2,0,1185
E01028151,972,3,1,3,0,979
E01028152,1252,4,14,0,0,1270
E01028153,1024,9,5,2,0,1040
E01028154,1354,7,3,1,1,1366
E01028155,1091,14,58,17,0,1180
E01028156,1012,9,58,18,5,1102
E01028157,889,16,141,19,2,1067
E01028158,1231,29,17,26,2,1305
E01028159,942,18,70,21,5,1056
E01028160,1154,18,38,22,6,1238
E01028161,1005,32,93,73,4,1207
E01028162,1101,20,21,21,0,1163
E01028163,1160,14,47,29,0,1250
E01028164,983,10,17,18,5,1033
E01028165,1154,18,15,26,1,1214
E01028166,1273,11,36,28,2,1350
E01028167,1396,20,48,20,8,1492
E01028168,1025,10,32,11,2,1080
E01028169,1206,7,4,8,6,1231
E01028170,1157,20,22,4,0,1203
E01028171,1155,12,22,10,6,1205
E01028172,888,12,7,6,6,919
E01028173,752,15,7,15,0,789
E01028174,1120,20,12,17,2,1171
E01028175,1383,28,34,13,2,1460
E01028176,1159,18,53,17,1,1248
E01028177,1271,7,30,8,0,1316
E01028178,1725,12,67,8,3,1815
E01028179,1086,18,88,19,2,1213
E01028180,1145,11,32,31,3,1222
E01028181,1092,13,40,17,8,1170
E01028182,1110,20,114,37,4,1285
E01028183,1027,10,14,14,3,1068
E01028184,858,18,60,19,3,958
E01028185,1436,13,15,18,5,1487
E01028186,1182,23,17,12,2,1236
E01028187,1032,23,21,12,2,1090
E01028188,1098,23,22,21,6,1170
E01028189,1802,15,64,14,2,1897
E01028190,1216,16,33,19,5,1289
E01028191,1354,26,14,26,1,1421
E01028192,1160,22,9,13,0,1204
E01028193,1051,22,41,24,5,1143
E01028194,1138,28,23,28,0,1217
E01028195,1084,17,30,32,4,1167
E01028196,1109,17,22,17,2,1167
E01028197,1084,13,17,25,1,1140
E01028198,1143,8,34,8,2,1195
E01028199,1249,8,15,2,2,1276
E01028200,1251,17,74,13,4,1359
E01028201,948,0,24,3,0,975
E01028202,1174,10,12,27,8,1231
E01028203,1122,17,12,11,4,1166
E01028204,1087,9,25,15,1,1137
E01028205,990,8,15,9,2,1024
E01028206,1175,12,18,17,3,1225
E01028207,1017,5,41,13,0,1076
E01028208,856,8,27,10,0,901
E01028209,1092,12,20,24,0,1148
E01028210,1088,19,10,12,4,1133
E01028211,1035,31,34,45,3,1148
E01028212,1157,27,23,21,1,1229
E01028213,1565,12,13,5,2,1597
E01028214,1124,12,45,17,3,1201
E01028215,979,15,57,14,6,1071
E01028216,1008,6,30,13,0,1057
E01028217,1035,30,51,13,15,1144
E01028218,1208,5,48,20,1,1282
E01028219,1177,4,33,5,3,1222
E01028220,1472,13,32,7,2,1526
E01028222,1309,10,17,6,3,1345
E01028223,848,3,5,0,0,856
E01028224,1235,0,7,2,1,1245
E01028225,1277,4,2,3,4,1290
E01028226,1117,8,2,6,1,1134
E01028227,1070,14,18,3,1,1106
E01028228,970,3,14,5,2,994
E01028229,1258,10,15,6,2,1291
E01028230,1081,7,17,1,1,1107
E01028231,1146,4,20,6,0,1176
E01028232,1245,7,7,3,1,1263
E01028233,1459,11,30,13,5,1518
E01028234,1299,10,2,5,2,1318
E01028235,1298,5,4,3,4,1314
E01028236,1373,3,16,6,3,1401
E01028237,1336,7,4,0,1,1348
E01028238,1210,9,15,2,1,1237
E01028239,1261,7,13,5,0,1286
E01028240,1208,8,19,1,2,1238
E01028241,1750,8,18,5,5,1786
E01028242,1270,7,3,2,1,1283
E01028243,1518,10,14,6,1,1549
E01028244,1188,5,34,13,4,1244
E01028245,1036,2,10,2,5,1055
E01028246,1385,14,30,4,3,1436
E01028247,1249,17,47,24,8,1345
E01028248,1165,12,21,5,1,1204
E01028249,1075,7,16,5,1,1104
E01028250,1200,9,8,1,1,1219
E01028251,1337,6,13,7,0,1363
E01028252,1525,15,19,1,1,1561
E01028253,1392,11,8,2,0,1413
E01028254,1108,8,19,2,0,1137
E01028255,1130,5,24,3,4,1166
E01028256,1256,17,20,7,2,1302
E01028257,1216,8,5,1,0,1230
E01028258,1394,3,2,4,2,1405
E01028259,1148,8,5,2,1,1164
E01028260,1405,3,2,5,3,1418
E01028261,1267,9,28,12,2,1318
E01028262,1243,10,3,2,1,1259
E01028263,1239,14,5,5,2,1265
E01028264,1557,9,13,9,1,1589
E01028267,1463,7,16,5,1,1492
E01028268,1388,12,41,7,12,1460
E01028269,1145,9,13,6,2,1175
E01028270,1212,5,30,4,0,1251
E01028271,1335,4,6,1,1,1347
E01028272,1366,6,14,3,0,1389
E01028273,1221,7,10,3,0,1241
E01028274,1157,14,9,11,4,1195
E01028275,1135,14,14,2,3,1168
E01028276,1193,14,7,15,1,1230
E01028277,1060,1,2,3,1,1067
E01028278,1185,7,12,7,0,1211
E01028279,1190,5,4,3,1,1203
E01028280,1076,4,0,2,0,1082
E01028281,1058,10,5,11,1,1085
E01028282,910,4,4,1,0,919
E01028283,1477,11,14,8,2,1512
E01028284,1304,15,22,8,4,1353
E01028285,976,4,9,4,0,993
E01028286,1046,4,4,3,0,1057
E01028287,1167,6,12,10,1,1196
E01028288,1206,12,13,5,0,1236
E01028289,1127,10,8,1,1,1147
E01028290,1160,4,14,4,2,1184
E01028291,1204,11,11,5,2,1233
E01028292,1768,9,29,10,3,1819
E01028293,1459,10,18,11,6,1504
E01028294,1362,8,20,9,1,1400
E01028295,1628,6,4,3,1,1642
E01028296,1062,7,9,6,0,1084
E01028297,1470,11,1,0,4,1486
E01028298,1292,2,8,3,1,1306
E01028299,998,2,5,1,0,1006
E01028300,1244,4,3,4,1,1256
E01028301,1393,8,16,2,2,1421
E01028302,1339,3,2,0,1,1345
E01028303,1290,2,4,1,0,1297
E01028304,1091,10,13,9,0,1123
E01028305,1091,12,20,7,0,1130
E01028306,1247,12,23,5,2,1289
E01028307,995,12,9,4,0,1020
E01028308,1330,10,10,6,0,1356
E01028309,1205,6,10,5,1,1227
E01028310,1349,12,54,7,6,1428
E01028311,1280,16,26,10,1,1333
E01028312,1893,5,9,2,2,1911
E01028313,1576,4,8,5,1,1594
E01028314,1955,20,16,4,0,1995
E01028315,1239,3,3,1,0,1246
E01028316,1247,4,9,6,1,1267
E01028317,1337,7,5,1,0,1350
E01028318,1190,17,17,9,2,1235
E01028319,1448,17,10,3,2,1480
E01028320,1275,5,11,2,8,1301
E01028321,1383,5,1,1,2,1392
E01028322,1669,2,8,2,0,1681
E01028323,1271,1,1,7,0,1280
E01028325,979,4,5,3,1,992
E01028326,1072,3,9,3,0,1087
E01028327,1272,8,16,2,3,1301
E01028328,1408,3,8,3,4,1426
E01028329,1330,6,12,3,1,1352
E01028330,1345,10,13,3,1,1372
E01028331,1659,82,104,140,15,2000
E01028332,1395,7,9,3,2,1416
E01028333,1108,8,7,4,1,1128
E01028334,1142,9,25,5,3,1184
E01028335,1383,16,23,17,13,1452
E01028336,925,5,6,2,0,938
E01028337,1249,10,4,0,2,1265
E01028338,1297,5,3,1,1,1307
E01028339,1395,2,7,12,0,1416
E01028340,1252,4,2,1,3,1262
E01028341,1427,5,10,7,2,1451
E01028342,1157,3,7,3,3,1173
E01028343,1698,12,7,2,1,1720
E01028344,1172,6,3,2,2,1185
E01028345,1792,4,10,6,4,1816
E01028346,1743,6,7,3,2,1761
E01028347,1200,7,21,3,8,1239
E01028348,1210,2,11,11,2,1236
E01028349,1253,5,1,3,3,1265
E01028350,946,3,4,0,0,953
E01028351,1009,5,5,13,0,1032
E01028352,960,7,8,5,1,981
E01028353,2221,8,23,2,2,2256
E01028354,1108,18,59,5,3,1193
E01028355,1128,12,58,14,2,1214
E01028356,1069,16,109,5,7,1206
E01028357,1228,4,4,7,3,1246
E01028358,1070,11,15,4,1,1101
E01028359,1277,8,14,3,3,1305
E01028360,1349,16,25,6,4,1400
E01028361,1079,11,13,8,0,1111
E01028362,1096,9,13,2,3,1123
E01028363,933,9,173,16,24,1155
E01028364,1126,12,230,16,16,1400
E01028365,1127,21,171,13,9,1341
E01028366,999,2,8,3,0,1012
E01028367,1189,11,13,5,3,1221
E01028368,1219,5,6,1,1,1232
E01028369,1108,6,8,7,1,1130
E01028370,1168,11,6,7,1,1193
E01028371,2333,23,40,31,5,2432
E01028372,835,11,114,7,4,971
E01028373,1013,12,98,6,12,1141
E01028374,944,19,72,11,13,1059
E01028375,1251,26,72,10,18,1377
E01028376,1179,8,94,10,9,1300
E01028377,1240,28,164,31,8,1471
E01028378,1666,19,10,5,3,1703
E01028379,1391,7,16,0,5,1419
E01028380,938,7,6,4,3,958
E01028381,1141,7,6,3,4,1161
E01028382,1172,5,9,4,0,1190
E01028383,937,9,7,4,0,957
E01028384,1263,18,65,19,6,1371
E01028385,1233,20,71,7,5,1336
E01028386,1220,17,54,11,7,1309
E01028387,1301,7,15,8,3,1334
E01028388,1274,7,15,5,0,1301
E01028389,1235,4,13,2,0,1254
E01028390,1337,6,16,3,1,1363
E01028391,1435,10,167,15,7,1634
E01028392,1358,37,163,15,20,1593
E01028393,945,8,18,3,1,975
E01028394,1238,7,13,3,3,1264
E01028395,1068,5,26,6,1,1106
E01028396,1148,10,54,10,2,1224
E01028397,1261,18,73,9,8,1369
E01028398,1062,13,92,8,3,1178
E01028399,934,16,75,10,9,1044
E01028400,1142,17,89,10,8,1266
E01028401,865,14,110,18,5,1012
E01028402,1531,3,5,2,2,1543
E01028403,1754,11,15,7,1,1788
E01028404,1296,12,17,3,4,1332
E01028405,1488,20,34,6,6,1554
E01028406,1249,15,61,5,4,1334
E01028407,1603,11,48,4,3,1669
E01028408,2088,22,127,18,10,2265
E01028409,1049,5,18,4,2,1078
E01028410,1025,7,18,1,1,1052
E01028411,1685,9,8,1,1,1704
E01028412,1521,15,30,1,0,1567
E01028413,1278,13,27,6,5,1329
E01028414,1300,12,28,3,5,1348
E01028415,1239,10,11,7,0,1267
E01028416,1268,28,87,18,3,1404
E01028417,1190,25,117,12,6,1350
E01028418,1197,43,57,15,10,1322
E01028419,2002,7,17,9,0,2035
E01028420,1120,3,5,2,0,1130
E01028421,1785,9,26,1,4,1825
E01028422,1192,11,13,1,3,1220
E01028423,1204,4,11,1,1,1221
E01028424,1232,8,19,1,3,1263
E01028425,1493,29,28,88,19,1657
E01028426,1046,14,30,4,5,1099
E01028427,1014,18,122,51,11,1216
E01028428,1077,6,49,15,3,1150
E01028429,825,7,61,11,7,911
E01028430,1139,33,35,15,1,1223
E01028431,1208,8,49,11,3,1279
E01028432,1216,8,44,8,2,1278
E01028433,1416,8,11,9,3,1447
E01028434,1129,9,44,9,0,1191
E01028435,1311,30,91,58,13,1503
E01028437,1017,19,191,20,3,1250
E01028438,1146,18,144,33,10,1351
E01028439,1001,9,85,14,2,1111
E01028440,1125,20,115,31,6,1297
E01028441,1714,22,96,21,2,1855
E01028443,1102,8,25,10,3,1148
E01028444,1207,12,34,8,6,1267
E01028445,898,11,136,21,1,1067
E01028446,1129,11,78,14,0,1232
E01028447,874,13,121,19,4,1031
E01028448,1062,16,114,16,9,1217
E01028449,902,9,84,17,1,1013
E01028450,970,12,44,30,2,1058
E01028451,957,17,38,7,0,1019
E01028452,919,16,52,16,3,1006
E01028453,911,15,65,16,0,1007
E01028454,1041,28,97,12,1,1179
E01028455,1112,8,16,8,4,1148
E01028456,1115,16,48,17,2,1198
E01028457,1073,7,23,16,3,1122
E01028458,1143,15,15,20,0,1193
E01028459,1093,10,38,12,3,1156
E01028460,1401,19,48,10,6,1484
E01028461,1243,15,48,24,6,1336
E01028462,1212,10,42,17,2,1283
E01028463,1722,28,59,36,8,1853
E01028464,1027,13,31,17,1,1089
E01028465,1018,6,22,21,2,1069
E01028466,1221,28,55,23,9,1336
E01028467,1226,17,40,12,8,1303
E01028468,1503,17,76,19,3,1618
E01028469,1213,19,28,16,3,1279
E01028470,1342,7,29,13,2,1393
E01028471,917,20,44,29,2,1012
E01028472,986,8,27,12,3,1036
E01028473,1182,13,37,11,0,1243
E01028474,1240,4,12,6,2,1264
E01028475,1732,12,10,4,4,1762
E01028476,1850,11,24,9,7,1901
E01028477,1171,8,19,12,2,1212
E01028478,957,12,25,45,13,1052
E01028479,1056,2,4,1,2,1065
E01028480,1208,12,5,1,0,1226
E01028481,1159,7,16,1,2,1185
E01028482,962,6,3,4,2,977
E01028483,993,6,8,0,2,1009
E01028484,888,5,7,4,1,905
E01028485,1001,8,1,2,0,1012
E01028486,1058,1,6,2,1,1068
E01028487,880,14,101,24,13,1032
E01028488,1040,24,186,58,39,1347
E01028489,1188,12,19,10,12,1241
E01028490,945,12,32,21,10,1020
E01028491,1234,14,27,12,3,1290
E01028492,1134,17,74,21,8,1254
E01028493,1079,18,48,13,6,1164
E01028494,803,27,73,14,1,918
E01028495,971,18,54,13,10,1066
E01028496,933,21,103,22,17,1096
E01028497,1160,6,17,5,2,1190
E01028498,1233,14,11,9,4,1271
E01028499,1237,1,15,7,1,1261
E01028500,1598,74,97,99,13,1881
E01028501,1043,1,17,4,4,1069
E01028502,945,5,17,1,1,969
E01028503,967,5,5,0,0,977
E01028504,1189,8,25,0,6,1228
E01028505,1346,17,9,13,3,1388
E01028506,1394,10,8,3,1,1416
E01028507,1142,10,11,3,4,1170
E01028508,878,6,4,0,2,890
E01028509,1277,4,8,5,3,1297
E01028510,1253,11,40,9,5,1318
E01028511,1290,15,41,28,7,1381
E01028512,1149,17,20,16,3,1205
E01028513,1267,36,223,125,24,1675
E01028514,861,24,108,90,6,1089
E01028515,1117,19,133,57,11,1337
E01028516,1119,35,139,64,13,1370
E01028517,761,34,57,122,7,981
E01028518,937,30,73,183,7,1230
E01028519,849,54,79,142,6,1130
E01028520,945,54,69,128,10,1206
E01028521,6609,319,1028,113,110,8179
E01028522,2657,146,422,77,53,3355
E01028523,905,33,253,78,30,1299
E01028524,886,27,184,73,13,1183
E01028525,1095,46,229,140,29,1539
E01028526,1664,46,366,73,33,2182
E01028527,1143,42,186,42,14,1427
E01028528,807,37,267,87,33,1231
E01028529,860,45,182,116,17,1220
E01028530,1000,39,212,101,10,1362
E01028531,1520,38,200,88,40,1886
E01028532,1517,44,498,134,36,2229
E01028533,1152,63,356,150,36,1757
E01028534,783,12,102,21,9,927
E01028535,1115,28,159,38,20,1360
E01028536,1030,22,112,29,15,1208
E01028537,1037,32,272,69,27,1437
E01028538,935,26,169,52,14,1196
E01028539,1076,21,303,61,36,1497
E01028540,1970,78,345,90,34,2517
E01028541,1087,24,74,22,24,1231
E01028542,1207,44,210,43,16,1520
E01028543,887,32,148,42,8,1117
E01028544,1001,23,101,30,11,1166
E01028545,1206,29,97,40,13,1385
E01028546,1105,34,300,87,16,1542
E01028547,1486,53,257,46,19,1861
E01028548,1248,22,133,11,23,1437
E01028549,1234,32,114,30,13,1423
E01028550,1099,34,93,23,20,1269
E01028551,1495,58,290,33,46,1922
E01028552,1117,29,72,82,6,1306
E01028553,1279,33,83,73,11,1479
E01028554,881,11,116,67,11,1086
E01028555,1123,22,76,78,4,1303
E01028556,1035,30,263,80,27,1435
E01028557,1316,52,226,120,17,1731
E01028558,1001,52,234,72,18,1377
E01028559,1131,39,192,57,6,1425
E01028560,1077,22,114,23,13,1249
E01028561,1102,17,173,22,12,1326
E01028562,1013,30,173,35,24,1275
E01028563,1033,27,162,15,19,1256
E01028565,930,12,53,7,7,1009
E01028567,1031,49,72,166,14,1332
E01028568,875,40,27,150,15,1107
E01028569,978,39,56,118,13,1204
E01028570,1084,40,83,127,15,1349
E01028571,1140,32,88,41,19,1320
E01028572,1161,25,96,28,5,1315
E01028573,1111,40,175,40,16,1382
E01028574,939,20,106,51,15,1131
E01028575,1067,29,147,42,12,1297
E01028576,687,21,239,57,13,1017
E01028577,1046,31,224,158,12,1471
E01028578,1108,12,129,35,10,1294
E01028579,1186,48,219,58,8,1519
E01028580,1106,52,148,36,36,1378
E01028581,1141,33,119,37,9,1339
E01028582,1002,38,166,24,19,1249
E01028583,1054,33,145,17,26,1275
E01028584,1774,50,138,38,24,2024
E01028585,1093,42,155,18,9,1317
E01028586,1313,59,112,72,12,1568
E01028587,1419,64,252,55,15,1805
E01028588,1212,68,202,28,15,1525
E01028591,905,16,63,5,14,1003
E01028592,991,34,80,14,15,1134
E01028594,1125,12,100,24,34,1295
E01028595,1078,14,25,11,4,1132
E01028596,1084,22,72,15,15,1208
E01028597,991,22,128,24,11,1176
E01028598,1926,7,9,5,2,1949
E01028599,1153,0,10,4,4,1171
E01028600,1190,8,12,4,1,1215
E01028601,1607,15,7,10,1,1640
E01028602,1023,10,6,13,2,1054
E01028603,926,7,9,5,0,947
E01028604,1024,8,87,15,3,1137
E01028605,1202,14,10,13,2,1241
E01028606,1421,6,13,3,1,1444
E01028607,1074,6,6,4,0,1090
E01028608,969,5,14,2,1,991
E01028609,1008,14,10,3,1,1036
E01028610,1235,7,15,1,0,1258
E01028611,888,10,14,0,1,913
E01028612,953,12,11,1,2,979
E01028613,1107,6,11,6,2,1132
E01028614,1188,6,16,4,1,1215
E01028615,1344,3,16,3,0,1366
E01028616,1115,4,4,0,2,1125
E01028617,1453,7,25,5,1,1491
E01028618,1427,5,24,6,1,1463
E01028619,1442,10,19,4,0,1475
E01028620,2159,45,70,70,4,2348
E01028621,966,12,26,9,11,1024
E01028622,980,7,11,10,2,1010
E01028623,1228,11,62,14,14,1329
E01028624,1207,5,15,5,0,1232
E01028625,1350,14,76,20,10,1470
E01028626,1209,8,21,19,2,1259
E01028627,1084,10,30,13,0,1137
E01028628,1095,9,33,3,2,1142
E01028629,1067,15,34,9,6,1131
E01028630,1155,15,55,18,2,1245
E01028631,853,9,32,4,1,899
E01028632,1101,10,41,9,5,1166
E01028633,1105,16,35,27,2,1185
E01028634,1037,7,19,5,3,1071
E01028635,1199,2,16,7,2,1226
E01028636,993,6,30,2,2,1033
E01028637,1258,1,18,1,3,1281
E01028638,1112,13,21,4,1,1151
E01028639,1024,19,63,20,14,1140
E01028640,1153,11,24,2,1,1191
E01028641,983,5,16,3,0,1007
E01028642,980,6,12,1,1,1000
E01028643,1083,7,26,0,2,1118
E01028644,1295,13,10,2,0,1320
E01028645,1239,6,3,4,2,1254
E01028646,904,14,16,2,1,937
E01028647,1261,8,11,9,7,1296
E01028648,929,9,7,1,1,947
E01028649,1238,9,3,8,0,1258
E01028650,1529,17,32,4,9,1591
E01028651,1283,10,29,2,3,1327
E01028652,1639,14,43,9,6,1711
E01028653,1070,17,26,4,5,1122
E01028654,1186,7,21,2,4,1220
E01028655,1361,17,38,8,4,1428
E01028656,1037,9,15,1,3,1065
E01028657,974,17,29,12,3,1035
E01028658,1034,8,18,9,1,1070
E01028659,1280,7,13,4,2,1306
E01028660,1334,19,17,2,3,1375
E01028661,1341,14,27,3,9,1394
E01028662,1004,3,17,2,4,1030
E01028663,1156,9,9,1,2,1177
E01028664,1069,12,14,7,2,1104
E01028665,1058,7,9,4,1,1079
E01028666,1212,8,28,5,1,1254
E01028667,1028,8,20,6,1,1063
E01028668,1124,6,6,1,1,1138
E01028669,1031,8,39,8,1,1087
E01028670,1162,2,10,2,2,1178
E01028671,1106,16,26,7,2,1157
E01028672,1365,14,14,1,2,1396
E01028673,964,13,13,1,1,992
E01028674,1030,1,18,3,2,1054
E01028675,946,16,8,11,0,981
E01028676,1554,15,33,13,4,1619
E01028677,1169,11,30,2,6,1218
E01028678,1216,13,10,5,1,1245
E01028679,1739,16,19,2,0,1776
E01028680,1346,6,26,3,4,1385
E01028681,1052,9,17,2,1,1081
E01028682,989,6,8,5,1,1009
E01028683,1144,7,9,9,4,1173
E01028684,1131,12,25,22,3,1193
E01028685,969,2,7,1,6,985
E01028686,1033,7,23,12,0,1075
E01028688,944,13,28,5,5,995
E01028689,1082,16,42,19,4,1163
E01028690,1296,10,32,8,5,1351
E01028691,1146,10,15,13,2,1186
E01028692,929,9,35,9,3,985
E01028693,1184,12,67,8,5,1276
E01028694,1089,8,64,22,4,1187
E01028695,1223,13,25,20,1,1282
E01028696,1041,7,55,10,4,1117
E01028697,1149,12,42,24,2,1229
E01028698,1141,14,38,18,2,1213
E01028699,1262,7,14,10,8,1301
E01028700,1197,10,37,16,4,1264
E01028701,1193,14,34,5,1,1247
E01028702,1052,6,19,7,1,1085
E01028703,1386,16,50,22,8,1482
E01028704,1427,9,50,13,5,1504
E01028705,1023,6,34,2,2,1067
E01028706,1186,8,50,3,3,1250
E01028707,1206,6,41,5,2,1260
E01028708,1422,12,61,9,9,1513
E01028709,1234,14,89,15,12,1364
E01028710,1234,12,68,18,12,1344
E01028711,1315,10,11,2,3,1341
E01028712,1605,10,18,7,3,1643
E01028713,1894,10,20,1,6,1931
E01028714,1851,8,16,14,6,1895
E01028715,1097,8,13,2,2,1122
E01028716,1349,14,37,17,2,1419
E01028717,1240,12,45,12,4,1313
E01028718,1126,4,20,8,1,1159
E01028719,1323,7,13,9,0,1352
E01028720,1829,8,19,3,0,1859
E01028721,1009,13,13,11,0,1046
E01028722,1276,11,26,19,1,1333
E01028723,1190,3,8,4,1,1206
E01028724,1032,3,19,8,1,1063
E01028725,1161,4,6,5,0,1176
E01028726,1798,8,22,3,1,1832
E01028727,1289,9,19,5,3,1325
E01028728,915,6,14,3,7,945
E01028729,822,7,10,6,1,846
E01028730,1271,6,7,2,3,1289
E01028731,1047,5,11,1,1,1065
E01028732,956,7,8,2,1,974
E01028733,1000,9,51,7,9,1076
E01028734,1227,12,42,19,5,1305
E01028735,1264,8,62,7,8,1349
E01028736,1821,12,26,11,7,1877
E01028737,1860,3,12,5,2,1882
E01028738,1394,37,82,168,14,1695
E01028739,1341,9,11,14,3,1378
E01028740,1148,28,100,6,11,1293
E01028741,1194,25,45,14,11,1289
E01028742,1229,13,71,10,15,1338
E01028743,1136,6,8,7,1,1158
E01028744,1021,5,20,2,1,1049
E01028745,1098,6,26,3,5,1138
E01028746,1005,5,20,1,0,1031
E01028747,865,4,20,10,6,905
E01028748,749,9,24,1,7,790
E01028749,1881,8,30,10,0,1929
E01028750,1067,9,32,48,0,1156
E01028751,1187,17,18,7,11,1240
E01028752,1279,13,31,20,4,1347
E01028753,1129,9,13,8,2,1161
E01028754,1082,10,12,7,1,1112
E01028755,1295,8,12,5,2,1322
E01028756,1937,21,45,6,3,2012
E01028757,1187,10,11,7,0,1215
E01028758,1252,5,8,3,4,1272
E01028759,1212,15,12,1,0,1240
E01028760,998,3,14,10,2,1027
E01028761,1015,4,19,3,4,1045
E01028762,1420,12,3,0,0,1435
E01028763,1590,5,3,1,4,1603
E01028764,1461,16,5,4,1,1487
E01028765,1569,8,5,0,0,1582
E01028766,1599,7,12,2,1,1621
E01028767,1545,12,10,6,2,1575
E01028771,1197,14,20,5,1,1237
E01028772,1394,13,11,3,1,1422
E01028773,1110,9,16,3,0,1138
E01028774,2146,36,18,15,6,2221
E01028775,1068,9,16,5,0,1098
E01028776,1565,7,13,1,7,1593
E01028777,909,5,9,2,1,926
E01028778,1200,5,7,1,1,1214
E01028779,893,1,9,1,0,904
E01028780,1607,13,37,4,4,1665
E01028781,968,4,10,5,5,992
E01028782,1220,5,12,6,4,1247
E01028783,1240,12,34,13,2,1301
E01028784,1717,8,6,2,4,1737
E01028785,1248,8,20,4,2,1282
E01028786,1033,9,16,6,1,1065
E01028787,1040,7,13,0,1,1061
E01028788,1306,18,25,3,9,1361
E01028789,1186,5,9,4,1,1205
E01028790,942,11,4,5,5,967
E01028791,1280,6,18,4,0,1308
E01028792,886,2,3,4,6,901
E01028793,1254,2,6,1,0,1263
E01028794,1170,2,15,3,2,1192
E01028795,1259,5,8,0,1,1273
E01028796,1054,8,11,4,3,1080
E01028797,901,15,10,0,0,926
E01028798,1611,7,7,0,2,1627
E01028799,1582,11,10,7,0,1610
E01028800,1013,5,9,7,1,1035
E01028801,1068,9,9,5,1,1092
E01028802,1200,4,19,6,2,1231
E01028804,1020,4,12,2,3,1041
E01028806,1585,9,15,1,1,1611
E01028807,1768,18,40,19,7,1852
E01028808,1351,13,31,12,1,1408
E01028809,1009,5,3,10,1,1028
E01028810,1089,4,17,2,1,1113
E01028811,1059,16,19,3,2,1099
E01028813,969,11,17,9,0,1006
E01028814,1147,7,17,2,3,1176
E01028815,1067,7,5,2,4,1085
E01028816,1047,9,46,3,0,1105
E01028817,1141,9,28,5,5,1188
E01028818,1407,9,40,12,4,1472
E01028819,1248,13,29,7,2,1299
E01028820,1019,13,6,2,4,1044
E01028821,1126,11,24,7,0,1168
E01028822,1101,5,23,10,0,1139
E01028823,1055,15,30,3,3,1106
E01028824,1215,10,18,4,3,1250
E01028825,918,7,15,1,1,942
E01028826,1396,11,12,1,0,1420
E01028827,1168,9,12,2,0,1191
E01028828,1379,1,4,1,0,1385
E01028829,1129,1,1,0,0,1131
E01028830,1234,4,14,5,0,1257
E01028831,1267,5,1,4,0,1277
E01028832,1399,7,22,3,2,1433
E01028833,1270,4,8,0,1,1283
E01028834,1277,6,17,0,0,1300
E01028835,1215,8,4,0,2,1229
E01028836,1198,5,5,0,1,1209
E01028837,1245,2,5,0,0,1252
E01028838,1183,2,2,0,1,1188
E01028839,1091,3,10,1,0,1105
E01028840,1078,1,1,0,0,1080
E01028841,1290,5,4,0,0,1299
E01028842,1340,8,5,7,4,1364
E01028843,1424,2,5,1,1,1433
E01028844,1515,13,26,8,65,1627
E01028845,1661,4,12,6,2,1685
E01028846,1435,2,8,1,0,1446
E01028847,1231,10,8,0,0,1249
E01028848,1372,0,2,0,5,1379
E01028849,1555,6,17,2,0,1580
E01028850,1854,6,7,1,2,1870
E01028851,1399,9,1,1,1,1411
E01028852,1383,3,3,0,0,1389
E01028853,1185,5,4,1,0,1195
E01028854,1285,7,15,1,0,1308
E01028855,1252,7,9,2,0,1270
E01028856,1039,10,6,1,0,1056
E01028857,1442,4,9,3,0,1458
E01028858,1793,2,26,2,0,1823
E01028859,1390,6,7,6,1,1410
E01028860,1506,6,2,3,0,1517
E01028861,1050,3,3,0,1,1057
E01028862,1315,5,1,0,2,1323
E01028863,1142,6,1,2,0,1151
E01028864,1230,1,8,0,3,1242
E01028865,1385,6,2,1,1,1395
E01028866,1068,7,21,1,2,1099
E01028867,1071,3,5,0,0,1079
E01028868,1271,4,2,1,1,1279
E01028869,1146,5,3,8,1,1163
E01028870,1239,7,5,0,2,1253
E01028871,973,2,2,7,0,984
E01028872,1275,7,33,0,6,1321
E01028873,1400,11,10,3,1,1425
E01028874,1144,3,7,0,1,1155
E01028875,1926,9,19,2,0,1956
E01028876,1396,10,17,1,1,1425
E01028877,1049,2,4,0,0,1055
E01028878,1268,3,10,0,0,1281
E01028879,1240,5,11,0,0,1256
E01028880,1279,6,9,6,4,1304
E01028881,1059,7,12,0,1,1079
E01028882,1264,7,14,1,1,1287
E01028883,1352,4,7,3,1,1367
E01028884,1201,8,17,1,0,1227
E01028885,2193,48,56,47,10,2354
E01028886,1305,11,11,5,1,1333
E01028887,1135,1,9,4,1,1150
E01028888,1283,5,5,4,0,1297
E01028889,1184,5,11,22,1,1223
E01028890,1130,7,11,3,1,1152
E01028891,1363,10,21,2,0,1396
E01028892,1192,1,5,0,0,1198
E01028893,1276,7,6,1,2,1292
E01028894,1237,7,3,1,4,1252
E01028895,1384,2,8,0,0,1394
E01028896,1646,4,5,1,2,1658
E01028897,1170,4,6,2,0,1182
E01028898,1158,4,5,1,4,1172
E01028899,1267,4,4,1,3,1279
E01028902,943,3,3,1,0,950
E01028903,1074,5,8,0,2,1089
E01028904,1153,6,14,2,0,1175
E01028905,1321,3,18,2,3,1347
E01028906,1054,5,11,3,3,1076
E01028907,1454,11,11,4,3,1483
E01028908,1173,14,18,11,1,1217
E01028909,1146,7,9,3,2,1167
E01028910,1332,4,16,1,2,1355
E01028911,1104,2,6,0,0,1112
E01028912,913,7,10,2,0,932
E01028913,1289,3,4,1,0,1297
E01028914,932,6,5,0,1,944
E01028915,1134,1,4,0,0,1139
E01028916,1339,5,4,0,0,1348
E01028917,1142,16,34,8,2,1202
E01028918,1181,9,6,0,1,1197
E01028919,969,0,4,0,0,973
E01028920,1038,4,2,2,0,1046
E01028921,1255,3,11,1,2,1272
E01028922,1067,3,7,0,3,1080
E01028923,1332,3,1,1,2,1339
E01028924,1256,5,13,0,2,1276
E01028925,1146,4,30,0,2,1182
E01028926,1114,4,7,2,0,1127
E01028927,860,2,11,3,0,876
E01028928,1259,0,9,0,0,1268
E01028929,1171,6,10,3,5,1195
E01028930,1316,5,10,5,0,1336
E01028931,1629,19,17,4,2,1671
E01028932,1546,6,17,1,6,1576
E01028933,1272,7,7,2,1,1289
E01028934,1126,5,9,2,0,1142
E01028935,1265,0,8,0,0,1273
E01028936,1757,6,6,5,1,1775
E01028937,1246,3,5,2,0,1256
E01028938,1397,13,12,2,2,1426
E01028939,1264,8,14,1,0,1287
E01028940,1300,6,15,3,0,1324
E01028941,1445,11,102,15,9,1582
E01028942,1042,15,45,12,8,1122
E01028943,1724,14,62,12,11,1823
E01028944,1370,7,38,5,3,1423
E01028945,1647,12,39,9,5,1712
E01028946,2023,23,65,8,6,2125
E01028947,1227,4,16,2,0,1249
E01028948,1203,15,13,1,2,1234
E01028949,1230,4,12,0,2,1248
E01028950,1882,4,13,2,5,1906
E01028951,1218,5,18,2,1,1244
E01028952,1393,6,36,1,3,1439
E01028953,1185,4,21,3,3,1216
E01028954,1065,4,3,0,3,1075
E01028955,883,4,9,0,4,900
E01028956,1258,3,11,1,2,1275
E01028957,1147,6,10,4,3,1170
E01028958,1475,6,11,2,2,1496
E01028959,2068,7,10,5,2,2092
E01028960,1080,9,7,0,0,1096
E01028961,1116,12,233,8,3,1372
E01028962,1244,4,13,4,8,1273
E01028963,1344,0,4,0,0,1348
E01028964,1337,12,29,2,2,1382
E01028965,1154,6,9,1,2,1172
E01028966,1025,4,11,1,2,1043
E01028967,1185,6,10,1,2,1204
E01028968,1021,5,7,3,0,1036
E01028969,1130,6,21,5,0,1162
E01028970,1109,2,10,1,1,1123
E01028971,1738,12,7,2,1,1760
E01028972,1372,3,25,2,4,1406
E01028973,1619,16,17,5,4,1661
E01028974,1179,30,84,6,4,1303
E01028975,1395,1,21,5,1,1423
E01028976,1423,3,10,2,2,1440
E01028977,1603,1,6,0,0,1610
E01028978,1225,7,4,1,1,1238
E01028979,993,5,5,0,3,1006
E01028980,1808,9,5,1,0,1823
E01028981,1306,7,3,3,2,1321
E01028982,1249,5,2,1,1,1258
E01028983,1563,14,7,2,1,1587
E01028984,1164,11,9,1,2,1187
E01028985,1134,3,9,0,0,1146
E01028986,1258,3,14,0,0,1275
E01028987,1759,12,44,1,4,1820
E01028988,1311,7,15,1,0,1334
E01028989,1284,12,8,2,0,1306
E01028990,982,0,4,1,0,987
E01028991,1012,6,9,0,0,1027
E01028992,1333,7,13,1,2,1356
E01028993,1257,7,3,1,0,1268
E01028994,1043,8,13,3,1,1068
E01028995,1265,3,5,3,1,1277
E01028996,1112,7,2,0,1,1122
E01028997,1988,8,10,1,2,2009
E01028998,2033,9,13,5,9,2069
E01028999,1318,2,4,0,0,1324
E01029000,993,2,6,0,0,1001
E01029001,1570,6,10,0,0,1586
E01029002,1043,4,8,1,0,1056
E01029003,1972,4,3,2,4,1985
E01029004,909,2,5,0,3,919
E01029005,1021,3,5,0,1,1030
E01029006,1368,12,6,1,2,1389
E01029007,868,3,6,2,1,880
E01029009,984,3,5,0,0,992
E01029010,1067,10,12,6,0,1095
E01029011,1232,2,5,1,0,1240
E01029012,1457,7,7,1,2,1474
E01029013,1425,3,32,2,1,1463
E01029014,900,9,8,6,1,924
E01029015,1169,3,7,0,1,1180
E01029016,1149,4,5,4,0,1162
E01029018,1895,15,12,3,1,1926
E01029019,1930,11,5,0,3,1949
E01029020,1131,6,4,3,2,1146
E01029021,993,2,1,3,0,999
E01029022,1083,6,2,3,0,1094
E01029023,954,5,3,3,1,966
E01029024,1651,13,7,3,1,1675
E01029025,1060,2,4,4,0,1070
E01029026,806,3,0,3,0,812
E01029027,997,0,4,1,0,1002
E01029028,941,6,15,0,2,964
E01029029,1329,6,7,3,0,1345
E01029030,1547,6,10,0,1,1564
E01029031,1344,3,10,1,0,1358
E01029032,905,3,2,0,0,910
E01029033,1142,5,6,1,0,1154
E01029034,1082,9,14,2,1,1108
E01029035,1160,9,15,1,1,1186
E01029036,1227,15,25,15,2,1284
E01029037,1070,10,9,3,1,1093
E01029038,1039,7,9,4,0,1059
E01029039,1294,2,11,2,0,1309
E01029040,1298,3,11,1,0,1313
E01029041,1563,13,29,6,0,1611
E01029042,1188,11,19,6,1,1225
E01029043,1211,6,5,2,0,1224
E01029044,1020,13,4,1,0,1038
E01029045,1261,11,6,5,1,1284
E01029046,1174,13,10,2,4,1203
E01029047,1211,5,22,1,0,1239
E01029050,1808,17,11,2,0,1838
E01029051,1321,10,6,3,2,1342
E01029052,1768,7,2,0,1,1778
E01029053,1846,13,5,2,1,1867
E01029054,1230,7,3,0,0,1240
E01029055,961,6,3,0,0,970
E01029056,1907,17,13,4,1,1942
E01029057,1615,13,9,5,1,1643
E01029058,1828,8,12,1,5,1854
E01029059,1728,6,8,1,2,1745
E01029060,1560,8,1,1,0,1570
E01029061,1784,11,7,0,0,1802
E01029062,1075,7,16,3,5,1106
E01029063,1930,14,15,5,1,1965
E01029064,1298,10,22,6,1,1337
E01029065,1328,7,4,1,1,1341
E01029066,1410,7,15,3,0,1435
E01029067,1202,12,4,0,0,1218
E01029068,1129,9,10,5,2,1155
E01029069,874,4,1,1,1,881
E01029070,1403,19,24,2,1,1449
E01029071,1164,8,19,4,2,1197
E01029072,1281,6,9,0,2,1298
E01029073,949,7,15,8,1,980
E01029074,1474,23,57,14,10,1578
E01029075,1154,7,11,1,1,1174
E01029076,1644,4,10,2,0,1660
E01029077,1699,2,2,3,0,1706
E01029078,1481,13,16,1,2,1513
E01029079,1288,2,18,1,0,1309
E01029080,1214,4,14,0,1,1233
E01029081,1326,5,14,3,0,1348
E01029082,1124,6,13,3,1,1147
E01029083,1086,15,36,5,2,1144
E01029084,1227,6,11,3,0,1247
E01029085,1647,14,19,2,1,1683
E01029086,1796,10,5,0,3,1814
E01029089,1773,7,11,2,7,1800
E01029090,1235,7,6,1,1,1250
E01029091,1302,9,9,2,1,1323
E01029092,1223,2,3,1,0,1229
E01029093,1234,7,13,1,5,1260
E01029094,1274,6,15,4,2,1301
E01029095,1271,8,25,5,8,1317
E01029096,1117,10,7,1,2,1137
E01029097,1065,5,4,0,0,1074
E01029098,1136,4,9,5,5,1159
E01029099,1038,12,10,2,0,1062
E01029100,990,6,3,1,0,1000
E01029101,873,6,7,1,1,888
E01029102,1225,5,5,2,3,1240
E01029103,1322,4,8,1,0,1335
E01029104,1237,3,10,1,1,1252
E01029105,1200,16,15,1,0,1232
E01029106,1222,9,2,0,2,1235
E01029107,1176,6,19,0,0,1201
E01029108,1721,7,8,0,2,1738
E01029109,1027,5,0,2,0,1034
E01029110,1715,12,12,6,2,1747
E01029111,1833,7,24,1,1,1866
E01029112,1631,15,29,9,3,1687
E01029113,1409,2,8,1,0,1420
E01029114,1373,6,5,2,2,1388
E01029115,1383,4,5,1,3,1396
E01029116,1369,14,19,9,2,1413
E01029117,1368,5,30,5,2,1410
E01029118,1396,2,8,4,1,1411
E01029119,1329,5,10,5,1,1350
E01029120,1188,4,12,2,0,1206
E01029121,1089,6,1,0,1,1097
E01029122,1183,12,0,1,1,1197
E01029123,919,4,2,0,1,926
E01029124,1447,2,3,0,2,1454
E01029125,1136,1,5,0,0,1142
E01029126,1258,7,7,0,0,1272
E01029127,1265,4,16,1,1,1287
E01029128,1519,2,11,0,1,1533
E01029129,1537,12,5,1,0,1555
E01029130,1750,7,3,1,1,1762
E01029131,1540,19,21,3,0,1583
E01029132,1151,5,8,2,0,1166
E01029133,1108,4,6,2,1,1121
E01029134,1601,5,5,2,0,1613
E01029135,1397,4,2,0,1,1404
E01029136,1620,10,6,0,1,1637
E01029137,1309,8,1,1,1,1320
E01029138,1137,5,2,0,0,1144
E01029139,1203,8,4,0,2,1217
E01029140,2334,17,12,9,4,2376
E01029142,1232,3,5,1,1,1242
E01029143,1136,5,5,0,3,1149
E01029144,1038,5,0,0,1,1044
E01029145,1615,3,4,1,0,1623
E01029147,1392,7,7,3,2,1411
E01029148,1263,9,2,2,4,1280
E01029149,1142,9,8,5,2,1166
E01029150,1074,4,4,1,4,1087
E01029151,1071,5,2,0,0,1078
E01029152,1746,9,1,2,0,1758
E01029153,1992,10,4,2,0,2008
E01029154,1476,10,4,2,4,1496
E01029155,1546,4,6,2,2,1560
E01029156,1508,10,8,1,1,1528
E01029157,1047,4,21,4,2,1078
E01029158,1042,9,9,7,1,1068
E01029159,1199,4,7,0,3,1213
E01029160,1900,17,48,10,5,1980
E01029161,1223,7,23,9,3,1265
E01029162,1280,11,24,2,2,1319
E01029163,1851,12,4,1,0,1868
E01029164,1169,4,3,2,0,1178
E01029165,1009,1,7,1,1,1019
E01029166,1877,6,4,2,0,1889
E01029167,1332,6,3,4,1,1346
E01029168,1324,6,14,3,5,1352
E01029169,1205,7,13,1,5,1231
E01029170,869,8,5,4,0,886
E01029171,1774,16,8,3,0,1801
E01029172,1221,1,2,1,1,1226
E01029173,951,3,3,2,0,959
E01029174,941,2,9,0,0,952
E01029175,1604,16,17,10,2,1649
E01029176,1079,6,3,6,1,1095
E01029177,893,7,9,5,2,916
E01029178,1247,3,4,3,0,1257
E01029179,911,5,1,1,0,918
E01029180,1179,6,1,1,3,1190
E01029181,1115,4,10,1,0,1130
E01029182,1219,1,4,1,1,1226
E01029183,1151,5,2,3,0,1161
E01029184,1494,2,9,2,1,1508
E01029185,1349,4,27,0,0,1380
E01029186,1239,2,12,5,0,1258
E01029187,846,2,4,0,1,853
E01029188,1260,1,1,3,1,1266
E01029189,911,3,1,2,0,917
E01029190,1076,4,6,2,3,1091
E01029191,1000,7,3,2,0,1012
E01029192,1172,5,1,2,1,1181
E01029193,1568,9,8,5,0,1590
E01029194,1998,11,16,3,2,2030
E01029195,1295,0,3,6,3,1307
E01029196,1207,4,5,1,3,1220
E01029197,1035,8,5,1,0,1049
E01029198,901,8,12,3,2,926
E01029199,2581,17,11,16,6,2631
E01029200,1171,12,10,1,1,1195
E01029201,1211,2,10,3,0,1226
E01029202,989,3,9,1,0,1002
E01029203,1257,4,8,1,0,1270
E01029204,1025,11,4,0,1,1041
E01029205,1418,6,6,3,6,1439
E01029206,1205,6,5,0,1,1217
E01029207,1110,4,1,0,3,1118
E01029208,944,3,2,1,0,950
E01029209,1095,4,2,0,2,1103
E01029210,1334,2,6,3,1,1346
E01029211,1145,0,6,0,1,1152
E01029212,898,3,2,0,0,903
E01029213,1067,3,1,1,0,1072
E01029214,951,4,2,3,0,960
E01029215,926,3,2,2,0,933
E01029216,1218,5,5,0,3,1231
E01029217,1281,3,5,0,0,1289
E01029218,1544,5,5,6,2,1562
E01029219,1214,5,4,2,0,1225
E01029220,1008,1,4,0,0,1013
E01029221,1958,6,25,5,1,1995
E01029222,1293,3,1,0,2,1299
E01029223,1011,4,3,0,2,1020
E01029224,1369,4,7,5,0,1385
E01029225,1738,1,7,0,0,1746
E01029226,1395,6,8,7,1,1417
E01029227,1313,6,7,1,0,1327
E01029228,1316,8,6,0,0,1330
E01029229,1597,12,33,1,5,1648
E01029230,1951,7,7,2,2,1969
E01029231,1184,8,64,4,4,1264
E01029232,1128,5,73,9,1,1216
E01029233,1016,5,39,0,2,1062
E01029234,1526,17,55,11,3,1612
E01029235,1105,14,8,4,0,1131
E01029236,1100,3,11,2,0,1116
E01029237,1164,6,13,2,0,1185
E01029238,1193,4,5,1,2,1205
E01029239,1142,11,35,5,5,1198
E01029240,1206,6,10,1,4,1227
E01029241,1425,11,16,8,5,1465
E01029242,1188,2,15,7,0,1212
E01029243,1455,2,7,0,4,1468
E01029244,1230,3,8,8,4,1253
E01029245,1767,17,21,9,2,1816
E01029246,1290,8,11,0,1,1310
E01029247,1132,8,4,4,3,1151
E01029248,1199,6,18,7,2,1232
E01029249,1109,4,10,1,1,1125
E01029250,1138,6,15,0,0,1159
E01029251,1103,5,6,1,1,1116
E01029252,1141,6,12,4,6,1169
E01029253,1226,10,7,5,2,1250
E01029254,1157,8,6,2,0,1173
E01029255,1125,7,5,7,0,1144
E01029256,1216,3,17,5,1,1242
E01029257,1695,13,47,7,3,1765
E01029258,1182,6,3,2,1,1194
E01029259,1188,1,4,4,1,1198
E01029260,1607,11,8,6,3,1635
E01029261,1710,9,7,6,2,1734
E01029262,1952,5,9,2,2,1970
E01029263,1071,6,42,2,1,1122
E01029264,1062,4,18,1,4,1089
E01029265,1178,4,12,0,3,1197
E01029266,1020,12,93,4,6,1135
E01029267,1368,7,2,2,2,1381
E01029268,1278,3,1,2,2,1286
E01029269,1837,6,12,0,1,1856
E01029270,1830,5,7,2,1,1845
E01029271,1455,13,9,2,1,1480
E01029273,947,6,1,0,0,954
E01029274,1261,7,3,3,0,1274
E01029275,1081,5,5,0,1,1092
E01029276,1210,11,62,16,5,1304
E01029277,810,5,15,0,4,834
E01029278,1079,3,3,0,0,1085
E01029279,1155,2,1,1,0,1159
E01029280,1243,9,15,5,3,1275
E01029281,1369,8,25,5,2,1409
E01029282,1086,6,22,3,2,1119
E01029283,1434,12,11,1,2,1460
E01029284,1405,16,66,3,4,1494
E01029285,1869,20,80,11,4,1984
E01029286,1298,15,28,10,5,1356
E01029287,1200,12,22,6,4,1244
E01029288,1199,11,18,7,3,1238
E01029289,1508,14,21,9,6,1558
E01029290,1138,11,20,4,2,1175
E01029291,1304,4,7,2,1,1318
E01029292,1087,14,29,0,0,1130
E01029293,1067,9,4,0,0,1080
E01029294,1397,6,9,2,1,1415
E01029295,1333,7,15,1,4,1360
E01029296,1327,4,9,1,0,1341
E01029297,1016,7,22,2,2,1049
E01029298,1136,4,8,2,3,1153
E01029299,1240,8,25,5,4,1282
E01029300,1212,9,16,4,2,1243
E01029301,1591,15,47,5,6,1664
E01029302,1321,13,55,11,8,1408
E01029303,1564,10,26,3,2,1605
E01029304,1198,12,3,5,2,1220
E01029305,1136,8,4,1,1,1150
E01029306,1296,9,9,1,2,1317
E01029307,1091,3,8,5,0,1107
E01029308,1663,9,14,4,0,1690
E01029309,1524,9,37,7,6,1583
E01029310,1548,1,30,4,1,1584
E01029311,1160,9,18,4,1,1192
E01029312,1124,3,11,0,0,1138
E01029313,1032,4,5,1,2,1044
E01029314,2016,8,10,7,0,2041
E01029315,1197,5,3,0,2,1207
E01029316,1340,9,29,6,0,1384
E01029317,982,6,13,1,3,1005
E01029318,1281,2,10,0,0,1293
E01029319,1110,11,16,5,1,1143
E01029320,1286,13,11,0,1,1311
E01029321,1897,6,8,2,0,1913
E01029322,1758,16,3,5,2,1784
E01029324,1263,6,5,0,2,1276
E01029325,1620,10,5,0,1,1636
E01029326,1027,1,3,0,0,1031
E01029327,1704,8,7,1,1,1721
E01029328,1663,8,15,2,0,1688
E01029329,1495,10,12,3,5,1525
E01029330,1791,10,27,2,2,1832
E01029331,1316,5,3,1,0,1325
E01029333,954,3,4,1,0,962
E01029334,948,7,2,0,0,957
E01029335,931,6,5,0,0,942
E01029336,1804,2,2,0,3,1811
E01029337,1789,5,1,0,0,1795
E01029338,1532,9,6,0,0,1547
E01029339,1207,3,4,0,0,1214
E01029341,1086,4,4,1,2,1097
E01029342,978,2,1,0,2,983
E01029343,1271,7,14,0,1,1293
E01029345,1287,4,11,3,0,1305
E01029346,1269,5,12,7,1,1294
E01029347,1250,8,5,1,0,1264
E01029348,1401,6,6,6,0,1419
E01029349,1076,2,5,1,0,1084
E01029350,1227,6,7,3,6,1249
E01029351,1149,11,6,1,1,1168
E01029352,1106,5,7,0,0,1118
E01029353,1189,5,14,6,0,1214
E01029354,1216,16,17,6,1,1256
E01029355,1228,9,5,2,1,1245
E01029356,1158,10,11,4,0,1183
E01029357,1092,4,11,1,0,1108
E01029358,912,4,8,2,0,926
E01029359,1257,11,14,8,0,1290
E01029360,1212,8,44,8,0,1272
E01029361,1197,14,11,7,2,1231
E01029362,1197,9,10,9,0,1225
E01029363,1194,5,2,0,0,1201
E01029364,1332,7,36,2,4,1381
E01029365,1267,9,7,2,0,1285
E01029366,1457,7,25,4,2,1495
E01029367,1754,6,21,5,0,1786
E01029368,1071,3,11,0,0,1085
E01029369,973,5,11,0,0,989
E01029370,1202,3,4,2,3,1214
E01029371,1210,9,6,4,6,1235
E01029372,1009,9,4,1,1,1024
E01029373,1732,13,34,8,4,1791
E01029374,1814,4,26,5,1,1850
E01029375,1824,10,32,10,11,1887
E01029376,1517,4,15,8,1,1545
E01029377,1071,9,13,5,2,1100
E01029378,1313,5,20,6,2,1346
E01029379,1291,9,22,11,2,1335
E01029380,1197,1,5,2,0,1205
E01029381,1260,3,11,1,0,1275
E01029382,1369,8,8,1,0,1386
E01029383,1254,9,5,5,0,1273
E01029384,1554,3,18,3,3,1581
E01029385,1234,4,12,3,0,1253
E01029386,1146,7,5,0,0,1158
E01029387,1213,5,14,6,1,1239
E01029388,1089,5,7,6,0,1107
E01029389,1353,15,11,4,1,1384
E01029390,845,9,14,2,2,872
E01029391,1373,9,7,2,0,1391
E01029392,1493,5,16,4,0,1518
E01029393,1402,10,14,4,0,1430
E01029394,1237,5,1,1,4,1248
E01029395,1341,8,12,6,0,1367
E01029396,1402,6,9,4,1,1422
E01029397,1957,14,17,6,0,1994
E01029398,1388,2,3,1,0,1394
E01029399,1287,10,8,2,1,1308
E01029400,1345,5,13,1,0,1364
E01029401,1270,9,19,4,1,1303
E01029402,1641,3,10,5,1,1660
E01029403,1194,8,5,0,0,1207
E01029404,1257,14,17,0,0,1288
E01029405,1357,4,5,0,0,1366
E01029406,1002,2,1,0,2,1007
E01029407,775,16,264,27,7,1089
E01029408,1149,19,381,48,22,1619
E01029409,871,24,332,47,11,1285
E01029410,826,15,314,49,4,1208
E01029411,1054,4,0,1,0,1059
E01029412,1098,6,16,5,0,1125
E01029413,1177,21,36,13,0,1247
E01029414,1194,8,133,14,2,1351
E01029415,1137,7,65,15,6,1230
E01029416,981,7,53,8,0,1049
E01029417,983,5,14,2,0,1004
E01029418,1674,11,29,10,1,1725
E01029419,1235,7,23,16,3,1284
E01029420,1393,9,19,9,0,1430
E01029422,1066,11,21,4,2,1104
E01029423,1235,6,13,1,1,1256
E01029424,871,2,6,1,1,881
E01029425,1962,41,54,55,7,2119
E01029426,939,19,338,16,13,1325
E01029427,957,25,144,29,4,1159
E01029428,1097,17,80,8,0,1202
E01029429,713,15,264,16,5,1013
E01029430,1228,3,5,0,0,1236
E01029431,1271,1,2,1,0,1275
E01029432,1222,2,8,0,2,1234
E01029433,1234,3,4,0,10,1251
E01029434,1075,26,74,15,5,1195
E01029435,1118,14,80,21,11,1244
E01029436,1275,23,137,42,2,1479
E01029437,1590,38,112,18,5,1763
E01029438,1208,8,18,12,3,1249
E01029439,1200,12,11,0,1,1224
E01029440,1011,4,12,4,0,1031
E01029441,1241,5,12,5,0,1263
E01029442,1041,5,32,1,0,1079
E01029443,1364,5,18,1,3,1391
E01029444,1347,6,9,1,2,1365
E01029445,1117,30,330,34,14,1525
E01029446,1263,12,111,13,3,1402
E01029447,579,19,610,25,12,1245
E01029448,1005,22,275,28,10,1340
E01029449,1376,9,21,4,1,1411
E01029450,1132,21,21,4,6,1184
E01029451,1396,7,9,7,4,1423
E01029452,1268,13,15,9,10,1315
E01029453,1118,13,24,15,6,1176
E01029454,1337,3,25,5,4,1374
E01029455,1422,5,26,6,0,1459
E01029456,1263,0,11,5,0,1279
E01029457,1054,9,15,1,0,1079
E01029458,1223,4,13,2,5,1247
E01029459,1195,1,16,2,3,1217
E01029460,1374,6,16,3,3,1402
E01029461,1526,10,13,4,4,1557
E01029462,1349,5,18,3,2,1377
E01029463,1016,5,12,4,0,1037
E01029464,1272,4,18,3,0,1297
E01029465,1270,8,9,1,3,1291
E01029466,1170,3,60,7,6,1246
E01029467,1722,1,9,3,0,1735
E01029468,1172,19,19,9,1,1220
E01029469,1460,8,22,7,4,1501
E01029470,1140,8,50,7,8,1213
E01029471,1393,15,32,18,4,1462
E01029472,1252,15,25,4,1,1297
E01029473,1162,3,1,1,1,1168
E01029474,969,5,11,3,1,989
E01029475,1690,8,9,3,0,1710
E01029476,1200,4,5,0,0,1209
E01029477,1255,3,6,3,6,1273
E01029478,1258,5,2,5,0,1270
E01029479,2055,27,45,14,5,2146
E01029480,1450,5,4,6,6,1471
E01029481,1602,4,3,2,0,1611
E01029482,1285,3,14,11,0,1313
E01029483,1277,9,27,5,2,1320
E01029484,1491,6,28,6,0,1531
E01029485,1245,5,24,5,1,1280
E01029486,1237,5,2,4,1,1249
E01029487,1293,10,14,4,0,1321
E01029488,1785,79,73,85,12,2034
E01029489,1366,5,2,4,0,1377
E01029490,1199,6,11,2,1,1219
E01029491,1426,8,21,2,3,1460
E01029492,1455,12,17,1,1,1486
E01029493,1573,14,5,1,0,1593
E01029494,1274,1,13,8,0,1296
E01029495,1327,13,25,3,0,1368
E01029496,1467,13,7,0,0,1487
E01029497,1610,10,11,3,3,1637
E01029498,1522,4,5,1,1,1533
E01029499,1400,6,5,2,0,1413
E01029500,1465,7,14,4,3,1493
E01029501,1211,4,21,7,1,1244
E01029502,1314,6,16,4,2,1342
E01029503,1302,5,7,1,2,1317
E01029504,1243,11,28,8,0,1290
E01029505,1309,7,21,2,1,1340
E01029506,1591,5,7,5,0,1608
E01029507,1372,7,7,7,1,1394
E01029508,1827,9,10,9,0,1855
E01029509,1393,5,18,5,1,1422
E01029511,1284,12,13,6,1,1316
E01029512,1451,11,24,8,4,1498
E01029513,915,9,177,9,7,1117
E01029514,1129,9,210,7,0,1355
E01029515,1573,4,11,5,0,1593
E01029516,1570,10,11,1,1,1593
E01029517,1369,4,4,1,1,1379
E01029518,2081,25,44,8,3,2161
E01029519,1655,14,50,10,3,1732
E01029520,1264,6,29,7,4,1310
E01029521,1371,3,44,6,1,1425
E01029522,1363,8,16,3,5,1395
E01029523,1276,2,13,1,0,1292
E01029524,1402,12,14,6,1,1435
E01029525,1470,12,10,4,8,1504
E01029526,1334,19,18,10,5,1386
E01029527,1004,3,2,3,0,1012
E01029528,1011,4,8,5,0,1028
E01029529,952,7,6,3,0,968
E01029530,1310,10,30,7,0,1357
E01029531,1412,3,8,4,1,1428
E01029532,1186,13,11,6,2,1218
E01029533,1266,8,4,4,2,1284
E01029534,1273,3,7,6,0,1289
E01029535,1114,7,2,6,0,1129
E01029536,1248,9,8,6,0,1271
E01029537,1215,7,11,2,1,1236
E01029538,1378,9,18,11,0,1416
E01029539,1199,11,21,9,0,1240
E01029540,1221,8,3,4,1,1237
E01029541,1191,8,8,0,0,1207
E01029542,1119,5,2,4,6,1136
E01029543,1030,4,2,4,0,1040
E01029544,1069,9,34,1,5,1118
E01029545,1223,2,23,5,5,1258
E01029546,1044,4,69,1,1,1119
E01029547,1076,6,18,9,3,1112
E01029548,1143,6,8,4,4,1165
E01029549,1380,9,25,6,4,1424
E01029551,1248,12,26,4,9,1299
E01029552,1189,5,24,7,0,1225
E01029553,1081,12,23,8,12,1136
E01029554,956,9,31,4,7,1007
E01029555,1385,19,60,14,10,1488
E01029556,2080,8,9,6,1,2104
E01029557,1078,11,3,2,0,1094
E01029558,1181,10,13,7,1,1212
E01029559,1147,10,10,5,0,1172
E01029560,1207,4,7,2,0,1220
E01029561,1153,4,1,2,0,1160
E01029562,1054,5,4,2,1,1066
E01029563,1154,4,3,3,1,1165
E01029564,1025,8,5,6,2,1046
E01029565,1006,6,7,3,0,1022
E01029566,837,7,25,4,0,873
E01029567,1296,12,23,10,8,1349
E01029568,1140,4,31,2,1,1178
E01029569,1217,4,12,2,0,1235
E01029570,2010,20,38,1,4,2073
E01029571,1116,9,11,0,1,1137
E01029572,1310,11,20,6,5,1352
E01029573,1209,7,16,3,8,1243
E01029574,1163,8,2,0,2,1175
E01029575,812,7,4,2,0,825
E01029576,2919,129,873,256,48,4225
E01029577,1284,6,11,5,1,1307
E01029578,1286,12,52,9,12,1371
E01029579,1357,1,12,2,0,1372
E01029580,1102,12,36,8,2,1160
E01029581,1302,8,5,0,0,1315
E01029582,1505,12,10,0,2,1529
E01029583,1178,9,20,9,0,1216
E01029584,945,9,23,8,2,987
E01029585,1166,9,27,6,0,1208
E01029586,1062,2,6,0,0,1070
E01029587,1006,14,7,1,0,1028
E01029588,1259,12,10,3,11,1295
E01029589,981,7,53,8,9,1058
E01029590,1141,1,38,2,3,1185
E01029591,1188,6,40,11,0,1245
E01029593,1380,15,18,0,7,1420
E01029594,1540,15,5,7,1,1568
E01029595,1081,5,5,2,0,1093
E01029596,1025,5,6,1,1,1038
E01029597,1140,12,9,5,0,1166
E01029598,1272,20,72,18,23,1405
E01029599,1171,8,43,4,7,1233
E01029600,1157,8,19,5,4,1193
E01029601,1158,23,91,14,9,1295
E01029602,1436,38,184,50,21,1729
E01029603,1146,23,108,17,6,1300
E01029604,1383,32,75,16,7,1513
E01029605,1006,5,23,3,3,1040
E01029606,1134,13,28,9,3,1187
E01029607,1112,14,36,8,3,1173
E01029608,1145,7,105,17,16,1290
E01029609,1310,12,17,14,3,1356
E01029610,1087,11,7,4,1,1110
E01029611,1236,11,28,10,0,1285
E01029612,1001,5,5,4,6,1021
E01029613,1165,10,16,4,1,1196
E01029614,1273,29,75,12,7,1396
E01029615,952,12,12,3,5,984
E01029616,1232,11,14,10,1,1268
E01029617,1355,6,33,3,1,1398
E01029618,1298,8,14,3,2,1325
E01029619,1568,14,21,11,1,1615
E01029620,1030,5,13,1,0,1049
E01029621,1204,11,13,8,3,1239
E01029622,1246,6,16,2,4,1274
E01029623,978,8,12,2,0,1000
E01029624,1179,10,16,1,3,1209
E01029625,943,3,2,2,0,950
E01029626,1202,7,7,9,1,1226
E01029627,1149,13,25,5,2,1194
E01029628,986,5,17,5,3,1016
E01029629,978,7,27,1,0,1013
E01029630,1174,10,34,7,0,1225
E01029631,1125,12,43,9,5,1194
E01029632,1510,12,48,7,7,1584
E01029633,1373,15,22,7,4,1421
E01029634,1128,5,13,9,5,1160
E01029635,1314,25,23,24,0,1386
E01029636,1183,8,31,4,0,1226
E01029637,1806,110,171,121,4,2212
E01029638,1698,17,11,2,2,1730
E01029639,1134,6,28,5,4,1177
E01029640,1122,9,21,5,0,1157
E01029641,1400,7,14,5,0,1426
E01029642,1295,7,6,7,3,1318
E01029643,1215,4,5,4,0,1228
E01029644,1234,9,14,2,1,1260
E01029645,1770,8,20,7,0,1805
E01029646,1141,4,11,1,2,1159
E01029647,1663,17,20,5,3,1708
E01029648,1174,9,19,4,0,1206
E01029649,1010,4,6,2,1,1023
E01029650,1305,6,11,0,2,1324
E01029651,1302,6,13,1,8,1330
E01029652,1449,16,29,2,3,1499
E01029653,990,11,6,0,0,1007
E01029654,1845,20,21,4,1,1891
E01029655,1664,10,6,5,0,1685
E01029656,1519,12,30,1,2,1564
E01029657,1362,4,21,0,3,1390
E01029658,1059,9,10,9,2,1089
E01029659,1157,1,0,1,0,1159
E01029660,1734,7,13,5,1,1760
E01029661,1587,18,52,23,11,1691
E01029662,1686,17,98,25,18,1844
E01029663,1144,9,37,6,0,1196
E01029664,1254,18,41,6,1,1320
E01029665,1384,20,74,28,4,1510
E01029666,1188,21,47,23,2,1281
E01029667,1824,13,27,8,3,1875
E01029668,1044,7,6,4,0,1061
E01029669,1072,4,7,4,0,1087
E01029670,1290,9,16,7,0,1322
E01029671,1252,10,14,1,1,1278
E01029672,1186,9,109,4,10,1318
E01029673,1270,11,72,15,9,1377
E01029674,1453,6,19,2,1,1481
E01029675,1288,8,3,3,0,1302
E01029676,906,9,7,2,0,924
E01029677,1086,6,7,2,1,1102
E01029678,1416,5,19,2,0,1442
E01029679,1134,7,20,5,0,1166
E01029680,1245,12,10,4,3,1274
E01029681,939,8,2,9,0,958
E01029682,1425,9,4,1,2,1441
E01029683,1047,15,27,2,0,1091
E01029684,1167,2,34,5,6,1214
E01029685,1251,5,26,8,2,1292
E01029686,1116,4,37,2,9,1168
E01029687,1585,7,12,6,2,1612
E01029688,1840,8,15,1,2,1866
E01029689,1381,19,45,25,3,1473
E01029690,1150,15,52,23,7,1247
E01029691,996,12,39,28,8,1083
E01029692,1112,26,73,21,6,1238
E01029693,933,23,299,78,42,1375
E01029694,1038,18,94,34,16,1200
E01029695,1710,7,9,0,1,1727
E01029696,1260,7,10,2,1,1280
E01029697,1285,24,30,34,0,1373
E01029698,1286,4,6,7,1,1304
E01029699,1514,33,69,33,23,1672
E01029700,995,9,46,6,4,1060
E01029701,1474,45,121,32,33,1705
E01029702,1267,9,18,6,0,1300
E01029703,1245,7,23,4,0,1279
E01029704,1164,6,4,3,0,1177
E01029705,1227,5,13,4,2,1251
E01029706,1309,4,2,1,1,1317
E01029707,1183,7,2,1,0,1193
E01029708,1581,7,6,1,1,1596
E01029709,1253,2,7,0,0,1262
E01029710,1228,7,3,4,1,1243
E01029711,1217,5,8,2,3,1235
E01029712,1537,7,7,4,6,1561
E01029713,1283,15,4,1,2,1305
E01029714,1265,18,17,11,1,1312
E01029715,1278,22,11,20,5,1336
E01029716,1185,15,33,23,3,1259
E01029717,1257,30,7,53,2,1349
E01029718,1541,14,56,21,3,1635
E01029719,1290,14,19,10,1,1334
E01029720,1162,6,27,28,4,1227
E01029721,1277,15,36,19,3,1350
E01029722,1239,24,91,22,13,1389
E01029723,1237,10,67,12,17,1343
E01029724,1431,5,43,7,7,1493
E01029725,1742,76,155,73,10,2056
E01029726,1354,9,31,14,1,1409
E01029727,1173,16,18,5,3,1215
E01029728,1125,10,11,9,3,1158
E01029729,1317,17,23,14,1,1372
E01029730,890,5,11,2,5,913
E01029731,1226,11,52,5,2,1296
E01029732,1960,32,119,29,8,2148
E01029733,1622,5,12,2,1,1642
E01029734,1542,26,48,26,6,1648
E01029735,1796,22,49,18,1,1886
E01029736,1208,12,87,3,2,1312
E01029737,1255,14,32,17,8,1326
E01029738,1098,7,14,14,5,1138
E01029739,1278,9,16,2,0,1305
E01029740,1260,10,20,3,1,1294
E01029741,1307,9,11,1,0,1328
E01029742,1760,7,13,11,1,1792
E01029743,1193,7,10,3,1,1214
E01029744,1835,20,26,9,2,1892
E01029745,1401,5,29,6,10,1451
E01029746,1229,11,5,3,3,1251
E01029747,1193,6,5,2,0,1206
E01029748,1136,4,13,12,0,1165
E01029749,1357,6,11,9,0,1383
E01029750,1142,13,32,8,2,1197
E01029751,1301,5,26,14,9,1355
E01029752,921,18,13,8,0,960
E01029753,1100,5,6,5,6,1122
E01029754,1095,2,5,3,4,1109
E01029755,1206,7,13,1,3,1230
E01029756,1395,7,21,2,2,1427
E01029757,1209,13,30,2,3,1257
E01029758,1236,4,36,2,7,1285
E01029759,1374,11,45,5,4,1439
E01029760,1266,8,35,3,8,1320
E01029761,1170,4,7,0,2,1183
E01029762,1323,4,8,2,1,1338
E01029763,1243,12,5,2,1,1263
E01029764,1329,8,5,1,0,1343
E01029765,1062,2,1,6,0,1071
E01029766,1197,9,4,8,3,1221
E01029767,1423,5,0,0,1,1429
E01029768,1191,2,6,0,1,1200
E01029769,1473,1,6,0,0,1480
E01029770,1636,1,8,0,0,1645
E01029771,1423,5,4,0,1,1433
E01029772,1485,3,6,0,0,1494
E01029773,1292,5,4,0,0,1301
E01029774,1568,14,15,0,0,1597
E01029775,1326,4,3,0,2,1335
E01029776,1514,3,6,0,0,1523
E01029777,1244,5,7,3,1,1260
E01029778,1475,4,9,0,1,1489
E01029779,1374,13,8,3,0,1398
E01029780,1318,13,7,10,3,1351
E01029781,1277,3,1,0,1,1282
E01029782,1616,10,12,1,3,1642
E01029783,1152,8,2,1,0,1163
E01029784,1809,5,4,3,0,1821
E01029785,1461,7,2,1,1,1472
E01029786,1229,5,4,2,0,1240
E01029787,1422,10,39,1,1,1473
E01029788,1140,1,1,3,1,1146
E01029789,861,5,3,0,1,870
E01029790,1558,6,10,1,0,1575
E01029791,1173,4,5,1,0,1183
E01029792,1922,2,14,3,1,1942
E01029793,1319,2,2,1,1,1325
E01029794,1185,9,17,3,0,1214
E01029795,1407,6,3,1,0,1417
E01029796,1240,3,0,0,0,1243
E01029797,1297,6,2,1,0,1306
E01029798,1411,7,5,6,0,1429
E01029799,1573,0,5,0,1,1579
E01029800,1299,3,5,5,1,1313
E01029801,1540,3,5,0,0,1548
E01029802,1545,8,5,1,1,1560
E01029803,1547,3,6,2,0,1558
E01029804,1421,16,22,5,1,1465
E01029805,1413,8,7,0,0,1428
E01029806,1279,5,6,2,0,1292
E01029807,967,0,6,2,3,978
E01029808,1153,5,6,3,1,1168
E01029809,1169,5,3,3,0,1180
E01029810,1045,4,7,1,1,1058
E01029811,1244,10,7,2,3,1266
E01029812,1578,14,19,4,4,1619
E01029813,1732,6,11,1,1,1751
E01029814,1352,7,20,2,3,1384
E01029815,1307,8,2,0,0,1317
E01029816,1201,4,9,0,0,1214
E01029817,1589,2,3,0,0,1594
E01029818,1278,5,3,1,1,1288
E01029819,1437,5,5,1,1,1449
E01029820,1182,10,20,2,5,1219
E01029821,1254,2,4,2,0,1262
E01029822,1119,17,16,8,4,1164
E01029823,1261,3,7,3,1,1275
E01029824,1340,8,21,6,4,1379
E01029825,1073,4,2,10,1,1090
E01029826,1268,10,2,4,0,1284
E01029827,1082,12,10,6,0,1110
E01029828,930,4,7,8,1,950
E01029829,1492,8,6,10,5,1521
E01029830,951,5,8,5,0,969
E01029831,1176,3,10,1,6,1196
E01029832,1350,4,5,3,0,1362
E01029833,1306,7,17,7,2,1339
E01029834,1220,5,13,4,1,1243
E01029835,1499,11,12,6,5,1533
E01029836,1010,10,16,7,3,1046
E01029837,1241,9,12,4,3,1269
E01029838,1274,7,17,11,1,1310
E01029839,942,2,10,7,1,962
E01029840,884,10,14,8,2,918
E01029841,1200,5,7,8,1,1221
E01029842,938,16,14,6,0,974
E01029843,1091,11,1,0,0,1103
E01029844,988,8,9,3,1,1009
E01029845,797,7,1,1,0,806
E01029846,1032,4,8,1,3,1048
E01029847,1163,3,3,1,0,1170
E01029848,1019,4,10,1,0,1034
E01029849,1131,4,17,4,2,1158
E01029850,1008,8,11,6,0,1033
E01029851,1710,15,36,16,1,1778
E01029852,1380,7,6,2,0,1395
E01029853,1367,11,25,7,0,1410
E01029854,1290,3,10,3,1,1307
E01029855,1140,13,12,5,4,1174
E01029856,1178,8,6,9,0,1201
E01029857,1045,6,26,13,2,1092
E01029858,1239,11,18,23,0,1291
E01029859,1301,21,10,12,6,1350
E01029860,1099,3,6,3,1,1112
E01029861,1130,3,7,2,0,1142
E01029862,1035,5,13,3,1,1057
E01029863,1424,3,15,3,3,1448
E01029864,1285,7,30,11,2,1335
E01029865,1275,21,29,26,1,1352
E01029867,1291,5,7,8,1,1312
E01029868,1132,4,9,8,1,1154
E01029869,1272,7,2,6,2,1289
E01029870,895,6,4,1,0,906
E01029871,1140,6,0,1,2,1149
E01029872,1145,4,7,2,0,1158
E01029873,1782,4,1,5,2,1794
E01029874,1393,9,8,6,1,1417
E01029875,1757,4,4,4,0,1769
E01029876,1701,6,3,4,2,1716
E01029877,1061,8,9,0,0,1078
E01029878,992,12,12,8,2,1026
E01029879,1238,12,8,4,1,1263
E01029880,1395,15,7,0,8,1425
E01029881,1632,8,8,4,3,1655
E01029882,1243,11,6,7,0,1267
E01029883,1615,5,22,5,0,1647
E01029884,1218,4,7,4,1,1234
E01029885,1800,6,4,0,1,1811
E01029886,1047,7,5,4,0,1063
E01029887,1473,6,13,3,2,1497
E01029888,937,5,10,3,0,955
E01029889,963,9,18,4,3,997
E01029890,1037,4,9,1,1,1052
E01029891,1506,5,9,2,2,1524
E01029892,1419,19,22,2,4,1466
E01029893,2010,12,14,7,8,2051
E01029894,947,4,8,3,0,962
E01029895,947,6,8,4,1,966
E01029896,1122,6,4,4,1,1137
E01029897,1783,15,39,7,2,1846
E01029898,1499,4,6,0,3,1512
E01029899,1460,4,8,0,0,1472
E01029900,1347,10,7,5,0,1369
E01029901,1834,7,4,4,10,1859
E01029902,1776,6,12,3,1,1798
E01029903,1139,7,3,2,0,1151
E01029904,1189,7,13,0,0,1209
E01029905,883,5,13,1,2,904
E01029906,1513,8,7,3,1,1532
E01029907,1829,6,6,2,0,1843
E01029908,1235,23,16,6,2,1282
E01029909,1245,17,12,8,3,1285
E01029910,861,17,17,12,4,911
E01029911,1779,8,4,3,4,1798
E01029912,1274,17,10,7,0,1308
E01029913,953,1,3,7,1,965
E01029914,1201,4,12,2,2,1221
E01029915,981,5,23,1,3,1013
E01029916,958,11,18,7,3,997
E01029917,1510,13,9,1,8,1541
E01029918,892,7,16,3,4,922
E01029919,1232,10,11,6,5,1264
E01029920,1461,10,28,14,5,1518
E01029921,1067,8,1,1,0,1077
E01029922,1084,5,1,6,2,1098
E01029923,1133,2,4,1,1,1141
E01029925,1408,24,50,23,3,1508
E01029926,1441,17,4,10,1,1473
E01029927,1802,33,24,20,11,1890
E01029928,1423,18,14,14,5,1474
E01029929,1798,26,23,13,5,1865
E01029930,1217,21,9,20,5,1272
E01029937,1603,17,33,8,5,1666
E01029938,990,18,19,17,5,1049
E01029939,1171,17,20,29,22,1259
E01029940,1085,23,22,13,3,1146
E01029941,1426,16,9,9,3,1463
E01029942,1165,25,18,29,10,1247
E01029944,1349,9,11,15,16,1400
E01029945,1490,26,17,33,10,1576
E01029946,1504,46,46,37,20,1653
E01029947,1825,32,31,25,17,1930
E01029949,1133,14,21,16,1,1185
E01029950,1310,23,86,44,7,1470
E01029951,1147,11,42,6,4,1210
E01029952,1026,4,31,5,1,1067
E01029953,1092,14,30,18,2,1156
E01029954,1852,20,66,8,5,1951
E01029955,1470,24,32,7,5,1538
E01029956,1009,13,33,23,5,1083
E01029957,1347,13,20,6,3,1389
E01029958,1046,27,33,21,2,1129
E01029960,1318,48,53,37,6,1462
E01029961,1024,30,43,36,4,1137
E01029962,1103,22,129,29,4,1287
E01029963,1227,9,34,15,1,1286
E01029964,965,23,50,20,1,1059
E01029965,1151,13,51,5,2,1222
E01029966,1037,18,75,30,14,1174
E01029967,1096,9,26,7,2,1140
E01029968,1079,24,25,47,13,1188
E01029969,1135,23,20,20,11,1209
E01029970,1351,23,38,21,13,1446
E01029971,1115,20,17,22,10,1184
E01029973,1234,12,28,8,10,1292
E01029974,1197,13,39,15,11,1275
E01029975,997,11,22,11,4,1045
E01029976,1206,20,32,15,4,1277
E01029977,1210,17,9,16,1,1253
E01029978,1018,20,20,30,2,1090
E01029979,1093,55,22,30,8,1208
E01029980,1065,44,37,45,9,1200
E01029981,924,7,18,16,0,965
E01029982,971,25,41,22,1,1060
E01029983,1140,38,43,47,8,1276
E01029984,1038,39,42,49,12,1180
E01029985,1653,61,123,64,25,1926
E01029986,1042,35,20,41,22,1160
E01029987,1157,29,8,17,7,1218
E01029988,1241,59,126,103,31,1560
E01029990,1161,23,53,26,3,1266
E01029991,1331,21,15,14,6,1387
E01029992,1021,15,36,11,6,1089
E01029994,944,47,125,71,5,1192
E01029995,1248,14,32,29,4,1327
E01029996,1111,45,93,76,5,1330
E01029997,1125,21,36,11,5,1198
E01029998,1268,40,76,27,9,1420
E01029999,1203,17,55,12,8,1295
E01030000,1118,23,47,18,6,1212
E01030001,1212,19,40,25,8,1304
E01030002,1451,29,66,23,2,1571
E01030003,1245,30,77,20,14,1386
E01030004,986,14,44,17,5,1066
E01030005,1571,26,87,28,9,1721
E01030006,1306,18,65,23,24,1436
E01030007,1143,33,49,28,10,1263
E01030008,1014,11,29,16,8,1078
E01030009,1150,19,48,13,9,1239
E01030010,1290,38,118,41,34,1521
E01030011,1271,17,22,8,1,1319
E01030012,925,20,8,20,6,979
E01030013,1100,24,13,15,5,1157
E01030014,1119,20,3,9,4,1155
E01030015,1075,13,5,10,0,1103
E01030016,1197,20,5,8,6,1236
E01030017,1048,32,19,11,17,1127
E01030018,1028,41,17,52,10,1148
E01030019,1205,16,31,15,0,1267
E01030020,1207,16,3,39,2,1267
E01030021,965,48,14,41,20,1088
E01030022,1544,54,51,60,21,1730
E01030023,1231,47,93,68,31,1470
E01030024,1584,95,150,100,110,2039
E01030025,1235,45,155,56,18,1509
E01030026,1189,32,32,38,4,1295
E01030027,1566,36,21,35,9,1667
E01030028,1205,27,22,36,19,1309
E01030029,1161,40,35,29,12,1277
E01030030,1466,41,20,33,16,1576
E01030031,1102,27,28,18,9,1184
E01030032,929,64,21,52,6,1072
E01030033,1278,23,3,12,1,1317
E01030034,1190,19,17,13,0,1239
E01030035,1220,46,19,70,4,1359
E01030036,1327,41,34,31,4,1437
E01030037,970,1,11,2,0,984
E01030038,1022,4,3,1,0,1030
E01030039,1176,3,3,5,1,1188
E01030040,987,3,2,1,1,994
E01030041,1836,6,8,5,0,1855
E01030042,1304,10,1,6,2,1323
E01030043,985,12,4,6,3,1010
E01030044,978,10,7,4,0,999
E01030045,1423,15,10,4,0,1452
E01030046,1318,7,10,3,0,1338
E01030047,1029,1,6,0,0,1036
E01030048,1855,12,9,4,4,1884
E01030049,1360,6,8,3,0,1377
E01030050,1556,11,39,1,0,1607
E01030051,1362,14,11,0,0,1387
E01030052,1760,6,10,5,4,1785
E01030053,1881,11,2,4,1,1899
E01030054,1017,6,2,0,0,1025
E01030055,1130,2,6,3,0,1141
E01030056,1802,9,1,4,0,1816
E01030057,1823,12,3,3,2,1843
E01030058,1702,4,6,0,0,1712
E01030059,1850,8,3,1,0,1862
E01030060,1306,4,7,4,1,1322
E01030061,1289,15,7,6,1,1318
E01030062,1115,9,11,10,1,1146
E01030063,1861,11,13,7,1,1893
E01030064,1883,7,5,0,1,1896
E01030065,1670,5,8,2,2,1687
E01030066,1301,11,3,3,2,1320
E01030067,1031,6,7,2,1,1047
E01030068,1370,6,5,5,0,1386
E01030069,1098,4,2,4,0,1108
E01030070,1621,48,48,102,11,1830
E01030071,1215,10,14,3,3,1245
E01030072,1322,8,18,4,4,1356
E01030073,1248,8,6,4,1,1267
E01030075,1245,6,14,1,0,1266
E01030076,1159,5,21,2,2,1189
E01030077,1193,8,18,3,2,1224
E01030078,1374,10,3,2,0,1389
E01030079,1178,12,12,6,4,1212
E01030080,1302,4,13,6,0,1325
E01030081,1895,4,3,3,1,1906
E01030082,2092,7,18,2,0,2119
E01030083,1878,7,13,2,1,1901
E01030084,1313,12,5,4,3,1337
E01030085,1276,5,5,3,1,1290
E01030086,915,9,5,2,0,931
E01030087,1052,8,4,0,0,1064
E01030088,955,2,7,2,0,966
E01030089,1662,10,5,3,0,1680
E01030090,1943,8,8,7,2,1968
E01030091,1554,16,36,14,14,1634
E01030092,1387,12,10,4,3,1416
E01030093,1278,18,23,8,8,1335
E01030094,1126,9,8,2,0,1145
E01030095,955,4,3,0,1,963
E01030096,1203,5,10,1,1,1220
E01030097,974,4,3,3,2,986
E01030098,1845,7,2,5,3,1862
E01030099,1658,3,12,2,2,1677
E01030100,1735,3,11,6,7,1762
E01030101,1709,5,7,1,1,1723
E01030103,1745,5,11,3,1,1765
E01030104,1808,14,20,4,1,1847
E01030105,1378,19,30,27,8,1462
E01030106,1825,23,48,20,4,1920
E01030107,1329,3,12,9,1,1354
E01030108,1413,19,40,24,2,1498
E01030109,1359,9,31,10,3,1412
E01030110,2080,19,46,12,11,2168
E01030111,1099,6,20,2,2,1129
E01030112,1397,18,21,17,4,1457
E01030113,1484,18,24,23,0,1549
E01030114,1149,6,14,22,3,1194
E01030115,1705,14,18,6,2,1745
E01030116,1642,17,46,24,0,1729
E01030117,1241,7,26,11,1,1286
E01030118,1197,15,43,24,6,1285
E01030119,1830,12,10,5,0,1857
E01030120,2279,77,94,178,9,2637
E01030121,1874,6,6,5,4,1895
E01030122,1597,17,16,3,0,1633
E01030123,1234,11,15,2,1,1263
E01030124,1308,5,6,4,1,1324
E01030125,1219,5,19,6,9,1258
E01030127,975,8,22,5,2,1012
E01030128,1125,15,19,14,3,1176
E01030129,1148,12,15,5,0,1180
E01030130,1018,8,14,3,4,1047
E01030131,923,14,19,10,2,968
E01030132,1508,17,13,49,2,1589
E01030133,1175,5,8,11,0,1199
E01030134,969,4,4,2,1,980
E01030135,1120,5,18,9,2,1154
E01030137,1291,14,27,8,5,1345
E01030138,1892,6,11,1,4,1914
E01030139,1313,16,30,5,3,1367
E01030140,1012,8,3,2,1,1026
E01030141,1213,11,9,7,3,1243
E01030142,1409,10,57,9,10,1495
E01030143,1114,15,126,9,3,1267
E01030144,995,7,19,1,1,1023
E01030145,1154,4,3,3,0,1164
E01030146,917,3,0,2,3,925
E01030147,1221,5,32,7,1,1266
E01030148,1030,6,16,2,2,1056
E01030149,1183,7,11,4,0,1205
E01030150,1801,6,9,6,2,1824
E01030151,1770,32,45,58,6,1911
E01030152,1799,4,5,0,0,1808
E01030153,1068,5,14,1,0,1088
E01030154,1723,4,3,3,0,1733
E01030155,1617,12,37,4,2,1672
E01030158,1283,15,7,2,4,1311
E01030159,1179,11,17,5,8,1220
E01030160,1155,12,8,3,3,1181
E01030161,1055,13,5,3,1,1077
E01030162,1136,11,43,9,5,1204
E01030163,1198,9,23,9,2,1241
E01030164,1279,10,17,3,3,1312
E01030165,1266,12,39,6,2,1325
E01030166,1279,8,17,9,2,1315
E01030167,1112,11,33,6,2,1164
E01030168,1114,20,16,3,2,1155
E01030169,1186,9,18,6,3,1222
E01030170,1348,9,14,3,1,1375
E01030171,1535,14,28,5,5,1587
E01030172,1308,6,13,0,0,1327
E01030173,1278,14,78,0,1,1371
E01030174,1135,3,10,2,1,1151
E01030175,1839,8,11,4,1,1863
E01030176,1631,2,10,2,2,1647
E01030179,1813,23,74,22,9,1941
E01030180,1059,9,25,7,0,1100
E01030181,1399,20,70,15,7,1511
E01030183,1679,11,15,5,0,1710
E01030184,1460,14,26,8,5,1513
E01030185,1644,13,29,5,1,1692
E01030186,1222,6,1,0,0,1229
E01030187,1248,13,23,1,0,1285
E01030188,1307,15,25,1,0,1348
E01030189,1313,6,10,1,1,1331
E01030190,1503,3,17,2,1,1526
E01030191,1273,17,46,8,6,1350
E01030192,1214,8,15,10,3,1250
E01030193,1315,9,13,5,1,1343
E01030194,1314,13,11,5,2,1345
E01030195,1336,7,6,5,2,1356
E01030196,1247,23,59,18,6,1353
E01030197,1316,7,21,10,2,1356
E01030198,1102,3,7,1,0,1113
E01030199,1530,7,12,7,1,1557
E01030200,1835,14,8,4,1,1862
E01030201,1767,5,9,2,0,1783
E01030203,1635,16,17,6,1,1675
E01030204,1405,14,47,5,7,1478
E01030205,937,8,31,18,3,997
E01030206,1224,19,50,5,4,1302
E01030207,1232,11,20,5,2,1270
E01030208,1070,5,4,1,1,1081
E01030209,1282,4,13,0,2,1301
E01030210,1619,9,5,3,1,1637
E01030211,1642,16,15,15,0,1688
E01030212,1628,2,4,2,4,1640
E01030214,1048,4,15,6,1,1074
E01030215,1088,10,6,1,0,1105
E01030216,1237,5,6,3,2,1253
E01030217,1089,6,4,5,2,1106
E01030218,1181,7,12,3,0,1203
E01030219,1647,6,5,2,3,1663
E01030220,1794,8,4,4,1,1811
E01030221,1664,4,14,1,0,1683
E01030222,1674,1,8,1,2,1686
E01030223,1402,5,5,3,4,1419
E01030224,1425,9,10,2,2,1448
E01030225,1346,8,16,0,11,1381
E01030226,1451,13,14,3,1,1482
E01030227,1123,3,3,2,1,1132
E01030228,1498,3,4,0,1,1506
E01030229,1804,8,8,2,2,1824
E01030230,1554,21,11,4,4,1594
E01030231,1213,11,9,1,1,1235
E01030232,1344,10,11,1,0,1366
E01030233,1271,3,5,5,1,1285
E01030234,1135,12,15,4,2,1168
E01030235,1231,11,7,0,0,1249
E01030236,1419,3,10,9,0,1441
E01030237,2243,15,19,8,1,2286
E01030238,1428,13,12,5,2,1460
E01030239,1473,8,17,2,2,1502
E01030240,1372,5,12,2,0,1391
E01030241,1244,4,8,5,0,1261
E01030242,1197,7,12,3,3,1222
E01030243,1204,5,2,0,1,1212
E01030244,1505,5,6,2,0,1518
E01030245,1352,10,2,1,1,1366
E01030246,1058,6,15,2,0,1081
E01030247,1219,12,30,7,2,1270
E01030248,1131,18,10,5,0,1164
E01030249,1245,10,24,10,6,1295
E01030250,1343,19,33,5,3,1403
E01030251,1296,4,9,1,1,1311
E01030252,1505,5,7,0,2,1519
E01030253,1434,10,12,2,1,1459
E01030254,1102,8,14,10,6,1140
E01030255,1013,19,16,0,1,1049
E01030256,1209,23,13,10,7,1262
E01030257,1278,12,7,7,0,1304
E01030258,1222,15,25,3,7,1272
E01030259,947,5,1,3,0,956
E01030260,1114,42,44,72,1,1273
E01030261,1066,11,14,5,0,1096
E01030262,978,13,4,5,0,1000
E01030263,1183,8,8,3,1,1203
E01030264,1043,6,24,0,1,1074
E01030265,1102,11,13,2,1,1129
E01030266,1352,7,4,2,3,1368
E01030267,1066,6,11,1,1,1085
E01030268,1073,3,10,1,1,1088
E01030269,1415,13,1,3,0,1432
E01030270,1235,9,14,4,0,1262
E01030271,1276,5,6,3,0,1290
E01030272,1294,5,10,3,0,1312
E01030273,1365,2,11,2,1,1381
E01030274,1022,6,2,1,0,1031
E01030275,941,7,6,1,2,957
E01030276,1013,2,3,1,0,1019
E01030277,922,6,10,3,3,944
E01030278,1344,7,6,6,0,1363
E01030279,1051,7,6,2,1,1067
E01030280,1184,5,7,0,1,1197
E01030281,1864,16,12,2,2,1896
E01030282,1022,11,3,1,0,1037
E01030283,1076,10,32,2,0,1120
E01030284,1062,9,3,2,2,1078
E01030285,1847,9,6,2,0,1864
E01030286,1836,5,5,2,0,1848
E01030287,1189,4,8,6,0,1207
E01030288,1222,6,8,0,1,1237
E01030289,1152,12,6,4,0,1174
E01030290,1253,4,5,1,0,1263
E01030291,1115,2,3,1,0,1121
E01030292,1238,3,4,2,1,1248
E01030293,1368,8,18,3,0,1397
E01030294,1184,9,7,1,0,1201
E01030295,1854,14,5,1,0,1874
E01030296,1288,17,51,5,5,1366
E01030297,1608,18,75,10,14,1725
E01030298,1177,15,41,4,8,1245
E01030299,1204,15,38,6,5,1268
E01030300,1211,12,65,15,14,1317
E01030301,1096,11,60,3,10,1180
E01030302,1267,20,26,11,8,1332
E01030303,1281,20,58,3,17,1379
E01030304,1219,15,33,17,8,1292
E01030305,1023,25,74,13,27,1162
E01030306,965,32,78,11,20,1106
E01030307,1179,17,73,4,21,1294
E01030308,1168,27,69,6,7,1277
E01030309,1161,20,45,6,14,1246
E01030310,1247,24,95,29,25,1420
E01030311,1133,15,47,12,13,1220
E01030312,951,21,53,9,11,1045
E01030313,1128,4,84,14,1,1231
E01030314,1104,26,79,21,3,1233
E01030315,1201,13,36,2,11,1263
E01030316,1192,13,42,7,12,1266
E01030317,1289,21,42,4,7,1363
E01030318,1207,15,46,10,5,1283
E01030319,1132,20,137,8,11,1308
E01030320,1149,21,124,15,6,1315
E01030321,1090,21,113,4,13,1241
E01030322,1198,29,149,13,12,1401
E01030323,934,12,101,6,16,1069
E01030324,1136,21,49,11,7,1224
E01030325,1072,18,97,9,18,1214
E01030326,1286,23,49,12,13,1383
E01030327,1202,21,40,10,12,1285
E01030328,1218,22,41,5,8,1294
E01030329,1130,15,38,8,11,1202
E01030330,1127,25,86,13,13,1264
E01030331,1187,9,52,12,11,1271
E01030332,1087,19,55,7,6,1174
E01030333,1051,24,86,11,8,1180
E01030334,975,19,159,13,3,1169
E01030335,1346,21,44,16,12,1439
E01030336,1349,15,73,10,13,1460
E01030337,1216,15,63,7,12,1313
E01030338,1175,17,33,2,9,1236
E01030339,1059,21,58,6,14,1158
E01030340,1050,18,58,8,22,1156
E01030341,1276,29,108,9,21,1443
E01030342,1201,20,100,7,25,1353
E01030343,1200,20,47,11,16,1294
E01030344,1024,12,74,9,30,1149
E01030345,1161,15,72,9,17,1274
E01030346,993,29,102,11,24,1159
E01030347,1120,31,90,17,15,1273
E01030348,1136,27,114,15,18,1310
E01030349,1245,25,86,5,30,1391
E01030350,1212,25,34,9,11,1291
E01030351,1122,15,47,4,7,1195
E01030352,1129,20,42,8,4,1203
E01030353,1089,20,53,13,9,1184
E01030354,985,16,72,26,8,1107
E01030355,1018,13,59,10,8,1108
E01030356,933,19,42,8,15,1017
E01030357,1230,23,47,3,3,1306
E01030358,1059,28,59,7,15,1168
E01030359,1627,39,105,20,21,1812
E01030360,1143,24,66,22,7,1262
E01030361,1473,21,44,9,6,1553
E01030362,843,11,53,13,2,922
E01030363,1364,28,31,24,14,1461
E01030364,1100,16,53,24,12,1205
E01030365,1105,19,99,5,11,1239
E01030366,1288,33,125,19,23,1488
E01030367,1179,17,99,12,13,1320
E01030368,1152,19,51,9,10,1241
E01030369,1525,23,92,9,17,1666
E01030370,1112,19,58,3,6,1198
E01030371,1109,19,68,12,8,1216
E01030372,952,16,37,5,5,1015
E01030373,1117,14,47,6,14,1198
E01030374,1203,28,77,11,16,1335
E01030375,1224,47,70,14,14,1369
E01030376,918,17,58,5,13,1011
E01030377,1686,23,140,14,16,1879
E01030378,1136,17,84,11,13,1261
E01030379,1057,25,113,12,10,1217
E01030380,1009,12,80,7,4,1112
E01030381,1111,9,68,4,12,1204
E01030382,1015,20,105,4,4,1148
E01030383,1530,45,233,89,49,1946
E01030384,1599,59,222,61,49,1990
E01030385,1051,32,163,53,23,1322
E01030386,971,15,176,9,39,1210
E01030387,1153,14,117,22,18,1324
E01030388,850,21,154,10,54,1089
E01030389,1007,23,179,10,38,1257
E01030390,1429,22,42,7,4,1504
E01030391,1365,20,85,22,26,1518
E01030392,1453,12,76,12,20,1573
E01030393,1359,24,194,29,32,1638
E01030394,1270,11,98,10,18,1407
E01030395,1367,16,91,9,21,1504
E01030396,1290,20,132,12,12,1466
E01030398,1201,20,192,9,4,1426
E01030399,1437,29,123,51,24,1664
E01030400,940,32,125,48,28,1173
E01030401,1739,30,153,34,20,1976
E01030402,864,23,72,10,19,988
E01030403,1084,23,72,13,9,1201
E01030404,1173,19,52,2,15,1261
E01030405,1182,14,67,4,7,1274
E01030406,1124,22,105,11,38,1300
E01030407,1054,16,55,18,6,1149
E01030408,1332,18,86,11,6,1453
E01030409,942,40,194,35,20,1231
E01030410,968,28,84,40,10,1130
E01030411,1524,49,248,37,35,1893
E01030412,1426,29,107,40,24,1626
E01030413,1385,31,107,16,19,1558
E01030414,961,16,43,15,17,1052
E01030415,1173,16,75,18,12,1294
E01030416,987,15,72,6,17,1097
E01030417,984,13,53,4,2,1056
E01030418,1113,15,39,7,9,1183
E01030419,1151,12,132,42,13,1350
E01030420,880,20,61,8,8,977
E01030421,1202,6,8,6,1,1223
E01030422,1164,7,17,8,2,1198
E01030423,1326,7,17,18,3,1371
E01030424,1154,8,38,13,0,1213
E01030425,1240,7,39,19,6,1311
E01030426,1070,10,50,13,4,1147
E01030427,1160,7,27,6,8,1208
E01030428,915,9,32,14,5,975
E01030429,1170,7,24,13,3,1217
E01030430,1250,10,20,8,4,1292
E01030431,1192,6,26,8,3,1235
E01030432,1116,17,35,26,1,1195
E01030433,1276,12,35,10,1,1334
E01030434,1173,13,67,12,29,1294
E01030435,1248,23,59,9,25,1364
E01030436,1646,13,93,18,42,1812
E01030437,1331,19,55,11,28,1444
E01030438,1210,15,64,16,28,1333
E01030439,1191,20,110,8,28,1357
E01030440,1244,7,23,0,6,1280
E01030441,1016,3,11,2,2,1034
E01030442,1149,10,15,3,6,1183
E01030443,1030,7,11,1,4,1053
E01030444,1154,7,13,9,1,1184
E01030445,1130,15,26,11,3,1185
E01030446,1027,11,51,3,3,1095
E01030447,1060,4,9,3,1,1077
E01030448,1185,9,26,11,6,1237
E01030449,1039,19,56,11,27,1152
E01030450,1758,47,153,22,23,2003
E01030451,1413,41,134,24,31,1643
E01030452,1558,36,110,29,43,1776
E01030453,1127,30,55,13,50,1275
E01030454,1275,17,34,9,7,1342
E01030455,1247,29,82,29,33,1420
E01030456,1094,10,13,9,15,1141
E01030457,1178,32,133,15,49,1407
E01030458,994,12,5,3,3,1017
E01030459,1054,24,36,47,3,1164
E01030460,1148,10,53,6,15,1232
E01030461,1250,10,31,2,3,1296
E01030462,1214,16,100,13,19,1362
E01030463,1109,16,66,10,20,1221
E01030464,1151,28,70,10,11,1270
E01030465,1123,3,25,12,6,1169
E01030466,1301,4,9,6,0,1320
E01030467,1233,14,50,10,6,1313
E01030468,2203,95,786,166,125,3375
E01030469,1037,8,59,11,17,1132
E01030470,1815,80,580,168,98,2741
E01030471,997,5,6,1,3,1012
E01030472,1010,4,7,1,7,1029
E01030473,1307,14,18,8,8,1355
E01030474,1259,33,57,87,28,1464
E01030475,1030,8,13,6,4,1061
E01030476,996,5,15,2,2,1020
E01030477,1294,11,21,1,1,1328
E01030478,1610,13,38,9,3,1673
E01030479,1382,12,21,3,6,1424
E01030480,1398,8,26,5,11,1448
E01030481,1279,16,53,18,21,1387
E01030482,1031,19,61,10,14,1135
E01030483,1070,2,30,1,7,1110
E01030484,1248,16,78,15,11,1368
E01030485,1297,28,71,25,17,1438
E01030486,1210,23,73,13,19,1338
E01030487,1240,26,84,21,11,1382
E01030488,1418,28,285,56,62,1849
E01030489,1780,20,126,19,20,1965
E01030490,1277,7,13,4,7,1308
E01030491,1463,21,18,7,7,1516
E01030492,1625,7,16,3,4,1655
E01030493,961,23,57,25,3,1069
E01030494,1221,20,89,24,21,1375
E01030495,1352,27,120,31,18,1548
E01030496,1135,14,139,18,18,1324
E01030497,1089,16,99,35,10,1249
E01030498,1043,24,59,11,15,1152
E01030499,1240,13,34,3,9,1299
E01030500,1134,14,81,24,14,1267
E01030501,1204,11,56,8,16,1295
E01030502,1015,6,19,10,10,1060
E01030503,986,9,73,22,22,1112
E01030504,904,4,28,6,10,952
E01030505,1183,10,48,9,2,1252
E01030506,1015,17,16,5,0,1053
E01030507,948,11,17,1,0,977
E01030508,1037,5,63,5,0,1110
E01030509,853,15,30,7,1,906
E01030510,1210,17,57,6,18,1308
E01030511,1157,12,31,8,8,1216
E01030512,1219,17,25,16,5,1282
E01030513,1030,11,33,9,7,1090
E01030514,1122,8,34,5,4,1173
E01030515,1561,3,11,3,4,1582
E01030516,1034,8,24,11,5,1082
E01030517,1237,7,25,3,4,1276
E01030518,1097,13,15,1,1,1127
E01030519,1207,4,21,5,2,1239
E01030520,1147,5,19,0,4,1175
E01030521,1302,12,28,4,10,1356
E01030522,1051,5,6,0,3,1065
E01030523,950,10,11,3,4,978
E01030524,1721,15,33,9,3,1781
E01030525,1242,5,9,3,0,1259
E01030526,1059,6,4,2,1,1072
E01030527,1319,12,16,3,1,1351
E01030528,1152,3,11,3,3,1172
E01030529,1316,9,8,3,1,1337
E01030530,1016,2,14,1,3,1036
E01030531,1858,25,46,17,7,1953
E01030532,1126,9,40,3,5,1183
E01030533,1017,5,34,3,11,1070
E01030534,1055,3,34,5,3,1100
E01030535,1439,16,54,2,5,1516
E01030536,1421,24,32,10,15,1502
E01030537,1406,11,29,4,4,1454
E01030538,1203,14,63,10,14,1304
E01030539,1341,21,42,7,5,1416
E01030540,1700,15,30,3,3,1751
E01030541,1071,10,31,1,3,1116
E01030542,970,8,11,3,1,993
E01030543,1125,18,46,2,9,1200
E01030544,1302,7,8,3,0,1320
E01030545,1233,3,10,7,4,1257
E01030546,1262,9,14,17,3,1305
E01030547,1191,11,30,8,17,1257
E01030548,1280,19,118,18,15,1450
E01030549,1334,26,95,14,10,1479
E01030550,1355,21,87,14,17,1494
E01030551,1123,24,73,20,9,1249
E01030552,1149,16,62,6,8,1241
E01030553,1355,26,46,5,10,1442
E01030554,889,6,17,9,5,926
E01030555,1353,8,14,5,5,1385
E01030556,1576,16,45,9,4,1650
E01030557,1484,12,16,2,4,1518
E01030558,1736,17,33,5,3,1794
E01030559,1041,9,37,6,2,1095
E01030560,1306,23,59,6,7,1401
E01030561,1190,3,37,12,9,1251
E01030562,1008,14,16,15,2,1055
E01030563,1452,65,111,166,9,1803
E01030564,1030,19,28,9,1,1087
E01030565,1157,13,37,11,3,1221
E01030566,1115,11,26,21,2,1175
E01030567,1292,11,12,16,1,1332
E01030568,1193,15,39,13,2,1262
E01030569,1692,66,142,93,21,2014
E01030570,1133,19,108,26,12,1298
E01030571,1143,15,66,13,18,1255
E01030572,1365,27,192,61,11,1656
E01030573,1263,18,101,19,3,1404
E01030574,1224,27,115,26,10,1402
E01030575,1563,30,117,26,10,1746
E01030576,1236,20,84,21,5,1366
E01030577,1257,18,38,24,21,1358
E01030578,1131,9,55,13,11,1219
E01030579,1154,17,62,14,15,1262
E01030580,1371,28,55,21,8,1483
E01030581,1007,9,26,6,5,1053
E01030582,890,18,44,16,7,975
E01030583,1169,9,33,9,9,1229
E01030584,1273,9,27,11,1,1321
E01030585,1245,8,37,14,0,1304
E01030586,1257,16,37,16,5,1331
E01030587,1144,11,32,11,1,1199
E01030588,1072,12,59,22,5,1170
E01030589,1325,18,69,18,9,1439
E01030590,1406,25,63,8,6,1508
E01030591,1087,11,78,15,3,1194
E01030592,1500,17,78,10,14,1619
E01030593,1020,13,49,17,8,1107
E01030594,1289,20,28,10,14,1361
E01030595,1089,12,37,5,0,1143
E01030596,1106,9,14,5,3,1137
E01030597,1148,13,21,5,5,1192
E01030598,1214,15,53,13,6,1301
E01030599,1056,19,100,29,8,1212
E01030600,1138,18,33,21,12,1222
E01030601,1084,21,60,39,5,1209
E01030602,1341,24,55,18,5,1443
E01030603,1109,18,90,16,10,1243
E01030604,1188,9,47,16,2,1262
E01030605,1061,15,34,7,5,1122
E01030606,973,14,60,8,7,1062
E01030607,1332,22,61,15,10,1440
E01030608,990,9,55,18,4,1076
E01030609,983,17,73,30,7,1110
E01030610,898,13,75,11,8,1005
E01030611,1867,45,158,43,32,2145
E01030612,1678,38,259,79,30,2084
E01030613,1247,30,171,57,16,1521
E01030614,1219,16,44,15,4,1298
E01030615,816,39,283,55,26,1219
E01030616,1208,22,62,3,9,1304
E01030617,1178,26,109,39,11,1363
E01030618,1302,25,118,28,18,1491
E01030619,1018,14,104,22,13,1171
E01030620,1310,33,65,3,9,1420
E01030621,1118,13,37,16,10,1194
E01030622,1390,21,63,14,10,1498
E01030623,1646,19,51,7,3,1726
E01030624,997,12,20,5,2,1036
E01030625,1059,19,37,13,4,1132
E01030626,831,6,25,6,1,869
E01030627,1295,24,61,10,10,1400
E01030628,1141,9,29,11,4,1194
E01030629,920,10,38,12,1,981
E01030630,1219,7,35,6,0,1267
E01030631,1124,13,27,9,2,1175
E01030632,1039,5,20,6,1,1071
E01030633,1073,10,31,20,0,1134
E01030634,1049,12,30,17,1,1109
E01030635,1230,9,20,3,4,1266
E01030636,896,8,75,5,10,994
E01030637,967,12,19,3,6,1007
E01030638,1184,10,44,5,5,1248
E01030639,1250,9,30,6,3,1298
E01030640,1168,18,29,25,5,1245
E01030641,1221,6,58,6,3,1294
E01030642,1177,16,54,10,6,1263
E01030643,1016,20,33,15,2,1086
E01030644,1004,23,46,10,5,1088
E01030645,1408,18,75,25,12,1538
E01030646,1535,21,103,22,13,1694
E01030647,1266,15,52,12,5,1350
E01030648,1223,14,64,6,10,1317
E01030649,1214,19,118,19,9,1379
E01030650,894,14,73,12,1,994
E01030651,1001,12,49,10,3,1075
E01030652,1247,10,52,8,4,1321
E01030653,1015,23,78,15,6,1137
E01030654,1090,12,45,6,2,1155
E01030655,1178,18,100,16,9,1321
E01030656,1212,13,52,24,6,1307
E01030657,1095,14,52,26,5,1192
E01030658,1164,12,44,4,0,1224
E01030659,1253,27,61,8,5,1354
E01030660,1536,19,69,7,4,1635
E01030661,1379,10,22,4,4,1419
E01030662,1157,17,53,0,10,1237
E01030663,1139,14,78,7,8,1246
E01030664,1214,14,91,9,6,1334
E01030665,1068,15,102,6,10,1201
E01030666,1266,28,97,9,25,1425
E01030667,1075,26,122,11,26,1260
E01030668,1298,25,209,17,18,1567
E01030669,1186,28,120,26,19,1379
E01030670,1077,41,130,19,9,1276
E01030671,1906,99,636,60,50,2751
E01030672,1707,41,258,29,61,2096
E01030673,795,8,37,3,13,856
E01030674,1076,29,49,17,31,1202
E01030675,1012,18,97,17,10,1154
E01030676,972,39,97,26,30,1164
E01030677,1044,25,191,28,15,1303
E01030678,944,23,65,38,6,1076
E01030679,977,7,31,1,0,1016
E01030680,1186,8,48,9,3,1254
E01030681,1216,7,73,1,8,1305
E01030682,1015,7,48,7,1,1078
E01030683,1006,14,60,12,1,1093
E01030684,1140,12,34,13,6,1205
E01030685,1064,20,58,11,10,1163
E01030686,1081,12,80,8,19,1200
E01030687,928,15,55,5,2,1005
E01030688,1122,18,60,6,6,1212
E01030689,1053,11,81,5,14,1164
E01030690,1161,24,117,21,37,1360
E01030691,1072,20,95,20,32,1239
E01030692,934,5,69,9,29,1046
E01030693,954,13,26,4,7,1004
E01030694,1008,26,36,12,7,1089
E01030695,1021,13,33,3,2,1072
E01030696,1144,14,42,6,3,1209
E01030697,1175,13,70,23,10,1291
E01030698,1238,15,69,14,8,1344
E01030699,1117,8,93,13,1,1232
E01030700,1225,26,129,27,9,1416
E01030701,1151,19,63,14,8,1255
E01030702,778,20,67,18,3,886
E01030703,1128,13,112,19,7,1279
E01030704,1127,19,82,22,8,1258
E01030705,1239,19,57,11,7,1333
E01030706,1036,11,85,19,2,1153
E01030707,1064,25,189,25,35,1338
E01030708,1109,31,133,36,5,1314
E01030709,914,36,161,25,29,1165
E01030710,1014,13,196,42,31,1296
E01030711,1073,25,224,35,12,1369
E01030712,1000,14,108,17,11,1150
E01030713,935,9,48,7,12,1011
E01030714,1103,29,63,41,10,1246
E01030715,1142,20,73,20,4,1259
E01030716,1143,16,82,23,5,1269
E01030717,1230,28,45,16,8,1327
E01030718,1013,15,33,7,9,1077
E01030719,1179,17,63,12,11,1282
E01030720,1261,13,32,10,12,1328
E01030721,1199,13,39,8,10,1269
E01030722,1253,12,25,10,5,1305
E01030723,1243,19,35,10,3,1310
E01030724,1178,14,36,1,7,1236
E01030725,1189,36,130,38,8,1401
E01030726,1284,16,45,12,7,1364
E01030727,1374,30,117,22,11,1554
E01030728,1334,16,59,7,4,1420
E01030729,1148,22,57,15,9,1251
E01030730,1456,15,37,2,5,1515
E01030731,1455,14,29,5,12,1515
E01030732,1222,13,34,3,6,1278
E01030733,1298,20,44,9,10,1381
E01030734,1062,16,98,15,18,1209
E01030735,1155,22,100,11,19,1307
E01030736,1079,37,339,41,56,1552
E01030737,1056,27,119,8,12,1222
E01030738,1055,19,116,11,22,1223
E01030739,1181,28,53,28,10,1300
E01030740,1296,20,71,20,10,1417
E01030741,1268,25,85,21,6,1405
E01030742,1448,28,101,11,4,1592
E01030743,991,24,220,28,5,1268
E01030744,1099,31,141,42,11,1324
E01030745,999,21,156,29,24,1229
E01030746,1060,21,153,35,7,1276
E01030747,893,29,153,25,19,1119
E01030748,1188,28,112,31,23,1382
E01030749,1056,29,46,24,18,1173
E01030750,1111,29,84,17,15,1256
E01030751,1083,30,127,27,18,1285
E01030752,1028,27,179,39,23,1296
E01030753,1312,25,49,9,18,1413
E01030754,1141,22,88,9,9,1269
E01030755,1349,27,96,28,8,1508
E01030756,1268,18,80,12,9,1387
E01030757,1185,20,50,11,6,1272
E01030758,901,4,54,2,5,966
E01030759,1227,13,41,7,6,1294
E01030760,937,7,50,3,6,1003
E01030761,1558,60,47,90,2,1757
E01030762,1441,17,45,10,2,1515
E01030763,964,6,24,6,8,1008
E01030764,972,16,10,4,4,1006
E01030765,1088,11,24,6,0,1129
E01030766,1112,18,203,24,16,1373
E01030767,1098,14,101,15,9,1237
E01030768,957,10,118,16,4,1105
E01030769,1123,15,104,8,3,1253
E01030770,1160,12,40,7,1,1220
E01030771,959,26,35,9,5,1034
E01030772,1126,11,71,8,2,1218
E01030773,1083,13,30,12,6,1144
E01030774,1013,10,32,8,5,1068
E01030775,1096,10,46,9,7,1168
E01030776,1205,6,64,7,12,1294
E01030777,1137,13,75,14,11,1250
E01030778,1403,12,51,6,3,1475
E01030779,1393,5,55,6,6,1465
E01030780,1244,14,59,5,5,1327
E01030781,1198,13,25,5,1,1242
E01030782,1250,16,31,8,10,1315
E01030783,1259,15,42,3,2,1321
E01030784,1667,28,115,60,26,1896
E01030785,1190,7,22,2,5,1226
E01030786,1222,19,113,16,10,1380
E01030787,1020,10,79,15,5,1129
E01030788,902,25,98,4,3,1032
E01030789,1130,12,80,14,6,1242
E01030790,1234,19,70,15,6,1344
E01030791,1231,11,100,13,17,1372
E01030792,1009,10,55,7,7,1088
E01030793,888,27,209,39,17,1180
E01030794,1053,19,178,24,11,1285
E01030795,1589,32,110,20,19,1770
E01030796,1023,16,65,8,7,1119
E01030797,1061,14,94,6,5,1180
E01030798,1078,10,82,9,20,1199
E01030799,995,10,95,5,21,1126
E01030800,1178,10,129,24,18,1359
E01030801,1124,19,111,11,20,1285
E01030802,1238,20,106,14,5,1383
E01030803,1151,18,183,23,24,1399
E01030804,1376,18,110,9,2,1515
E01030805,1057,21,191,16,17,1302
E01030806,1152,13,20,6,7,1198
E01030807,1048,5,48,7,6,1114
E01030808,1178,14,27,5,8,1232
E01030809,1154,7,17,1,1,1180
E01030810,1042,19,43,4,3,1111
E01030811,1159,10,18,4,6,1197
E01030812,1191,13,17,6,1,1228
E01030813,1236,11,10,6,1,1264
E01030814,1008,11,14,1,3,1037
E01030815,1117,13,26,11,0,1167
E01030816,1241,8,13,10,4,1276
E01030817,1124,10,18,9,5,1166
E01030818,990,11,12,4,0,1017
E01030819,1210,7,39,12,2,1270
E01030820,1394,10,29,5,3,1441
E01030821,1797,24,37,20,2,1880
E01030822,1443,14,30,3,6,1496
E01030823,1668,15,43,4,9,1739
E01030824,1137,11,14,9,1,1172
E01030825,1103,12,16,6,3,1140
E01030826,1096,16,18,3,1,1134
E01030827,1265,11,11,3,4,1294
E01030828,987,17,81,13,7,1105
E01030829,1136,25,35,17,13,1226
E01030830,958,18,38,20,4,1038
E01030831,1789,7,34,2,5,1837
E01030832,1060,8,10,2,0,1080
E01030833,1072,15,10,8,3,1108
E01030834,1084,6,31,2,0,1123
E01030835,1134,9,7,0,3,1153
E01030836,1201,11,49,13,6,1280
E01030837,1155,8,29,1,6,1199
E01030838,1001,8,8,2,4,1023
E01030839,1100,14,12,7,3,1136
E01030840,1131,12,7,16,2,1168
E01030841,1001,4,4,4,2,1015
E01030842,1362,15,22,5,4,1408
E01030843,1145,8,13,4,7,1177
E01030844,1267,28,56,32,7,1390
E01030845,871,21,47,27,13,979
E01030846,1156,27,42,22,2,1249
E01030847,1269,22,63,27,14,1395
E01030848,1568,28,53,15,3,1667
E01030850,1543,38,82,55,14,1732
E01030851,1491,24,48,36,8,1607
E01030852,1540,25,40,12,4,1621
E01030853,1329,16,28,12,0,1385
E01030854,1513,29,35,14,2,1593
E01030855,1477,23,74,14,9,1597
E01030856,1161,13,23,14,6,1217
E01030857,1505,25,88,47,10,1675
E01030858,1507,39,93,32,11,1682
E01030859,1357,54,84,49,15,1559
E01030860,1439,35,81,38,13,1606
E01030861,1505,27,95,22,6,1655
E01030862,1574,9,8,0,0,1591
E01030863,1471,5,17,6,1,1500
E01030864,1174,9,18,13,3,1217
E01030865,1151,8,33,16,5,1213
E01030866,1190,9,17,5,4,1225
E01030867,1120,8,11,2,1,1142
E01030868,1001,5,13,2,1,1022
E01030869,967,8,11,0,3,989
E01030870,1304,8,17,1,1,1331
E01030871,1282,6,18,8,0,1314
E01030872,1386,14,21,10,11,1442
E01030873,1140,7,11,1,2,1161
E01030874,1222,15,23,6,3,1269
E01030875,1056,9,21,3,6,1095
E01030876,1026,6,21,3,2,1058
E01030877,968,2,14,1,2,987
E01030878,1226,13,15,12,4,1270
E01030879,875,3,11,1,0,890
E01030880,1746,19,60,19,2,1846
E01030881,1049,10,28,2,2,1091
E01030882,1011,6,16,3,4,1040
E01030883,1052,9,14,0,2,1077
E01030884,1197,14,17,6,6,1240
E01030885,1318,19,38,7,5,1387
E01030886,984,7,13,3,3,1010
E01030887,1014,12,17,6,9,1058
E01030888,1088,11,47,5,3,1154
E01030889,1139,8,37,6,3,1193
E01030890,1171,12,15,3,6,1207
E01030891,1250,10,10,2,5,1277
E01030892,981,7,33,6,4,1031
E01030893,1447,14,34,10,5,1510
E01030894,1219,8,19,3,26,1275
E01030895,1215,18,37,14,2,1286
E01030896,867,12,33,11,12,935
E01030897,1025,7,8,2,1,1043
E01030898,1228,8,15,1,1,1253
E01030899,1275,9,15,4,17,1320
E01030900,978,9,10,1,3,1001
E01030901,988,11,32,10,3,1044
E01030902,1034,8,20,2,1,1065
E01030903,1233,14,22,3,2,1274
E01030904,1149,8,18,5,1,1181
E01030905,1184,13,25,5,6,1233
E01030906,1276,13,23,6,11,1329
E01030907,970,10,18,2,2,1002
E01030908,1216,24,105,8,2,1355
E01030909,966,4,12,0,1,983
E01030910,942,8,21,3,2,976
E01030911,1214,17,21,3,0,1255
E01030912,1081,6,10,1,2,1100
E01030913,931,10,11,7,8,967
E01030914,1031,18,23,2,3,1077
E01030915,1219,15,22,7,4,1267
E01030916,1357,13,46,6,8,1430
E01030917,857,12,20,6,13,908
E01030918,904,12,29,7,4,956
E01030919,1280,29,86,6,7,1408
E01030920,1196,22,29,9,3,1259
E01030921,1327,15,17,11,4,1374
E01030922,1138,7,15,3,2,1165
E01030923,1092,10,15,8,0,1125
E01030924,968,8,9,1,4,990
E01030925,1189,21,23,6,3,1242
E01030926,1168,9,36,9,9,1231
E01030927,995,14,13,6,6,1034
E01030928,1377,10,25,16,11,1439
E01030929,1064,18,54,2,4,1142
E01030930,1229,15,16,2,6,1268
E01030931,1323,18,22,4,4,1371
E01030932,1139,12,6,3,5,1165
E01030933,1367,6,21,4,8,1406
E01030934,1238,15,19,3,1,1276
E01030935,1006,13,22,2,2,1045
E01030937,1238,16,10,3,2,1269
E01030938,1058,13,19,3,1,1094
E01030939,908,10,12,2,0,932
E01030940,1367,6,8,9,2,1392
E01030941,1113,16,50,16,4,1199
E01030942,1077,14,15,3,3,1112
E01030943,964,6,7,5,0,982
E01030944,958,20,75,7,9,1069
E01030945,882,7,18,3,5,915
E01030946,975,18,55,9,7,1064
E01030947,1066,4,46,7,18,1141
E01030948,1173,14,48,6,10,1251
E01030949,1287,15,52,8,10,1372
E01030950,1197,25,56,11,22,1311
E01030951,930,15,106,12,13,1076
E01030952,724,18,280,21,29,1072
E01030953,1106,17,96,12,9,1240
E01030954,1430,46,276,52,53,1857
E01030955,965,22,145,14,11,1157
E01030956,990,17,53,5,9,1074
E01030957,863,13,80,12,6,974
E01030958,1093,15,80,12,4,1204
E01030959,775,15,56,14,1,861
E01030960,1272,20,81,9,15,1397
E01030961,1454,14,64,15,5,1552
E01030962,1300,21,58,21,4,1404
E01030963,1203,13,33,10,5,1264
E01030964,1304,29,112,17,17,1479
E01030965,1108,11,60,7,10,1196
E01030966,1020,22,47,9,3,1101
E01030967,1245,17,30,7,6,1305
E01030968,888,16,87,31,10,1032
E01030969,1024,15,75,6,8,1128
E01030970,1047,21,71,14,16,1169
E01030971,1368,16,86,26,5,1501
E01030972,1382,22,115,9,4,1532
E01030973,1305,15,56,11,6,1393
E01030974,1100,25,95,15,11,1246
E01030975,1057,12,45,12,11,1137
E01030976,1138,6,67,7,17,1235
E01030977,1287,27,78,19,15,1426
E01030978,963,19,115,24,16,1137
E01030979,1376,28,136,30,11,1581
E01030980,462,22,784,50,28,1346
E01030981,474,16,716,14,23,1243
E01030982,762,18,595,54,8,1437
E01030983,664,31,660,40,45,1440
E01030984,1075,17,372,18,18,1500
E01030985,791,18,333,25,22,1189
E01030986,845,11,33,5,3,897
E01030987,1081,6,31,4,1,1123
E01030988,1345,21,272,36,19,1693
E01030989,1160,12,172,18,12,1374
E01030990,1075,17,61,14,4,1171
E01030991,1434,23,141,60,16,1674
E01030992,1227,25,92,17,14,1375
E01030993,1495,39,398,71,65,2068
E01030994,1263,29,46,19,6,1363
E01030995,927,17,93,17,5,1059
E01030996,1193,8,65,4,14,1284
E01030997,1218,10,17,6,5,1256
E01030998,1436,15,52,5,16,1524
E01030999,1063,16,51,5,11,1146
E01031000,1172,18,51,14,12,1267
E01031001,1276,17,66,40,18,1417
E01031002,1326,22,55,6,7,1416
E01031003,1274,24,48,10,9,1365
E01031004,1492,29,128,33,23,1705
E01031005,1119,3,9,3,1,1135
E01031006,1141,11,10,7,0,1169
E01031007,991,5,7,1,0,1004
E01031008,1057,3,8,4,1,1073
E01031009,1781,8,28,2,2,1821
E01031010,1357,9,20,2,0,1388
E01031011,1586,7,17,5,1,1616
E01031012,1188,2,1,1,1,1193
E01031013,900,6,11,1,0,918
E01031014,1002,3,13,1,2,1021
E01031015,1080,8,2,2,3,1095
E01031016,1290,4,3,2,0,1299
E01031017,1041,6,15,2,0,1064
E01031018,945,1,4,1,1,952
E01031019,1333,12,13,11,1,1370
E01031020,1265,9,10,6,1,1291
E01031021,1342,12,16,8,0,1378
E01031022,1410,8,10,7,2,1437
E01031023,1289,6,27,16,4,1342
E01031024,1368,7,21,3,1,1400
E01031025,1305,5,24,12,2,1348
E01031026,1230,9,11,1,1,1252
E01031027,1226,3,22,6,0,1257
E01031028,1517,9,17,3,0,1546
E01031029,1175,5,24,3,1,1208
E01031030,1816,6,20,1,0,1843
E01031031,1985,9,9,3,2,2008
E01031032,1045,7,16,1,0,1069
E01031033,1536,4,15,1,0,1556
E01031034,1538,9,5,8,7,1567
E01031035,1605,6,14,2,0,1627
E01031036,1244,3,2,1,1,1251
E01031037,1217,4,4,3,0,1228
E01031038,1545,9,9,4,5,1572
E01031039,1370,7,4,4,0,1385
E01031040,1439,6,6,7,0,1458
E01031041,1424,17,8,5,0,1454
E01031042,1437,7,7,3,0,1454
E01031043,1226,11,157,12,7,1413
E01031044,1234,5,77,11,6,1333
E01031045,1292,4,122,8,1,1427
E01031046,779,18,554,18,11,1380
E01031047,1035,18,412,34,11,1510
E01031048,973,5,43,10,1,1032
E01031049,1644,15,126,19,7,1811
E01031050,1361,8,80,29,0,1478
E01031051,1092,1,56,3,0,1152
E01031052,1011,12,116,14,6,1159
E01031053,1196,7,36,14,3,1256
E01031054,1210,11,48,2,3,1274
E01031055,1137,4,90,8,5,1244
E01031056,1154,9,32,1,1,1197
E01031057,1075,17,40,23,4,1159
E01031058,1143,8,13,8,5,1177
E01031059,1110,10,58,8,1,1187
E01031060,1110,14,50,14,8,1196
E01031061,1135,11,39,9,1,1195
E01031062,999,7,16,1,0,1023
E01031063,1071,6,16,5,0,1098
E01031064,1008,7,8,21,0,1044
E01031065,1216,14,11,2,0,1243
E01031066,1060,10,7,2,0,1079
E01031067,1250,9,26,2,3,1290
E01031068,1426,1,10,2,0,1439
E01031069,1218,1,47,0,3,1269
E01031070,1302,3,15,5,0,1325
E01031073,1468,8,34,15,1,1526
E01031074,1212,10,11,17,0,1250
E01031075,1241,8,24,7,1,1281
E01031077,1041,15,44,11,10,1121
E01031078,1506,23,135,10,18,1692
E01031079,1136,4,88,15,8,1251
E01031080,1207,5,83,8,10,1313
E01031081,1206,14,31,8,3,1262
E01031082,1057,6,12,8,5,1088
E01031083,1215,4,8,4,3,1234
E01031084,1682,7,17,11,1,1718
E01031085,1098,5,21,6,0,1130
E01031086,1433,16,43,10,6,1508
E01031087,1530,16,97,19,23,1685
E01031088,1377,8,106,25,9,1525
E01031089,1201,4,45,3,6,1259
E01031090,1054,12,14,8,2,1090
E01031091,1122,8,23,6,2,1161
E01031092,1105,9,8,4,0,1126
E01031093,1087,7,14,3,2,1113
E01031094,877,3,9,12,2,903
E01031095,912,6,15,12,2,947
E01031096,988,12,97,19,13,1129
E01031097,1287,6,24,2,4,1323
E01031098,740,12,366,19,33,1170
E01031099,1365,25,352,52,40,1834
E01031100,1019,6,85,5,4,1119
E01031101,1054,0,87,12,8,1161
E01031102,1033,9,57,13,5,1117
E01031103,1025,4,61,6,5,1101
E01031104,1231,5,42,2,1,1281
E01031105,1139,11,12,5,1,1168
E01031106,1153,3,49,1,5,1211
E01031107,887,2,33,3,1,926
E01031108,1016,8,79,5,6,1114
E01031109,1251,4,35,6,0,1296
E01031110,1217,7,57,3,3,1287
E01031111,885,2,57,1,0,945
E01031112,1280,7,15,4,1,1307
E01031113,1190,4,25,2,1,1222
E01031114,1245,6,29,7,4,1291
E01031115,957,12,395,17,20,1401
E01031116,1224,6,38,4,0,1272
E01031117,1084,6,49,0,3,1142
E01031118,894,10,17,11,2,934
E01031119,852,8,396,20,20,1296
E01031120,1136,2,29,0,3,1170
E01031121,970,4,41,1,0,1016
E01031122,1220,7,45,5,1,1278
E01031123,1035,6,35,3,2,1081
E01031124,1218,10,70,4,9,1311
E01031125,1175,7,34,9,1,1226
E01031127,1093,14,30,13,2,1152
E01031129,944,2,16,3,4,969
E01031130,1147,21,156,83,5,1412
E01031131,890,41,243,118,5,1297
E01031132,1356,34,134,83,6,1613
E01031133,1105,23,80,45,7,1260
E01031134,1411,8,26,7,2,1454
E01031135,1329,7,62,6,2,1406
E01031136,1389,12,35,11,1,1448
E01031137,903,8,45,20,2,978
E01031138,864,3,65,12,6,950
E01031139,1332,17,103,17,0,1469
E01031140,981,12,98,14,3,1108
E01031141,1170,32,106,69,3,1380
E01031142,997,52,57,83,7,1196
E01031143,1213,4,70,11,5,1303
E01031144,958,13,40,39,6,1056
E01031145,1045,28,58,26,2,1159
E01031146,1140,23,70,20,2,1255
E01031147,1286,7,21,5,4,1323
E01031148,1351,11,28,7,0,1397
E01031149,1234,7,5,6,2,1254
E01031150,957,6,9,5,1,978
E01031151,1211,7,79,9,3,1309
E01031152,904,10,37,8,3,962
E01031153,1110,9,18,7,1,1145
E01031154,1413,10,31,8,1,1463
E01031155,1051,10,55,7,1,1124
E01031156,1135,17,36,16,4,1208
E01031157,1338,13,156,28,4,1539
E01031158,877,5,19,7,0,908
E01031159,1306,6,40,9,3,1364
E01031160,1765,7,18,9,0,1799
E01031161,1638,11,37,7,0,1693
E01031162,1357,20,34,13,3,1427
E01031163,1238,13,29,8,5,1293
E01031164,1568,13,22,13,3,1619
E01031165,1221,8,14,6,0,1249
E01031166,1532,4,14,6,0,1556
E01031167,1037,19,35,24,2,1117
E01031168,1889,43,80,65,14,2091
E01031169,1273,36,236,64,12,1621
E01031170,1115,19,112,53,8,1307
E01031171,1089,21,39,34,2,1185
E01031172,1189,21,30,30,4,1274
E01031173,1387,32,72,63,13,1567
E01031174,955,38,275,126,4,1398
E01031175,1195,2,48,6,6,1257
E01031176,1046,22,49,17,5,1139
E01031177,993,16,53,20,6,1088
E01031178,1130,10,37,11,3,1191
E01031179,1295,12,61,8,3,1379
E01031180,1529,21,40,20,1,1611
E01031181,1385,8,61,8,9,1471
E01031182,1667,15,256,24,16,1978
E01031183,1393,9,19,3,1,1425
E01031184,1224,6,8,4,3,1245
E01031185,1117,4,6,2,1,1130
E01031186,1260,6,8,1,1,1276
E01031187,1535,8,14,4,5,1566
E01031188,1857,10,11,1,1,1880
E01031189,1271,6,14,4,1,1296
E01031190,1371,2,5,1,3,1382
E01031191,1480,14,6,2,2,1504
E01031192,1536,13,9,2,1,1561
E01031193,1793,6,2,3,0,1804
E01031194,1902,19,32,9,3,1965
E01031195,1830,11,6,4,3,1854
E01031196,1882,10,17,6,0,1915
E01031197,1004,2,5,2,1,1014
E01031198,991,5,3,2,0,1001
E01031199,1208,8,8,0,1,1225
E01031200,1263,5,17,4,0,1289
E01031201,1298,7,2,2,1,1310
E01031202,1327,3,7,3,1,1341
E01031203,1250,9,11,0,2,1272
E01031204,1123,6,1,0,4,1134
E01031205,1289,2,19,4,0,1314
E01031206,1176,10,6,2,2,1196
E01031207,1020,5,6,1,2,1034
E01031208,1745,8,18,0,1,1772
E01031209,1784,10,12,0,1,1807
E01031210,1023,2,6,1,1,1033
E01031211,851,8,10,1,1,871
E01031212,2062,16,25,11,2,2116
E01031213,1509,8,27,6,2,1552
E01031214,1461,11,5,0,0,1477
E01031215,1469,9,11,4,1,1494
E01031216,1252,1,12,2,1,1268
E01031217,993,4,6,2,1,1006
E01031218,946,8,9,3,3,969
E01031219,1125,1,18,2,4,1150
E01031220,1205,9,12,1,2,1229
E01031221,1228,6,11,6,0,1251
E01031222,1653,4,19,1,3,1680
E01031223,1045,8,6,1,2,1062
E01031224,905,6,8,0,0,919
E01031225,1354,7,23,4,2,1390
E01031227,1653,9,28,7,4,1701
E01031228,1346,5,23,4,1,1379
E01031229,1580,17,63,8,4,1672
E01031230,1846,14,34,5,8,1907
E01031231,1699,19,45,13,6,1782
E01031232,1794,16,189,9,14,2022
E01031233,1352,13,10,4,1,1380
E01031234,1506,15,38,2,3,1564
E01031235,1553,10,39,1,1,1604
E01031236,1295,11,18,5,7,1336
E01031237,1196,9,17,4,2,1228
E01031238,1092,14,16,6,5,1133
E01031239,1272,9,12,5,2,1300
E01031240,1111,9,1,3,2,1126
E01031241,1142,8,7,5,1,1163
E01031242,1217,12,14,3,4,1250
E01031243,1601,3,38,6,6,1654
E01031244,1526,12,23,1,1,1563
E01031245,1029,5,4,1,0,1039
E01031246,895,1,9,0,1,906
E01031247,1905,9,13,2,1,1930
E01031248,1780,11,4,5,0,1800
E01031249,958,5,10,2,1,976
E01031250,1259,6,5,0,2,1272
E01031251,1002,3,10,2,2,1019
E01031252,1151,10,9,5,1,1176
E01031253,1217,3,2,1,1,1224
E01031254,1211,10,28,3,6,1258
E01031255,1170,4,16,1,2,1193
E01031256,1359,9,37,6,4,1415
E01031257,1140,8,47,7,1,1203
E01031258,1211,17,51,4,3,1286
E01031259,908,12,146,7,1,1074
E01031260,947,3,18,2,1,971
E01031261,1048,31,179,16,22,1296
E01031262,989,28,145,17,11,1190
E01031263,1289,53,235,29,23,1629
E01031264,1130,19,139,9,7,1304
E01031265,904,26,178,20,17,1145
E01031266,1481,52,218,25,14,1790
E01031267,1471,1,22,3,2,1499
E01031268,1982,22,51,11,0,2066
E01031269,1355,8,10,3,7,1383
E01031271,1393,34,73,17,16,1533
E01031272,1365,34,111,23,18,1551
E01031273,976,19,35,26,7,1063
E01031274,1067,12,69,15,12,1175
E01031275,943,16,68,17,10,1054
E01031276,1119,17,60,10,10,1216
E01031277,1210,11,37,3,8,1269
E01031278,1081,11,81,1,5,1179
E01031279,1148,8,15,3,3,1177
E01031280,1046,9,34,1,2,1092
E01031281,1200,3,20,5,1,1229
E01031282,1206,3,20,1,1,1231
E01031283,1033,10,15,1,5,1064
E01031284,988,5,25,3,0,1021
E01031285,1726,19,80,21,16,1862
E01031286,1123,14,53,2,8,1200
E01031287,1124,10,81,6,5,1226
E01031288,1296,12,100,9,16,1433
E01031289,1114,17,44,6,14,1195
E01031290,1347,19,70,8,8,1452
E01031291,1249,43,130,18,13,1453
E01031292,1085,14,96,9,14,1218
E01031293,1190,31,121,17,11,1370
E01031294,1201,21,74,13,6,1315
E01031295,897,5,84,5,17,1008
E01031296,1266,8,37,1,4,1316
E01031297,1462,13,61,5,5,1546
E01031298,1362,6,25,2,3,1398
E01031299,1130,3,22,5,0,1160
E01031300,1338,10,21,4,2,1375
E01031301,1150,4,27,2,3,1186
E01031302,796,12,33,0,6,847
E01031303,1190,14,28,6,6,1244
E01031304,1164,5,16,1,3,1189
E01031305,1277,2,16,1,2,1298
E01031306,1147,11,18,4,10,1190
E01031307,1195,9,28,5,2,1239
E01031308,2293,61,699,80,57,3190
E01031309,1244,22,82,10,8,1366
E01031310,1017,10,71,7,9,1114
E01031311,1033,10,41,6,4,1094
E01031312,878,15,48,7,9,957
E01031313,1094,9,61,6,3,1173
E01031314,1029,4,73,14,12,1132
E01031315,1282,29,262,16,53,1642
E01031316,1158,12,49,8,15,1242
E01031317,1214,9,56,6,4,1289
E01031318,1046,19,307,4,28,1404
E01031319,1455,21,110,14,10,1610
E01031320,1036,19,103,6,29,1193
E01031321,924,10,30,5,8,977
E01031322,1453,18,64,14,0,1549
E01031323,1267,16,82,12,3,1380
E01031324,1729,23,55,16,8,1831
E01031325,1052,11,46,3,2,1114
E01031327,1007,13,155,11,22,1208
E01031328,1546,9,219,12,32,1818
E01031329,1621,38,262,10,29,1960
E01031330,1018,3,143,9,21,1194
E01031331,1299,7,134,5,21,1466
E01031332,762,18,254,25,28,1087
E01031333,682,20,334,15,39,1090
E01031334,1072,21,118,9,7,1227
E01031335,1105,19,127,15,22,1288
E01031336,1725,66,160,28,17,1996
E01031337,1184,27,66,10,2,1289
E01031338,938,10,26,2,1,977
E01031339,944,6,7,1,3,961
E01031340,1233,7,14,2,1,1257
E01031341,1053,4,20,6,7,1090
E01031342,1413,17,10,8,8,1456
E01031343,1143,2,12,2,4,1163
E01031344,1082,15,13,6,4,1120
E01031345,1224,13,15,3,1,1256
E01031346,1152,9,10,10,2,1183
E01031347,1220,19,31,8,10,1288
E01031348,1157,20,27,18,11,1233
E01031349,1092,4,14,3,11,1124
E01031350,917,10,36,8,4,975
E01031351,1234,18,18,8,9,1287
E01031352,1152,14,36,2,4,1208
E01031353,1027,10,52,9,1,1099
E01031354,1016,5,6,1,8,1036
E01031355,1282,10,15,5,2,1314
E01031356,1832,27,22,12,1,1894
E01031357,1753,18,25,3,17,1816
E01031358,1170,10,20,20,4,1224
E01031359,1066,6,10,4,0,1086
E01031360,1234,2,14,5,2,1257
E01031361,1148,13,14,14,1,1190
E01031362,1014,7,15,7,1,1044
E01031363,1339,5,12,7,5,1368
E01031364,1206,18,17,9,4,1254
E01031365,1193,22,41,3,5,1264
E01031366,1057,17,38,5,4,1121
E01031367,1048,21,10,4,3,1086
E01031368,1022,8,14,2,4,1050
E01031369,1058,23,10,2,4,1097
E01031370,1092,15,20,0,10,1137
E01031371,955,25,17,0,7,1004
E01031372,962,10,35,7,3,1017
E01031373,1123,13,20,14,9,1179
E01031374,1206,8,19,4,8,1245
E01031375,1202,10,14,8,6,1240
E01031376,1114,6,4,0,1,1125
E01031377,1241,11,53,6,1,1312
E01031378,1144,7,14,5,5,1175
E01031379,1346,6,2,11,2,1367
E01031380,1386,9,2,1,2,1400
E01031381,1379,10,20,2,4,1415
E01031382,1489,3,7,1,1,1501
E01031383,1403,6,15,2,0,1426
E01031384,1465,15,13,1,1,1495
E01031385,1300,8,4,3,1,1316
E01031386,1171,5,7,1,0,1184
E01031387,1219,15,14,2,2,1252
E01031388,1997,26,32,6,2,2063
E01031389,1746,9,10,4,4,1773
E01031390,1114,3,7,3,0,1127
E01031391,1220,7,9,5,0,1241
E01031392,1301,2,10,2,0,1315
E01031393,1493,12,14,3,0,1522
E01031394,1285,15,24,7,1,1332
E01031395,1219,11,13,4,2,1249
E01031396,1513,7,21,5,2,1548
E01031397,1458,13,13,1,4,1489
E01031398,1230,8,9,5,2,1254
E01031399,1428,5,13,1,1,1448
E01031400,1350,16,34,8,8,1416
E01031401,1244,14,23,6,0,1287
E01031402,1322,13,26,4,5,1370
E01031403,1125,6,19,6,4,1160
E01031404,892,4,6,1,1,904
E01031405,1115,7,21,5,1,1149
E01031406,1020,5,7,4,2,1038
E01031407,1187,11,8,2,3,1211
E01031408,1486,13,19,4,0,1522
E01031409,1051,6,14,1,2,1074
E01031410,1048,2,16,2,0,1068
E01031411,1244,7,9,2,1,1263
E01031412,1193,7,12,2,0,1214
E01031413,1173,8,11,2,2,1196
E01031414,1206,8,6,3,4,1227
E01031415,1335,5,6,5,2,1353
E01031416,1342,8,13,2,3,1368
E01031417,1265,2,4,2,2,1275
E01031418,1420,10,19,2,1,1452
E01031419,1373,10,10,2,1,1396
E01031420,1386,6,10,0,0,1402
E01031421,1390,3,6,11,0,1410
E01031422,1373,5,8,1,1,1388
E01031423,1408,7,8,2,0,1425
E01031424,1219,5,8,0,1,1233
E01031425,1150,4,7,1,2,1164
E01031426,1008,6,10,3,5,1032
E01031427,1053,8,13,5,0,1079
E01031428,1191,9,38,5,7,1250
E01031429,986,20,18,12,4,1040
E01031430,1111,16,14,4,2,1147
E01031431,1470,16,41,16,7,1550
E01031432,1559,27,73,21,6,1686
E01031433,1183,7,6,1,3,1200
E01031434,1339,15,8,8,3,1373
E01031435,1440,12,29,11,2,1494
E01031436,1493,28,47,10,3,1581
E01031437,1682,15,48,15,9,1769
E01031438,1297,7,2,3,0,1309
E01031439,1672,6,9,5,0,1692
E01031440,1380,4,6,2,0,1392
E01031441,1322,5,13,5,3,1348
E01031442,1203,19,36,5,3,1266
E01031443,1018,8,14,6,1,1047
E01031444,1220,11,42,7,4,1284
E01031445,1357,5,18,4,0,1384
E01031446,1130,5,6,2,0,1143
E01031447,1323,8,8,3,0,1342
E01031448,1348,9,9,3,0,1369
E01031449,1256,5,26,4,0,1291
E01031450,936,7,19,5,1,968
E01031451,1137,8,18,5,1,1169
E01031452,1162,10,26,6,1,1205
E01031453,1410,14,27,10,1,1462
E01031454,1672,29,95,11,11,1818
E01031455,1165,11,24,1,3,1204
E01031456,1392,25,100,20,12,1549
E01031457,1423,5,7,2,0,1437
E01031458,1634,6,3,4,1,1648
E01031459,1442,13,19,6,2,1482
E01031460,1551,5,21,1,2,1580
E01031461,1528,6,6,1,1,1542
E01031462,1146,7,9,2,3,1167
E01031463,1299,6,12,3,4,1324
E01031464,1314,11,18,4,1,1348
E01031465,1138,8,19,1,0,1166
E01031466,1177,7,6,4,1,1195
E01031467,1373,3,12,8,2,1398
E01031468,1767,22,22,3,3,1817
E01031469,1395,7,7,3,2,1414
E01031470,1425,24,38,76,13,1576
E01031471,1033,3,8,1,2,1047
E01031472,1255,8,13,0,2,1278
E01031473,933,9,45,0,0,987
E01031474,1154,5,14,1,1,1175
E01031475,1107,4,17,3,1,1132
E01031476,1239,4,5,10,2,1260
E01031477,1834,5,16,6,7,1868
E01031478,909,2,12,1,0,924
E01031479,888,8,2,2,3,903
E01031480,1008,17,60,10,1,1096
E01031481,1214,28,29,10,9,1290
E01031482,1184,22,43,8,0,1257
E01031483,1768,32,88,21,6,1915
E01031484,1455,16,81,5,8,1565
E01031485,1253,13,13,4,11,1294
E01031486,1581,23,47,14,14,1679
E01031487,1268,9,29,4,8,1318
E01031488,1422,36,65,39,12,1574
E01031489,1259,5,19,2,3,1288
E01031490,1587,18,114,11,13,1743
E01031491,1493,19,45,8,6,1571
E01031492,1139,8,36,3,5,1191
E01031493,1418,5,31,1,0,1455
E01031494,1278,12,19,16,1,1326
E01031495,1348,5,17,3,2,1375
E01031496,1783,12,35,5,4,1839
E01031497,1097,3,9,2,1,1112
E01031498,902,8,8,1,1,920
E01031499,1461,10,21,3,2,1497
E01031500,1614,10,10,2,3,1639
E01031501,1198,3,12,4,0,1217
E01031502,1149,12,14,4,2,1181
E01031503,1216,15,15,7,2,1255
E01031504,1644,11,22,2,2,1681
E01031505,1924,4,11,5,1,1945
E01031506,1027,7,4,0,1,1039
E01031507,1160,1,3,0,4,1168
E01031508,1661,10,10,9,5,1695
E01031509,1931,11,15,7,8,1972
E01031511,1265,6,5,0,2,1278
E01031512,1539,9,21,2,3,1574
E01031513,1757,7,13,5,4,1786
E01031514,1427,4,7,3,0,1441
E01031515,1258,11,9,1,0,1279
E01031516,1211,5,8,0,0,1224
E01031517,1438,4,14,3,0,1459
E01031518,1227,8,8,3,0,1246
E01031519,1094,7,8,6,2,1117
E01031520,1093,5,6,1,1,1106
E01031521,898,5,9,2,4,918
E01031522,1601,8,3,3,2,1617
E01031523,1297,8,16,6,3,1330
E01031524,1315,4,9,4,1,1333
E01031525,1167,3,4,2,1,1177
E01031526,1158,9,9,1,0,1177
E01031527,1314,3,5,3,1,1326
E01031528,1217,10,17,1,0,1245
E01031529,976,5,4,4,0,989
E01031530,995,2,15,6,3,1021
E01031531,1080,5,5,0,1,1091
E01031532,1146,14,26,70,11,1267
E01031533,953,5,6,3,2,969
E01031534,1440,13,8,11,4,1476
E01031535,1318,5,18,7,2,1350
E01031536,932,0,8,3,2,945
E01031538,1200,4,13,1,2,1220
E01031539,824,6,20,7,1,858
E01031540,1199,4,5,1,2,1211
E01031541,1181,4,6,5,0,1196
E01031542,1495,4,9,3,1,1512
E01031543,1818,13,14,1,2,1848
E01031544,1004,8,8,8,1,1029
E01031545,986,3,18,1,0,1008
E01031546,805,24,184,89,6,1108
E01031547,848,17,117,39,14,1035
E01031548,906,28,171,104,22,1231
E01031549,837,26,175,59,11,1108
E01031550,890,23,130,59,18,1120
E01031551,865,32,193,67,12,1169
E01031552,1073,39,235,121,21,1489
E01031553,840,31,186,43,15,1115
E01031554,1070,33,154,70,12,1339
E01031555,722,18,327,67,16,1150
E01031556,1045,35,89,33,16,1218
E01031557,1268,21,95,37,15,1436
E01031558,935,57,91,83,16,1182
E01031559,854,29,140,73,8,1104
E01031560,1118,14,100,8,4,1244
E01031561,1120,11,83,5,2,1221
E01031562,881,11,150,21,2,1065
E01031563,985,15,98,9,10,1117
E01031564,1121,21,58,18,11,1229
E01031565,1462,32,129,53,12,1688
E01031566,1134,23,143,29,9,1338
E01031567,1055,19,38,19,9,1140
E01031568,1017,19,45,21,4,1106
E01031569,1114,28,32,31,6,1211
E01031570,1018,13,71,23,9,1134
E01031571,1146,26,79,37,8,1296
E01031572,1098,27,107,21,2,1255
E01031573,880,17,321,40,10,1268
E01031574,1014,41,300,40,29,1424
E01031575,957,39,308,131,9,1444
E01031576,727,20,420,39,19,1225
E01031577,463,26,550,31,14,1084
E01031578,1251,25,88,17,8,1389
E01031579,1064,26,128,20,12,1250
E01031580,1479,21,132,38,15,1685
E01031581,1130,12,108,18,12,1280
E01031582,1243,27,64,42,6,1382
E01031583,1308,51,209,54,26,1648
E01031584,1033,13,251,43,9,1349
E01031585,1054,15,284,38,14,1405
E01031586,1179,18,109,30,11,1347
E01031587,1241,12,136,16,7,1412
E01031588,1057,30,118,11,9,1225
E01031589,1164,21,212,27,11,1435
E01031590,1165,18,102,11,18,1314
E01031591,1176,28,179,45,18,1446
E01031592,1481,11,105,12,13,1622
E01031593,1021,22,109,9,6,1167
E01031594,966,22,91,13,9,1101
E01031595,1064,28,190,34,9,1325
E01031596,1181,29,170,66,12,1458
E01031597,1002,33,196,28,4,1263
E01031598,1222,33,114,55,18,1442
E01031599,1182,23,171,53,17,1446
E01031600,970,18,142,6,10,1146
E01031601,803,13,151,26,15,1008
E01031603,944,23,219,13,13,1212
E01031604,1164,14,74,19,6,1277
E01031605,1058,26,83,41,6,1214
E01031606,1087,17,51,14,6,1175
E01031607,950,15,104,28,11,1108
E01031608,1158,43,190,44,16,1451
E01031609,1081,24,117,23,7,1252
E01031610,1161,16,230,38,11,1456
E01031611,1313,14,14,2,2,1345
E01031612,1608,11,22,9,2,1652
E01031613,1563,9,27,7,0,1606
E01031614,1525,11,26,5,3,1570
E01031615,1259,12,19,5,1,1296
E01031616,1269,8,11,1,1,1290
E01031617,1952,8,22,4,1,1987
E01031618,1103,3,8,8,2,1124
E01031619,1181,18,19,4,1,1223
E01031620,1234,7,21,6,1,1269
E01031621,1511,4,16,0,2,1533
E01031622,1290,8,5,1,1,1305
E01031623,1479,8,6,1,1,1495
E01031624,1193,7,15,2,2,1219
E01031625,1129,15,3,1,1,1149
E01031626,1202,12,11,2,1,1228
E01031627,1634,5,7,0,0,1646
E01031628,1074,6,9,4,1,1094
E01031629,1217,8,5,1,4,1235
E01031630,1420,8,15,3,0,1446
E01031631,1284,4,17,2,0,1307
E01031632,1222,9,15,1,1,1248
E01031633,1047,2,4,5,0,1058
E01031634,1038,5,11,0,1,1055
E01031635,1119,12,8,1,1,1141
E01031636,1651,27,165,33,10,1886
E01031637,1485,8,29,10,0,1532
E01031638,1413,14,30,3,2,1462
E01031639,1517,9,33,4,3,1566
E01031640,1478,14,12,1,1,1506
E01031641,1372,12,25,2,2,1413
E01031642,1490,9,15,1,6,1521
E01031643,1306,7,19,2,2,1336
E01031644,1091,8,28,3,1,1131
E01031645,1062,18,29,6,1,1116
E01031646,1125,10,38,8,1,1182
E01031647,895,14,34,5,4,952
E01031648,1346,22,22,5,4,1399
E01031649,862,11,36,3,5,917
E01031650,1003,5,18,3,3,1032
E01031651,1259,21,16,7,8,1311
E01031652,1244,21,70,6,1,1342
E01031653,1380,23,55,9,3,1470
E01031654,1253,12,31,4,2,1302
E01031655,1098,11,47,10,3,1169
E01031656,1294,15,70,18,7,1404
E01031657,1629,15,28,14,3,1689
E01031658,1651,12,29,12,6,1710
E01031659,1223,1,9,2,0,1235
E01031660,1001,2,9,3,3,1018
E01031661,1294,16,6,6,6,1328
E01031662,1323,5,14,1,0,1343
E01031663,1403,4,21,3,2,1433
E01031664,1336,5,21,1,2,1365
E01031665,1019,6,6,1,0,1032
E01031666,1259,11,22,7,7,1306
E01031667,1212,15,39,2,3,1271
E01031668,1228,7,28,3,5,1271
E01031669,1174,14,52,13,2,1255
E01031670,1199,22,61,10,4,1296
E01031671,1284,17,34,10,2,1347
E01031672,1374,12,55,12,6,1459
E01031673,1226,8,27,1,0,1262
E01031674,1018,6,77,3,5,1109
E01031675,1093,1,17,2,2,1115
E01031676,2098,14,28,14,5,2159
E01031677,1175,1,10,3,4,1193
E01031678,1237,9,4,2,2,1254
E01031679,1157,44,41,57,3,1302
E01031680,1060,6,4,1,2,1073
E01031681,1110,11,12,4,5,1142
E01031682,880,11,12,6,1,910
E01031683,1134,8,31,6,2,1181
E01031684,1194,8,8,4,1,1215
E01031685,1459,8,5,2,0,1474
E01031686,1191,10,6,1,0,1208
E01031687,1292,12,38,20,0,1362
E01031688,1074,1,14,6,5,1100
E01031689,1217,11,19,3,4,1254
E01031690,1221,4,18,5,0,1248
E01031691,1297,13,46,8,5,1369
E01031692,1630,17,19,12,3,1681
E01031693,1518,7,14,3,2,1544
E01031694,1457,11,46,5,3,1522
E01031695,1168,15,20,4,2,1209
E01031696,1051,8,14,5,2,1080
E01031697,974,11,5,2,0,992
E01031698,1283,8,12,0,1,1304
E01031699,1268,11,31,3,0,1313
E01031700,1212,9,34,10,5,1270
E01031701,1362,16,36,13,1,1428
E01031702,1209,11,31,3,0,1254
E01031703,1422,11,47,3,2,1485
E01031704,1305,19,52,4,1,1381
E01031705,1160,17,49,5,8,1239
E01031706,1348,14,28,13,2,1405
E01031707,1293,7,36,2,2,1340
E01031708,1190,28,142,23,6,1389
E01031709,1254,9,66,7,6,1342
E01031710,1153,11,15,5,3,1187
E01031711,1368,10,16,9,4,1407
E01031712,1112,18,35,4,3,1172
E01031713,1131,8,7,9,1,1156
E01031714,1170,15,21,3,0,1209
E01031715,1125,17,33,3,5,1183
E01031716,859,9,30,4,0,902
E01031717,1033,7,47,5,5,1097
E01031718,1449,11,42,9,4,1515
E01031719,1380,7,39,17,3,1446
E01031720,1131,6,25,4,9,1175
E01031721,1254,7,11,5,1,1278
E01031722,1024,13,42,5,5,1089
E01031723,1166,11,15,3,2,1197
E01031724,1073,17,17,0,0,1107
E01031725,1165,9,17,4,0,1195
E01031726,1080,5,15,16,3,1119
E01031727,1345,13,13,4,4,1379
E01031728,1585,5,6,10,7,1613
E01031729,1456,9,36,1,3,1505
E01031730,1358,9,44,10,7,1428
E01031731,1491,10,57,18,2,1578
E01031732,1418,16,29,3,4,1470
E01031733,1353,14,40,9,6,1422
E01031734,1315,16,27,2,7,1367
E01031735,1380,10,16,4,5,1415
E01031736,1360,11,18,5,2,1396
E01031737,1144,14,34,6,2,1200
E01031738,1014,5,10,3,0,1032
E01031739,1402,14,30,14,2,1462
E01031740,1074,11,22,4,0,1111
E01031741,1290,16,93,14,4,1417
E01031742,1555,11,49,19,3,1637
E01031743,1235,14,69,15,9,1342
E01031744,1180,8,10,2,4,1204
E01031745,1461,9,15,2,2,1489
E01031746,1275,19,15,3,0,1312
E01031747,1198,11,8,2,1,1220
E01031748,1047,16,14,1,0,1078
E01031749,1113,14,45,3,6,1181
E01031750,1118,12,40,7,8,1185
E01031751,1862,26,165,31,9,2093
E01031752,969,11,49,15,2,1046
E01031753,1037,14,35,10,3,1099
E01031754,1176,10,71,9,5,1271
E01031755,968,12,41,13,6,1040
E01031756,1434,12,33,6,10,1495
E01031757,1155,20,36,8,1,1220
E01031758,1069,6,36,1,3,1115
E01031759,1234,14,85,7,7,1347
E01031760,1320,15,39,14,5,1393
E01031761,1525,22,221,35,14,1817
E01031763,1351,14,36,5,7,1413
E01031764,1156,5,4,0,0,1165
E01031765,1251,10,10,7,0,1278
E01031766,1759,13,13,8,1,1794
E01031767,1185,9,10,5,3,1212
E01031768,1234,5,6,3,1,1249
E01031769,1312,14,7,4,0,1337
E01031770,1303,13,12,1,9,1338
E01031771,1155,15,14,2,2,1188
E01031772,1348,14,6,5,3,1376
E01031773,1555,7,12,0,1,1575
E01031774,1270,12,15,3,2,1302
E01031775,1379,10,22,1,1,1413
E01031776,1195,5,17,9,1,1227
E01031777,1226,12,63,15,5,1321
E01031778,1211,14,12,16,3,1256
E01031779,905,13,47,14,2,981
E01031780,1129,8,36,10,5,1188
E01031781,1228,12,23,6,5,1274
E01031782,1419,10,20,4,1,1454
E01031783,1115,17,43,11,0,1186
E01031784,1403,9,49,13,7,1481
E01031785,1120,9,37,6,7,1179
E01031786,1176,12,22,3,3,1216
E01031787,1455,20,98,43,24,1640
E01031788,1424,38,190,32,12,1696
E01031789,1531,23,92,35,9,1690
E01031790,1478,14,76,19,14,1601
E01031791,1518,30,78,35,16,1677
E01031792,1079,8,17,5,1,1110
E01031793,1100,7,26,6,5,1144
E01031794,1148,8,2,10,1,1169
E01031795,1123,13,15,7,6,1164
E01031796,1096,27,61,12,3,1199
E01031797,1027,4,11,4,4,1050
E01031798,1190,17,31,15,4,1257
E01031799,1133,11,59,16,9,1228
E01031800,1176,3,12,2,3,1196
E01031801,1281,30,74,19,5,1409
E01031802,1381,4,21,3,3,1412
E01031803,1241,20,25,1,5,1292
E01031804,1369,6,35,2,2,1414
E01031805,1388,5,15,3,1,1412
E01031806,1241,11,50,4,7,1313
E01031807,1485,21,25,4,4,1539
E01031808,1243,30,69,30,15,1387
E01031809,1275,19,42,24,10,1370
E01031810,1192,22,46,30,6,1296
E01031811,1266,13,41,13,14,1347
E01031812,1355,18,31,3,5,1412
E01031813,1368,11,42,12,4,1437
E01031814,1274,9,16,9,3,1311
E01031815,1322,10,17,9,4,1362
E01031816,1165,15,27,6,9,1222
E01031817,1183,22,25,4,8,1242
E01031818,1544,16,29,11,4,1604
E01031819,882,11,23,9,3,928
E01031820,1483,5,18,5,0,1511
E01031821,1346,8,17,0,2,1373
E01031822,1256,15,25,5,4,1305
E01031823,1093,11,30,0,3,1137
E01031824,1038,10,17,1,2,1068
E01031825,1390,5,26,3,1,1425
E01031826,1072,10,26,7,1,1116
E01031827,1123,11,18,6,2,1160
E01031828,1098,14,15,0,1,1128
E01031829,1305,13,19,0,2,1339
E01031830,1207,10,24,9,4,1254
E01031831,1203,15,124,10,8,1360
E01031832,1359,14,29,16,3,1421
E01031833,1153,14,71,24,4,1266
E01031834,1165,22,56,10,8,1261
E01031835,1453,32,87,26,15,1613
E01031836,1235,15,46,18,6,1320
E01031837,1405,14,63,16,9,1507
E01031838,1279,16,31,6,4,1336
E01031839,1335,12,20,4,4,1375
E01031840,1371,10,18,3,1,1403
E01031841,1457,4,15,1,1,1478
E01031842,1532,8,4,1,0,1545
E01031843,1401,12,3,3,2,1421
E01031844,1504,15,10,1,3,1533
E01031845,1328,8,8,1,3,1348
E01031846,1344,10,3,2,1,1360
E01031847,1410,7,7,5,0,1429
E01031848,1759,32,12,23,4,1830
E01031849,1313,7,53,1,0,1374
E01031850,1590,14,13,1,1,1619
E01031851,1151,15,11,4,3,1184
E01031852,1588,4,38,8,0,1638
E01031853,1169,11,14,13,1,1208
E01031854,1492,16,24,15,5,1552
E01031855,1231,2,11,3,0,1247
E01031856,1285,10,8,3,3,1309
E01031857,1296,15,12,0,0,1323
E01031858,1511,25,66,4,2,1608
E01031859,1332,12,23,11,4,1382
E01031860,1185,8,3,4,4,1204
E01031861,1977,9,26,3,1,2016
E01031862,1227,8,11,8,1,1255
E01031863,985,7,17,1,8,1018
E01031864,1025,7,29,2,2,1065
E01031865,1399,22,27,4,1,1453
E01031866,1296,5,5,1,6,1313
E01031867,1515,6,5,4,0,1530
E01031868,1385,12,37,0,0,1434
E01031869,1496,9,12,0,1,1518
E01031870,1464,9,15,1,0,1489
E01031871,1326,6,10,2,1,1345
E01031872,1284,14,3,5,0,1306
E01031873,1491,9,15,2,3,1520
E01031874,1237,5,11,1,2,1256
E01031876,1226,4,1,3,1,1235
E01031877,1444,8,7,1,2,1462
E01031878,1865,37,38,46,6,1992
E01031879,1235,48,100,169,22,1574
E01031880,2974,53,52,108,20,3207
E01031882,1617,9,9,3,1,1639
E01031883,1500,6,3,0,0,1509
E01031884,1302,7,16,3,2,1330
E01031885,1241,7,7,2,1,1258
E01031886,1159,5,2,0,0,1166
E01031887,1382,5,10,3,1,1401
E01031888,1091,4,2,2,0,1099
E01031889,1386,16,13,13,6,1434
E01031890,1173,10,8,4,3,1198
E01031891,1867,15,5,4,2,1893
E01031892,1130,7,3,0,0,1140
E01031893,1248,9,6,1,0,1264
E01031894,1212,8,8,1,0,1229
E01031895,1217,6,3,5,3,1234
E01031896,925,13,4,4,0,946
E01031897,1594,12,16,8,0,1630
E01031898,1314,11,34,15,1,1375
E01031900,1870,9,16,1,3,1899
E01031901,1141,8,5,1,1,1156
E01031902,910,5,4,1,5,925
E01031903,1907,9,10,1,7,1934
E01031904,1682,7,15,2,1,1707
E01031905,1076,7,22,5,0,1110
E01031906,1126,7,24,9,0,1166
E01031907,1862,17,42,10,6,1937
E01031908,1236,19,15,12,1,1283
E01031909,1037,5,7,9,0,1058
E01031910,1102,20,33,15,3,1173
E01031911,995,15,20,9,0,1039
E01031912,1071,26,40,22,1,1160
E01031913,1101,12,20,6,4,1143
E01031914,892,20,11,15,1,939
E01031915,1063,17,32,3,1,1116
E01031916,1033,11,4,11,1,1060
E01031917,1140,16,27,14,5,1202
E01031918,2005,21,38,3,4,2071
E01031919,1180,13,20,11,0,1224
E01031920,962,12,9,5,2,990
E01031921,1086,9,12,7,3,1117
E01031922,1008,16,15,3,3,1045
E01031923,1060,4,9,8,1,1082
E01031924,1236,9,20,3,2,1270
E01031925,884,5,14,12,1,916
E01031926,1154,7,30,11,2,1204
E01031927,1036,8,18,8,0,1070
E01031928,1022,15,19,14,1,1071
E01031929,1047,10,3,1,0,1061
E01031930,1213,13,18,14,7,1265
E01031931,1323,5,18,5,0,1351
E01031932,1269,3,9,1,0,1282
E01031933,1203,13,16,3,0,1235
E01031934,1411,5,12,5,2,1435
E01031935,1374,16,13,5,2,1410
E01031936,1151,3,12,1,0,1167
E01031937,922,3,9,2,2,938
E01031938,1091,5,5,0,1,1102
E01031939,1692,12,19,10,1,1734
E01031940,1778,4,12,3,1,1798
E01031941,1214,8,6,1,1,1230
E01031942,1172,9,6,1,3,1191
E01031944,875,11,2,3,2,893
E01031946,1431,19,55,34,6,1545
E01031947,1259,11,26,5,4,1305
E01031948,1564,8,32,5,2,1611
E01031949,1478,12,20,3,0,1513
E01031950,1103,7,3,3,1,1117
E01031951,1054,11,91,20,1,1177
E01031952,1915,19,24,4,2,1964
E01031953,2188,19,20,2,1,2230
E01031954,1050,10,16,2,1,1079
E01031955,1333,9,12,2,3,1359
E01031956,991,11,6,4,2,1014
E01031957,1158,1,6,2,1,1168
E01031958,1095,3,2,4,5,1109
E01031959,1335,3,4,3,2,1347
E01031960,871,12,84,76,9,1052
E01031961,1062,9,13,5,2,1091
E01031962,1054,7,31,0,3,1095
E01031963,1410,10,37,9,9,1475
E01031964,1422,14,28,5,1,1470
E01031965,1143,14,8,10,1,1176
E01031966,1251,10,11,4,2,1278
E01031967,1546,10,21,6,2,1585
E01031968,1300,10,13,8,7,1338
E01031969,1164,6,11,4,0,1185
E01031970,1301,5,5,2,3,1316
E01031971,960,10,4,3,3,980
E01031972,1194,9,4,2,1,1210
E01031973,1505,9,15,1,1,1531
E01031974,1075,5,16,6,4,1106
E01031975,1001,7,8,5,0,1021
E01031976,937,9,20,5,0,971
E01031977,2162,24,30,11,4,2231
E01031978,1287,16,13,9,0,1325
E01031979,1713,10,43,12,3,1781
E01031980,1165,9,19,1,1,1195
E01031981,1200,12,18,6,1,1237
E01031982,1123,10,31,1,0,1165
E01031983,1262,8,14,9,4,1297
E01031984,1179,3,25,2,1,1210
E01031985,995,7,23,0,2,1027
E01031986,1001,15,23,0,4,1043
E01031988,909,21,57,126,18,1131
E01031989,1144,7,9,16,0,1176
E01031990,1578,12,0,6,1,1597
E01031991,1622,8,19,1,2,1652
E01031992,1227,12,8,1,2,1250
E01031993,1166,5,14,2,2,1189
E01031994,1091,5,8,2,5,1111
E01031995,1311,12,2,3,2,1330
E01031996,1094,17,11,10,2,1134
E01031997,1136,8,6,12,4,1166
E01031998,1965,30,36,126,11,2168
E01031999,1268,9,8,1,1,1287
E01032000,1783,11,66,5,3,1868
E01032001,1215,12,1,1,6,1235
E01032002,1121,6,30,3,6,1166
E01032003,1190,7,59,11,4,1271
E01032004,1851,11,8,0,1,1871
E01032005,1022,5,28,7,2,1064
E01032006,966,5,18,2,0,991
E01032007,976,9,40,0,3,1028
E01032008,1196,5,16,4,1,1222
E01032009,1519,5,28,7,1,1560
E01032010,1747,3,10,1,0,1761
E01032011,1875,14,45,13,1,1948
E01032012,1516,3,14,4,1,1538
E01032013,1696,11,22,6,4,1739
E01032014,1430,8,57,7,2,1504
E01032015,1120,8,34,5,4,1171
E01032016,1096,14,27,6,2,1145
E01032017,1198,7,11,3,1,1220
E01032018,1313,8,9,5,3,1338
E01032019,1202,13,18,8,3,1244
E01032020,1196,6,13,5,2,1222
E01032021,1285,11,63,7,0,1366
E01032022,1384,14,47,8,6,1459
E01032023,1378,17,66,11,0,1472
E01032024,1862,23,53,14,10,1962
E01032025,1228,5,8,5,0,1246
E01032026,1305,3,4,3,4,1319
E01032027,1140,3,5,4,2,1154
E01032029,1118,6,9,3,1,1137
E01032030,1263,4,12,1,1,1281
E01032031,922,4,3,1,1,931
E01032032,1323,3,10,4,0,1340
E01032033,1161,4,3,2,3,1173
E01032034,1119,4,9,6,2,1140
E01032035,1306,3,10,1,0,1320
E01032036,1209,1,2,1,0,1213
E01032037,1223,4,6,1,0,1234
E01032038,1156,2,4,1,0,1163
E01032039,1101,9,12,3,1,1126
E01032040,1162,6,5,2,0,1175
E01032041,1594,8,6,2,0,1610
E01032042,1346,9,7,2,0,1364
E01032043,1010,9,22,5,2,1048
E01032044,1155,10,3,1,1,1170
E01032045,1167,8,8,2,2,1187
E01032046,1242,14,4,3,0,1263
E01032047,1144,7,4,3,0,1158
E01032048,1339,14,4,9,9,1375
E01032049,1278,4,3,2,2,1289
E01032050,1503,13,14,4,3,1537
E01032051,1108,1,4,1,0,1114
E01032052,1098,4,5,2,0,1109
E01032053,1132,7,4,7,2,1152
E01032054,984,4,15,4,0,1007
E01032055,1052,5,1,0,3,1061
E01032056,1036,10,6,2,1,1055
E01032057,988,5,3,0,2,998
E01032058,1132,9,8,2,3,1154
E01032059,1446,11,12,3,1,1473
E01032060,1302,7,6,1,0,1316
E01032061,940,14,7,1,1,963
E01032062,1274,19,22,14,5,1334
E01032063,1449,11,10,20,4,1494
E01032064,975,7,6,15,2,1005
E01032065,1196,9,16,5,2,1228
E01032066,1139,7,15,5,2,1168
E01032067,1215,13,22,7,0,1257
E01032068,1126,8,15,11,1,1161
E01032069,1015,6,10,0,0,1031
E01032070,1248,11,3,9,1,1272
E01032071,1838,6,15,2,3,1864
E01032072,1493,11,15,12,2,1533
E01032073,1033,12,13,17,1,1076
E01032074,983,1,5,5,0,994
E01032075,1103,2,2,5,2,1114
E01032076,1010,8,2,4,2,1026
E01032077,1356,11,10,2,5,1384
E01032078,2140,25,8,19,15,2207
E01032079,1199,9,5,1,7,1221
E01032080,1227,14,6,8,3,1258
E01032081,1040,6,4,1,0,1051
E01032082,1038,3,8,0,0,1049
E01032083,1800,13,2,7,5,1827
E01032084,2060,15,11,7,3,2096
E01032085,1287,20,29,14,6,1356
E01032086,1796,48,52,35,17,1948
E01032087,1686,28,19,32,11,1776
E01032088,1208,3,18,6,2,1237
E01032089,1144,27,14,17,7,1209
E01032090,1120,12,9,14,9,1164
E01032091,950,15,7,12,1,985
E01032092,1144,9,7,15,6,1181
E01032093,1270,31,8,29,15,1353
E01032094,1664,28,56,25,25,1798
E01032095,1268,15,21,6,16,1326
E01032096,1321,27,13,12,11,1384
E01032097,1521,11,8,6,1,1547
E01032098,1416,9,16,4,7,1452
E01032099,2123,17,27,20,10,2197
E01032100,1197,5,15,19,8,1244
E01032101,1330,17,24,15,5,1391
E01032102,1259,11,12,13,11,1306
E01032103,1408,10,35,12,2,1467
E01032104,1030,10,18,11,4,1073
E01032105,1248,7,11,2,0,1268
E01032106,1180,8,14,4,0,1206
E01032107,903,12,35,49,12,1011
E01032108,1102,17,3,8,1,1131
E01032109,1195,7,6,1,1,1210
E01032110,1306,4,18,5,3,1336
E01032111,1021,8,5,6,1,1041
E01032112,1150,6,13,3,3,1175
E01032113,1120,5,5,0,4,1134
E01032114,1143,11,39,5,1,1199
E01032115,1420,5,19,4,2,1450
E01032116,2011,13,13,4,1,2042
E01032117,1964,13,20,5,4,2006
E01032118,1110,9,7,4,0,1130
E01032119,1486,13,13,9,2,1523
E01032121,1274,4,5,2,5,1290
E01032122,1673,23,42,8,4,1750
E01032123,1283,14,29,3,4,1333
E01032124,1196,11,8,3,0,1218
E01032125,1170,10,9,2,1,1192
E01032126,1721,12,16,3,1,1753
E01032127,1344,8,7,4,1,1364
E01032128,1163,7,5,5,0,1180
E01032129,1025,12,42,7,0,1086
E01032130,2029,26,24,9,4,2092
E01032131,1224,17,19,9,1,1270
E01032132,1684,21,10,8,3,1726
E01032133,1283,20,19,8,3,1333
E01032134,1375,18,31,19,6,1449
E01032135,1292,11,38,8,1,1350
E01032136,1064,2,10,0,6,1082
E01032137,1229,4,13,3,0,1249
E01032138,1098,4,45,4,1,1152
E01032139,1220,11,16,4,5,1256
E01032140,1280,9,30,4,2,1325
E01032141,1130,26,53,7,1,1217
E01032142,1227,12,13,5,0,1257
E01032143,1188,16,51,2,5,1262
E01032144,1405,10,37,4,3,1459
E01032145,1202,6,21,10,1,1240
E01032146,1336,12,30,11,0,1389
E01032147,1041,3,15,3,0,1062
E01032148,874,5,18,4,1,902
E01032149,933,15,44,0,6,998
E01032150,1225,19,17,5,0,1266
E01032151,1141,6,8,4,1,1160
E01032152,1067,5,5,3,1,1081
E01032153,1175,7,20,2,8,1212
E01032154,1341,10,38,8,2,1399
E01032155,1307,8,25,6,5,1351
E01032156,1303,19,127,14,2,1465
E01032157,1501,10,28,5,3,1547
E01032158,1242,10,20,2,1,1275
E01032159,1447,9,38,1,2,1497
E01032160,1402,9,19,4,3,1437
E01032161,1136,9,5,5,1,1156
E01032162,1458,15,29,2,3,1507
E01032166,1754,11,7,3,1,1776
E01032168,920,6,16,6,0,948
E01032169,946,7,14,4,4,975
E01032170,1115,18,4,4,6,1147
E01032171,1275,5,11,3,0,1294
E01032172,1178,16,12,15,1,1222
E01032173,1308,10,19,11,1,1349
E01032174,1200,11,18,6,0,1235
E01032175,1332,6,14,9,0,1361
E01032176,1816,11,20,1,0,1848
E01032177,927,8,9,9,1,954
E01032178,1070,13,27,2,1,1113
E01032179,1390,1,5,3,0,1399
E01032180,1548,5,11,2,1,1567
E01032181,1776,9,8,1,0,1794
E01032182,1686,8,3,4,1,1702
E01032183,1139,4,12,1,0,1156
E01032184,1341,7,14,5,1,1368
E01032185,1198,9,8,2,1,1218
E01032186,1039,16,115,12,1,1183
E01032187,1371,7,21,0,3,1402
E01032188,1496,17,12,5,1,1531
E01032189,1593,9,11,5,3,1621
E01032190,1509,7,14,0,1,1531
E01032191,1947,7,13,4,0,1971
E01032192,1315,13,4,1,0,1333
E01032193,1807,9,5,4,2,1827
E01032194,1203,5,6,0,3,1217
E01032195,1326,6,8,1,3,1344
E01032196,1351,8,26,0,1,1386
E01032197,1222,5,23,2,4,1256
E01032198,1759,4,7,3,2,1775
E01032199,1409,4,10,4,0,1427
E01032200,1710,9,10,0,3,1732
E01032201,1186,10,18,2,4,1220
E01032202,1301,11,13,2,2,1329
E01032203,1218,13,10,2,1,1244
E01032204,1126,5,16,0,3,1150
E01032205,892,4,10,1,0,907
E01032206,1009,2,11,2,0,1024
E01032207,1180,3,5,0,0,1188
E01032208,1264,9,39,0,4,1316
E01032209,1107,21,74,18,4,1224
E01032210,940,1,12,2,2,957
E01032211,1546,6,4,0,0,1556
E01032212,1576,6,3,1,2,1588
E01032213,1320,5,52,10,0,1387
E01032214,1821,8,5,1,2,1837
E01032215,957,5,2,0,1,965
E01032216,1287,5,12,2,0,1306
E01032217,1317,1,12,1,1,1332
E01032218,1266,8,35,10,19,1338
E01032219,1373,7,7,1,1,1389
E01032220,1221,9,15,2,0,1247
E01032221,1146,16,15,12,1,1190
E01032222,1075,11,9,2,2,1099
E01032223,1670,12,3,0,1,1686
E01032224,962,22,354,37,2,1377
E01032225,808,21,49,14,3,895
E01032226,1512,20,73,12,9,1626
E01032227,941,4,5,1,2,953
E01032228,1123,14,3,5,1,1146
E01032229,1155,13,14,22,3,1207
E01032230,1170,4,10,4,8,1196
E01032231,1386,7,19,4,0,1416
E01032232,1192,23,76,25,3,1319
E01032233,2134,31,54,22,4,2245
E01032234,1260,37,84,35,5,1421
E01032235,1299,20,46,15,1,1381
E01032236,1205,30,160,47,4,1446
E01032237,1167,18,74,11,4,1274
E01032238,937,16,162,16,1,1132
E01032239,924,35,386,50,3,1398
E01032240,1001,23,20,2,2,1048
E01032241,991,16,12,7,3,1029
E01032242,1068,10,5,8,2,1093
E01032243,1216,7,8,6,1,1238
E01032244,1001,10,13,5,0,1029
E01032245,1077,12,6,28,1,1124
E01032246,1124,7,17,7,2,1157
E01032247,1132,7,22,7,1,1169
E01032248,1143,12,20,5,4,1184
E01032249,1230,10,22,4,1,1267
E01032250,943,15,42,10,2,1012
E01032251,1270,24,36,23,2,1355
E01032252,963,18,46,11,4,1042
E01032253,1014,13,13,18,4,1062
E01032254,1172,17,48,13,2,1252
E01032255,1067,9,40,12,1,1129
E01032256,1175,13,11,18,4,1221
E01032257,1144,11,14,9,0,1178
E01032258,1226,13,17,7,1,1264
E01032259,1250,8,25,1,0,1284
E01032260,1063,16,22,18,0,1119
E01032261,1167,6,13,3,0,1189
E01032262,1341,32,239,28,3,1643
E01032263,1334,16,95,15,3,1463
E01032264,1245,13,62,13,7,1340
E01032265,1152,14,33,10,7,1216
E01032266,1279,10,26,17,5,1337
E01032267,1190,28,48,11,2,1279
E01032268,1002,11,12,5,0,1030
E01032269,1349,17,9,5,3,1383
E01032270,1069,12,21,2,2,1106
E01032271,1044,10,22,6,4,1086
E01032272,994,17,16,9,0,1036
E01032273,1153,11,7,5,0,1176
E01032274,1045,7,12,11,0,1075
E01032275,1077,14,26,6,2,1125
E01032276,1190,5,8,7,1,1211
E01032277,979,23,27,5,1,1035
E01032278,1170,23,24,15,6,1238
E01032279,969,6,40,8,2,1025
E01032280,1301,19,27,9,5,1361
E01032281,1070,14,59,11,2,1156
E01032282,1351,25,150,22,8,1556
E01032283,1219,10,86,3,5,1323
E01032284,1571,10,45,5,3,1634
E01032285,1239,7,67,9,10,1332
E01032286,1303,10,32,3,3,1351
E01032287,1274,20,20,5,2,1321
E01032288,1246,4,16,3,5,1274
E01032289,1264,4,14,1,1,1284
E01032290,1269,8,4,0,1,1282
E01032292,875,29,340,27,6,1277
E01032294,953,8,178,8,9,1156
E01032295,1923,27,68,10,3,2031
E01032296,1341,8,32,4,1,1386
E01032297,1275,10,9,1,4,1299
E01032298,1501,5,15,2,0,1523
E01032299,1228,12,20,4,3,1267
E01032300,1294,4,7,1,2,1308
E01032301,1142,12,20,1,1,1176
E01032302,813,9,133,4,8,967
E01032303,865,7,13,4,0,889
E01032304,1083,14,9,4,2,1112
E01032305,1240,11,90,6,4,1351
E01032306,1065,14,107,1,6,1193
E01032307,1161,12,160,4,9,1346
E01032308,1224,8,62,3,1,1298
E01032309,1066,12,102,6,2,1188
E01032310,1118,16,23,10,3,1170
E01032311,1140,12,18,6,0,1176
E01032312,1126,18,47,8,3,1202
E01032313,919,18,31,1,3,972
E01032314,933,5,11,4,1,954
E01032315,1824,41,53,14,4,1936
E01032316,1004,5,12,5,2,1028
E01032317,1273,6,4,8,1,1292
E01032318,1084,11,19,2,6,1122
E01032319,1453,7,5,3,3,1471
E01032320,1451,9,22,7,4,1493
E01032321,1152,9,15,1,0,1177
E01032322,1530,24,26,12,8,1600
E01032323,1159,9,29,2,3,1202
E01032324,1072,5,23,7,0,1107
E01032325,1160,8,45,7,1,1221
E01032326,1133,2,12,0,3,1150
E01032327,1269,13,33,7,4,1326
E01032328,1171,10,32,5,2,1220
E01032329,1631,9,34,3,5,1682
E01032330,986,3,15,9,0,1013
E01032331,1119,9,6,2,0,1136
E01032332,931,15,14,9,2,971
E01032333,1291,17,24,7,3,1342
E01032334,1775,15,39,12,4,1845
E01032335,1126,10,42,1,3,1182
E01032336,1173,11,46,7,4,1241
E01032337,1432,11,90,3,2,1538
E01032338,1450,21,62,8,1,1542
E01032339,1169,14,46,7,5,1241
E01032340,1169,5,3,1,4,1182
E01032341,1105,5,7,2,1,1120
E01032342,1167,5,29,3,4,1208
E01032343,1866,15,67,3,13,1964
E01032344,1180,2,19,2,0,1203
E01032345,1154,6,5,2,0,1167
E01032346,1061,4,7,2,0,1074
E01032347,1042,5,1,2,2,1052
E01032348,988,5,3,1,4,1001
E01032349,1273,5,6,2,1,1287
E01032350,870,5,1,0,2,878
E01032351,1344,10,10,0,0,1364
E01032352,1285,4,6,1,2,1298
E01032353,1321,7,8,1,3,1340
E01032354,1986,14,30,10,2,2042
E01032355,1100,2,4,0,0,1106
E01032356,898,5,3,1,0,907
E01032357,979,5,11,1,0,996
E01032358,1181,6,16,0,0,1203
E01032359,1573,14,31,4,1,1623
E01032360,1495,6,27,6,3,1537
E01032361,1399,11,18,4,0,1432
E01032362,1471,9,22,10,2,1514
E01032363,1273,8,6,4,1,1292
E01032364,1320,9,21,0,0,1350
E01032365,1415,9,11,4,2,1441
E01032366,1337,6,10,1,2,1356
E01032367,1220,3,11,3,1,1238
E01032368,935,7,16,6,1,965
E01032369,1104,9,18,3,1,1135
E01032370,971,11,4,10,2,998
E01032371,1084,5,8,1,1,1099
E01032372,1188,7,1,1,2,1199
E01032373,1081,3,7,0,0,1091
E01032374,1065,5,2,0,2,1074
E01032375,976,0,1,1,0,978
E01032376,1242,6,26,0,3,1277
E01032377,1453,14,16,7,6,1496
E01032378,1331,12,23,5,3,1374
E01032379,1505,7,12,0,5,1529
E01032380,1326,6,24,3,4,1363
E01032381,1515,20,12,1,7,1555
E01032382,1027,5,6,4,0,1042
E01032383,1294,10,2,5,3,1314
E01032384,1060,5,6,0,1,1072
E01032385,1097,1,10,0,0,1108
E01032386,1110,6,4,6,1,1127
E01032387,1133,5,9,1,4,1152
E01032388,1105,3,3,0,1,1112
E01032389,1008,5,15,2,2,1032
E01032390,1094,2,11,0,1,1108
E01032391,880,4,4,0,1,889
E01032392,1310,4,13,1,2,1330
E01032393,1283,6,5,1,0,1295
E01032394,991,8,5,0,1,1005
E01032395,1005,4,3,0,0,1012
E01032396,1246,8,18,1,0,1273
E01032397,1420,9,11,2,2,1444
E01032398,1356,11,6,0,2,1375
E01032399,1377,12,15,3,0,1407
E01032400,1730,11,19,2,9,1771
E01032401,1247,6,7,1,5,1266
E01032402,1063,5,12,2,1,1083
E01032403,1163,8,9,1,8,1189
E01032404,1982,11,20,1,2,2016
E01032405,1123,2,6,0,0,1131
E01032406,1200,3,6,1,1,1211
E01032407,1206,3,5,1,0,1215
E01032408,1167,2,2,2,1,1174
E01032409,1294,1,12,3,0,1310
E01032410,1151,6,1,1,0,1159
E01032411,1296,6,9,0,2,1313
E01032412,1024,2,3,2,2,1033
E01032413,889,2,2,1,0,894
E01032414,1240,6,12,0,0,1258
E01032415,1294,30,44,44,7,1419
E01032416,936,5,2,1,1,945
E01032417,1230,7,3,7,0,1247
E01032418,1100,10,18,5,1,1134
E01032419,1142,6,3,4,1,1156
E01032420,1022,10,5,3,0,1040
E01032421,1021,5,6,1,0,1033
E01032422,1050,20,12,2,1,1085
E01032423,1273,7,10,2,1,1293
E01032424,1112,8,5,2,0,1127
E01032425,1223,5,1,1,2,1232
E01032426,1231,1,7,0,5,1244
E01032427,1304,8,3,0,3,1318
E01032428,1440,10,8,1,3,1462
E01032429,1295,7,6,3,2,1313
E01032430,1388,8,6,4,2,1408
E01032431,1244,5,6,0,0,1255
E01032432,1060,10,87,3,1,1161
E01032433,1015,7,14,2,0,1038
E01032434,1136,19,74,4,2,1235
E01032435,1049,17,85,8,3,1162
E01032436,1266,8,6,3,1,1284
E01032437,1346,7,29,6,1,1389
E01032438,1273,7,17,1,0,1298
E01032439,1136,8,0,0,1,1145
E01032440,970,3,2,3,3,981
E01032441,1066,4,1,0,0,1071
E01032442,1169,2,2,6,0,1179
E01032443,1165,5,2,1,0,1173
E01032444,992,4,4,1,0,1001
E01032445,1222,6,6,0,1,1235
E01032446,1164,6,20,0,1,1191
E01032447,1149,18,27,9,0,1203
E01032448,968,7,15,1,2,993
E01032449,1256,16,28,4,1,1305
E01032450,1778,19,54,13,4,1868
E01032451,1317,2,3,0,1,1323
E01032452,1289,8,20,0,1,1318
E01032453,1293,21,20,1,1,1336
E01032454,1419,11,22,1,0,1453
E01032455,1240,5,4,1,0,1250
E01032456,965,3,4,4,1,977
E01032457,1071,4,1,0,0,1076
E01032458,1157,1,6,0,1,1165
E01032459,1161,9,12,1,1,1184
E01032460,1471,9,10,1,4,1495
E01032461,1583,10,35,9,4,1641
E01032462,1731,14,15,3,3,1766
E01032463,1386,6,13,2,3,1410
E01032464,1245,6,8,4,1,1264
E01032465,1083,9,11,3,5,1111
E01032466,1242,7,10,3,2,1264
E01032467,993,5,5,2,0,1005
E01032468,1007,4,16,1,1,1029
E01032469,1319,9,8,1,0,1337
E01032470,1440,4,16,4,0,1464
E01032471,1146,6,9,3,0,1164
E01032472,1042,4,3,0,2,1051
E01032473,1002,11,14,1,0,1028
E01032474,1281,29,48,6,1,1365
E01032475,1302,12,16,9,1,1340
E01032476,1133,2,4,1,1,1141
E01032477,1005,9,3,6,1,1024
E01032478,1172,8,15,5,3,1203
E01032479,1780,11,14,1,2,1808
E01032480,1491,7,11,1,0,1510
E01032481,1482,4,5,1,1,1493
E01032482,1156,11,8,5,3,1183
E01032483,1388,7,7,7,3,1412
E01032484,1077,2,0,4,1,1084
E01032485,1431,8,7,0,1,1447
E01032486,1173,4,4,2,0,1183
E01032487,800,4,7,2,3,816
E01032488,1466,7,12,3,1,1489
E01032489,1557,14,28,9,4,1612
E01032490,997,13,50,8,4,1072
E01032491,907,1,33,4,11,956
E01032492,1550,18,35,13,2,1618
E01032493,1009,30,56,24,14,1133
E01032494,1207,35,62,41,16,1361
E01032495,1598,17,89,49,6,1759
E01032496,1566,9,31,8,4,1618
E01032497,957,20,36,64,0,1077
E01032498,1284,12,7,7,0,1310
E01032499,1271,14,143,17,17,1462
E01032500,821,23,95,17,3,959
E01032501,912,9,15,6,6,948
E01032502,1262,34,43,12,59,1410
E01032503,1151,4,14,1,5,1175
E01032504,1241,11,34,3,4,1293
E01032505,994,23,46,7,17,1087
E01032506,1114,44,32,11,16,1217
E01032507,1267,32,14,16,10,1339
E01032508,1268,33,67,18,22,1408
E01032509,1081,16,23,17,2,1139
E01032510,1409,11,25,10,6,1461
E01032511,1107,15,10,10,2,1144
E01032512,762,117,278,283,390,1830
E01032513,523,56,153,170,142,1044
E01032514,1343,34,16,19,6,1418
E01032515,1080,6,9,15,6,1116
E01032516,1472,20,35,17,7,1551
E01032517,1113,29,38,50,10,1240
E01032518,1060,45,112,114,11,1342
E01032519,783,30,63,38,6,920
E01032520,1575,91,235,34,25,1960
E01032522,1519,103,212,50,26,1910
E01032523,787,56,43,69,29,984
E01032524,733,14,10,18,13,788
E01032525,1699,86,53,132,55,2025
E01032526,1302,18,15,21,12,1368
E01032527,1077,20,34,71,1,1203
E01032528,994,21,66,146,2,1229
E01032529,998,7,50,25,6,1086
E01032530,1479,17,46,17,9,1568
E01032531,1723,30,81,65,14,1913
E01032532,1036,8,54,3,13,1114
E01032533,898,42,460,39,38,1477
E01032534,1066,26,290,78,19,1479
E01032535,812,10,118,15,14,969
E01032536,1187,27,252,38,16,1520
E01032537,1223,21,300,42,5,1591
E01032538,1329,45,269,45,7,1695
E01032540,802,1,2,2,0,807
E01032541,1750,6,10,4,0,1770
E01032542,778,2,20,3,3,806
E01032543,1625,6,26,0,2,1659
E01032544,1471,9,50,5,3,1538
E01032545,986,7,8,3,1,1005
E01032546,1414,4,21,5,3,1447
E01032548,1362,2,7,2,0,1373
E01032549,1369,7,24,3,1,1404
E01032550,2138,14,32,24,1,2209
E01032551,2021,3,16,7,6,2053
E01032552,1273,9,4,0,0,1286
E01032553,1084,11,6,3,1,1105
E01032554,1594,30,114,15,19,1772
E01032555,1266,62,204,56,72,1660
E01032556,1156,11,18,1,2,1188
E01032557,1101,26,35,53,2,1217
E01032558,979,25,16,34,4,1058
E01032559,1976,30,28,17,1,2052
E01032560,913,5,2,0,0,920
E01032561,1154,7,7,1,0,1169
E01032562,884,43,62,134,8,1131
E01032563,1030,22,89,68,21,1230
E01032564,609,35,72,182,37,935
E01032565,713,37,62,169,72,1053
E01032566,1146,38,84,90,14,1372
E01032567,885,46,149,212,12,1304
E01032568,972,27,50,108,10,1167
E01032569,731,87,93,304,21,1236
E01032570,1250,11,16,14,0,1291
E01032571,1498,9,6,2,1,1516
E01032572,1076,51,127,62,25,1341
E01032573,1150,53,145,44,35,1427
E01032574,630,58,249,434,105,1476
E01032575,544,68,110,544,71,1337
E01032576,478,30,701,72,26,1307
E01032577,1003,34,216,41,16,1310
E01032579,583,65,170,327,30,1175
E01032580,478,25,323,140,26,992
E01032581,660,43,368,163,33,1267
E01032582,1032,76,263,237,50,1658
E01032583,974,44,183,166,44,1411
E01032584,644,61,148,206,22,1081
E01032585,1216,6,9,0,7,1238
E01032586,1358,7,9,1,1,1376
E01032587,1010,35,163,67,12,1287
E01032588,1003,8,111,11,7,1140
E01032589,732,10,346,27,16,1131
E01032590,1060,28,281,11,13,1393
E01032591,281,21,848,112,77,1339
E01032592,1201,24,157,46,18,1446
E01032593,1549,15,47,7,11,1629
E01032594,1149,11,4,2,2,1168
E01032595,1419,9,18,2,7,1455
E01032596,1149,8,6,3,2,1168
E01032597,895,40,92,56,8,1091
E01032598,1478,23,220,15,12,1748
E01032599,724,24,428,27,44,1247
E01032600,1277,14,270,39,15,1615
E01032601,1009,16,149,10,27,1211
E01032602,1027,28,51,58,12,1176
E01032603,1156,10,74,13,2,1255
E01032604,1211,11,24,3,6,1255
E01032605,1141,10,10,6,5,1172
E01032606,1548,18,39,9,6,1620
E01032607,853,17,38,14,5,927
E01032608,811,17,115,14,7,964
E01032609,969,8,22,3,3,1005
E01032610,1222,14,45,26,7,1314
E01032611,1451,14,18,0,6,1489
E01032612,1600,28,69,19,4,1720
E01032613,1030,5,4,0,0,1039
E01032614,1005,7,8,1,2,1023
E01032615,951,5,3,0,1,960
E01032616,1292,11,11,0,1,1315
E01032617,1337,8,16,1,0,1362
E01032618,1204,3,17,0,1,1225
E01032619,1254,16,20,8,1,1299
E01032620,1872,14,16,1,3,1906
E01032621,1209,30,22,69,2,1332
E01032622,1033,10,66,14,0,1123
E01032623,1107,32,299,28,31,1497
E01032624,1220,24,204,18,24,1490
E01032625,903,8,9,4,1,925
E01032626,1128,10,54,14,0,1206
E01032627,1735,9,13,1,2,1760
E01032628,1676,5,5,1,1,1688
E01032629,1205,3,8,1,2,1219
E01032630,1188,8,12,3,1,1212
E01032631,981,7,17,1,0,1006
E01032632,1007,5,3,0,0,1015
E01032633,1892,13,8,1,2,1916
E01032634,1040,8,4,0,0,1052
E01032635,1772,9,8,2,0,1791
E01032636,1601,9,23,0,1,1634
E01032637,921,38,187,26,20,1192
E01032638,936,23,104,11,25,1099
E01032639,944,55,236,194,44,1473
E01032640,933,38,136,42,33,1182
E01032641,1279,9,22,3,0,1313
E01032642,1824,7,23,4,3,1861
E01032643,1332,15,47,8,7,1409
E01032644,970,2,19,8,3,1002
E01032645,934,6,11,4,8,963
E01032646,1027,57,154,135,52,1425
E01032647,1246,6,50,5,14,1321
E01032648,1089,7,39,7,3,1145
E01032649,892,11,36,2,3,944
E01032650,872,3,26,5,1,907
E01032651,1614,45,16,1,0,1676
E01032652,895,12,5,6,2,920
E01032653,1214,3,6,6,3,1232
E01032654,1307,11,42,15,2,1377
E01032655,1115,11,9,23,0,1158
E01032656,1080,3,8,28,4,1123
E01032657,1322,27,60,21,9,1439
E01032658,1024,40,64,11,15,1154
E01032659,954,23,48,4,3,1032
E01032660,1278,28,99,12,10,1427
E01032661,1093,6,43,3,5,1150
E01032662,928,9,33,2,0,972
E01032663,1812,17,32,15,6,1882
E01032664,906,18,43,7,1,975
E01032665,1032,19,58,26,1,1136
E01032666,937,5,5,0,0,947
E01032667,784,2,8,6,3,803
E01032668,1033,15,8,4,8,1068
E01032669,999,6,9,2,6,1022
E01032670,1076,5,16,6,4,1107
E01032671,902,5,8,8,2,925
E01032672,1015,8,13,7,1,1044
E01032673,1052,8,15,2,3,1080
E01032674,1780,12,24,2,4,1822
E01032675,1048,12,21,1,10,1092
E01032676,1119,17,18,3,7,1164
E01032677,959,9,14,2,0,984
E01032678,1068,11,15,3,0,1097
E01032679,943,4,13,2,3,965
E01032680,1566,8,4,5,0,1583
E01032681,1020,7,8,0,3,1038
E01032682,758,7,10,1,2,778
E01032683,1875,3,2,1,0,1881
E01032684,1163,47,279,159,30,1678
E01032685,1063,39,218,63,50,1433
E01032686,1114,35,142,46,27,1364
E01032687,1020,38,120,45,26,1249
E01032688,939,12,5,3,0,959
E01032689,1007,6,18,3,0,1034
E01032690,1224,7,15,4,4,1254
E01032691,1095,17,16,11,2,1141
E01032692,966,5,10,2,2,985
E01032693,1004,13,16,2,3,1038
E01032694,1148,7,10,2,1,1168
E01032695,1193,9,4,2,0,1208
E01032696,2419,31,25,48,9,2532
E01032697,904,20,55,42,11,1032
E01032698,1178,11,13,36,4,1242
E01032699,1759,20,82,37,2,1900
E01032700,1078,7,31,14,8,1138
E01032701,853,17,40,26,5,941
E01032702,950,12,60,31,1,1054
E01032703,1002,12,40,9,1,1064
E01032704,969,21,42,8,5,1045
E01032705,993,15,21,14,7,1050
E01032706,1153,36,71,16,7,1283
E01032707,1385,16,92,13,5,1511
E01032708,1192,40,88,41,9,1370
E01032709,923,15,31,18,5,992
E01032710,931,9,49,10,1,1000
E01032711,944,21,45,32,7,1049
E01032712,958,15,45,21,6,1045
E01032713,1127,18,44,26,10,1225
E01032714,842,38,239,14,6,1139
E01032715,795,23,44,20,3,885
E01032716,1023,22,111,10,4,1170
E01032717,2159,8,10,1,1,2179
E01032719,532,46,160,232,62,1032
E01032720,596,58,275,365,129,1423
E01032722,1117,95,182,380,52,1826
E01032724,890,14,118,38,11,1071
E01032725,1043,20,52,18,1,1134
E01032726,1009,9,39,21,4,1082
E01032727,2293,22,95,9,5,2424
E01032728,1003,32,78,33,13,1159
E01032729,515,38,466,194,25,1238
E01032730,482,29,450,157,29,1147
E01032731,397,30,502,105,46,1080
E01032732,753,29,330,103,18,1233
E01032733,738,23,96,13,18,888
E01032734,868,24,241,14,12,1159
E01032735,1206,13,19,4,2,1244
E01032737,1078,15,13,22,5,1133
E01032738,991,36,105,55,29,1216
E01032739,761,31,157,8,22,979
E01032740,891,24,113,23,19,1070
E01032741,741,28,94,63,19,945
E01032742,1011,12,60,39,11,1133
E01032743,527,83,459,285,127,1481
E01032744,454,35,486,152,55,1182
E01032745,1542,88,250,98,70,2048
E01032746,828,24,124,30,89,1095
E01032748,832,39,85,31,45,1032
E01032750,935,47,237,76,55,1350
E01032751,840,25,103,30,39,1037
E01032753,1771,47,250,28,45,2141
E01032755,444,27,180,93,23,767
E01032756,1862,70,595,38,58,2623
E01032758,1073,19,91,32,4,1219
E01032759,1059,14,73,25,5,1176
E01032761,1934,24,211,38,15,2222
E01032763,1777,14,45,7,7,1850
E01032764,796,51,186,80,32,1145
E01032765,772,75,248,107,36,1238
E01032766,602,44,375,65,52,1138
E01032767,1023,40,347,28,78,1516
E01032768,812,37,257,51,24,1181
E01032769,625,38,353,30,9,1055
E01032770,502,47,398,53,37,1037
E01032771,438,30,359,50,46,923
E01032772,515,24,357,32,42,970
E01032773,612,30,511,95,46,1294
E01032774,537,48,317,80,34,1016
E01032775,618,26,292,28,25,989
E01032776,496,19,367,56,42,980
E01032777,407,34,373,98,36,948
E01032778,427,38,404,60,41,970
E01032779,483,38,265,64,47,897
E01032780,691,37,433,38,19,1218
E01032781,848,30,414,40,46,1378
E01032782,609,51,452,106,60,1278
E01032783,665,39,395,99,27,1225
E01032784,887,49,267,62,26,1291
E01032785,757,63,190,95,21,1126
E01032786,704,26,349,85,25,1189
E01032787,649,50,1030,150,25,1904
E01032788,679,40,61,102,18,900
E01032789,573,38,147,96,92,946
E01032790,551,41,111,88,81,872
E01032792,943,21,84,18,20,1086
E01032794,971,18,81,9,21,1100
E01032795,1029,29,174,26,32,1290
E01032797,4072,173,679,83,71,5078
E01032798,2394,67,311,169,39,2980
E01032799,804,29,356,47,74,1310
E01032800,874,25,54,41,18,1012
E01032802,1000,19,85,15,27,1146
E01032803,875,58,166,70,45,1214
E01032805,875,89,176,734,82,1956
E01032807,1153,42,96,27,37,1355
E01032808,1067,35,86,13,34,1235
E01032809,4372,197,746,359,130,5804
E01032810,1039,14,26,17,3,1099
E01032811,1061,11,74,25,4,1175
E01032812,1291,8,36,13,4,1352
E01032813,1278,18,20,29,2,1347
E01032814,1404,12,16,9,3,1444
E01032815,662,14,35,23,6,740
E01032816,1284,17,28,28,6,1363
E01032817,772,14,58,41,2,887
E01032818,1001,14,45,31,2,1093
E01032819,1159,10,83,16,8,1276
E01032820,1030,17,106,21,3,1177
E01032821,1172,14,54,16,10,1266
E01032822,1107,13,11,19,1,1151
E01032823,1191,19,35,16,24,1285
E01032824,1101,8,33,13,7,1162
E01032825,1007,24,36,8,3,1078
E01032826,1034,15,49,6,6,1110
E01032827,1060,14,52,10,1,1137
E01032828,851,7,17,4,7,886
E01032829,1085,8,3,3,7,1106
E01032830,1915,5,16,5,4,1945
E01032831,1257,18,30,4,3,1312
E01032832,1152,24,27,17,5,1225
E01032833,1077,14,39,8,15,1153
E01032834,882,32,104,33,29,1080
E01032835,936,39,191,22,27,1215
E01032836,1067,18,229,23,14,1351
E01032837,1094,8,20,11,2,1135
E01032838,931,17,28,17,3,996
E01032839,902,12,56,21,2,993
E01032840,1250,25,87,61,7,1430
E01032841,1166,21,51,20,4,1262
E01032842,654,20,368,31,6,1079
E01032843,1098,20,85,45,5,1253
E01032844,1044,22,106,53,4,1229
E01032845,1221,12,115,20,4,1372
E01032846,798,37,389,19,7,1250
E01032847,974,31,118,17,6,1146
E01032848,1008,16,54,11,4,1093
E01032849,962,18,57,15,9,1061
E01032850,1065,13,42,11,5,1136
E01032851,1379,26,78,54,3,1540
E01032852,1126,10,72,6,6,1220
E01032853,1117,12,95,6,9,1239
E01032854,1023,22,96,16,5,1162
E01032855,945,12,17,3,0,977
E01032856,1638,15,34,27,1,1715
E01032857,737,13,67,2,5,824
E01032858,1442,44,84,40,10,1620
E01032859,1233,13,43,12,3,1304
E01032860,1046,20,48,5,2,1121
E01032862,548,33,624,70,100,1375
E01032863,387,23,727,47,73,1257
E01032865,474,24,949,43,70,1560
E01032867,826,62,506,126,178,1698
E01032868,879,57,452,179,67,1634
E01032870,1431,17,28,9,4,1489
E01032871,1217,8,2,5,0,1232
E01032872,678,55,239,84,106,1162
E01032873,705,61,277,110,138,1291
E01032875,1020,67,526,156,85,1854
E01032876,2250,77,127,24,15,2493
E01032877,1851,11,8,1,5,1876
E01032878,905,11,26,2,4,948
E01032879,1059,6,15,9,2,1091
E01032880,988,8,26,4,8,1034
E01032881,1171,15,10,8,13,1217
E01032882,1363,17,26,6,3,1415
E01032883,1086,7,5,4,6,1108
E01032884,1692,18,31,4,3,1748
E01032885,891,18,90,15,3,1017
E01032886,1301,14,166,15,16,1512
E01032887,1163,58,654,117,57,2049
E01032888,1820,41,42,44,13,1960
E01032889,1304,18,56,38,9,1425
E01032890,1576,6,25,19,2,1628
E01032891,1101,16,151,36,7,1311
E01032892,1594,6,60,14,5,1679
E01032893,1095,12,130,19,12,1268
E01032894,843,16,63,16,1,939
E01032895,1047,14,44,7,5,1117
E01032896,810,14,83,39,9,955
E01032897,935,19,13,6,2,975
E01032898,752,15,195,37,8,1007
E01032899,1351,18,3,14,2,1388
E01032900,1422,15,31,3,2,1473
E01032901,1146,10,15,17,1,1189
E01032902,1098,8,9,6,1,1122
E01032903,1841,18,18,7,1,1885
E01032904,1329,14,77,10,5,1435
E01032905,1191,6,49,2,2,1250
E01032906,937,40,64,84,38,1163
E01032907,865,22,116,40,30,1073
E01032909,1046,31,157,11,50,1295
E01032911,882,35,105,42,21,1085
E01032912,1068,26,66,53,10,1223
E01032914,1202,39,149,74,23,1487
E01032915,993,26,88,78,20,1205
E01032917,811,17,77,48,17,970
E01032919,2591,101,237,231,59,3219
E01032920,1389,23,50,24,0,1486
E01032921,429,29,1283,75,15,1831
E01032922,2030,9,21,4,1,2065
E01032923,1795,26,43,13,3,1880
E01032924,1158,10,6,12,3,1189
E01032925,1107,6,4,3,4,1124
E01032926,1203,11,28,3,2,1247
E01032927,1138,7,15,3,6,1169
E01032928,1409,14,37,4,4,1468
E01032929,909,6,8,1,2,926
E01032930,1612,23,72,32,12,1751
E01032931,958,15,35,7,1,1016
E01032932,995,22,51,32,3,1103
E01032933,990,18,23,32,2,1065
E01032934,1139,7,7,13,2,1168
E01032935,1056,12,31,22,5,1126
E01032936,1109,36,22,43,2,1212
E01032937,909,40,44,33,0,1026
E01032938,1181,8,11,6,1,1207
E01032939,1146,11,11,2,2,1172
E01032940,991,4,10,11,5,1021
E01032941,982,20,109,21,5,1137
E01032942,934,23,116,36,12,1121
E01032943,1125,16,26,8,1,1176
E01032944,1039,7,31,16,1,1094
E01032945,2851,86,114,24,6,3081
E01032946,2059,69,161,47,32,2368
E01032947,1210,19,64,10,7,1310
E01032948,1428,6,40,13,7,1494
E01032949,1064,18,12,8,4,1106
E01032950,1302,21,18,8,3,1352
E01032951,1388,13,24,12,0,1437
E01032952,1111,10,18,6,1,1146
E01032953,1604,19,28,19,2,1672
E01032954,2137,17,22,7,3,2186
E01032955,1003,26,53,25,5,1112
E01032956,1174,11,43,18,3,1249
E01032957,974,19,45,34,4,1076
E01032958,1207,8,8,4,4,1231
E01032959,948,30,127,38,10,1153
E01032960,2267,20,23,24,6,2340
E01032961,701,19,79,51,4,854
E01032962,1102,18,28,32,7,1187
E01032963,1140,16,26,43,4,1229
E01032964,1130,18,33,60,8,1249
E01032965,889,26,25,63,3,1006
E01032966,1073,23,50,102,3,1251
E01032967,989,12,37,115,3,1156
E01032968,2525,114,129,145,11,2924
E01032969,882,15,12,8,1,918
E01032970,1039,13,21,10,0,1083
E01032971,806,19,20,5,0,850
E01032972,1181,5,2,5,0,1193
E01032973,1112,14,18,10,6,1160
E01032974,991,9,5,7,0,1012
E01032975,1144,39,60,29,8,1280
E01032976,964,20,32,11,9,1036
E01032977,1040,35,97,43,11,1226
E01032978,767,38,103,211,43,1162
E01032979,709,69,78,183,9,1048
E01032980,969,47,93,83,9,1201
E01032981,1081,37,69,44,8,1239
E01032982,862,14,75,22,3,976
E01032983,903,16,77,26,6,1028
E01032984,944,9,105,24,4,1086
E01032985,1234,5,16,2,1,1258
E01032986,933,9,12,4,1,959
E01032987,1060,8,8,4,0,1080
E01032988,1096,4,15,4,0,1119
E01032989,991,13,22,5,3,1034
E01032990,1688,11,17,5,6,1727
E01032991,1165,3,19,2,2,1191
E01032992,1143,5,12,2,1,1163
E01032993,1186,7,22,8,5,1228
E01032994,1045,3,4,3,1,1056
E01032995,1130,21,33,9,7,1200
E01032996,1109,8,2,0,1,1120
E01032997,903,6,2,2,0,913
E01032998,891,12,25,2,2,932
E01032999,940,7,8,1,0,956
E01033000,753,56,229,190,27,1255
E01033002,640,38,165,131,164,1138
E01033003,694,86,249,357,143,1529
E01033005,1961,117,768,304,140,3290
E01033006,2069,131,718,156,165,3239
E01033008,780,42,136,18,106,1082
E01033010,1729,88,608,69,284,2778
E01033011,1136,47,99,28,43,1353
E01033013,818,25,98,84,24,1049
E01033015,892,46,135,15,45,1133
E01033016,765,39,115,25,52,996
E01033018,867,31,162,9,36,1105
E01033019,1378,51,155,25,57,1666
E01033021,850,47,53,87,14,1051
E01033022,940,31,108,34,5,1118
E01033023,1132,28,70,34,9,1273
E01033024,986,19,89,50,10,1154
E01033025,822,14,76,30,9,951
E01033026,1030,19,76,55,1,1181
E01033027,952,20,95,51,4,1122
E01033028,879,59,162,22,13,1135
E01033029,935,36,134,30,26,1161
E01033030,544,31,653,65,31,1324
E01033031,778,56,162,112,52,1160
E01033032,841,33,225,45,43,1187
E01033033,1272,42,140,33,47,1534
E01033034,836,37,76,30,25,1004
E01033035,331,84,203,325,132,1075
E01033036,1200,12,6,8,6,1232
E01033037,1099,11,9,13,2,1134
E01033038,1388,14,9,9,5,1425
E01033039,838,10,4,3,2,857
E01033040,1359,76,54,123,6,1618
E01033041,817,6,2,2,1,828
E01033042,1896,11,18,24,5,1954
E01033043,981,17,14,13,6,1031
E01033044,946,25,25,5,7,1008
E01033045,720,13,27,10,8,778
E01033046,929,25,16,8,9,987
E01033047,918,12,26,1,2,959
E01033048,1066,15,21,4,0,1106
E01033049,1058,12,12,5,4,1091
E01033050,945,14,28,5,5,997
E01033051,1902,10,11,3,2,1928
E01033052,1389,16,25,16,1,1447
E01033053,1196,11,26,22,5,1260
E01033054,802,7,8,5,3,825
E01033055,1079,11,14,4,1,1109
E01033056,1039,10,10,2,0,1061
E01033057,1870,10,23,3,0,1906
E01033058,1741,51,550,66,33,2441
E01033059,1087,4,43,6,8,1148
E01033060,1702,67,106,78,13,1966
E01033061,1329,11,49,7,13,1409
E01033062,1937,26,28,6,1,1998
E01033063,938,15,42,16,9,1020
E01033064,1003,18,57,16,11,1105
E01033065,941,3,6,2,2,954
E01033066,1709,15,11,13,3,1751
E01033067,1079,27,67,28,18,1219
E01033068,916,18,119,8,16,1077
E01033069,965,12,47,5,12,1041
E01033070,1283,23,133,20,25,1484
E01033071,986,16,69,18,13,1102
E01033072,2003,7,6,2,0,2018
E01033073,1368,20,122,19,11,1540
E01033074,1699,10,13,7,7,1736
E01033075,1638,5,13,2,1,1659
E01033076,1201,4,5,2,0,1212
E01033077,1467,4,2,0,2,1475
E01033078,1415,11,35,8,2,1471
E01033079,912,7,5,2,2,928
E01033080,1817,46,107,47,17,2034
E01033081,750,42,142,50,61,1045
E01033082,823,31,112,57,26,1049
E01033083,215,20,1006,41,24,1306
E01033084,489,36,696,78,58,1357
E01033085,1034,87,128,171,77,1497
E01033086,473,50,64,187,60,834
E01033087,1030,21,58,27,10,1146
E01033088,955,32,98,9,6,1100
E01033089,1028,10,112,25,4,1179
E01033090,941,30,55,22,14,1062
E01033091,1290,34,55,8,2,1389
E01033092,869,34,109,19,15,1046
E01033093,1156,32,95,35,22,1340
E01033094,814,15,24,15,26,894
E01033095,1517,7,5,0,0,1529
E01033096,2105,18,13,8,1,2145
E01033097,861,14,22,10,11,918
E01033098,640,41,134,31,89,935
E01033099,584,39,66,175,24,888
E01033100,702,58,103,204,36,1103
E01033101,845,42,141,35,61,1124
E01033102,1176,16,28,9,4,1233
E01033103,1278,9,43,5,8,1343
E01033104,1098,29,51,36,56,1270
E01033105,1094,15,15,7,8,1139
E01033106,884,11,10,19,6,930
E01033107,949,13,38,12,11,1023
E01033108,1056,11,10,11,10,1098
E01033109,1001,29,79,28,52,1189
E01033110,1163,17,15,15,13,1223
E01033111,1172,16,26,2,3,1219
E01033112,991,14,22,9,15,1051
E01033113,670,19,74,17,5,785
E01033114,931,20,96,22,10,1079
E01033115,815,10,80,25,5,935
E01033116,1195,8,52,14,5,1274
E01033117,757,13,80,24,15,889
E01033118,1039,15,57,4,8,1123
E01033119,1054,25,149,29,8,1265
E01033120,980,29,115,24,11,1159
E01033121,954,31,142,47,8,1182
E01033122,948,41,34,33,27,1083
E01033123,1330,33,65,31,8,1467
E01033124,932,46,50,42,5,1075
E01033125,750,25,102,31,12,920
E01033126,896,51,229,48,10,1234
E01033127,998,31,56,24,5,1114
E01033128,836,20,23,22,2,903
E01033129,753,33,182,63,40,1071
E01033130,754,39,27,42,47,909
E01033131,926,36,72,41,10,1085
E01033132,567,57,90,122,82,918
E01033133,756,52,100,105,43,1056
E01033135,826,21,39,11,13,910
E01033137,1140,18,29,16,4,1207
E01033138,1159,8,48,8,2,1225
E01033139,1011,25,87,40,16,1179
E01033140,869,13,76,13,11,982
E01033141,831,16,56,17,11,931
E01033142,1416,22,70,26,5,1539
E01033143,2194,13,21,5,2,2235
E01033144,1159,20,80,29,9,1297
E01033145,1089,8,31,9,2,1139
E01033146,495,58,108,359,86,1106
E01033148,637,58,118,434,70,1317
E01033150,527,102,130,336,56,1151
E01033151,474,57,93,356,74,1054
E01033153,581,70,477,602,106,1836
E01033154,1490,25,136,27,9,1687
E01033156,1281,9,2,2,1,1295
E01033158,1066,7,6,2,0,1081
E01033159,805,5,38,8,0,856
E01033160,1628,8,3,1,2,1642
E01033161,1237,3,5,0,1,1246
E01033163,1525,3,10,1,5,1544
E01033164,1994,65,122,12,20,2213
E01033166,712,49,91,75,29,956
E01033167,654,28,183,70,28,963
E01033168,902,14,76,10,2,1004
E01033169,899,24,217,22,4,1166
E01033170,891,6,67,15,2,981
E01033171,1002,33,86,34,7,1162
E01033172,1070,47,82,55,30,1284
E01033173,1216,21,144,35,9,1425
E01033174,768,35,63,32,2,900
E01033175,882,21,90,36,5,1034
E01033176,1039,26,79,22,9,1175
E01033177,876,23,67,30,16,1012
E01033178,859,45,76,38,11,1029
E01033179,1083,13,48,26,7,1177
E01033180,926,32,79,55,6,1098
E01033181,981,29,67,36,16,1129
E01033182,1066,14,25,34,14,1153
E01033183,808,13,56,17,7,901
E01033184,1989,21,66,61,13,2150
E01033185,1074,2,4,4,5,1089
E01033186,1132,5,5,13,1,1156
E01033187,1446,39,46,73,8,1612
E01033188,1084,9,36,11,1,1141
E01033189,1046,16,71,22,5,1160
E01033190,933,23,70,24,13,1063
E01033191,1002,9,17,4,3,1035
E01033192,1003,22,29,34,4,1092
E01033193,1163,6,25,9,0,1203
E01033194,1565,28,364,147,94,2198
E01033195,1223,24,65,8,7,1327
E01033197,1826,42,86,12,12,1978
E01033198,1252,6,8,2,0,1268
E01033200,1982,48,31,145,13,2219
E01033202,949,2,2,0,1,954
E01033203,2266,5,3,2,3,2279
E01033205,1190,6,17,0,5,1218
E01033206,1192,2,8,1,2,1205
E01033207,959,76,79,289,40,1443
E01033208,919,72,263,157,87,1498
E01033209,897,11,41,3,3,955
E01033210,1959,9,24,2,4,1998
E01033211,987,7,32,6,12,1044
E01033212,1189,12,76,10,6,1293
E01033213,1159,9,92,12,7,1279
E01033214,1227,15,34,9,9,1294
E01033215,1056,7,32,3,4,1102
E01033216,1836,36,131,47,15,2065
E01033217,694,27,128,53,31,933
E01033218,1126,16,53,3,4,1202
E01033219,1134,11,47,6,7,1205
E01033220,822,33,100,76,39,1070
E01033221,3714,95,509,54,68,4440
E01033223,927,41,152,18,69,1207
E01033224,655,23,136,26,43,883
E01033226,616,29,208,35,21,909
E01033228,1427,16,4,1,2,1450
E01033229,1169,5,11,0,2,1187
E01033231,815,12,1112,4,11,1954
E01033232,1079,11,31,11,6,1138
E01033233,3908,112,632,61,47,4760
E01033234,1089,8,25,9,10,1141
E01033235,1061,7,10,4,7,1089
E01033236,879,8,11,1,3,902
E01033237,1022,10,17,0,4,1053
E01033239,2047,7,14,1,0,2069
E01033241,947,18,37,11,8,1021
E01033242,782,32,85,17,10,926
E01033243,1040,9,9,5,2,1065
E01033244,1787,20,20,23,3,1853
E01033245,793,2,9,2,1,807
E01033246,977,7,21,5,4,1014
E01033247,926,16,68,25,6,1041
E01033248,875,14,39,14,4,946
E01033249,956,18,76,17,5,1072
E01033250,966,8,35,9,6,1024
E01033251,818,18,20,0,4,860
E01033252,1052,2,14,3,2,1073
E01033253,1156,24,151,15,19,1365
E01033254,936,16,84,7,19,1062
E01033255,1205,12,52,4,9,1282
E01033256,1048,34,82,11,11,1186
E01033257,1945,13,91,11,12,2072
E01033258,357,18,1639,9,15,2038
E01033259,1205,10,32,12,2,1261
E01033260,1167,15,21,21,1,1225
E01033261,850,32,582,133,126,1723
E01033262,901,32,629,96,58,1716
E01033263,776,15,159,83,151,1184
E01033264,909,20,280,128,113,1450
E01033265,943,33,191,51,66,1284
E01033266,893,26,395,86,133,1533
E01033267,856,30,317,74,89,1366
E01033268,1524,60,200,127,50,1961
E01033269,326,64,227,415,237,1269
E01033270,694,47,203,217,105,1266
E01033271,553,40,185,221,125,1124
E01033272,679,31,119,146,54,1029
E01033273,1617,40,469,98,48,2272
E01033274,2008,45,252,30,21,2356
E01033275,1108,14,48,40,16,1226
E01033276,1194,59,1306,191,132,2882
E01033277,1572,26,32,65,32,1727
E01033278,1902,13,17,16,5,1953
E01033279,1845,7,19,40,6,1917
E01033280,1252,10,14,15,12,1303
E01033281,1782,22,288,2,4,2098
E01033282,3317,119,457,47,48,3988
E01033283,1067,10,47,5,11,1140
E01033285,855,33,65,7,26,986
E01033286,908,27,25,6,7,973
E01033288,917,8,22,6,8,961
E01033289,1890,6,25,5,4,1930
E01033291,1336,5,6,2,1,1350
E01033292,1004,10,6,2,0,1022
E01033294,1930,10,8,4,1,1953
E01033296,1122,6,34,7,3,1172
E01033297,1148,10,47,7,1,1213
E01033299,1501,15,65,12,9,1602
E01033300,829,11,115,14,20,989
E01033302,1118,9,115,11,10,1263
E01033303,919,9,28,5,8,969
E01033305,948,13,83,19,6,1069
E01033306,1279,10,54,19,6,1368
E01033308,1362,86,742,404,128,2722
E01033310,1020,20,149,49,15,1253
E01033311,1036,20,90,75,12,1233
E01033313,995,16,84,49,4,1148
E01033314,915,46,452,251,39,1703
E01033316,1130,13,13,10,0,1166
E01033317,1145,14,19,3,3,1184
E01033319,1376,13,21,9,3,1422
E01033320,649,65,120,353,32,1219
E01033322,632,59,139,226,15,1071
E01033324,817,60,109,293,49,1328
E01033325,748,38,285,43,26,1140
E01033327,744,62,176,268,61,1311
E01033328,1174,43,50,22,19,1308
E01033329,1269,71,307,52,72,1771
E01033330,1048,38,45,89,13,1233
E01033331,1731,56,163,53,20,2023
E01033333,1790,51,126,40,22,2029
E01033334,1110,12,54,13,0,1189
E01033336,1177,4,28,9,10,1228
E01033338,1157,9,30,18,15,1229
E01033339,1063,12,17,4,7,1103
E01033341,467,54,158,250,60,989
E01033342,1079,66,438,135,70,1788
E01033344,1096,56,320,56,21,1549
E01033345,846,35,352,49,20,1302
E01033347,576,64,83,202,30,955
E01033348,464,48,54,269,16,851
E01033350,896,21,33,25,9,984
E01033352,876,61,57,109,9,1112
E01033353,778,69,84,108,21,1060
E01033355,833,54,94,43,7,1031
E01033356,609,39,64,321,18,1051
E01033358,926,95,116,384,50,1571
E01033359,918,48,93,69,10,1138
E01033361,1059,42,52,23,7,1183
E01033362,907,36,52,20,11,1026
E01033364,1304,34,20,16,3,1377
E01033366,248,66,33,560,37,944
E01033367,760,53,71,226,13,1123
E01033369,464,45,65,392,28,994
E01033370,741,43,87,88,17,976
E01033372,1018,6,16,3,2,1045
E01033373,1018,9,4,4,2,1037
E01033375,905,4,16,4,0,929
E01033376,811,8,13,1,1,834
E01033378,1094,0,9,1,1,1105
E01033380,975,20,152,22,193,1362
E01033381,900,27,144,33,128,1232
E01033383,899,16,89,26,25,1055
E01033384,1226,13,48,6,16,1309
E01033386,1422,13,401,8,20,1864
E01033387,928,11,41,17,2,999
E01033388,1043,14,29,17,1,1104
E01033389,1012,10,23,6,1,1052
E01033390,1051,15,50,6,8,1130
E01033391,987,4,5,1,1,998
E01033392,1818,17,15,7,1,1858
E01033393,1579,20,43,10,4,1656
E01033394,1074,4,4,1,2,1085
E01033395,869,125,834,204,83,2115
E01033396,540,72,173,141,16,942
E01033397,992,59,103,145,8,1307
E01033398,634,87,93,127,14,955
E01033399,990,100,671,158,55,1974
E01033400,650,83,175,119,35,1062
E01033401,494,53,237,73,115,972
E01033402,685,68,189,52,41,1035
E01033403,680,82,149,39,57,1007
E01033404,2885,167,447,153,52,3704
E01033405,661,96,336,101,69,1263
E01033406,604,74,253,50,50,1031
E01033407,640,48,250,49,49,1036
E01033408,2494,132,394,135,44,3199
E01033409,923,96,370,89,42,1520
E01033410,1618,67,691,92,77,2545
E01033411,467,94,90,186,15,852
E01033412,1968,14,29,10,4,2025
E01033413,1812,6,13,4,1,1836
E01033414,1889,11,19,3,3,1925
E01033415,858,55,374,63,40,1390
E01033417,785,22,161,36,6,1010
E01033418,622,36,232,74,48,1012
E01033420,601,27,276,62,49,1015
E01033421,793,49,379,193,42,1456
E01033422,660,26,200,88,25,999
E01033423,703,25,216,70,24,1038
E01033424,346,69,463,283,65,1226
E01033425,1310,18,33,12,6,1379
E01033426,989,11,39,11,7,1057
E01033427,910,9,16,15,1,951
E01033428,1094,20,33,9,9,1165
E01033429,1556,3,18,8,2,1587
E01033430,1050,14,27,25,5,1121
E01033431,802,27,98,55,6,988
E01033432,1656,30,79,46,10,1821
E01033433,1716,39,24,51,13,1843
E01033434,875,12,70,14,5,976
E01033435,1099,35,138,67,84,1423
E01033436,1018,7,51,19,24,1119
E01033437,1093,29,53,22,5,1202
E01033438,1198,24,60,10,11,1303
E01033439,1199,21,56,26,14,1316
E01033440,811,32,85,29,13,970
E01033441,955,33,121,19,15,1143
E01033442,1013,18,43,15,2,1091
E01033443,1338,13,10,21,6,1388
E01033444,937,13,54,10,4,1018
E01033445,1272,9,20,2,3,1306
E01033446,2013,43,45,85,8,2194
E01033447,1102,4,18,4,1,1129
E01033448,1018,5,6,3,2,1034
E01033449,1276,10,14,5,1,1306
E01033450,2054,5,19,1,0,2079
E01033451,939,29,27,66,29,1090
E01033452,1001,24,13,23,11,1072
E01033453,2197,138,81,207,102,2725
E01033454,915,27,12,26,12,992
E01033455,406,59,153,238,78,934
E01033456,272,83,244,907,71,1577
E01033457,407,57,706,111,109,1390
E01033458,1015,17,39,32,4,1107
E01033459,1438,12,35,21,4,1510
E01033460,973,10,25,16,2,1026
E01033461,1073,21,13,14,1,1122
E01033462,778,11,35,15,1,840
E01033463,731,33,1422,163,122,2471
E01033464,591,50,1035,386,134,2196
E01033465,1349,5,32,1,1,1388
E01033466,1513,5,3,2,0,1523
E01033467,949,4,13,1,0,967
E01033468,1337,56,559,47,85,2084
E01033469,1404,15,64,11,11,1505
E01033470,1297,11,130,9,5,1452
E01033471,1593,3,3,3,4,1606
E01033472,1982,8,7,6,1,2004
E01033473,1657,3,1,2,3,1666
E01033474,1110,13,61,4,3,1191
E01033475,1102,9,110,11,6,1238
E01033476,1146,17,99,5,6,1273
E01033477,1490,37,459,62,24,2072
E01033478,1215,8,76,5,8,1312
E01033479,1221,10,58,3,4,1296
E01033480,1351,6,37,1,1,1396
E01033481,998,11,18,4,2,1033
E01033482,1193,8,22,7,1,1231
E01033483,811,12,37,8,0,868
E01033484,986,11,25,10,0,1032
E01033485,591,87,307,474,95,1554
E01033486,567,56,81,115,39,858
E01033487,694,55,192,85,37,1063
E01033488,644,62,128,138,50,1022
E01033489,1280,67,308,52,45,1752
E01033490,925,56,395,99,51,1526
E01033491,1045,106,129,163,46,1489
E01033492,898,58,147,100,20,1223
E01033493,1027,55,95,42,17,1236
E01033494,1013,42,93,106,34,1288
E01033495,986,5,37,13,6,1047
E01033496,1278,8,17,2,2,1307
E01033497,806,18,36,44,11,915
E01033498,861,16,78,132,10,1097
E01033499,823,45,212,138,14,1232
E01033500,825,39,291,86,12,1253
E01033501,1114,40,147,149,8,1458
E01033503,980,20,99,54,7,1160
E01033505,1061,55,174,102,11,1403
E01033506,1174,20,139,125,9,1467
E01033508,934,37,191,77,7,1246
E01033509,811,36,152,175,9,1183
E01033511,795,40,140,161,8,1144
E01033512,1026,17,113,54,8,1218
E01033514,766,22,124,78,5,995
E01033515,1038,19,201,102,9,1369
E01033517,924,23,104,51,8,1110
E01033519,1026,32,131,126,17,1332
E01033520,1070,25,133,57,11,1296
E01033522,837,36,99,99,11,1082
E01033523,718,20,153,120,24,1035
E01033525,922,24,154,97,15,1212
E01033526,899,10,9,1,0,919
E01033527,1140,4,4,1,0,1149
E01033528,2014,8,17,1,1,2041
E01033529,873,4,1,1,0,879
E01033530,1630,2,1,2,4,1639
E01033531,1186,8,14,4,4,1216
E01033532,996,13,40,4,7,1060
E01033533,1140,16,24,6,3,1189
E01033534,782,11,22,6,3,824
E01033535,1111,11,12,4,0,1138
E01033536,1228,8,14,0,0,1250
E01033537,1308,12,18,5,0,1343
E01033538,1496,18,69,18,6,1607
E01033539,1077,8,15,8,6,1114
E01033540,1226,6,8,8,5,1253
E01033541,1132,8,22,5,0,1167
E01033542,1316,26,887,12,11,2252
E01033543,677,39,384,34,129,1263
E01033545,790,35,213,20,102,1160
E01033547,1513,21,71,19,2,1626
E01033548,818,17,139,30,41,1045
E01033550,1265,16,104,5,49,1439
E01033551,1306,12,131,12,5,1466
E01033553,1955,37,437,59,73,2561
E01033554,784,42,313,42,56,1237
E01033556,1192,64,780,121,65,2222
E01033557,1195,82,538,112,70,1997
E01033559,827,46,196,108,19,1196
E01033561,1229,97,907,401,72,2706
E01033562,1335,70,547,120,57,2129
E01033564,568,48,362,94,75,1147
E01033565,704,32,193,57,8,994
E01033567,467,44,521,65,30,1127
E01033568,768,57,248,28,80,1181
E01033569,1058,44,178,32,57,1369
E01033570,836,51,227,38,56,1208
E01033571,1027,22,85,26,36,1196
E01033572,567,48,507,117,66,1305
E01033573,595,79,397,238,96,1405
E01033574,447,39,362,99,72,1019
E01033575,440,35,363,65,64,967
E01033576,569,45,298,157,57,1126
E01033577,661,55,264,183,49,1212
E01033578,479,38,303,214,52,1086
E01033579,507,51,398,138,60,1154
E01033580,748,38,400,103,61,1350
E01033581,718,53,192,386,24,1373
E01033582,636,42,292,136,60,1166
E01033583,1123,112,739,498,112,2584
E01033584,599,35,169,319,42,1164
E01033585,955,89,399,455,56,1954
E01033586,511,45,268,260,41,1125
E01033587,532,43,264,300,20,1159
E01033588,480,41,220,329,30,1100
E01033589,197,47,878,129,30,1281
E01033590,346,41,264,155,10,816
E01033591,366,34,765,190,66,1421
E01033592,604,54,547,210,35,1450
E01033593,391,38,201,74,216,920
E01033594,723,40,198,72,200,1233
E01033595,813,43,137,45,71,1109
E01033596,807,40,140,33,69,1089
E01033597,602,33,92,69,74,870
E01033598,381,51,190,117,206,945
E01033599,610,50,170,145,130,1105
E01033600,846,37,94,36,65,1078
E01033601,563,50,347,119,117,1196
E01033602,549,58,199,172,219,1197
E01033603,635,68,176,141,123,1143
E01033604,461,59,207,68,240,1035
E01033605,757,57,290,188,290,1582
E01033606,677,47,100,62,83,969
E01033607,796,57,76,45,70,1044
E01033608,972,40,99,63,86,1260
E01033609,1799,14,29,9,0,1851
E01033610,740,42,142,185,17,1126
E01033611,843,35,105,224,10,1217
E01033612,881,22,111,157,22,1193
E01033613,841,23,103,135,24,1126
E01033614,950,33,94,220,13,1310
E01033615,498,51,327,48,48,972
E01033616,496,61,174,193,41,965
E01033617,1106,97,1411,195,119,2928
E01033618,745,36,289,29,32,1131
E01033619,655,50,178,121,6,1010
E01033620,445,34,399,68,47,993
E01033621,306,69,1129,554,45,2103
E01033622,987,86,424,100,54,1651
E01033623,651,53,201,148,33,1086
E01033624,460,45,173,136,35,849
E01033625,849,53,551,70,114,1637
E01033626,404,57,233,144,63,901
E01033627,488,53,153,167,31,892
E01033628,194,45,1020,382,26,1667
E01033629,1798,76,53,142,20,2089
E01033630,557,68,113,189,27,954
E01033631,3305,132,987,124,120,4668
E01033632,1339,66,122,216,13,1756
E01033633,1618,78,26,85,5,1812
E01033634,2708,116,903,115,53,3895
E01033635,248,47,1327,400,93,2115
E01033636,175,23,1850,232,30,2310
E01033637,211,64,1148,507,30,1960
E01033638,327,45,356,416,25,1169
E01033639,583,95,276,387,48,1389
E01033640,319,74,158,325,44,920
E01033641,390,52,1564,125,60,2191
E01033642,281,21,1485,182,76,2045
E01033643,211,39,1590,154,80,2074
E01033644,170,53,1569,200,25,2017
E01033645,528,67,1401,224,315,2535
E01033646,856,65,210,197,8,1336
E01033647,221,27,523,72,17,860
E01033648,481,52,1084,196,103,1916
E01033649,216,25,732,88,18,1079
E01033650,124,32,1378,121,69,1724
E01033651,838,34,152,29,48,1101
E01033652,769,66,443,126,49,1453
E01033653,1101,54,424,24,40,1643
E01033654,2046,86,620,102,86,2940
E01033655,879,29,199,25,27,1159
E01033656,2058,158,974,117,163,3470
E01033657,722,53,422,158,28,1383
E01033658,927,42,152,24,45,1190
E01033659,1127,26,104,15,28,1300
E01033660,1038,24,59,20,12,1153
E01033661,951,33,102,25,29,1140
E01033662,909,44,209,24,132,1318
E01033663,895,39,107,46,39,1126
E01033664,918,25,100,31,20,1094
E01033665,924,41,116,45,23,1149
E01033666,1673,52,93,253,27,2098
E01033667,839,26,68,21,29,983
E01033668,677,35,112,113,24,961
E01033669,857,54,66,133,6,1116
E01033670,936,32,109,14,41,1132
E01033671,1382,50,98,20,26,1576
E01033672,657,72,102,178,47,1056
E01033673,950,27,73,21,18,1089
E01033674,1394,110,267,133,57,1961
E01033675,756,65,307,300,41,1469
E01033676,743,35,276,126,59,1239
E01033677,693,40,258,29,122,1142
E01033678,805,46,128,165,18,1162
E01033679,782,43,82,153,16,1076
E01033680,739,60,101,115,71,1086
E01033681,1113,24,136,8,57,1338
E01033682,1087,31,95,9,19,1241
E01033683,867,33,222,28,68,1218
E01033684,981,45,101,29,24,1180
E01033685,890,20,131,111,14,1166
E01033686,642,58,157,140,59,1056
E01033687,1013,33,79,42,34,1201
E01033688,824,42,148,145,19,1178
E01033689,948,19,70,11,12,1060
E01033690,575,35,194,86,150,1040
E01033691,386,34,602,78,82,1182
E01033692,468,43,178,95,135,919
E01033693,360,30,1107,68,83,1648
E01033694,817,24,28,11,4,884
E01033695,1094,36,268,18,17,1433
E01033696,1030,31,116,15,14,1206
E01033697,375,27,1441,28,65,1936
E01033698,494,50,126,286,81,1037
E01033699,661,83,133,176,43,1096
E01033700,913,107,135,182,54,1391
E01033701,630,100,178,440,144,1492
E01033702,459,61,105,162,58,845
E01033703,673,61,133,239,70,1176
E01033704,1012,66,108,143,57,1386
E01033705,433,65,105,370,57,1030
E01033706,1048,82,144,99,43,1416
E01033707,658,46,138,244,73,1159
E01033708,1162,126,135,62,45,1530
E01033709,871,77,170,268,48,1434
E01033710,490,53,90,194,41,868
E01033711,689,62,149,90,44,1034
E01033712,847,55,120,220,41,1283
E01033713,639,85,130,202,39,1095
E01033714,1909,5,126,7,6,2053
E01033715,890,3,10,1,2,906
E01033716,1924,6,14,0,0,1944
E01033717,1139,6,14,0,2,1161
E01033718,1711,6,8,5,0,1730
E01033719,830,60,351,134,169,1544
E01033720,1334,25,64,28,27,1478
E01033721,1078,12,102,33,14,1239
E01033722,1125,35,102,52,34,1348
E01033723,1407,30,92,115,13,1657
E01033724,2269,175,1403,439,207,4493
E01033725,1411,34,341,138,64,1988
E01033726,1180,62,221,340,44,1847
E01033727,1178,96,400,400,51,2125
E01033728,800,25,188,54,13,1080
E01033729,1960,84,267,183,26,2520
E01033730,768,54,116,79,17,1034
E01033731,562,49,113,130,22,876
E01033732,501,43,214,73,18,849
E01033733,603,27,290,33,17,970
E01033734,676,54,123,152,17,1022
E01033735,448,46,145,224,33,896
E01033736,736,35,115,100,22,1008
E01033737,505,23,230,307,38,1103
E01033738,751,34,167,72,16,1040
E01033739,422,41,107,460,20,1050
E01033740,407,43,178,433,30,1091
E01033741,854,119,225,663,47,1908
E01033742,537,37,154,334,39,1101
E01033743,413,52,112,699,26,1302
E01033744,710,52,186,413,26,1387
E01033745,522,33,94,544,27,1220
E01033746,1077,39,65,64,11,1256
E01033747,735,9,22,18,38,822
E01033748,1037,21,72,37,21,1188
E01033749,950,29,71,37,33,1120
E01033750,1146,42,97,46,42,1373
E01033751,1470,39,181,51,35,1776
E01033752,963,23,85,23,67,1161
E01033753,818,30,73,28,74,1023
E01033754,1126,63,95,41,38,1363
E01033755,882,27,84,24,31,1048
E01033756,860,26,146,37,78,1147
E01033757,597,74,209,63,28,971
E01033758,948,34,575,40,86,1683
E01033759,843,8,10,21,4,886
E01033760,1598,51,340,66,45,2100
E01033761,1085,43,122,30,72,1352
E01033762,1475,31,155,47,64,1772
E01033763,1133,43,102,77,45,1400
E01033764,1742,15,30,44,16,1847
E01033765,971,35,36,20,18,1080
E01033766,886,29,20,16,10,961
E01033767,812,16,14,13,24,879
E01033768,774,115,67,111,63,1130
W01000001,979,4,5,3,1,992
W01000002,1045,4,2,0,1,1052
W01000003,2044,5,14,4,1,2068
W01000004,1062,5,4,1,1,1073
W01000005,1643,8,6,5,4,1666
W01000006,1287,7,5,0,0,1299
W01000007,1437,5,3,0,1,1446
W01000008,1211,3,39,0,12,1265
W01000009,1521,8,6,4,4,1543
W01000010,1607,6,1,0,1,1615
W01000011,1015,13,60,2,13,1103
W01000012,1226,7,7,0,2,1242
W01000013,1832,14,20,3,9,1878
W01000014,1634,7,8,0,7,1656
W01000015,1302,7,35,1,0,1345
W01000016,936,6,15,8,0,965
W01000017,1205,8,6,1,3,1223
W01000018,1132,4,3,0,0,1139
W01000019,1331,6,0,2,1,1340
W01000020,1120,0,1,1,1,1123
W01000021,1910,7,3,5,3,1928
W01000022,1342,5,2,1,8,1358
W01000023,1156,3,8,0,0,1167
W01000024,1073,9,9,3,6,1100
W01000025,1642,16,12,2,3,1675
W01000026,1073,4,1,3,2,1083
W01000027,1496,10,8,5,3,1522
W01000028,1574,8,4,0,0,1586
W01000029,1167,12,8,2,2,1191
W01000030,1762,20,7,0,3,1792
W01000031,1282,2,3,0,2,1289
W01000032,897,3,0,2,1,903
W01000033,1193,9,5,1,5,1213
W01000034,951,4,3,0,0,958
W01000035,1537,15,7,1,1,1561
W01000036,856,13,8,0,5,882
W01000037,967,6,0,1,1,975
W01000038,1825,24,4,4,0,1857
W01000039,916,4,3,0,0,923
W01000040,1021,3,3,0,1,1028
W01000041,1153,4,9,2,0,1168
W01000042,1661,14,47,2,24,1748
W01000043,970,7,2,2,2,983
W01000044,959,6,2,0,0,967
W01000047,1080,7,10,0,0,1097
W01000048,1107,11,12,1,4,1135
W01000049,936,7,5,4,2,954
W01000050,1102,7,7,1,5,1122
W01000051,1620,9,5,1,2,1637
W01000052,922,4,1,2,1,930
W01000053,965,7,1,1,4,978
W01000054,940,6,4,1,4,955
W01000056,1492,7,7,6,4,1516
W01000057,1216,6,5,2,1,1230
W01000059,1622,9,19,0,3,1653
W01000060,1095,6,3,1,1,1106
W01000061,1469,7,13,2,3,1494
W01000062,1339,35,219,23,79,1695
W01000063,1462,6,4,1,4,1477
W01000064,1283,14,88,4,46,1435
W01000065,932,6,4,1,6,949
W01000066,994,8,4,1,0,1007
W01000067,1033,6,6,2,0,1047
W01000068,1177,4,13,0,3,1197
W01000069,1340,6,2,0,0,1348
W01000070,1051,7,2,1,2,1063
W01000071,1813,24,15,1,5,1858
W01000072,1347,10,88,2,21,1468
W01000073,1392,3,5,0,0,1400
W01000074,1688,19,22,3,0,1732
W01000075,1100,18,95,14,24,1251
W01000076,1108,27,38,4,17,1194
W01000077,1061,9,105,9,48,1232
W01000078,1364,5,0,0,2,1371
W01000079,929,5,1,3,2,940
W01000080,1518,18,10,4,11,1561
W01000081,1673,13,8,1,2,1697
W01000082,879,4,1,0,0,884
W01000083,1063,4,5,1,0,1073
W01000084,997,3,2,6,4,1012
W01000085,1709,6,11,16,1,1743
W01000086,1800,9,3,3,2,1817
W01000087,1470,8,3,1,5,1487
W01000088,1570,5,3,0,2,1580
W01000089,1651,7,2,0,0,1660
W01000090,1014,8,23,1,6,1052
W01000091,842,15,26,9,6,898
W01000092,3278,76,542,55,65,4016
W01000093,1876,4,21,1,2,1904
W01000094,1027,3,0,0,0,1030
W01000095,1091,7,0,1,0,1099
W01000096,962,7,9,4,3,985
W01000097,907,11,3,0,3,924
W01000098,1653,15,16,3,0,1687
W01000099,1399,9,5,2,2,1417
W01000100,851,1,1,6,0,859
W01000101,1186,7,5,1,1,1200
W01000102,825,8,109,18,34,994
W01000103,948,7,29,6,17,1007
W01000104,1444,9,4,5,0,1462
W01000105,1392,6,15,1,4,1418
W01000106,1523,14,17,0,4,1558
W01000107,1055,0,8,1,0,1064
W01000108,1746,10,7,0,2,1765
W01000109,1544,15,4,1,1,1565
W01000110,1169,7,20,4,2,1202
W01000111,1217,11,25,0,6,1259
W01000112,1485,7,24,1,4,1521
W01000113,1503,4,6,1,6,1520
W01000114,1303,5,5,3,7,1323
W01000115,1753,22,1,1,2,1779
W01000116,1482,6,11,0,0,1499
W01000117,1279,6,17,0,1,1303
W01000118,1329,3,5,1,0,1338
W01000119,1805,8,33,5,59,1910
W01000121,1037,1,5,0,1,1044
W01000122,1772,4,11,6,3,1796
W01000123,1487,5,14,1,0,1507
W01000124,1690,11,1,2,1,1705
W01000125,1264,8,2,3,0,1277
W01000126,1386,10,9,2,1,1408
W01000127,1061,9,3,0,3,1076
W01000128,1212,13,11,1,2,1239
W01000129,884,0,0,0,2,886
W01000130,1296,17,14,2,2,1331
W01000131,1172,5,5,1,4,1187
W01000132,1264,16,41,3,12,1336
W01000133,1626,10,22,1,2,1661
W01000134,1723,13,8,2,1,1747
W01000135,1815,8,22,0,3,1848
W01000136,1515,13,26,4,0,1558
W01000137,1274,2,0,2,0,1278
W01000138,1494,7,11,0,2,1514
W01000139,1319,9,18,3,7,1356
W01000140,1178,5,9,0,2,1194
W01000141,1362,10,15,0,0,1387
W01000142,1367,9,32,1,3,1412
W01000143,1178,7,42,2,5,1234
W01000144,1153,20,25,3,6,1207
W01000145,999,13,14,0,1,1027
W01000146,1912,23,42,14,10,2001
W01000147,1302,10,13,1,2,1328
W01000148,935,5,0,0,0,940
W01000149,1232,10,21,4,0,1267
W01000150,1212,6,15,0,1,1234
W01000151,1162,6,21,3,1,1193
W01000152,1190,5,13,5,1,1214
W01000153,1291,7,12,2,0,1312
W01000154,1260,1,7,0,1,1269
W01000155,1317,2,14,3,10,1346
W01000156,1339,7,17,3,2,1368
W01000157,1187,12,8,2,5,1214
W01000158,1383,5,12,1,4,1405
W01000159,1182,6,6,0,1,1195
W01000162,1544,3,5,1,2,1555
W01000163,953,6,4,2,1,966
W01000164,1065,5,9,2,2,1083
W01000165,1624,5,10,1,1,1641
W01000166,1532,11,8,4,4,1559
W01000167,1490,9,24,1,2,1526
W01000168,1399,10,7,1,4,1421
W01000169,1578,19,35,6,6,1644
W01000170,1501,13,4,2,2,1522
W01000171,1305,11,7,3,1,1327
W01000172,1020,9,3,2,0,1034
W01000173,1201,7,8,1,5,1222
W01000174,1368,9,14,3,10,1404
W01000175,1417,8,14,2,5,1446
W01000176,1256,7,16,2,3,1284
W01000177,1007,5,6,1,1,1020
W01000178,1476,7,28,2,1,1514
W01000179,1418,5,8,0,1,1432
W01000180,1288,8,34,13,15,1358
W01000181,1160,8,32,1,10,1211
W01000182,1610,10,38,13,8,1679
W01000183,1180,15,47,2,4,1248
W01000184,2035,4,11,6,0,2056
W01000185,1028,6,5,1,1,1041
W01000186,1390,11,12,4,5,1422
W01000187,1071,11,20,5,5,1112
W01000188,1435,7,22,1,11,1476
W01000189,1237,9,7,1,0,1254
W01000190,1170,0,3,1,0,1174
W01000191,1622,10,73,3,5,1713
W01000192,863,5,4,2,1,875
W01000193,1068,3,1,0,5,1077
W01000194,1678,11,62,5,5,1761
W01000195,1158,6,5,0,1,1170
W01000196,1166,2,24,1,5,1198
W01000197,1330,7,16,3,0,1356
W01000198,1108,4,6,2,1,1121
W01000199,1380,7,7,6,2,1402
W01000200,1027,7,5,0,1,1040
W01000201,1148,9,8,0,1,1166
W01000202,1313,9,2,1,1,1326
W01000203,2020,10,10,1,2,2043
W01000204,1227,8,0,0,1,1236
W01000205,936,9,4,0,0,949
W01000206,1727,10,8,4,3,1752
W01000207,1852,11,12,2,2,1879
W01000208,1054,10,4,0,3,1071
W01000209,1236,6,6,0,5,1253
W01000210,1162,12,2,2,0,1178
W01000211,1529,4,6,1,1,1541
W01000212,1805,8,22,2,0,1837
W01000213,1021,1,18,1,2,1043
W01000214,884,4,15,3,2,908
W01000215,1169,8,15,4,3,1199
W01000216,1110,11,10,0,3,1134
W01000217,1606,7,16,1,0,1630
W01000218,1259,3,22,2,0,1286
W01000219,1911,17,27,5,2,1962
W01000220,1490,2,9,1,4,1506
W01000221,1103,12,9,8,0,1132
W01000222,1432,6,1,2,0,1441
W01000223,1100,8,12,0,0,1120
W01000224,1154,5,9,0,0,1168
W01000225,1241,3,6,2,2,1254
W01000226,1280,9,7,0,0,1296
W01000227,1288,7,10,9,1,1315
W01000228,941,6,7,2,4,960
W01000229,1349,11,10,0,1,1371
W01000230,1658,17,9,3,2,1689
W01000231,1133,4,27,5,1,1170
W01000232,1277,12,7,5,1,1302
W01000233,1064,7,12,1,0,1084
W01000234,1027,11,24,4,0,1066
W01000235,1052,3,10,1,0,1066
W01000236,1337,7,57,6,3,1410
W01000237,1197,11,29,0,0,1237
W01000238,1258,9,43,1,3,1314
W01000239,1311,20,91,4,8,1434
W01000240,1035,12,44,5,0,1096
W01000241,904,16,39,4,1,964
W01000242,1523,7,16,1,2,1549
W01000243,1387,14,92,5,5,1503
W01000244,1399,5,3,0,5,1412
W01000245,1363,10,19,1,2,1395
W01000246,1371,4,9,3,1,1388
W01000247,1625,7,24,3,4,1663
W01000248,1349,5,8,5,3,1370
W01000249,1023,1,2,2,0,1028
W01000250,1303,6,3,2,2,1316
W01000251,1161,7,12,0,1,1181
W01000252,1403,5,21,1,0,1430
W01000253,1548,9,7,1,1,1566
W01000254,1727,6,1,0,1,1735
W01000255,1842,14,20,1,2,1879
W01000256,1196,7,18,1,2,1224
W01000257,1745,13,13,2,0,1773
W01000258,1821,3,2,2,1,1829
W01000259,1357,6,8,0,1,1372
W01000260,1482,4,5,0,3,1494
W01000261,1290,2,10,0,0,1302
W01000262,1134,8,14,1,0,1157
W01000263,1179,7,3,0,1,1190
W01000264,1275,7,8,4,0,1294
W01000265,1112,3,3,2,0,1120
W01000266,1092,7,13,0,1,1113
W01000267,1281,7,4,2,1,1295
W01000268,1368,2,3,1,1,1375
W01000269,1347,4,9,1,1,1362
W01000270,1087,1,4,0,0,1092
W01000271,1067,3,3,0,0,1073
W01000272,1580,2,7,1,4,1594
W01000273,1246,7,17,1,3,1274
W01000274,1371,11,12,1,0,1395
W01000275,1004,4,10,0,2,1020
W01000276,1023,8,8,0,1,1040
W01000277,1052,6,7,0,4,1069
W01000278,1110,8,2,0,0,1120
W01000279,1076,3,10,0,0,1089
W01000280,1165,2,2,1,0,1170
W01000281,1005,2,3,0,2,1012
W01000282,1243,8,11,0,0,1262
W01000283,1837,11,6,1,4,1859
W01000284,1327,5,17,3,6,1358
W01000285,1208,10,17,1,1,1237
W01000286,1678,7,28,2,4,1719
W01000287,1508,7,9,2,2,1528
W01000288,1732,17,29,1,3,1782
W01000289,1087,1,2,0,0,1090
W01000290,1041,4,15,2,4,1066
W01000291,1096,3,8,1,0,1108
W01000292,1104,3,4,1,6,1118
W01000293,1255,4,5,1,2,1267
W01000294,1567,6,7,1,0,1581
W01000295,1340,2,10,0,0,1352
W01000296,1185,1,9,2,0,1197
W01000297,922,6,3,1,2,934
W01000298,1252,2,1,2,2,1259
W01000299,1639,6,4,0,0,1649
W01000300,1464,1,2,0,1,1468
W01000301,1481,5,1,0,2,1489
W01000302,1553,8,13,6,1,1581
W01000303,1342,9,6,0,2,1359
W01000304,1515,7,26,1,2,1551
W01000305,1413,2,10,2,2,1429
W01000306,1893,11,23,2,1,1930
W01000307,1116,1,0,0,0,1117
W01000308,991,2,6,2,1,1002
W01000309,1705,9,9,2,0,1725
W01000310,1542,5,7,0,0,1554
W01000311,1463,1,5,2,0,1471
W01000312,1384,4,13,0,2,1403
W01000313,1207,3,15,1,3,1229
W01000314,928,6,19,2,0,955
W01000315,1630,4,14,0,3,1651
W01000316,1065,5,10,0,0,1080
W01000317,1091,2,3,2,0,1098
W01000318,839,7,9,2,0,857
W01000319,1220,7,7,4,1,1239
W01000320,1483,5,2,0,1,1491
W01000321,1371,4,2,2,3,1382
W01000322,1126,1,4,1,0,1132
W01000323,1263,9,10,0,0,1282
W01000324,1206,2,5,0,2,1215
W01000325,1274,4,3,2,2,1285
W01000326,1366,7,4,0,0,1377
W01000327,1804,3,10,2,0,1819
W01000328,1700,13,33,2,3,1751
W01000329,1037,6,26,3,1,1073
W01000330,1598,12,34,3,0,1647
W01000331,1314,4,9,2,1,1330
W01000332,1208,5,26,0,5,1244
W01000333,1086,4,15,2,3,1110
W01000334,1576,3,29,2,2,1612
W01000335,890,4,16,1,0,911
W01000336,1054,4,19,2,0,1079
W01000337,1707,15,40,1,1,1764
W01000338,1535,5,4,3,1,1548
W01000339,1345,4,2,1,1,1353
W01000340,1899,7,11,0,3,1920
W01000341,1267,3,14,5,0,1289
W01000342,1259,11,14,5,5,1294
W01000343,904,0,4,1,0,909
W01000344,1104,3,15,2,2,1126
W01000345,1318,1,8,2,0,1329
W01000346,1297,4,2,0,1,1304
W01000347,1959,8,19,9,5,2000
W01000348,1084,8,7,2,0,1101
W01000349,1449,11,45,9,5,1519
W01000350,1039,22,283,14,10,1368
W01000351,1743,4,9,0,2,1758
W01000352,806,5,26,2,0,839
W01000353,967,18,25,8,0,1018
W01000354,1440,4,8,0,3,1455
W01000355,1329,6,3,2,1,1341
W01000356,1333,3,0,0,5,1341
W01000359,958,6,3,2,0,969
W01000360,982,2,6,1,0,991
W01000361,1638,5,5,3,1,1652
W01000362,1168,4,11,0,0,1183
W01000363,1252,4,1,3,1,1261
W01000364,1329,3,10,5,4,1351
W01000365,1754,13,106,18,5,1896
W01000366,1116,2,27,2,5,1152
W01000367,1033,4,11,1,2,1051
W01000368,1685,10,9,1,3,1708
W01000369,1071,3,4,0,1,1079
W01000370,1211,10,12,0,1,1234
W01000371,881,10,109,12,1,1013
W01000372,1139,19,142,15,10,1325
W01000373,1365,6,23,15,0,1409
W01000374,1103,5,6,6,4,1124
W01000375,1476,13,25,10,1,1525
W01000376,1116,2,3,4,2,1127
W01000377,1198,9,15,2,5,1229
W01000378,956,9,10,0,0,975
W01000379,1264,13,8,5,1,1291
W01000380,1210,6,14,4,0,1234
W01000381,916,8,28,7,0,959
W01000382,851,6,17,9,1,884
W01000383,1846,1,31,7,8,1893
W01000384,931,3,5,1,0,940
W01000385,1423,6,18,4,2,1453
W01000386,1171,6,12,1,6,1196
W01000387,1033,2,3,4,0,1042
W01000388,875,3,13,2,2,895
W01000389,1640,8,9,3,0,1660
W01000390,1403,2,5,2,4,1416
W01000391,1185,2,1,0,2,1190
W01000392,1282,5,8,0,1,1296
W01000393,1563,9,28,10,2,1612
W01000394,1043,2,6,2,2,1055
W01000395,893,1,5,3,0,902
W01000396,987,10,12,3,2,1014
W01000397,839,8,10,2,2,861
W01000398,1075,6,5,2,0,1088
W01000399,945,1,5,1,1,953
W01000400,1308,3,18,8,1,1338
W01000401,1387,4,7,5,0,1403
W01000402,1958,19,239,28,13,2257
W01000403,1103,2,1,0,0,1106
W01000404,1575,4,9,2,1,1591
W01000405,1728,4,19,5,3,1759
W01000406,1644,14,3,6,6,1673
W01000407,1104,7,6,3,1,1121
W01000408,922,4,3,2,7,938
W01000409,1350,6,18,20,2,1396
W01000410,1330,7,7,4,0,1348
W01000411,1267,4,5,7,0,1283
W01000412,1292,5,13,5,1,1316
W01000413,887,13,16,9,0,925
W01000414,856,9,17,15,4,901
W01000415,1240,9,20,2,1,1272
W01000416,1032,2,14,4,0,1052
W01000417,1270,9,16,1,1,1297
W01000418,1342,4,8,0,4,1358
W01000419,1145,6,11,21,0,1183
W01000420,1117,3,13,11,0,1144
W01000422,1783,6,15,0,1,1805
W01000423,1558,5,37,22,4,1626
W01000424,1031,3,17,8,3,1062
W01000425,1622,5,24,24,4,1679
W01000426,1192,2,2,1,0,1197
W01000427,1163,4,4,0,0,1171
W01000428,1136,3,1,1,0,1141
W01000429,1903,1,5,4,1,1914
W01000430,1060,1,7,0,2,1070
W01000431,1026,6,10,4,0,1046
W01000432,1011,1,5,1,0,1018
W01000433,1950,8,0,1,0,1959
W01000434,1385,5,14,0,2,1406
W01000438,1082,5,1,2,0,1090
W01000439,1602,6,2,0,1,1611
W01000440,1119,0,2,0,0,1121
W01000441,1146,3,2,1,0,1152
W01000442,1694,4,1,0,0,1699
W01000443,1925,6,5,0,2,1938
W01000444,1910,5,2,2,0,1919
W01000445,1267,3,2,1,3,1276
W01000446,1350,3,5,0,1,1359
W01000447,1677,6,4,1,0,1688
W01000448,1157,4,1,0,0,1162
W01000449,1338,4,6,0,0,1348
W01000450,1155,3,2,2,0,1162
W01000451,910,0,3,1,2,916
W01000452,1605,5,2,0,2,1614
W01000453,1163,2,4,0,2,1171
W01000454,1050,9,11,1,0,1071
W01000455,1605,11,14,1,5,1636
W01000456,1695,11,9,0,2,1717
W01000457,1744,4,0,1,4,1753
W01000458,1449,4,10,0,1,1464
W01000459,979,4,5,0,0,988
W01000460,1425,5,2,3,4,1439
W01000461,1254,7,3,0,0,1264
W01000464,1047,5,3,3,5,1063
W01000465,862,5,14,1,0,882
W01000466,1151,4,2,3,1,1161
W01000467,1295,7,5,2,2,1311
W01000470,1583,2,10,3,0,1598
W01000471,1561,12,8,2,0,1583
W01000472,968,2,4,0,0,974
W01000473,1808,12,12,0,1,1833
W01000474,1422,4,4,2,1,1433
W01000475,2000,5,2,0,0,2007
W01000476,1072,2,2,2,1,1079
W01000477,1225,2,2,1,3,1233
W01000478,1232,16,6,0,0,1254
W01000479,1124,13,5,1,0,1143
W01000480,1666,10,34,4,2,1716
W01000481,1877,8,23,1,1,1910
W01000482,1481,9,14,0,0,1504
W01000483,1388,4,2,2,1,1397
W01000484,1332,3,7,1,0,1343
W01000485,1351,10,6,0,3,1370
W01000486,913,3,4,4,1,925
W01000487,1742,7,12,2,0,1763
W01000488,1775,11,9,5,1,1801
W01000489,1372,4,51,1,3,1431
W01000492,1298,14,42,0,4,1358
W01000493,1035,15,152,6,8,1216
W01000494,1404,8,5,0,4,1421
W01000496,1769,8,11,1,0,1789
W01000497,1118,2,2,3,0,1125
W01000498,1211,4,15,3,2,1235
W01000499,1054,6,7,1,1,1069
W01000500,1249,5,12,1,0,1267
W01000501,1871,10,12,4,5,1902
W01000502,1751,6,8,5,1,1771
W01000503,873,2,2,1,0,878
W01000504,921,5,7,1,0,934
W01000505,1160,9,12,0,0,1181
W01000506,1230,8,4,4,2,1248
W01000507,1030,5,5,2,0,1042
W01000508,946,4,7,19,2,978
W01000509,1463,3,19,1,2,1488
W01000510,985,9,21,0,15,1030
W01000511,900,13,11,3,0,927
W01000512,1813,39,52,15,10,1929
W01000513,2207,42,96,18,7,2370
W01000515,1108,22,24,1,3,1158
W01000516,1269,8,15,7,11,1310
W01000517,1283,24,53,12,9,1381
W01000518,1068,15,25,2,9,1119
W01000519,1390,6,4,4,2,1406
W01000522,1117,4,0,0,0,1121
W01000523,1531,7,12,15,3,1568
W01000524,1619,7,7,2,2,1637
W01000525,965,9,61,7,12,1054
W01000527,1212,15,66,17,26,1336
W01000528,1151,16,12,3,16,1198
W01000529,1293,9,4,0,2,1308
W01000531,1529,3,3,1,1,1537
W01000532,1668,5,7,3,0,1683
W01000533,1176,3,2,0,5,1186
W01000534,1206,4,15,1,12,1238
W01000535,1666,4,7,2,7,1686
W01000536,1218,3,5,3,2,1231
W01000537,1230,5,8,3,2,1248
W01000538,1259,16,3,4,3,1285
W01000539,1032,11,1,0,3,1047
W01000540,978,3,5,1,0,987
W01000541,1507,5,19,2,10,1543
W01000542,1812,7,3,2,11,1835
W01000543,1632,11,7,5,7,1662
W01000544,880,10,6,0,1,897
W01000545,1764,3,8,1,2,1778
W01000546,968,5,3,0,0,976
W01000547,978,4,2,2,0,986
W01000548,1478,10,24,3,6,1521
W01000549,1424,4,19,4,2,1453
W01000550,999,7,1,0,2,1009
W01000551,1088,8,1,1,0,1098
W01000552,1624,8,11,13,8,1664
W01000553,1074,3,3,0,0,1080
W01000554,1500,8,3,0,0,1511
W01000555,1184,5,24,1,2,1216
W01000556,993,2,0,0,0,995
W01000557,1211,4,2,1,0,1218
W01000558,1657,8,8,0,2,1675
W01000559,1209,5,2,4,2,1222
W01000560,1014,2,0,1,2,1019
W01000561,1006,2,3,0,2,1013
W01000562,1441,4,4,0,0,1449
W01000563,989,1,4,2,2,998
W01000564,1010,5,20,1,2,1038
W01000565,1566,5,9,3,2,1585
W01000566,1268,2,2,0,7,1279
W01000567,1593,11,10,0,2,1616
W01000568,1847,7,50,11,6,1921
W01000569,967,2,24,1,2,996
W01000570,971,6,20,4,5,1006
W01000571,1808,12,33,4,10,1867
W01000572,1344,9,111,16,14,1494
W01000573,1958,10,41,5,1,2015
W01000574,1564,6,5,1,1,1577
W01000575,2016,11,17,7,2,2053
W01000576,1821,6,26,1,2,1856
W01000577,1317,1,13,0,2,1333
W01000578,1414,3,5,1,1,1424
W01000579,1868,9,7,1,0,1885
W01000580,1871,8,5,3,2,1889
W01000581,1249,2,2,0,0,1253
W01000582,1360,9,7,2,0,1378
W01000583,1149,2,6,0,0,1157
W01000584,1676,4,13,1,1,1695
W01000585,1195,2,5,1,0,1203
W01000586,1712,11,20,4,3,1750
W01000587,1646,15,30,3,6,1700
W01000588,1657,2,5,0,1,1665
W01000589,903,4,0,0,0,907
W01000590,956,0,6,2,0,964
W01000591,956,2,6,0,1,965
W01000592,983,7,3,0,0,993
W01000593,2184,11,33,1,2,2231
W01000594,1750,10,7,4,4,1775
W01000595,1570,10,7,0,2,1589
W01000596,1227,3,10,8,3,1251
W01000597,973,0,5,0,0,978
W01000598,1815,6,9,7,4,1841
W01000599,1702,5,6,2,2,1717
W01000600,1329,10,13,3,4,1359
W01000601,1132,3,4,1,3,1143
W01000602,1057,10,11,2,7,1087
W01000603,1460,11,16,6,1,1494
W01000604,1153,6,10,1,0,1170
W01000605,1430,7,10,0,0,1447
W01000606,1196,4,7,0,2,1209
W01000607,1580,6,10,0,2,1598
W01000608,1177,3,8,1,6,1195
W01000609,2047,7,9,2,1,2066
W01000610,1444,6,12,4,3,1469
W01000611,1400,2,29,0,3,1434
W01000612,1538,3,8,0,0,1549
W01000613,1841,9,10,2,2,1864
W01000614,1187,0,3,1,0,1191
W01000615,1290,5,5,4,3,1307
W01000616,913,5,21,1,1,941
W01000617,1175,9,5,0,2,1191
W01000618,1549,17,3,3,1,1573
W01000619,1732,6,24,1,4,1767
W01000620,873,1,18,2,23,917
W01000621,1262,13,14,1,2,1292
W01000622,1241,2,8,1,1,1253
W01000623,1590,5,9,0,0,1604
W01000624,1885,7,13,2,0,1907
W01000625,921,2,14,0,0,937
W01000626,1161,9,20,4,3,1197
W01000627,1726,9,2,1,2,1740
W01000628,1319,4,17,0,0,1340
W01000629,1373,6,20,1,0,1400
W01000630,1292,6,15,1,3,1317
W01000631,1366,4,11,0,0,1381
W01000632,1155,3,4,0,1,1163
W01000633,1184,1,6,1,1,1193
W01000634,1185,4,7,0,1,1197
W01000635,1809,1,14,1,4,1829
W01000636,1486,5,21,1,8,1521
W01000637,1104,5,16,3,7,1135
W01000638,859,3,17,3,5,887
W01000639,1107,4,11,3,5,1130
W01000640,927,10,61,5,5,1008
W01000641,1731,20,61,7,9,1828
W01000642,1454,2,21,5,3,1485
W01000643,1271,3,22,5,3,1304
W01000644,1467,11,27,6,6,1517
W01000645,1319,6,14,5,8,1352
W01000646,1810,9,9,1,13,1842
W01000647,1245,2,8,7,1,1263
W01000648,1217,4,7,2,1,1231
W01000649,1299,4,4,2,3,1312
W01000650,1368,3,14,3,1,1389
W01000651,1279,5,12,1,0,1297
W01000652,1476,8,64,7,6,1561
W01000653,1217,5,12,0,4,1238
W01000654,1401,10,17,0,5,1433
W01000655,1547,10,29,0,3,1589
W01000656,1703,3,10,5,0,1721
W01000657,896,4,7,1,0,908
W01000658,1007,4,6,0,1,1018
W01000659,1149,8,21,0,4,1182
W01000660,1235,5,15,2,3,1260
W01000662,1772,8,12,0,0,1792
W01000663,1885,9,4,0,1,1899
W01000664,1488,7,2,3,4,1504
W01000665,1477,3,10,2,2,1494
W01000666,1151,2,3,1,2,1159
W01000667,1138,3,7,2,1,1151
W01000670,1309,4,5,3,3,1324
W01000671,1507,5,7,3,2,1524
W01000672,1358,5,2,0,1,1366
W01000673,1002,6,5,0,0,1013
W01000674,1734,12,4,1,0,1751
W01000675,1648,3,9,3,2,1665
W01000676,1280,6,4,2,2,1294
W01000677,1153,9,2,3,0,1167
W01000678,1201,9,6,2,1,1219
W01000679,1017,3,24,0,0,1044
W01000680,1645,2,6,0,2,1655
W01000681,1573,3,11,2,0,1589
W01000682,1106,2,3,0,0,1111
W01000683,890,6,6,0,5,907
W01000684,1503,8,10,2,5,1528
W01000685,1290,3,6,0,0,1299
W01000686,1034,1,7,0,2,1044
W01000687,1593,10,2,1,3,1609
W01000688,1432,4,8,5,2,1451
W01000689,1354,7,6,1,1,1369
W01000690,1423,5,15,2,1,1446
W01000691,1314,2,16,1,2,1335
W01000692,1205,2,27,7,6,1247
W01000693,892,0,1,0,0,893
W01000694,1094,3,24,1,1,1123
W01000695,1261,4,7,2,1,1275
W01000696,1303,0,2,1,0,1306
W01000697,1495,9,20,8,0,1532
W01000698,1496,5,11,4,1,1517
W01000699,1249,2,12,3,0,1266
W01000700,1710,5,7,0,1,1723
W01000701,1263,2,8,1,1,1275
W01000702,974,5,7,0,0,986
W01000703,1426,8,19,0,6,1459
W01000704,1348,7,18,1,0,1374
W01000705,1482,7,26,4,2,1521
W01000706,1269,8,14,1,0,1292
W01000707,1101,4,11,1,2,1119
W01000708,1031,5,23,4,0,1063
W01000709,1865,5,6,1,3,1880
W01000710,1806,3,9,3,0,1821
W01000711,1647,9,8,2,0,1666
W01000712,1194,4,8,3,3,1212
W01000713,1110,4,8,3,1,1126
W01000714,1183,3,4,1,1,1192
W01000715,1053,7,14,1,2,1077
W01000716,1099,4,3,0,0,1106
W01000717,1182,2,1,1,0,1186
W01000718,1135,5,9,0,1,1150
W01000719,1216,4,4,0,1,1225
W01000720,1396,6,7,0,3,1412
W01000721,1090,2,4,2,0,1098
W01000722,1127,3,12,0,1,1143
W01000723,1151,1,1,1,5,1159
W01000724,1522,6,5,1,0,1534
W01000725,1840,3,13,6,0,1862
W01000726,1274,0,24,0,3,1301
W01000727,870,2,5,0,0,877
W01000728,1750,8,0,0,2,1760
W01000729,1036,0,4,0,0,1040
W01000730,1038,10,3,0,0,1051
W01000731,1976,12,14,4,1,2007
W01000732,1140,4,16,3,11,1174
W01000733,1009,4,23,2,3,1041
W01000734,1078,5,17,6,0,1106
W01000735,1831,14,12,2,4,1863
W01000736,1418,7,7,1,8,1441
W01000737,1294,5,5,4,15,1323
W01000738,1335,13,4,15,2,1369
W01000739,1415,18,29,11,11,1484
W01000740,1395,3,12,7,1,1418
W01000741,1261,8,18,6,3,1296
W01000742,1148,12,76,40,15,1291
W01000744,1174,10,61,22,6,1273
W01000745,1479,28,345,72,117,2041
W01000746,1416,16,84,12,39,1567
W01000747,1387,20,257,46,48,1758
W01000749,1376,18,188,16,35,1633
W01000750,1253,6,13,2,5,1279
W01000751,1211,6,5,1,2,1225
W01000752,1130,1,19,4,2,1156
W01000753,1097,9,12,2,1,1121
W01000754,1247,10,23,2,3,1285
W01000755,1519,8,27,2,17,1573
W01000756,1246,7,13,3,8,1277
W01000757,1268,6,16,5,2,1297
W01000758,1447,12,59,7,44,1569
W01000759,1323,4,14,0,1,1342
W01000760,1293,9,29,5,7,1343
W01000761,1175,8,27,12,6,1228
W01000762,1198,8,23,20,4,1253
W01000763,1171,5,9,2,2,1189
W01000764,1249,5,43,15,3,1315
W01000765,1326,11,31,6,0,1374
W01000766,1228,5,8,8,2,1251
W01000767,1280,7,8,5,1,1301
W01000768,1139,10,4,1,4,1158
W01000769,1138,4,4,1,4,1151
W01000770,1269,8,10,0,6,1293
W01000771,1071,6,12,2,6,1097
W01000772,1253,7,8,3,1,1272
W01000773,2010,9,24,7,6,2056
W01000774,1324,6,9,0,5,1344
W01000775,1507,5,3,2,1,1518
W01000776,1529,4,4,2,0,1539
W01000777,1450,9,20,1,1,1481
W01000778,1463,5,18,1,10,1497
W01000779,1166,15,13,3,2,1199
W01000781,1326,6,50,10,10,1402
W01000782,919,5,7,1,4,936
W01000784,1082,2,5,1,1,1091
W01000785,1092,1,0,1,0,1094
W01000786,1157,6,6,2,0,1171
W01000787,1243,6,13,8,3,1273
W01000788,1138,5,26,8,4,1181
W01000789,1108,6,19,6,1,1140
W01000790,1114,18,234,7,11,1384
W01000791,1187,4,10,3,0,1204
W01000792,1338,4,9,0,2,1353
W01000793,1421,6,19,3,1,1450
W01000794,1633,16,46,12,9,1716
W01000795,1260,8,14,5,1,1288
W01000796,1977,9,68,17,0,2071
W01000797,1239,3,14,4,1,1261
W01000798,1191,4,22,3,2,1222
W01000799,1376,3,21,3,4,1407
W01000800,1221,6,12,0,1,1240
W01000801,1186,5,5,10,0,1206
W01000802,1863,4,14,2,0,1883
W01000803,1507,12,9,0,1,1529
W01000804,1181,12,50,4,6,1253
W01000805,934,9,23,0,16,982
W01000806,1161,9,59,4,0,1233
W01000807,1177,11,26,2,0,1216
W01000808,1207,11,30,5,8,1261
W01000809,1217,9,31,11,7,1275
W01000810,974,10,60,19,12,1075
W01000811,1233,6,7,7,1,1254
W01000812,1121,9,20,13,15,1178
W01000813,1311,4,15,1,7,1338
W01000814,1151,18,34,17,4,1224
W01000815,1334,2,12,8,2,1358
W01000816,1225,7,118,12,22,1384
W01000817,1320,9,26,14,12,1381
W01000818,1207,5,13,2,2,1229
W01000819,1243,1,7,6,3,1260
W01000820,1159,4,12,1,4,1180
W01000821,1228,1,14,6,4,1253
W01000822,1080,2,10,7,4,1103
W01000823,1438,4,11,2,1,1456
W01000824,1346,6,9,2,4,1367
W01000825,1225,7,14,3,9,1258
W01000826,1143,6,14,1,15,1179
W01000827,1114,6,15,1,5,1141
W01000828,1454,1,1,1,1,1458
W01000829,1597,4,0,2,3,1606
W01000830,1124,8,22,18,5,1177
W01000831,1312,12,40,21,12,1397
W01000832,1210,11,14,19,19,1273
W01000833,1200,10,26,24,14,1274
W01000834,1096,8,13,15,0,1132
W01000835,1083,7,11,1,2,1104
W01000836,1507,14,82,32,19,1654
W01000837,1230,5,51,9,7,1302
W01000838,976,4,7,0,2,989
W01000839,826,5,3,0,1,835
W01000840,1385,9,4,3,0,1401
W01000841,1209,5,16,1,1,1232
W01000842,1189,6,4,2,0,1201
W01000843,1093,6,12,0,2,1113
W01000844,960,2,3,4,1,970
W01000845,1617,4,3,4,1,1629
W01000846,1349,5,15,7,2,1378
W01000847,1072,3,4,1,2,1082
W01000848,921,6,2,0,0,929
W01000849,1388,10,34,10,7,1449
W01000850,1724,15,124,27,65,1955
W01000851,1190,23,42,14,5,1274
W01000852,1185,7,19,9,6,1226
W01000853,1146,12,41,7,8,1214
W01000854,1085,6,44,3,23,1161
W01000855,1248,8,37,2,5,1300
W01000856,1324,14,88,22,53,1501
W01000857,1420,14,59,3,39,1535
W01000858,1303,12,65,7,14,1401
W01000859,1161,4,73,11,26,1275
W01000860,1195,6,76,3,18,1298
W01000861,1519,28,104,26,30,1707
W01000862,1017,12,56,15,31,1131
W01000863,1094,14,32,30,20,1190
W01000864,1077,9,27,40,25,1178
W01000865,1014,4,20,19,15,1072
W01000866,865,4,20,11,17,917
W01000867,981,12,13,4,5,1015
W01000868,1123,15,22,9,2,1171
W01000869,1263,17,101,27,19,1427
W01000870,1206,20,106,31,65,1428
W01000871,1390,18,171,48,13,1640
W01000872,1072,11,39,10,18,1150
W01000873,1527,27,94,29,53,1730
W01000874,1645,34,158,23,56,1916
W01000875,1625,25,148,105,12,1915
W01000876,1676,35,151,32,18,1912
W01000877,1268,3,8,2,1,1282
W01000878,985,5,11,4,1,1006
W01000879,1432,4,16,2,22,1476
W01000880,1345,8,18,1,4,1376
W01000881,1141,7,21,0,9,1178
W01000882,1351,8,18,11,13,1401
W01000883,1218,5,8,4,0,1235
W01000884,960,8,17,8,0,993
W01000885,1023,11,35,8,3,1080
W01000886,1157,13,28,11,3,1212
W01000887,1851,11,15,1,1,1879
W01000888,1878,7,13,0,2,1900
W01000889,1505,8,9,7,2,1531
W01000890,1369,6,11,2,1,1389
W01000891,1229,5,7,0,0,1241
W01000892,1559,8,11,8,0,1586
W01000893,1635,7,3,0,0,1645
W01000894,1135,1,9,0,10,1155
W01000895,1248,10,17,4,8,1287
W01000896,1276,2,2,12,2,1294
W01000897,1074,7,16,0,2,1099
W01000898,1197,2,5,2,1,1207
W01000899,1370,3,1,1,1,1376
W01000900,1411,8,7,2,2,1430
W01000901,1362,6,4,0,1,1373
W01000902,910,1,5,0,0,916
W01000903,967,2,5,0,0,974
W01000904,1202,3,7,0,0,1212
W01000905,1205,7,12,1,1,1226
W01000906,926,6,7,1,1,941
W01000907,1362,7,12,0,0,1381
W01000908,1403,5,2,4,1,1415
W01000909,1006,7,12,8,0,1033
W01000910,1250,2,12,4,0,1268
W01000911,1032,2,11,0,0,1045
W01000912,1042,3,1,3,1,1050
W01000913,963,3,9,4,1,980
W01000914,1235,5,22,10,0,1272
W01000915,971,2,5,0,0,978
W01000916,968,4,2,0,1,975
W01000917,2121,11,28,7,11,2178
W01000918,1584,3,5,5,0,1597
W01000919,956,4,3,3,0,966
W01000920,1017,8,2,1,0,1028
W01000921,1238,4,4,2,0,1248
W01000922,1357,6,7,0,0,1370
W01000923,1252,2,1,0,0,1255
W01000924,898,1,4,0,0,903
W01000925,1257,3,0,0,1,1261
W01000926,1576,7,6,3,1,1593
W01000927,1317,2,5,1,0,1325
W01000928,1318,3,11,4,0,1336
W01000929,1028,4,7,2,0,1041
W01000930,1108,8,3,2,0,1121
W01000931,1058,5,3,4,0,1070
W01000932,892,1,10,0,0,903
W01000933,1486,7,24,3,1,1521
W01000934,1036,4,12,3,4,1059
W01000935,1344,14,32,1,2,1393
W01000936,1169,8,7,1,2,1187
W01000937,1628,14,19,2,5,1668
W01000938,1203,9,12,2,1,1227
W01000939,1067,10,24,5,5,1111
W01000940,1023,4,7,1,0,1035
W01000941,1163,11,18,4,4,1200
W01000942,1424,14,19,4,1,1462
W01000943,1238,2,5,3,0,1248
W01000944,985,4,0,1,1,991
W01000945,936,1,8,0,0,945
W01000946,1316,8,0,1,2,1327
W01000947,1571,6,7,3,1,1588
W01000948,1487,10,20,0,8,1525
W01000949,1121,5,10,2,1,1139
W01000950,1223,16,36,3,1,1279
W01000951,1204,15,64,20,3,1306
W01000952,926,7,30,2,0,965
W01000953,1392,5,9,0,0,1406
W01000954,1184,1,0,0,3,1188
W01000955,1025,5,6,1,1,1038
W01000956,1008,3,6,0,0,1017
W01000957,1421,10,20,16,1,1468
W01000958,1302,13,7,2,2,1326
W01000959,1471,14,11,2,2,1500
W01000960,1386,10,19,7,5,1427
W01000961,1306,10,9,1,3,1329
W01000962,1182,11,11,4,0,1208
W01000963,1409,6,15,4,1,1435
W01000964,1420,8,7,0,3,1438
W01000965,1717,6,4,0,0,1727
W01000966,1203,4,11,3,0,1221
W01000967,1187,6,14,1,0,1208
W01000968,1535,7,14,1,2,1559
W01000969,1050,11,6,3,0,1070
W01000970,1030,2,8,2,0,1042
W01000971,1154,4,12,1,0,1171
W01000973,1204,5,2,5,3,1219
W01000974,1659,5,25,13,4,1706
W01000975,1703,7,8,3,0,1721
W01000976,877,2,1,1,2,883
W01000977,1127,4,9,0,0,1140
W01000978,1429,11,0,3,0,1443
W01000979,1269,7,32,4,1,1313
W01000980,1102,10,19,1,2,1134
W01000981,847,3,8,2,2,862
W01000982,1250,5,23,5,3,1286
W01000983,1186,6,14,1,5,1212
W01000984,1668,12,15,2,11,1708
W01000985,1095,8,7,3,3,1116
W01000986,1051,7,5,1,0,1064
W01000987,1724,13,28,4,3,1772
W01000989,1170,5,12,1,1,1189
W01000990,1201,1,17,3,1,1223
W01000991,879,7,4,0,0,890
W01000992,1174,7,8,1,0,1190
W01000993,1170,5,4,0,1,1180
W01000994,1088,5,4,1,0,1098
W01000995,1188,3,2,0,0,1193
W01000996,1248,4,3,1,2,1258
W01000997,1300,1,13,5,2,1321
W01000998,2223,69,41,35,11,2379
W01000999,1138,5,5,0,0,1148
W01001000,1453,7,3,3,1,1467
W01001001,1158,4,5,1,1,1169
W01001002,1829,7,18,3,2,1859
W01001003,1200,6,11,3,0,1220
W01001004,900,4,7,2,0,913
W01001005,1396,6,15,1,1,1419
W01001006,1941,7,11,1,0,1960
W01001007,1351,5,14,4,1,1375
W01001008,1787,7,26,3,8,1831
W01001009,1003,2,3,1,2,1011
W01001010,953,5,6,2,1,967
W01001011,1102,3,10,1,4,1120
W01001012,1219,7,5,0,0,1231
W01001013,1227,6,6,0,0,1239
W01001014,1356,1,13,5,1,1376
W01001015,1167,3,2,3,1,1176
W01001016,1408,5,7,7,0,1427
W01001017,1191,1,13,0,0,1205
W01001018,1143,4,9,5,0,1161
W01001019,1220,1,3,0,1,1225
W01001020,1145,3,3,0,2,1153
W01001021,1299,11,30,3,5,1348
W01001022,1070,9,7,1,4,1091
W01001023,1408,13,32,2,6,1461
W01001024,927,5,2,5,0,939
W01001025,975,3,10,1,0,989
W01001026,1581,13,27,5,2,1628
W01001027,1312,5,5,1,5,1328
W01001028,1555,13,25,3,4,1600
W01001029,1548,9,6,6,0,1569
W01001030,1504,6,5,2,1,1518
W01001031,1305,4,9,0,2,1320
W01001032,1473,12,6,0,0,1491
W01001033,1349,13,6,7,0,1375
W01001034,1137,7,8,12,1,1165
W01001035,1280,9,27,12,5,1333
W01001036,1328,8,15,4,0,1355
W01001037,1344,6,10,1,3,1364
W01001038,1629,10,120,5,12,1776
W01001039,1343,6,12,0,0,1361
W01001040,1200,7,5,0,0,1212
W01001041,1969,14,45,7,7,2042
W01001042,1045,3,5,1,1,1055
W01001043,939,3,4,0,0,946
W01001044,1356,6,11,3,11,1387
W01001045,1400,13,14,2,0,1429
W01001046,1494,16,14,5,3,1532
W01001047,1392,3,3,1,1,1400
W01001048,1142,6,15,3,2,1168
W01001049,1036,3,4,8,0,1051
W01001050,1252,2,16,7,7,1284
W01001051,1369,9,5,5,1,1389
W01001052,1096,6,4,2,0,1108
W01001053,877,3,2,0,1,883
W01001054,1091,4,3,1,2,1101
W01001055,965,8,1,2,1,977
W01001056,1044,7,4,2,0,1057
W01001057,1181,1,13,3,1,1199
W01001058,1537,3,4,3,0,1547
W01001059,1111,10,8,2,4,1135
W01001060,1224,5,6,1,2,1238
W01001061,1654,26,13,9,5,1707
W01001062,1070,19,10,5,2,1106
W01001063,1272,29,38,12,9,1360
W01001064,1146,7,9,7,2,1171
W01001065,1183,12,25,8,1,1229
W01001066,1167,24,19,18,1,1229
W01001067,1079,14,21,7,12,1133
W01001068,1291,24,41,1,5,1362
W01001069,1102,19,17,4,1,1143
W01001070,836,20,28,5,3,892
W01001071,1195,11,38,5,4,1253
W01001072,2014,26,30,10,3,2083
W01001073,1590,21,12,2,1,1626
W01001075,934,7,15,1,0,957
W01001076,1088,10,42,5,4,1149
W01001077,1176,10,10,3,2,1201
W01001078,984,8,16,4,3,1015
W01001079,1160,19,27,10,1,1217
W01001080,1193,13,21,14,5,1246
W01001081,1174,15,5,4,0,1198
W01001082,1306,3,4,1,3,1317
W01001083,1344,8,3,1,0,1356
W01001084,1323,11,2,2,0,1338
W01001085,1198,4,11,2,1,1216
W01001086,1236,6,17,3,0,1262
W01001087,1265,10,16,1,0,1292
W01001088,1472,13,15,4,2,1506
W01001089,1213,18,10,2,1,1244
W01001090,1194,10,13,0,1,1218
W01001091,1418,9,10,5,0,1442
W01001092,1325,13,9,5,3,1355
W01001093,1444,15,8,6,0,1473
W01001094,963,22,10,6,1,1002
W01001095,1088,23,5,5,5,1126
W01001096,1134,12,5,6,3,1160
W01001097,1169,19,15,5,21,1229
W01001098,911,7,10,4,0,932
W01001099,1034,13,5,7,0,1059
W01001100,1227,5,19,1,2,1254
W01001101,1115,21,19,7,8,1170
W01001102,1162,13,10,3,2,1190
W01001103,1009,7,11,4,2,1033
W01001104,1506,25,114,12,13,1670
W01001105,2109,6,13,3,6,2137
W01001106,1197,12,3,2,1,1215
W01001107,1336,6,6,0,2,1350
W01001108,1281,11,17,16,4,1329
W01001109,1204,1,0,1,2,1208
W01001110,1175,29,91,35,15,1345
W01001111,1157,6,8,0,0,1171
W01001112,1111,3,5,2,1,1122
W01001113,1785,10,12,3,9,1819
W01001114,1268,12,23,2,3,1308
W01001115,1602,14,56,6,11,1689
W01001116,1731,14,21,2,6,1774
W01001117,1169,8,0,1,0,1178
W01001118,1853,14,4,11,6,1888
W01001119,1342,11,15,3,8,1379
W01001120,1142,7,6,3,1,1159
W01001121,1233,12,9,1,1,1256
W01001122,2193,32,13,23,2,2263
W01001123,1381,6,23,5,9,1424
W01001124,1131,12,47,2,8,1200
W01001125,1136,3,32,3,3,1177
W01001126,1612,16,27,19,14,1688
W01001127,1003,8,5,1,1,1018
W01001128,1204,4,2,1,2,1213
W01001129,1060,12,3,4,0,1079
W01001130,972,12,21,2,5,1012
W01001131,1319,14,35,14,2,1384
W01001132,1077,11,18,1,5,1112
W01001133,1697,8,31,9,6,1751
W01001134,937,6,10,1,6,960
W01001135,1207,10,10,0,0,1227
W01001136,970,5,23,2,1,1001
W01001137,1905,16,19,6,6,1952
W01001138,1057,7,6,14,3,1087
W01001139,1160,1,10,4,0,1175
W01001140,1153,3,7,7,1,1171
W01001141,1260,2,4,14,5,1285
W01001142,1230,2,15,6,1,1254
W01001143,1271,7,10,3,3,1294
W01001144,1210,3,11,9,1,1234
W01001145,1378,6,11,10,0,1405
W01001146,1137,5,19,4,0,1165
W01001147,1469,4,33,3,1,1510
W01001148,1285,8,33,0,5,1331
W01001149,1145,6,19,9,1,1180
W01001150,1340,5,30,0,8,1383
W01001151,1406,2,12,1,0,1421
W01001152,1272,4,7,0,7,1290
W01001153,1190,5,12,2,0,1209
W01001154,1133,5,16,3,0,1157
W01001155,1270,6,19,1,0,1296
W01001156,1188,4,10,1,3,1206
W01001157,1125,6,14,0,0,1145
W01001158,1218,8,12,1,1,1240
W01001159,982,3,17,2,0,1004
W01001160,1316,7,9,1,1,1334
W01001161,1727,11,9,4,2,1753
W01001162,1300,14,20,7,1,1342
W01001164,1195,4,12,5,2,1218
W01001165,1031,4,14,2,0,1051
W01001166,1060,5,9,5,0,1079
W01001167,1134,6,5,8,0,1153
W01001168,1150,7,19,3,1,1180
W01001169,1300,12,24,1,1,1338
W01001170,1020,7,7,2,0,1036
W01001171,1048,6,5,2,0,1061
W01001172,1173,3,5,7,2,1190
W01001173,1122,4,4,0,0,1130
W01001174,1086,5,6,0,2,1099
W01001175,1187,4,5,0,0,1196
W01001176,1172,2,9,8,0,1191
W01001177,1036,7,3,3,0,1049
W01001178,1351,4,10,1,1,1367
W01001179,1378,4,6,2,0,1390
W01001180,1099,9,20,5,1,1134
W01001181,1137,8,2,7,2,1156
W01001182,1109,10,19,17,3,1158
W01001183,792,9,31,31,4,867
W01001184,1631,6,18,7,3,1665
W01001185,1302,4,20,13,0,1339
W01001186,1346,9,7,3,2,1367
W01001187,1106,3,25,6,1,1141
W01001188,861,7,7,0,0,875
W01001189,1250,2,5,5,0,1262
W01001190,1929,14,56,6,6,2011
W01001191,1929,15,13,4,1,1962
W01001192,1148,1,7,3,0,1159
W01001193,1002,8,2,1,1,1014
W01001194,1688,11,17,2,1,1719
W01001195,1204,10,12,14,2,1242
W01001196,1260,6,13,0,1,1280
W01001197,1012,3,11,4,3,1033
W01001198,1253,6,8,1,0,1268
W01001199,1347,8,8,0,5,1368
W01001200,825,5,4,1,1,836
W01001201,953,7,34,7,1,1002
W01001202,1452,3,5,1,0,1461
W01001203,1084,4,3,0,1,1092
W01001204,1039,4,7,2,1,1053
W01001205,1317,1,5,2,1,1326
W01001206,1213,2,1,0,0,1216
W01001207,1016,4,34,54,1,1109
W01001208,1288,5,12,2,1,1308
W01001209,1030,4,4,6,2,1046
W01001210,1166,1,7,2,7,1183
W01001211,1269,4,3,1,2,1279
W01001212,1065,5,1,3,1,1075
W01001213,1074,7,17,1,1,1100
W01001214,1056,5,4,1,0,1066
W01001215,843,3,6,5,1,858
W01001216,1256,2,2,1,0,1261
W01001217,911,2,17,8,0,938
W01001218,1241,4,7,0,0,1252
W01001219,1095,3,11,3,0,1112
W01001220,1184,2,1,0,0,1187
W01001221,1123,9,6,0,0,1138
W01001222,1137,9,16,45,0,1207
W01001223,1298,11,11,4,2,1326
W01001224,1507,7,35,5,0,1554
W01001225,1242,10,29,7,3,1291
W01001226,1301,7,17,4,0,1329
W01001227,1070,4,15,2,5,1096
W01001228,1241,12,28,7,0,1288
W01001229,1155,8,22,2,0,1187
W01001230,1282,6,15,1,1,1305
W01001231,1239,5,10,1,8,1263
W01001232,1117,8,20,26,6,1177
W01001233,1419,5,3,2,0,1429
W01001234,1214,4,4,0,1,1223
W01001235,1346,4,14,5,2,1371
W01001236,1198,4,8,2,0,1212
W01001237,1163,2,5,4,2,1176
W01001238,1207,4,9,5,0,1225
W01001239,1078,7,19,1,2,1107
W01001240,1637,2,12,4,2,1657
W01001241,1355,24,19,18,2,1418
W01001242,1103,12,24,4,2,1145
W01001243,1100,12,25,8,0,1145
W01001244,1171,9,12,2,2,1196
W01001245,1079,1,20,3,0,1103
W01001246,1143,7,30,2,0,1182
W01001247,1331,5,11,18,8,1373
W01001248,1577,4,41,44,1,1667
W01001249,1142,2,26,0,0,1170
W01001250,1197,1,9,0,0,1207
W01001251,1155,9,14,1,0,1179
W01001252,1232,4,14,0,0,1250
W01001253,1130,8,0,1,2,1141
W01001255,1250,2,14,0,1,1267
W01001256,968,7,7,3,1,986
W01001257,1058,4,13,0,2,1077
W01001258,1031,5,10,6,2,1054
W01001259,1345,4,4,1,1,1355
W01001260,841,6,17,3,1,868
W01001261,994,4,25,32,0,1055
W01001262,960,18,94,84,17,1173
W01001263,1124,22,242,169,17,1574
W01001264,1540,26,217,170,22,1975
W01001265,1232,7,7,1,0,1247
W01001266,1088,2,14,3,2,1109
W01001267,1160,3,4,1,0,1168
W01001268,1157,5,3,1,0,1166
W01001269,1171,2,6,1,1,1181
W01001270,1216,5,11,0,0,1232
W01001271,1277,2,11,0,1,1291
W01001272,1211,4,7,2,1,1225
W01001273,1386,4,4,1,2,1397
W01001274,961,4,12,16,3,996
W01001275,1409,6,3,9,5,1432
W01001276,1111,5,15,22,7,1160
W01001277,950,15,9,2,0,976
W01001278,847,5,7,0,0,859
W01001279,910,4,9,5,0,928
W01001280,1273,11,20,36,1,1341
W01001281,1371,4,9,3,0,1387
W01001282,1566,9,11,6,5,1597
W01001283,1223,2,7,2,0,1234
W01001284,883,2,9,3,0,897
W01001285,1232,9,9,6,0,1256
W01001286,1233,4,6,4,1,1248
W01001287,1188,3,6,5,0,1202
W01001288,1125,7,23,2,3,1160
W01001289,1163,5,4,1,0,1173
W01001290,1509,15,9,2,2,1537
W01001291,1387,14,26,8,3,1438
W01001292,1303,9,23,13,5,1353
W01001293,1366,7,6,1,2,1382
W01001294,1359,11,14,1,0,1385
W01001295,1236,5,14,8,1,1264
W01001296,1391,3,12,0,1,1407
W01001297,1509,6,5,1,3,1524
W01001298,1421,12,22,7,5,1467
W01001299,1164,12,59,2,2,1239
W01001300,1253,8,68,19,1,1349
W01001301,1408,23,24,6,0,1461
W01001302,905,5,1,0,1,912
W01001303,932,3,7,1,1,944
W01001304,1223,7,5,5,0,1240
W01001305,1084,7,9,3,2,1105
W01001306,1268,4,21,1,1,1295
W01001307,1256,6,13,0,1,1276
W01001308,932,14,15,5,0,966
W01001309,975,9,7,2,2,995
W01001310,1308,8,16,0,2,1334
W01001311,928,5,5,5,4,947
W01001312,1292,7,3,1,0,1303
W01001313,1271,6,11,1,1,1290
W01001314,1700,8,10,0,2,1720
W01001315,1386,22,34,12,9,1463
W01001316,2273,10,24,2,6,2315
W01001317,1333,12,6,0,3,1354
W01001318,1249,4,2,0,2,1257
W01001319,1342,8,18,1,1,1370
W01001320,1246,4,9,0,1,1260
W01001321,1217,6,8,1,2,1234
W01001322,1263,6,26,1,12,1308
W01001324,1681,11,20,1,8,1721
W01001325,1206,3,7,1,1,1218
W01001326,1643,8,19,1,1,1672
W01001327,1770,10,9,0,0,1789
W01001328,1221,8,8,2,1,1240
W01001329,1236,7,8,0,2,1253
W01001330,1170,4,6,0,4,1184
W01001331,1342,4,9,3,12,1370
W01001332,1481,6,8,1,4,1500
W01001333,1195,5,9,0,2,1211
W01001334,1130,9,4,0,1,1144
W01001335,1037,4,4,0,1,1046
W01001336,1197,6,3,1,5,1212
W01001337,1260,4,8,0,1,1273
W01001338,1390,9,8,0,2,1409
W01001339,1102,5,13,5,0,1125
W01001340,1459,5,4,1,1,1470
W01001341,1465,6,6,2,0,1479
W01001342,937,6,3,0,1,947
W01001343,950,8,7,1,0,966
W01001344,1410,6,8,4,1,1429
W01001345,1042,9,10,0,1,1062
W01001346,1209,3,8,1,3,1224
W01001347,1171,7,14,3,1,1196
W01001348,1365,12,9,1,0,1387
W01001349,1455,10,22,3,9,1499
W01001350,1430,12,12,2,5,1461
W01001351,1291,3,8,2,1,1305
W01001352,1445,8,17,4,1,1475
W01001353,1334,1,7,0,0,1342
W01001354,1329,11,3,1,0,1344
W01001355,1377,5,4,2,2,1390
W01001356,1007,5,6,5,0,1023
W01001357,1306,6,9,2,2,1325
W01001358,1226,7,2,1,0,1236
W01001359,1270,6,8,2,0,1286
W01001360,1073,5,0,2,0,1080
W01001361,990,1,6,0,0,997
W01001362,1710,3,13,2,0,1728
W01001363,1163,6,9,0,1,1179
W01001364,1432,3,19,0,0,1454
W01001365,1636,13,9,6,0,1664
W01001366,1363,6,11,0,0,1380
W01001367,1202,9,6,1,0,1218
W01001368,1209,7,4,0,7,1227
W01001369,1839,12,7,1,1,1860
W01001370,1412,8,17,4,2,1443
W01001371,1117,12,18,1,1,1149
W01001372,1511,2,15,6,2,1536
W01001373,1359,9,8,1,1,1378
W01001374,1185,1,2,0,0,1188
W01001375,1223,5,15,1,1,1245
W01001376,1181,6,7,0,0,1194
W01001377,1273,10,15,2,0,1300
W01001378,1300,2,6,0,1,1309
W01001379,1182,5,2,6,1,1196
W01001380,1471,3,4,0,2,1480
W01001381,1188,5,9,0,0,1202
W01001382,1368,7,16,0,1,1392
W01001383,1196,10,9,3,6,1224
W01001384,1305,7,11,3,2,1328
W01001385,1293,2,4,1,0,1300
W01001386,1322,4,6,0,0,1332
W01001387,1009,3,7,2,4,1025
W01001388,1364,7,27,1,3,1402
W01001389,918,5,1,0,1,925
W01001390,1415,2,12,0,0,1429
W01001391,1306,6,6,3,1,1322
W01001392,1445,9,11,1,2,1468
W01001393,1054,15,7,2,0,1078
W01001394,1068,5,7,1,0,1081
W01001395,1169,13,14,5,2,1203
W01001396,1216,6,14,3,0,1239
W01001397,1331,18,19,3,0,1371
W01001398,1824,9,36,10,0,1879
W01001399,1069,5,5,5,1,1085
W01001400,1047,3,20,2,1,1073
W01001401,1619,7,11,0,1,1638
W01001402,1284,0,3,1,4,1292
W01001403,1286,3,13,1,3,1306
W01001404,1213,1,4,0,0,1218
W01001405,1437,7,2,0,0,1446
W01001406,1606,4,7,3,6,1626
W01001407,1168,7,4,3,1,1183
W01001408,1113,2,7,6,1,1129
W01001409,1387,4,2,1,2,1396
W01001410,1519,12,3,5,5,1544
W01001411,1458,3,11,1,1,1474
W01001412,1420,3,17,6,3,1449
W01001413,1472,7,16,3,1,1499
W01001414,1226,7,9,0,2,1244
W01001415,1413,5,8,1,2,1429
W01001416,1253,6,7,2,0,1268
W01001417,1182,8,3,1,0,1194
W01001418,1175,8,3,2,0,1188
W01001419,1229,9,21,6,1,1266
W01001420,1039,11,12,1,3,1066
W01001421,1130,5,8,1,3,1147
W01001422,1212,7,18,2,0,1239
W01001423,1208,7,17,0,0,1232
W01001424,1220,4,33,1,0,1258
W01001425,1301,18,22,2,2,1345
W01001426,1107,9,19,1,3,1139
W01001427,1312,9,33,3,1,1358
W01001428,980,2,1,5,0,988
W01001429,953,1,6,0,2,962
W01001430,1875,9,5,2,2,1893
W01001431,1295,5,5,3,0,1308
W01001432,1724,6,20,2,2,1754
W01001433,1116,14,25,5,3,1163
W01001434,1114,11,4,0,0,1129
W01001435,1178,2,11,0,0,1191
W01001436,1152,13,7,1,1,1174
W01001437,1262,8,5,0,0,1275
W01001438,1225,1,4,0,0,1230
W01001439,1408,1,11,1,2,1423
W01001440,1120,5,2,0,0,1127
W01001441,996,5,9,4,0,1014
W01001442,1002,4,8,1,0,1015
W01001443,1153,6,8,1,1,1169
W01001444,1536,6,1,0,1,1544
W01001445,1184,14,12,3,0,1213
W01001446,1079,1,9,0,1,1090
W01001447,1180,17,6,0,2,1205
W01001448,1017,2,25,9,2,1055
W01001449,1202,1,19,2,0,1224
W01001450,1087,1,8,0,0,1096
W01001451,1152,2,0,2,2,1158
W01001452,1237,13,11,3,2,1266
W01001453,1217,5,7,0,3,1232
W01001454,1164,7,5,0,0,1176
W01001455,1425,7,8,2,0,1442
W01001456,1068,4,10,0,0,1082
W01001457,1376,1,1,1,0,1379
W01001458,1244,6,12,2,5,1269
W01001459,845,3,0,1,0,849
W01001460,1407,4,14,15,0,1440
W01001461,1146,3,20,4,7,1180
W01001462,1209,2,10,0,5,1226
W01001463,1569,5,3,1,0,1578
W01001464,1239,10,6,3,2,1260
W01001465,1276,4,2,3,2,1287
W01001466,1426,8,3,7,0,1444
W01001467,1500,5,9,5,0,1519
W01001468,1116,6,10,0,1,1133
W01001469,1001,7,2,1,1,1012
W01001470,1233,1,17,1,2,1254
W01001471,1371,7,4,2,0,1384
W01001472,1212,10,9,0,1,1232
W01001473,1080,5,0,0,1,1086
W01001474,1260,13,10,2,2,1287
W01001475,979,8,13,1,0,1001
W01001476,855,4,6,3,0,868
W01001477,1170,8,9,1,0,1188
W01001478,1211,7,11,2,5,1236
W01001479,1194,3,3,0,3,1203
W01001480,1235,5,3,0,0,1243
W01001481,1315,7,12,2,26,1362
W01001482,956,4,1,0,3,964
W01001483,1039,3,6,1,0,1049
W01001484,1383,7,10,1,1,1402
W01001485,965,1,2,1,2,971
W01001486,1198,2,14,1,2,1217
W01001487,1246,5,1,1,1,1254
W01001488,1237,10,8,0,0,1255
W01001489,1265,6,17,2,1,1291
W01001490,1049,1,5,2,0,1057
W01001491,1418,5,10,7,1,1441
W01001492,1831,6,21,5,2,1865
W01001493,1575,10,28,10,1,1624
W01001494,1253,2,8,4,0,1267
W01001495,1507,8,17,3,1,1536
W01001496,1129,6,23,5,1,1164
W01001497,1199,7,7,0,0,1213
W01001498,918,3,5,1,0,927
W01001499,962,6,15,1,1,985
W01001500,1052,8,30,4,1,1095
W01001501,993,9,3,5,1,1011
W01001502,1036,6,5,3,1,1051
W01001503,985,2,16,3,1,1007
W01001504,1556,6,64,4,2,1632
W01001505,1610,8,74,10,2,1704
W01001506,1124,8,60,9,0,1201
W01001507,1620,11,23,4,1,1659
W01001508,1033,8,25,3,1,1070
W01001509,1235,7,5,1,1,1249
W01001510,1242,2,6,0,1,1251
W01001511,1314,3,2,0,1,1320
W01001512,1184,2,4,0,0,1190
W01001513,1261,3,12,0,0,1276
W01001514,974,4,12,1,0,991
W01001515,1190,8,9,5,0,1212
W01001516,1182,4,6,0,0,1192
W01001517,1538,9,18,0,0,1565
W01001518,931,1,3,1,1,937
W01001519,1059,15,29,3,0,1106
W01001520,1447,4,10,0,0,1461
W01001521,1138,9,20,1,8,1176
W01001522,1344,7,6,2,11,1370
W01001523,1221,2,6,1,5,1235
W01001524,1531,7,11,2,2,1553
W01001525,1214,7,5,1,0,1227
W01001526,1021,4,14,6,1,1046
W01001527,1008,5,32,1,1,1047
W01001528,897,2,1,0,1,901
W01001529,1704,10,14,0,4,1732
W01001530,1325,11,9,4,5,1354
W01001531,1376,8,3,1,1,1389
W01001532,1352,10,16,3,0,1381
W01001533,1254,5,21,4,3,1287
W01001534,1184,14,16,3,1,1218
W01001535,1096,4,9,1,2,1112
W01001536,883,8,5,4,3,903
W01001537,1024,5,7,1,0,1037
W01001538,1015,7,10,1,0,1033
W01001539,1126,7,8,2,1,1144
W01001540,1051,5,1,1,0,1058
W01001541,965,3,0,0,0,968
W01001542,1488,2,8,1,0,1499
W01001543,1145,6,9,1,0,1161
W01001545,1227,8,21,2,8,1266
W01001546,1129,10,38,7,5,1189
W01001548,1728,6,3,3,2,1742
W01001549,1227,4,3,1,4,1239
W01001551,902,2,5,1,1,911
W01001552,1271,6,21,1,1,1300
W01001553,2081,12,27,2,4,2126
W01001554,1233,10,64,5,0,1312
W01001555,1001,0,1,0,2,1004
W01001556,956,5,3,4,1,969
W01001557,1483,11,48,6,4,1552
W01001558,1235,11,22,6,1,1275
W01001559,1110,3,12,0,1,1126
W01001560,1087,8,3,2,0,1100
W01001561,1301,1,10,1,1,1314
W01001562,1162,4,6,0,1,1173
W01001563,836,3,6,2,3,850
W01001564,1862,11,10,5,4,1892
W01001565,1541,7,6,0,1,1555
W01001566,1063,5,8,1,2,1079
W01001567,879,4,3,2,1,889
W01001568,1442,5,6,1,3,1457
W01001569,1198,3,14,5,1,1221
W01001571,1056,6,3,0,1,1066
W01001572,1232,9,4,2,0,1247
W01001573,1211,4,2,0,0,1217
W01001574,1189,5,12,4,1,1211
W01001575,1029,5,2,3,0,1039
W01001576,848,4,25,2,0,879
W01001577,1081,2,18,1,1,1103
W01001578,1787,6,7,3,0,1803
W01001579,1253,9,23,1,1,1287
W01001580,1435,5,13,6,4,1463
W01001581,1629,4,3,1,0,1637
W01001582,1389,4,14,2,1,1410
W01001583,1334,7,1,0,4,1346
W01001584,1507,4,2,1,1,1515
W01001585,1040,7,6,0,2,1055
W01001586,1892,9,14,1,9,1925
W01001587,1503,15,29,3,0,1550
W01001588,1448,6,11,1,1,1467
W01001589,1213,5,30,0,1,1249
W01001590,1794,10,19,1,0,1824
W01001591,1183,4,6,1,1,1195
W01001592,1231,11,11,3,2,1258
W01001593,1381,6,9,1,3,1400
W01001594,1162,2,1,0,7,1172
W01001595,1078,7,5,0,0,1090
W01001596,1142,11,9,16,2,1180
W01001597,1216,2,10,5,2,1235
W01001598,1337,6,7,1,1,1352
W01001599,1737,11,13,1,2,1764
W01001600,1220,11,58,4,4,1297
W01001601,993,26,45,49,14,1127
W01001602,1230,12,17,5,10,1274
W01001603,961,25,124,23,5,1138
W01001604,1124,6,52,17,7,1206
W01001605,995,16,103,31,20,1165
W01001606,1020,14,20,0,2,1056
W01001607,859,28,49,33,4,973
W01001608,1195,10,39,5,1,1250
W01001609,984,25,15,18,2,1044
W01001610,979,16,10,18,6,1029
W01001611,889,10,97,12,5,1013
W01001612,1159,16,102,17,5,1299
W01001613,1136,3,73,11,6,1229
W01001614,1164,14,27,13,5,1223
W01001615,1123,7,22,6,8,1166
W01001616,1188,4,23,8,4,1227
W01001617,932,19,7,28,8,994
W01001618,870,15,7,23,5,920
W01001619,1017,20,5,30,6,1078
W01001620,850,18,4,21,10,903
W01001621,1057,12,19,16,1,1105
W01001622,1011,10,1,11,2,1035
W01001623,1222,6,23,4,4,1259
W01001624,975,5,6,6,1,993
W01001625,1060,6,9,4,0,1079
W01001626,1160,8,11,7,2,1188
W01001627,1264,11,15,10,0,1300
W01001628,866,7,15,8,0,896
W01001629,1166,11,19,17,6,1219
W01001630,1191,27,22,5,13,1258
W01001631,1134,12,18,3,5,1172
W01001632,1020,25,29,9,1,1084
W01001633,993,18,52,24,6,1093
W01001634,1061,15,60,18,16,1170
W01001635,1053,8,14,5,3,1083
W01001636,1331,8,41,11,18,1409
W01001637,1294,10,16,14,4,1338
W01001638,952,2,4,4,0,962
W01001639,1349,16,85,5,9,1464
W01001640,987,5,2,1,3,998
W01001641,1115,10,22,7,5,1159
W01001642,1218,22,21,44,15,1320
W01001643,887,30,72,35,11,1035
W01001644,1786,35,189,14,38,2062
W01001645,985,9,10,14,3,1021
W01001646,1580,35,63,57,10,1745
W01001647,1246,5,14,9,5,1279
W01001648,1181,16,18,8,0,1223
W01001649,1200,5,14,1,2,1222
W01001650,1155,8,10,5,1,1179
W01001651,1275,4,10,0,11,1300
W01001652,1305,21,26,15,4,1371
W01001653,1179,3,4,5,6,1197
W01001654,1271,11,17,4,8,1311
W01001655,1314,10,13,8,4,1349
W01001657,1109,12,15,9,8,1153
W01001658,1398,12,35,8,4,1457
W01001659,852,58,240,92,84,1326
W01001660,838,28,241,66,47,1220
W01001661,1482,63,310,88,119,2062
W01001662,624,38,230,92,63,1047
W01001663,1169,17,38,19,4,1247
W01001664,1082,14,22,16,2,1136
W01001665,1317,15,28,11,10,1381
W01001666,1090,17,5,11,0,1123
W01001667,945,16,6,13,0,980
W01001668,869,3,1,10,0,883
W01001669,1099,2,24,1,1,1127
W01001670,1721,9,48,6,12,1796
W01001671,1343,17,28,27,7,1422
W01001672,1291,16,37,12,2,1358
W01001673,1217,8,21,3,1,1250
W01001674,1158,13,20,10,4,1205
W01001675,1111,19,63,16,8,1217
W01001676,1112,27,95,35,19,1288
W01001677,1153,15,16,6,2,1192
W01001678,1222,26,21,13,9,1291
W01001679,914,3,24,3,0,944
W01001680,927,12,40,13,4,996
W01001681,939,25,36,58,14,1072
W01001682,1039,8,13,12,9,1081
W01001683,856,7,7,15,5,890
W01001684,1092,12,26,23,7,1160
W01001685,1166,17,126,40,27,1376
W01001686,1006,11,85,24,18,1144
W01001687,965,30,284,114,86,1479
W01001688,1796,45,83,34,22,1980
W01001689,1216,29,30,28,9,1312
W01001690,1305,56,214,100,41,1716
W01001691,1055,12,84,32,14,1197
W01001692,1109,40,337,65,26,1577
W01001693,664,22,616,80,35,1417
W01001694,1145,53,217,82,55,1552
W01001695,2288,122,214,161,137,2922
W01001696,926,65,129,80,36,1236
W01001697,1173,37,112,37,31,1390
W01001698,1177,69,293,71,65,1675
W01001699,709,168,191,364,256,1688
W01001702,1321,43,31,24,3,1422
W01001703,906,23,21,9,3,962
W01001704,1046,26,23,22,3,1120
W01001705,1239,39,17,34,14,1343
W01001706,959,28,4,12,6,1009
W01001707,1394,40,38,13,11,1496
W01001708,1127,36,27,8,7,1205
W01001709,1245,38,167,27,25,1502
W01001710,1118,26,134,21,16,1315
W01001711,1063,27,159,26,23,1298
W01001712,1175,17,65,22,8,1287
W01001713,1196,43,109,38,18,1404
W01001714,1131,17,44,7,3,1202
W01001715,1218,22,68,12,12,1332
W01001716,965,13,43,8,3,1032
W01001717,1220,28,72,12,14,1346
W01001718,1237,48,215,28,26,1554
W01001719,1537,36,287,32,23,1915
W01001720,1586,34,139,29,29,1817
W01001721,2174,57,453,66,63,2813
W01001722,1291,35,123,12,25,1486
W01001724,1746,41,132,15,10,1944
W01001725,1799,51,225,27,46,2148
W01001726,1347,45,192,23,18,1625
W01001727,912,9,15,2,6,944
W01001728,1164,8,9,1,4,1186
W01001729,1605,31,86,5,6,1733
W01001730,1118,17,85,15,26,1261
W01001731,1013,9,77,11,25,1135
W01001732,1119,21,121,3,25,1289
W01001733,1482,25,259,17,56,1839
W01001734,984,20,192,8,32,1236
W01001735,1090,19,162,30,24,1325
W01001736,1069,10,62,5,12,1158
W01001737,1044,36,49,27,7,1163
W01001738,864,24,36,16,2,942
W01001739,861,28,32,31,7,959
W01001740,1061,30,39,28,9,1167
W01001741,952,51,41,23,5,1072
W01001742,979,40,17,24,4,1064
W01001743,1160,16,6,8,1,1191
W01001744,1137,30,13,29,10,1219
W01001745,1041,21,16,4,0,1082
W01001746,1082,52,36,28,7,1205
W01001747,1275,32,41,24,8,1380
W01001748,1152,20,20,7,5,1204
W01001749,1160,27,23,14,8,1232
W01001750,1299,24,21,16,8,1368
W01001751,1174,46,33,30,11,1294
W01001752,1324,11,17,1,1,1354
W01001753,1080,45,44,31,12,1212
W01001754,1335,31,43,22,10,1441
W01001755,1074,25,134,15,21,1269
W01001756,2936,76,419,45,37,3513
W01001757,980,20,183,28,27,1238
W01001758,1577,19,222,41,29,1888
W01001759,998,30,170,47,28,1273
W01001760,923,79,177,93,63,1335
W01001761,901,48,278,82,59,1368
W01001762,888,63,157,137,78,1323
W01001764,874,49,412,158,43,1536
W01001765,594,38,316,68,40,1056
W01001766,766,63,293,74,40,1236
W01001767,895,36,201,95,47,1274
W01001768,559,31,403,119,50,1162
W01001769,1238,10,36,1,7,1292
W01001770,856,14,95,12,7,984
W01001771,1219,16,68,6,18,1327
W01001772,1123,18,36,3,5,1185
W01001773,1636,37,182,14,74,1943
W01001774,1033,10,48,13,6,1110
W01001775,1210,22,61,16,9,1318
W01001776,972,7,75,5,31,1090
W01001777,1172,9,46,1,6,1234
W01001778,1407,16,81,7,20,1531
W01001779,1187,17,32,1,5,1242
W01001780,1344,29,105,25,12,1515
W01001781,1350,19,56,9,9,1443
W01001782,1110,23,33,5,14,1185
W01001783,921,11,65,5,17,1019
W01001784,1067,12,68,4,6,1157
W01001785,813,16,47,11,3,890
W01001786,1153,26,13,16,11,1219
W01001787,997,32,109,18,13,1169
W01001788,991,34,57,27,14,1123
W01001789,1198,15,25,7,5,1250
W01001790,866,27,32,7,3,935
W01001791,1245,22,28,6,19,1320
W01001792,1227,30,34,20,15,1326
W01001793,1041,22,31,6,8,1108
W01001794,1080,12,23,5,13,1133
W01001795,1151,15,43,4,1,1214
W01001796,1182,9,28,5,9,1233
W01001797,1151,13,24,3,9,1200
W01001798,1163,11,19,4,7,1204
W01001799,1032,4,34,1,4,1075
W01001800,1133,24,47,16,5,1225
W01001802,1267,28,41,3,3,1342
W01001803,1203,20,40,15,3,1281
W01001804,1122,37,25,28,12,1224
W01001805,1053,30,28,42,5,1158
W01001806,1307,31,44,18,8,1408
W01001807,1036,37,15,21,13,1122
W01001808,1045,43,29,28,6,1151
W01001809,967,20,46,17,13,1063
W01001810,1058,47,74,20,13,1212
W01001811,868,18,79,23,21,1009
W01001812,888,23,52,12,9,984
W01001813,1040,28,72,21,14,1175
W01001814,1069,23,44,25,10,1171
W01001815,999,21,25,6,21,1072
W01001816,1730,45,112,37,53,1977
W01001817,1026,24,36,12,20,1118
W01001818,987,28,94,18,37,1164
W01001819,1827,7,31,1,4,1870
W01001820,903,9,26,2,3,943
W01001821,1418,29,147,21,19,1634
W01001822,1210,31,125,21,6,1393
W01001823,984,13,53,5,7,1062
W01001824,1098,26,186,17,14,1341
W01001825,1206,36,135,30,47,1454
W01001826,999,13,108,5,23,1148
W01001827,1121,21,123,3,23,1291
W01001828,1190,18,95,8,9,1320
W01001829,1263,36,269,31,29,1628
W01001830,1128,55,222,47,47,1499
W01001831,1126,25,200,30,22,1403
W01001832,1361,25,274,27,47,1734
W01001833,1205,30,109,18,19,1381
W01001834,1206,35,134,32,24,1431
W01001835,1290,31,130,48,33,1532
W01001836,1084,24,194,11,13,1326
W01001837,1076,33,248,22,21,1400
W01001838,1194,35,289,14,27,1559
W01001839,1168,36,188,19,27,1438
W01001840,1360,25,54,10,11,1460
W01001841,1378,25,93,14,35,1545
W01001842,1194,18,82,19,40,1353
W01001843,1366,34,173,26,47,1646
W01001844,1389,35,91,15,37,1567
W01001846,1220,13,47,2,2,1284
W01001847,1240,12,46,5,10,1313
W01001848,1135,15,21,2,2,1175
W01001849,1271,12,21,2,4,1310
W01001850,1546,15,21,1,7,1590
W01001851,1207,7,14,3,9,1240
W01001852,1427,8,33,2,6,1476
W01001853,1309,10,28,4,7,1358
W01001854,1348,10,12,4,4,1378
W01001855,759,39,479,45,40,1362
W01001856,668,48,614,129,61,1520
W01001857,1027,37,281,74,48,1467
W01001858,1364,33,61,21,8,1487
W01001859,1147,20,44,13,15,1239
W01001860,1317,32,82,10,16,1457
W01001861,1284,19,114,22,22,1461
W01001862,730,46,478,77,58,1389
W01001863,1232,13,16,8,2,1271
W01001864,1185,27,36,12,7,1267
W01001865,1057,15,18,4,5,1099
W01001866,1172,17,21,12,11,1233
W01001867,966,25,11,29,3,1034
W01001868,1079,30,37,21,2,1169
W01001869,1073,30,39,28,13,1183
W01001870,982,35,45,36,3,1101
W01001871,1048,46,34,34,13,1175
W01001872,1068,31,93,28,25,1245
W01001873,1131,50,118,53,23,1375
W01001874,872,50,63,96,20,1101
W01001875,1622,63,196,58,65,2004
W01001876,1048,33,47,27,9,1164
W01001877,1304,22,43,6,16,1391
W01001878,1146,26,32,19,14,1237
W01001879,1234,52,60,28,23,1397
W01001880,883,40,38,39,22,1022
W01001881,1030,41,31,17,15,1134
W01001882,1278,19,48,13,22,1380
W01001883,1138,36,14,33,7,1228
W01001884,778,39,12,47,13,889
W01001885,1329,30,67,11,14,1451
W01001886,872,26,7,16,3,924
W01001887,1233,13,10,3,1,1260
W01001888,1250,10,41,6,12,1319
W01001889,1251,18,27,2,6,1304
W01001890,1304,15,49,9,8,1385
W01001891,1331,21,20,3,4,1379
W01001892,1196,6,2,5,2,1211
W01001893,1435,28,37,7,5,1512
W01001894,1228,7,38,13,4,1290
W01001895,1282,26,32,19,13,1372
W01001896,1202,14,18,1,7,1242
W01001897,1607,7,4,2,0,1620
W01001898,1238,6,6,2,2,1254
W01001899,1692,5,14,2,0,1713
W01001900,1212,5,12,0,0,1229
W01001901,1516,5,66,0,1,1588
W01001902,1051,5,14,4,1,1075
W01001903,1713,5,41,1,1,1761
W01001904,1362,8,45,1,3,1419
W01001905,1737,9,23,3,1,1773
W01001906,1624,4,3,0,0,1631
W01001907,1149,6,6,2,0,1163
W01001908,1792,3,10,1,0,1806
W01001909,2085,9,25,7,8,2134
W01001910,1162,24,62,10,8,1266
W01001911,864,19,16,8,1,908
W01001912,1177,6,36,5,4,1228
W01001913,1026,21,50,23,9,1129
W01001914,1341,5,19,0,0,1365
W01001915,1270,9,4,1,2,1286
W01001916,1082,7,22,2,2,1115
W01001917,1191,3,11,0,4,1209
W01001918,1063,9,22,7,2,1103
W01001919,982,12,38,6,2,1040
W01001920,894,12,6,4,2,918
W01001921,1063,10,32,5,8,1118
W01001922,1545,52,290,24,22,1933
W01001923,1007,9,14,2,7,1039
W01001924,1003,6,18,1,5,1033
W01001925,1893,5,25,4,3,1930
W01001926,1847,9,6,6,4,1872
W01001927,1082,3,5,1,3,1094
W01001928,992,7,3,1,1,1004
W01001929,1067,14,32,9,1,1123
W01001930,1799,2,6,0,2,1809
W01001931,1122,14,35,8,3,1182
W01001932,2358,10,6,2,10,2386
W01001933,1972,7,11,4,0,1994
W01001934,3496,63,156,19,32,3766
W01001935,855,18,37,11,6,927
W01001936,1949,48,59,13,29,2098
W01001937,1725,8,5,5,0,1743
W01001938,818,19,137,18,150,1142
W01001939,528,20,155,9,226,938
W01001940,865,36,98,19,32,1050
W01001941,589,35,172,21,202,1019
W01001942,751,106,94,114,77,1142
W01001943,820,25,72,33,39,989
W01001944,806,20,64,32,16,938
W01001945,1057,32,116,20,20,1245
W01001946,844,53,78,97,37,1109
W01001947,1149,37,98,54,19,1357
W01001948,1142,15,58,5,11,1231
W01001949,917,24,65,11,28,1045
W01001950,802,27,105,33,31,998
W01001951,733,31,71,48,32,915
W01001952,814,24,90,136,55,1119
W01001953,1123,25,42,11,5,1206
W01001954,1214,12,27,7,13,1273
W01001955,1179,23,152,99,62,1515
W01001956,2440,28,144,22,21,2655
W01001957,775,11,63,14,71,934
W01001958,952,9,133,31,96,1221
S01006506,726,1,15,6,1,749
S01006507,675,0,18,1,2,696
S01006508,523,3,17,8,1,552
S01006509,462,3,13,1,0,479
S01006510,535,4,5,3,2,549
S01006511,616,3,13,1,0,633
S01006512,342,2,8,8,0,360
S01006513,506,1,6,8,8,529
S01006514,770,3,25,6,5,809
S01006515,542,0,13,7,7,569
S01006516,424,6,14,4,4,452
S01006517,774,6,17,8,3,808
S01006518,503,1,7,1,2,514
S01006519,630,5,21,9,10,675
S01006520,443,1,39,13,9,505
S01006521,484,3,24,2,0,513
S01006522,420,1,10,4,3,438
S01006523,728,6,28,2,2,766
S01006524,735,7,17,11,2,772
S01006525,599,1,41,4,5,650
S01006526,733,0,28,20,3,784
S01006527,527,8,6,18,0,559
S01006528,751,4,56,58,7,876
S01006529,689,0,48,46,7,790
S01006530,612,3,30,22,4,671
S01006531,764,3,33,10,1,811
S01006532,613,1,22,8,0,644
S01006533,581,1,6,2,4,594
S01006534,700,2,17,7,3,729
S01006535,843,4,41,19,5,912
S01006536,861,6,34,18,1,920
S01006537,624,2,7,3,2,638
S01006538,462,0,12,6,0,480
S01006539,616,0,3,5,2,626
S01006540,765,6,38,15,1,825
S01006541,668,3,8,1,0,680
S01006542,821,3,28,16,6,874
S01006543,654,1,20,2,1,678
S01006544,825,4,71,13,17,930
S01006545,862,3,48,18,4,935
S01006546,517,0,4,5,0,526
S01006547,734,6,21,7,1,769
S01006548,603,0,11,3,1,618
S01006549,671,6,16,5,1,699
S01006550,800,1,13,7,0,821
S01006551,565,3,17,6,0,591
S01006552,712,4,22,12,3,753
S01006553,682,10,26,7,1,726
S01006554,572,0,25,18,0,615
S01006555,563,4,68,18,3,656
S01006556,669,1,28,8,1,707
S01006557,554,2,13,11,1,581
S01006558,546,1,12,2,2,563
S01006559,482,0,26,2,3,513
S01006560,794,6,22,16,9,847
S01006561,576,7,23,5,4,615
S01006562,570,3,18,14,3,608
S01006563,588,3,63,13,4,671
S01006564,779,3,89,11,9,891
S01006565,823,4,78,32,16,953
S01006566,622,9,43,6,4,684
S01006567,707,6,46,23,7,789
S01006568,767,8,73,19,9,876
S01006569,437,4,27,17,10,495
S01006570,583,5,47,22,0,657
S01006571,704,4,24,15,1,748
S01006572,685,2,18,11,2,718
S01006573,543,3,9,9,2,566
S01006574,775,4,18,5,7,809
S01006575,718,6,32,9,3,768
S01006576,540,1,23,9,4,577
S01006577,632,4,38,3,5,682
S01006578,928,7,61,23,6,1025
S01006579,761,6,90,47,10,914
S01006580,588,5,30,12,8,643
S01006581,721,2,16,5,1,745
S01006582,650,4,77,77,9,817
S01006583,578,4,52,40,4,678
S01006584,508,7,32,22,4,573
S01006585,641,4,70,11,8,734
S01006586,868,9,77,25,12,991
S01006587,418,4,48,32,2,504
S01006588,413,12,37,78,11,551
S01006589,545,7,32,42,4,630
S01006590,571,10,46,21,8,656
S01006591,565,7,41,33,8,654
S01006592,522,5,32,37,11,607
S01006593,620,4,38,29,16,707
S01006594,463,0,26,16,3,508
S01006595,761,4,47,30,10,852
S01006596,588,9,20,16,6,639
S01006597,455,5,20,15,3,498
S01006598,755,5,20,11,14,805
S01006599,687,6,27,29,2,751
S01006600,913,4,28,30,3,978
S01006601,831,3,33,21,11,899
S01006602,682,6,28,19,2,737
S01006603,687,0,10,3,4,704
S01006604,572,1,13,1,0,587
S01006605,634,2,9,10,3,658
S01006606,704,1,14,8,5,732
S01006607,754,0,9,4,2,769
S01006608,563,5,14,15,1,598
S01006609,866,4,13,2,1,886
S01006610,373,0,2,10,1,386
S01006611,743,2,9,18,0,772
S01006612,717,0,10,13,1,741
S01006613,472,1,11,7,2,493
S01006614,459,3,14,15,0,491
S01006615,528,0,20,15,0,563
S01006616,640,3,9,10,3,665
S01006617,570,0,0,4,0,574
S01006618,455,0,11,3,0,469
S01006619,738,1,3,2,0,744
S01006620,721,0,9,8,0,738
S01006621,410,1,7,10,0,428
S01006622,526,1,9,12,1,549
S01006623,648,2,11,9,0,670
S01006624,847,6,11,24,3,891
S01006625,519,1,15,12,0,547
S01006626,598,0,4,12,0,614
S01006627,718,2,24,24,5,773
S01006628,875,4,43,48,8,978
S01006629,625,0,15,8,2,650
S01006630,485,0,0,4,0,489
S01006631,780,1,13,9,2,805
S01006632,630,3,7,17,1,658
S01006633,508,0,15,4,2,529
S01006634,448,1,8,7,1,465
S01006635,501,4,3,14,0,522
S01006636,619,4,6,11,1,641
S01006637,632,7,34,23,3,699
S01006638,677,3,78,31,6,795
S01006639,813,6,54,22,5,900
S01006640,567,5,66,31,15,684
S01006641,832,12,51,68,17,980
S01006642,1110,22,114,77,9,1332
S01006643,616,4,58,22,9,709
S01006644,798,5,55,40,17,915
S01006645,523,4,22,22,6,577
S01006646,808,15,81,64,11,979
S01006647,490,4,32,22,2,550
S01006648,1485,14,140,79,12,1730
S01006649,766,6,79,33,8,892
S01006650,677,5,56,63,12,813
S01006651,508,1,58,33,12,612
S01006652,445,6,31,23,11,516
S01006653,429,2,57,8,17,513
S01006654,728,4,56,7,3,798
S01006655,593,3,33,9,12,650
S01006656,749,6,78,18,7,858
S01006657,409,5,44,22,2,482
S01006658,737,6,86,45,4,878
S01006659,534,8,34,10,8,594
S01006660,348,3,63,10,1,425
S01006661,523,7,42,13,5,590
S01006662,606,10,75,45,2,738
S01006663,466,4,37,6,9,522
S01006664,417,4,37,12,1,471
S01006665,596,9,52,18,6,681
S01006666,695,4,16,24,3,742
S01006667,597,2,30,21,3,653
S01006668,729,6,88,20,15,858
S01006669,961,9,106,61,24,1161
S01006670,797,4,43,52,5,901
S01006671,1991,42,167,143,12,2355
S01006672,608,7,43,19,8,685
S01006673,639,4,58,53,6,760
S01006674,732,1,23,14,9,779
S01006675,482,3,15,28,2,530
S01006676,550,0,30,16,10,606
S01006677,560,4,26,27,4,621
S01006678,891,2,21,18,3,935
S01006679,556,1,15,9,0,581
S01006680,629,4,12,12,11,668
S01006681,736,4,16,7,2,765
S01006682,616,5,21,20,0,662
S01006683,632,0,39,23,3,697
S01006684,550,5,23,23,4,605
S01006685,597,4,20,13,4,638
S01006686,480,1,31,9,0,521
S01006687,665,4,31,14,5,719
S01006688,828,0,18,5,0,851
S01006689,482,3,39,16,6,546
S01006690,478,4,36,11,4,533
S01006691,439,4,22,18,14,497
S01006692,629,3,23,10,4,669
S01006693,747,0,24,47,16,834
S01006694,709,1,11,13,1,735
S01006695,552,2,32,13,9,608
S01006696,613,1,40,36,5,695
S01006697,708,1,53,9,1,772
S01006698,555,1,45,6,1,608
S01006699,359,0,47,4,0,410
S01006700,704,1,41,8,0,754
S01006701,532,1,20,1,0,554
S01006702,618,1,7,8,1,635
S01006703,474,1,29,16,2,522
S01006704,470,0,8,3,0,481
S01006705,614,1,9,2,1,627
S01006706,465,2,25,2,1,495
S01006707,507,5,22,9,0,543
S01006708,613,2,45,8,0,668
S01006709,650,1,18,6,3,678
S01006710,738,0,8,7,0,753
S01006711,799,2,5,1,0,807
S01006712,445,0,7,2,0,454
S01006713,773,0,12,3,0,788
S01006714,573,1,15,0,0,589
S01006715,417,0,6,10,6,439
S01006716,473,0,4,19,0,496
S01006717,787,0,23,7,2,819
S01006718,488,3,13,12,3,519
S01006719,701,0,11,10,2,724
S01006720,454,0,1,18,4,477
S01006721,714,1,11,4,5,735
S01006722,582,2,25,9,1,619
S01006723,539,0,4,10,0,553
S01006724,657,1,8,20,1,687
S01006725,522,0,7,3,0,532
S01006726,938,1,26,18,2,985
S01006727,766,1,9,8,0,784
S01006728,555,0,4,29,0,588
S01006729,598,3,24,13,1,639
S01006730,536,2,16,25,0,579
S01006731,476,1,3,2,0,482
S01006732,823,7,19,5,4,858
S01006733,597,3,28,18,0,646
S01006734,673,1,54,23,5,756
S01006735,465,0,17,14,5,501
S01006736,707,4,37,20,4,772
S01006737,509,1,14,17,3,544
S01006738,683,2,12,17,0,714
S01006739,505,0,6,16,2,529
S01006740,633,0,1,3,0,637
S01006741,586,0,1,9,0,596
S01006742,382,0,5,0,1,388
S01006743,478,0,3,0,0,481
S01006744,516,1,6,1,0,524
S01006745,699,1,3,4,0,707
S01006746,700,1,9,1,1,712
S01006747,716,0,5,5,2,728
S01006748,738,2,21,11,0,772
S01006749,740,2,18,9,4,773
S01006750,606,1,14,3,3,627
S01006751,425,0,8,3,0,436
S01006752,576,3,13,2,2,596
S01006753,768,0,5,4,2,779
S01006754,802,0,0,3,3,808
S01006755,555,2,11,5,1,574
S01006756,554,3,43,13,3,616
S01006757,730,3,15,1,0,749
S01006758,582,1,8,6,2,599
S01006759,486,0,6,0,0,492
S01006760,405,0,3,11,2,421
S01006761,624,1,2,2,0,629
S01006762,702,1,15,0,0,718
S01006763,613,3,32,14,5,667
S01006764,629,0,22,12,2,665
S01006765,488,0,6,6,0,500
S01006766,484,2,15,4,0,505
S01006767,569,2,18,2,0,591
S01006768,476,0,29,1,1,507
S01006769,765,2,18,7,1,793
S01006770,560,0,7,0,0,567
S01006771,344,3,23,2,6,378
S01006772,685,2,26,14,1,728
S01006773,562,3,32,6,1,604
S01006774,495,0,37,7,1,540
S01006775,534,0,12,2,1,549
S01006776,436,1,8,0,2,447
S01006777,546,0,1,4,2,553
S01006778,558,2,2,0,4,566
S01006779,507,1,12,6,1,527
S01006780,490,2,3,2,1,498
S01006781,578,0,25,4,0,607
S01006782,575,2,29,5,13,624
S01006783,565,1,11,6,2,585
S01006784,531,0,13,4,0,548
S01006785,469,3,13,10,0,495
S01006786,620,3,40,5,4,672
S01006787,549,4,5,3,8,569
S01006788,605,6,37,10,4,662
S01006789,546,0,3,3,0,552
S01006790,762,0,3,1,0,766
S01006791,442,0,1,2,1,446
S01006792,414,0,2,0,0,416
S01006793,468,0,8,1,1,478
S01006794,498,0,0,0,1,499
S01006795,575,3,2,7,0,587
S01006796,434,1,1,0,0,436
S01006797,497,0,2,1,0,500
S01006798,486,6,1,0,0,493
S01006799,740,1,3,1,0,745
S01006800,675,2,8,1,1,687
S01006801,792,1,2,1,0,796
S01006802,552,0,2,1,1,556
S01006803,563,0,6,1,1,571
S01006804,571,2,4,0,1,578
S01006805,876,1,14,3,0,894
S01006806,846,0,2,1,0,849
S01006807,479,3,2,0,0,484
S01006808,501,2,4,0,0,507
S01006809,647,2,3,4,0,656
S01006810,698,2,4,0,0,704
S01006811,831,3,2,1,4,841
S01006812,589,2,5,4,1,601
S01006813,624,0,2,0,0,626
S01006814,614,5,2,2,1,624
S01006815,482,1,0,2,0,485
S01006816,579,1,4,1,1,586
S01006817,506,0,8,2,1,517
S01006818,573,2,1,3,1,580
S01006819,646,3,1,3,2,655
S01006820,380,0,3,0,0,383
S01006821,476,1,3,3,1,484
S01006822,605,1,3,0,0,609
S01006823,607,0,2,2,2,613
S01006824,646,0,5,1,0,652
S01006825,672,0,6,0,0,678
S01006826,781,2,2,0,0,785
S01006827,723,5,6,1,0,735
S01006828,783,2,8,4,2,799
S01006829,280,1,9,0,1,291
S01006830,625,0,0,1,1,627
S01006831,446,0,3,2,1,452
S01006832,854,0,6,2,0,862
S01006833,367,0,4,2,0,373
S01006834,355,1,18,1,0,375
S01006835,725,4,11,5,0,745
S01006836,366,2,3,1,0,372
S01006837,460,2,0,4,0,466
S01006838,503,3,1,2,1,510
S01006839,855,1,4,2,2,864
S01006840,791,1,1,0,0,793
S01006841,711,2,15,1,0,729
S01006842,672,1,7,0,0,680
S01006843,659,1,7,2,0,669
S01006844,570,6,7,4,0,587
S01006845,769,1,6,2,0,778
S01006846,459,0,15,0,0,474
S01006847,576,1,3,2,1,583
S01006848,758,5,17,5,2,787
S01006849,670,3,12,14,1,700
S01006850,747,1,13,5,1,767
S01006851,636,0,12,2,1,651
S01006852,482,1,5,4,0,492
S01006853,648,3,8,4,3,666
S01006854,703,0,1,2,1,707
S01006855,615,0,6,0,1,622
S01006856,509,0,8,1,0,518
S01006857,796,4,4,0,5,809
S01006858,509,1,8,0,0,518
S01006859,845,2,14,0,0,861
S01006860,464,0,1,0,0,465
S01006861,405,0,4,4,0,413
S01006862,565,0,6,3,1,575
S01006863,547,2,10,0,1,560
S01006864,305,1,5,0,0,311
S01006865,785,2,12,2,1,802
S01006866,453,0,1,1,0,455
S01006867,609,0,2,3,0,614
S01006868,704,4,1,0,0,709
S01006869,393,0,9,1,2,405
S01006870,394,1,2,0,0,397
S01006871,566,0,4,1,0,571
S01006872,527,4,4,2,0,537
S01006873,824,1,3,3,2,833
S01006874,488,1,1,0,0,490
S01006875,566,1,1,1,0,569
S01006876,791,0,4,0,0,795
S01006877,771,0,7,0,2,780
S01006878,583,1,3,0,0,587
S01006879,655,0,4,0,0,659
S01006880,465,1,1,2,1,470
S01006881,460,0,0,0,1,461
S01006882,336,0,0,0,0,336
S01006883,376,1,4,0,0,381
S01006884,721,2,2,2,0,727
S01006885,447,0,1,0,0,448
S01006886,613,0,4,0,0,617
S01006887,423,4,5,2,0,434
S01006888,619,1,1,2,1,624
S01006889,647,2,10,0,0,659
S01006890,517,1,3,0,0,521
S01006891,783,2,11,1,0,797
S01006892,488,0,3,1,1,493
S01006893,417,0,0,0,0,417
S01006894,810,2,5,2,1,820
S01006895,439,0,9,1,1,450
S01006896,672,0,7,1,1,681
S01006897,598,0,4,2,0,604
S01006898,606,1,5,1,0,613
S01006899,487,2,1,0,0,490
S01006900,501,1,1,1,0,504
S01006901,512,1,3,1,0,517
S01006902,532,2,3,2,1,540
S01006903,668,1,2,0,1,672
S01006904,598,2,1,1,2,604
S01006905,754,3,4,2,0,763
S01006906,728,0,3,0,1,732
S01006907,516,1,13,0,4,534
S01006908,706,1,5,0,1,713
S01006909,564,3,7,2,2,578
S01006910,695,1,4,1,0,701
S01006911,440,0,9,2,0,451
S01006912,376,1,1,0,0,378
S01006913,374,0,4,7,0,385
S01006914,584,0,3,1,2,590
S01006915,628,3,2,5,2,640
S01006916,393,1,2,0,1,397
S01006917,635,0,2,2,4,643
S01006918,369,2,1,3,1,376
S01006919,410,0,4,0,4,418
S01006920,401,2,1,3,2,409
S01006921,538,5,4,12,1,560
S01006922,404,0,3,0,0,407
S01006923,661,0,5,0,1,667
S01006924,428,0,10,0,1,439
S01006925,403,1,4,1,1,410
S01006926,525,1,7,2,3,538
S01006927,665,4,22,15,1,707
S01006928,819,2,3,0,1,825
S01006929,625,2,10,10,0,647
S01006930,740,3,11,3,5,762
S01006931,312,0,6,0,0,318
S01006932,421,0,8,3,1,433
S01006933,470,0,7,2,2,481
S01006934,518,1,5,2,1,527
S01006935,581,1,14,0,2,598
S01006936,514,0,6,0,1,521
S01006937,581,1,25,6,0,613
S01006938,438,2,8,6,2,456
S01006939,498,1,10,2,1,512
S01006940,751,1,27,2,6,787
S01006941,466,1,17,4,2,490
S01006942,806,1,24,8,3,842
S01006943,412,5,16,8,1,442
S01006944,579,10,19,12,1,621
S01006945,416,0,10,1,0,427
S01006946,638,2,9,0,1,650
S01006947,601,1,8,11,0,621
S01006948,724,0,5,3,0,732
S01006949,497,0,7,1,0,505
S01006950,374,3,0,4,1,382
S01006951,381,0,2,0,1,384
S01006952,709,2,1,0,0,712
S01006953,616,1,7,2,3,629
S01006954,644,2,15,3,1,665
S01006955,478,0,0,1,5,484
S01006956,780,2,16,12,5,815
S01006957,828,4,12,3,0,847
S01006958,781,2,5,2,0,790
S01006959,618,2,5,0,0,625
S01006960,660,2,14,1,0,677
S01006961,648,7,11,2,5,673
S01006962,772,0,3,2,1,778
S01006963,569,1,2,0,0,572
S01006964,628,1,9,0,0,638
S01006965,432,0,1,0,1,434
S01006966,485,1,2,1,0,489
S01006967,501,2,4,0,0,507
S01006968,432,0,0,2,0,434
S01006969,816,0,3,2,5,826
S01006970,551,3,12,0,2,568
S01006971,453,0,0,0,0,453
S01006972,422,0,0,0,0,422
S01006973,460,0,1,0,0,461
S01006974,805,2,3,2,2,814
S01006975,763,4,8,1,1,777
S01006976,369,2,3,1,0,375
S01006977,646,3,1,1,1,652
S01006978,712,2,4,0,0,718
S01006979,698,0,1,0,0,699
S01006980,670,2,5,10,0,687
S01006981,640,1,1,6,1,649
S01006982,679,0,2,2,0,683
S01006983,580,0,1,0,0,581
S01006984,564,0,1,1,0,566
S01006985,829,1,6,1,2,839
S01006986,504,0,3,4,3,514
S01006987,539,1,3,2,1,546
S01006988,450,3,0,1,1,455
S01006989,787,1,2,4,0,794
S01006990,641,4,8,4,0,657
S01006991,370,0,0,1,0,371
S01006992,499,0,1,1,0,501
S01006993,429,0,2,1,1,433
S01006994,485,3,1,4,2,495
S01006995,667,0,0,3,3,673
S01006996,600,1,0,1,2,604
S01006997,596,2,4,1,0,603
S01006998,890,4,3,2,0,899
S01006999,722,0,1,1,0,724
S01007000,763,0,3,0,0,766
S01007001,773,0,2,0,0,775
S01007002,445,0,3,0,2,450
S01007003,424,0,0,0,1,425
S01007004,586,1,1,0,0,588
S01007005,727,1,0,1,0,729
S01007006,724,1,8,0,2,735
S01007007,658,0,12,1,1,672
S01007008,862,1,4,3,0,870
S01007009,860,2,8,4,0,874
S01007010,715,1,4,0,0,720
S01007011,725,1,4,0,0,730
S01007012,568,0,3,0,0,571
S01007013,452,2,4,0,0,458
S01007014,797,1,6,2,0,806
S01007015,501,0,2,2,0,505
S01007016,473,1,1,2,1,478
S01007017,822,1,6,0,0,829
S01007018,787,1,5,0,0,793
S01007019,564,0,9,0,1,574
S01007020,667,1,6,1,0,675
S01007021,770,0,2,2,0,774
S01007022,386,1,1,3,0,391
S01007023,393,0,0,1,0,394
S01007024,867,0,8,2,0,877
S01007025,703,0,2,2,1,708
S01007026,766,0,6,2,0,774
S01007027,877,0,2,1,0,880
S01007028,610,1,2,1,0,614
S01007029,455,0,2,1,0,458
S01007030,659,0,1,2,1,663
S01007031,514,1,2,0,0,517
S01007032,824,1,4,1,3,833
S01007033,592,2,9,0,0,603
S01007034,483,0,9,0,2,494
S01007035,632,1,9,1,0,643
S01007036,791,1,6,1,1,800
S01007037,825,1,2,1,1,830
S01007038,604,0,8,1,0,613
S01007039,685,0,0,0,0,685
S01007040,533,0,2,1,1,537
S01007041,618,2,4,3,1,628
S01007042,596,0,1,0,1,598
S01007043,829,2,3,1,0,835
S01007044,577,2,0,2,0,581
S01007045,677,2,4,0,0,683
S01007046,507,0,1,1,0,509
S01007047,550,0,0,0,0,550
S01007048,771,1,2,0,1,775
S01007049,760,2,2,3,0,767
S01007050,545,0,1,0,1,547
S01007051,610,1,2,0,1,614
S01007052,469,1,3,0,0,473
S01007053,399,2,0,0,1,402
S01007054,799,0,1,2,1,803
S01007055,421,0,1,0,0,422
S01007056,519,0,9,0,0,528
S01007057,458,0,0,0,1,459
S01007058,499,0,3,0,0,502
S01007059,795,1,11,5,1,813
S01007060,484,0,1,0,0,485
S01007061,728,0,6,5,0,739
S01007062,557,2,5,1,0,565
S01007063,543,1,3,1,1,549
S01007064,523,0,3,1,1,528
S01007065,465,0,8,1,0,474
S01007066,535,0,1,1,0,537
S01007067,483,3,1,2,0,489
S01007068,621,0,4,0,0,625
S01007069,633,2,9,0,0,644
S01007070,427,0,2,0,0,429
S01007071,682,1,3,1,1,688
S01007072,511,0,2,0,0,513
S01007073,896,0,5,2,0,903
S01007074,542,2,5,0,0,549
S01007075,579,1,5,0,0,585
S01007076,594,0,2,1,2,599
S01007077,587,2,3,1,1,594
S01007078,713,0,2,1,1,717
S01007079,853,0,4,0,1,858
S01007080,663,1,3,2,0,669
S01007081,725,0,6,3,0,734
S01007082,437,1,0,0,1,439
S01007083,786,0,6,2,0,794
S01007084,549,1,4,3,0,557
S01007085,674,0,9,1,0,684
S01007086,883,3,25,4,2,917
S01007087,745,0,6,0,2,753
S01007088,433,0,2,0,2,437
S01007089,422,0,0,1,0,423
S01007090,446,1,3,1,0,451
S01007091,575,0,8,4,0,587
S01007092,532,4,1,0,0,537
S01007093,848,0,4,1,0,853
S01007094,753,2,1,2,1,759
S01007095,446,0,1,0,0,447
S01007096,644,0,0,0,1,645
S01007097,388,0,5,3,0,396
S01007098,628,0,10,1,1,640
S01007099,692,0,2,0,0,694
S01007100,601,0,0,0,0,601
S01007101,701,0,5,0,0,706
S01007102,587,0,0,0,3,590
S01007103,677,0,0,0,1,678
S01007104,395,0,0,2,1,398
S01007105,446,0,0,0,1,447
S01007106,612,0,3,0,0,615
S01007107,540,0,0,1,2,543
S01007108,468,0,0,0,0,468
S01007109,664,0,2,1,1,668
S01007110,603,1,2,2,0,608
S01007111,431,1,2,0,1,435
S01007112,474,1,0,0,0,475
S01007113,479,1,4,3,1,488
S01007114,741,2,2,0,0,745
S01007115,578,0,6,0,0,584
S01007116,728,0,3,1,0,732
S01007117,397,0,0,1,0,398
S01007118,526,0,5,0,0,531
S01007119,658,0,0,0,0,658
S01007120,902,0,5,0,0,907
S01007121,459,0,6,1,0,466
S01007122,497,1,8,0,0,506
S01007123,561,1,3,1,0,566
S01007124,745,0,4,0,0,749
S01007125,665,1,7,3,0,676
S01007126,716,0,4,3,0,723
S01007127,820,1,6,5,1,833
S01007128,687,1,8,0,0,696
S01007129,725,0,6,8,0,739
S01007130,525,2,2,1,0,530
S01007131,649,0,5,1,0,655
S01007132,581,0,9,0,0,590
S01007133,551,1,2,0,0,554
S01007134,598,2,10,0,1,611
S01007135,429,0,8,0,0,437
S01007136,380,2,15,0,6,403
S01007137,507,3,4,3,2,519
S01007138,473,0,1,1,2,477
S01007139,620,0,4,0,3,627
S01007140,819,0,6,1,0,826
S01007141,534,0,7,0,0,541
S01007142,442,2,8,1,0,453
S01007143,432,0,2,1,0,435
S01007144,609,2,3,0,0,614
S01007145,747,0,24,0,2,773
S01007146,599,2,4,1,0,606
S01007147,593,2,12,0,0,607
S01007148,418,0,24,2,0,444
S01007149,461,0,10,1,0,472
S01007150,681,0,16,0,0,697
S01007151,701,0,12,1,0,714
S01007152,471,3,2,0,0,476
S01007153,525,0,1,0,0,526
S01007154,702,1,8,1,0,712
S01007155,538,0,2,0,1,541
S01007156,607,0,1,0,0,608
S01007157,497,0,3,2,1,503
S01007158,729,0,9,0,2,740
S01007159,675,2,4,5,1,687
S01007160,670,2,4,0,0,676
S01007161,574,0,0,2,0,576
S01007162,419,0,3,0,0,422
S01007163,739,1,3,2,0,745
S01007164,501,2,0,0,0,503
S01007165,700,2,4,0,1,707
S01007166,559,0,0,0,3,562
S01007167,673,2,3,1,0,679
S01007168,833,2,6,1,0,842
S01007169,623,0,8,1,4,636
S01007170,540,1,1,0,0,542
S01007171,740,1,1,0,0,742
S01007172,698,0,1,2,0,701
S01007173,669,0,1,0,0,670
S01007174,678,0,3,0,0,681
S01007175,547,0,1,0,0,548
S01007176,551,0,5,1,0,557
S01007177,501,1,4,0,2,508
S01007178,829,0,4,3,1,837
S01007179,861,0,8,1,0,870
S01007180,632,1,0,1,0,634
S01007181,699,0,5,0,0,704
S01007182,899,0,7,1,0,907
S01007183,929,1,8,0,1,939
S01007184,904,1,10,1,0,916
S01007185,686,1,5,0,0,692
S01007186,481,1,10,2,0,494
S01007187,687,0,16,2,2,707
S01007188,508,2,2,2,1,515
S01007189,703,2,4,1,0,710
S01007190,702,1,5,2,1,711
S01007191,501,0,10,0,0,511
S01007192,496,0,5,0,0,501
S01007193,602,1,5,0,0,608
S01007194,462,1,0,0,0,463
S01007195,429,0,7,0,0,436
S01007196,531,4,4,0,1,540
S01007197,453,0,4,0,0,457
S01007198,396,0,4,2,0,402
S01007199,593,3,4,1,0,601
S01007200,713,1,0,0,1,715
S01007201,623,0,2,0,0,625
S01007202,614,0,4,1,0,619
S01007203,517,0,1,0,0,518
S01007204,821,0,1,1,2,825
S01007205,581,0,1,1,0,583
S01007206,330,0,1,0,0,331
S01007207,743,4,7,0,0,754
S01007208,792,3,10,2,1,808
S01007209,654,2,10,5,0,671
S01007210,625,0,1,1,1,628
S01007211,797,2,4,2,0,805
S01007212,435,2,18,1,0,456
S01007213,781,1,7,0,0,789
S01007214,637,2,15,1,1,656
S01007215,637,0,12,1,0,650
S01007216,612,0,4,0,0,616
S01007217,777,2,0,3,5,787
S01007218,703,9,3,1,6,722
S01007219,669,1,1,3,1,675
S01007220,551,0,1,3,1,556
S01007221,517,2,3,3,0,525
S01007222,633,1,6,0,0,640
S01007223,415,0,1,0,0,416
S01007224,488,1,2,0,0,491
S01007225,713,1,5,2,0,721
S01007226,664,1,3,1,0,669
S01007227,773,2,5,0,0,780
S01007228,512,1,3,1,0,517
S01007229,910,3,1,1,0,915
S01007230,584,0,4,0,0,588
S01007231,569,2,3,2,0,576
S01007232,595,0,1,4,1,601
S01007233,638,1,8,0,0,647
S01007234,504,0,0,1,0,505
S01007235,652,0,4,3,0,659
S01007236,512,0,7,1,1,521
S01007237,600,1,5,1,1,608
S01007238,776,1,1,0,0,778
S01007239,736,0,8,1,0,745
S01007240,459,0,3,1,0,463
S01007241,507,0,0,0,0,507
S01007242,831,1,0,0,1,833
S01007243,503,0,1,0,0,504
S01007244,612,1,6,1,0,620
S01007245,577,0,5,1,0,583
S01007246,471,0,0,2,0,473
S01007247,527,1,2,0,0,530
S01007248,630,0,13,0,0,643
S01007249,367,0,4,0,0,371
S01007250,712,2,2,0,0,716
S01007251,418,0,4,0,0,422
S01007252,640,0,2,0,0,642
S01007253,685,0,1,0,1,687
S01007254,672,0,0,3,4,679
S01007255,612,0,1,0,0,613
S01007256,634,2,8,2,1,647
S01007257,470,2,12,1,1,486
S01007258,725,4,2,1,1,733
S01007259,717,1,3,0,1,722
S01007260,708,3,4,3,1,719
S01007261,674,0,4,3,2,683
S01007262,582,1,2,0,0,585
S01007263,649,0,3,1,0,653
S01007264,659,1,3,0,0,663
S01007265,896,0,6,0,0,902
S01007266,564,0,4,1,0,569
S01007267,435,0,4,0,0,439
S01007268,493,0,1,2,0,496
S01007269,436,0,0,2,2,440
S01007270,381,0,3,0,0,384
S01007271,833,0,1,1,1,836
S01007272,667,0,3,1,1,672
S01007273,537,3,2,4,1,547
S01007274,705,0,11,1,0,717
S01007275,488,0,11,0,0,499
S01007276,674,0,1,2,1,678
S01007277,633,2,1,1,0,637
S01007278,446,1,1,0,1,449
S01007279,464,1,0,0,1,466
S01007280,438,2,2,0,3,445
S01007281,795,4,4,1,1,805
S01007282,432,1,2,0,1,436
S01007283,854,0,6,3,3,866
S01007284,694,2,3,2,1,702
S01007285,721,0,3,0,0,724
S01007286,784,0,2,1,0,787
S01007287,519,2,1,1,0,523
S01007288,483,2,1,1,0,487
S01007289,671,1,2,0,0,674
S01007290,508,1,3,1,2,515
S01007291,577,2,2,2,0,583
S01007292,624,0,7,1,0,632
S01007293,564,0,5,7,1,577
S01007294,737,0,5,2,1,745
S01007295,425,2,2,2,1,432
S01007296,508,2,9,0,0,519
S01007297,759,1,17,4,2,783
S01007298,433,0,3,1,0,437
S01007299,722,2,6,3,0,733
S01007300,407,1,1,2,0,411
S01007301,622,0,2,1,1,626
S01007302,511,1,0,0,0,512
S01007303,772,2,5,0,0,779
S01007304,581,1,0,1,1,584
S01007305,602,0,6,0,0,608
S01007306,610,1,1,0,0,612
S01007307,657,2,3,0,1,663
S01007308,680,2,1,1,2,686
S01007309,546,0,1,2,1,550
S01007310,680,2,1,2,1,686
S01007311,647,2,1,2,1,653
S01007312,620,0,5,1,0,626
S01007313,820,3,1,0,2,826
S01007314,523,1,2,2,0,528
S01007315,776,0,4,1,0,781
S01007316,727,0,3,1,2,733
S01007317,520,2,5,3,0,530
S01007318,466,1,5,3,0,475
S01007319,627,0,5,0,0,632
S01007320,635,0,4,0,1,640
S01007321,526,1,0,1,0,528
S01007322,630,1,2,1,0,634
S01007323,392,0,2,0,0,394
S01007324,286,2,1,1,0,290
S01007325,677,1,5,2,0,685
S01007326,658,0,0,1,0,659
S01007327,653,0,3,0,1,657
S01007328,711,0,1,0,1,713
S01007329,567,0,0,1,0,568
S01007330,686,1,2,1,0,690
S01007331,810,1,4,0,0,815
S01007332,433,0,0,2,0,435
S01007333,681,1,3,2,1,688
S01007334,580,2,6,3,0,591
S01007335,662,1,3,1,0,667
S01007336,449,1,6,1,1,458
S01007337,561,0,1,0,0,562
S01007338,603,1,2,0,0,606
S01007339,520,0,5,2,0,527
S01007340,401,0,1,2,0,404
S01007341,651,0,2,1,0,654
S01007342,719,0,3,1,1,724
S01007343,566,0,2,1,0,569
S01007344,390,0,3,1,0,394
S01007345,453,1,0,0,0,454
S01007346,479,0,4,2,2,487
S01007347,540,1,2,0,0,543
S01007348,489,1,1,0,0,491
S01007349,339,0,1,0,0,340
S01007350,506,0,0,0,0,506
S01007351,587,1,3,1,0,592
S01007352,439,0,2,0,1,442
S01007353,533,1,3,1,0,538
S01007354,702,0,4,0,1,707
S01007355,850,2,2,0,0,854
S01007356,620,1,2,1,1,625
S01007357,669,2,8,2,0,681
S01007358,757,0,5,2,1,765
S01007359,660,3,2,3,0,668
S01007360,478,1,1,1,0,481
S01007361,871,3,6,2,2,884
S01007362,656,2,0,1,0,659
S01007363,604,3,0,1,0,608
S01007364,682,3,0,1,1,687
S01007365,389,2,0,1,0,392
S01007366,393,1,1,1,2,398
S01007367,466,1,4,3,0,474
S01007368,400,3,0,1,0,404
S01007369,616,4,8,0,0,628
S01007370,632,4,2,1,1,640
S01007371,561,0,1,1,0,563
S01007372,743,2,12,2,0,759
S01007373,534,0,2,0,0,536
S01007374,434,0,0,0,1,435
S01007375,402,2,0,2,0,406
S01007376,683,0,2,3,0,688
S01007377,545,3,2,1,2,553
S01007378,1349,7,6,5,0,1367
S01007379,404,0,0,0,1,405
S01007380,445,1,2,0,0,448
S01007381,417,2,3,0,1,423
S01007382,534,0,0,0,0,534
S01007383,636,0,1,0,0,637
S01007384,606,1,3,1,0,611
S01007385,723,0,2,2,2,729
S01007386,671,0,8,1,4,684
S01007387,653,3,6,2,0,664
S01007388,563,2,5,2,0,572
S01007389,375,2,3,6,2,388
S01007390,361,0,1,0,1,363
S01007391,487,0,0,0,0,487
S01007392,407,0,6,0,0,413
S01007393,651,3,7,3,1,665
S01007394,550,1,8,0,0,559
S01007395,701,2,9,2,0,714
S01007396,668,1,21,1,0,691
S01007397,776,2,14,0,2,794
S01007398,507,0,8,0,0,515
S01007399,496,1,5,1,0,503
S01007400,594,1,7,2,1,605
S01007401,547,1,22,0,0,570
S01007402,519,0,2,0,0,521
S01007403,544,2,4,1,0,551
S01007404,368,2,0,0,1,371
S01007405,544,1,4,1,0,550
S01007406,512,2,5,2,0,521
S01007407,591,0,3,4,0,598
S01007408,474,1,9,0,0,484
S01007409,608,0,6,0,0,614
S01007410,540,0,1,0,0,541
S01007411,692,1,5,1,0,699
S01007412,396,0,0,0,0,396
S01007413,715,1,5,0,0,721
S01007414,505,0,17,2,1,525
S01007415,675,1,1,0,0,677
S01007416,421,0,2,0,0,423
S01007417,772,1,20,0,0,793
S01007418,528,2,3,1,0,534
S01007419,639,0,11,0,0,650
S01007420,1255,3,19,6,0,1283
S01007421,523,0,0,1,0,524
S01007422,481,0,8,3,0,492
S01007423,592,1,4,3,0,600
S01007424,672,0,1,0,0,673
S01007425,720,0,2,2,0,724
S01007426,526,0,12,5,0,543
S01007427,545,0,2,3,0,550
S01007428,744,1,4,0,0,749
S01007429,595,3,3,0,0,601
S01007430,393,0,2,0,0,395
S01007431,478,0,0,0,0,478
S01007432,699,1,7,1,0,708
S01007433,657,0,2,0,0,659
S01007434,400,1,1,0,0,402
S01007435,571,0,3,0,0,574
S01007436,538,0,2,1,2,543
S01007437,364,1,4,1,0,370
S01007438,560,1,9,2,0,572
S01007439,590,1,5,4,0,600
S01007440,531,0,8,0,0,539
S01007441,457,1,3,1,0,462
S01007442,410,0,8,0,0,418
S01007443,744,4,5,3,2,758
S01007444,761,2,8,2,0,773
S01007445,491,5,8,0,1,505
S01007446,414,2,5,0,1,422
S01007447,409,1,1,0,0,411
S01007448,730,0,5,1,0,736
S01007449,809,3,8,0,1,821
S01007450,591,1,6,0,0,598
S01007451,521,1,0,0,2,524
S01007452,408,0,5,0,1,414
S01007453,442,2,14,0,0,458
S01007454,414,0,0,3,1,418
S01007455,674,0,1,2,0,677
S01007456,695,0,7,0,0,702
S01007457,862,1,1,5,1,870
S01007458,442,0,0,1,0,443
S01007459,545,4,2,0,0,551
S01007460,615,1,2,1,0,619
S01007461,562,1,2,3,0,568
S01007462,651,0,5,0,5,661
S01007463,692,4,25,0,0,721
S01007464,538,3,6,1,0,548
S01007465,588,2,4,0,0,594
S01007466,828,2,21,0,0,851
S01007467,803,1,9,11,0,824
S01007468,604,0,3,0,0,607
S01007469,462,0,0,3,0,465
S01007470,568,0,4,0,0,572
S01007471,381,0,1,0,0,382
S01007472,450,1,6,0,1,458
S01007473,370,0,0,0,0,370
S01007474,442,0,3,0,0,445
S01007475,481,2,6,1,1,491
S01007476,560,2,1,2,0,565
S01007477,426,1,7,2,1,437
S01007478,739,0,12,0,0,751
S01007479,453,2,3,0,0,458
S01007480,602,0,7,0,0,609
S01007481,736,0,4,0,0,740
S01007482,408,0,0,0,0,408
S01007483,628,0,0,1,0,629
S01007484,467,1,2,0,0,470
S01007485,355,2,0,1,1,359
S01007486,379,1,0,1,1,382
S01007487,751,0,11,0,1,763
S01007488,829,1,7,1,0,838
S01007489,725,0,0,0,0,725
S01007490,754,0,0,3,0,757
S01007491,877,1,5,3,0,886
S01007492,595,0,2,0,0,597
S01007493,676,1,0,0,0,677
S01007494,446,0,2,0,0,448
S01007495,675,1,0,1,0,677
S01007496,875,0,3,4,0,882
S01007497,477,1,1,1,1,481
S01007498,736,0,1,0,0,737
S01007499,686,0,0,0,1,687
S01007500,512,2,2,0,0,516
S01007501,594,0,4,0,0,598
S01007502,445,0,1,0,1,447
S01007503,863,1,2,3,1,870
S01007504,586,0,0,2,0,588
S01007505,345,0,1,0,0,346
S01007506,426,0,0,0,0,426
S01007507,789,1,1,1,1,793
S01007508,602,0,1,1,0,604
S01007509,528,0,0,0,0,528
S01007510,854,1,0,3,4,862
S01007511,668,2,2,3,0,675
S01007512,447,1,0,1,0,449
S01007513,821,0,2,2,0,825
S01007514,435,0,9,0,1,445
S01007515,509,0,8,2,0,519
S01007516,473,0,1,1,0,475
S01007517,423,1,2,0,0,426
S01007518,694,1,2,0,2,699
S01007519,403,0,3,0,0,406
S01007520,808,1,0,0,1,810
S01007521,375,1,1,1,2,380
S01007522,863,2,0,0,3,868
S01007523,457,0,0,0,0,457
S01007524,809,1,2,0,6,818
S01007525,465,0,0,0,0,465
S01007526,630,0,1,2,0,633
S01007527,679,0,0,0,0,679
S01007528,629,0,4,0,0,633
S01007529,577,1,4,0,0,582
S01007530,443,1,2,0,0,446
S01007531,570,5,0,3,3,581
S01007532,480,0,0,0,0,480
S01007533,470,0,0,1,0,471
S01007534,787,0,1,2,0,790
S01007535,859,2,0,0,1,862
S01007536,772,2,5,2,2,783
S01007537,901,0,5,0,0,906
S01007538,755,0,5,0,0,760
S01007539,584,0,0,0,0,584
S01007540,714,1,6,1,0,722
S01007541,672,0,0,0,0,672
S01007542,703,2,7,0,0,712
S01007543,864,0,3,1,1,869
S01007544,925,1,2,1,1,930
S01007545,682,0,0,0,0,682
S01007546,457,1,0,0,0,458
S01007547,455,1,2,1,0,459
S01007548,574,1,3,0,0,578
S01007549,518,0,0,1,0,519
S01007550,787,2,0,0,0,789
S01007551,761,1,4,0,0,766
S01007552,732,2,0,3,0,737
S01007553,708,0,0,1,0,709
S01007554,370,0,0,1,0,371
S01007555,443,1,1,1,0,446
S01007556,433,1,3,1,1,439
S01007557,896,1,2,0,0,899
S01007558,365,0,1,0,0,366
S01007559,590,0,1,0,0,591
S01007560,792,0,3,1,0,796
S01007561,637,2,1,0,0,640
S01007562,685,0,2,1,0,688
S01007563,723,0,4,1,1,729
S01007564,652,0,0,0,0,652
S01007565,784,2,7,1,0,794
S01007566,600,2,1,0,0,603
S01007567,479,3,1,0,0,483
S01007568,547,0,2,0,1,550
S01007569,687,2,6,1,2,698
S01007570,564,0,2,1,0,567
S01007571,460,2,2,1,0,465
S01007572,784,3,0,0,1,788
S01007573,621,1,24,0,0,646
S01007574,818,0,0,2,0,820
S01007575,700,0,1,3,0,704
S01007576,539,0,2,0,1,542
S01007577,520,1,5,0,1,527
S01007578,534,2,1,3,0,540
S01007579,483,0,11,0,1,495
S01007580,630,0,8,0,0,638
S01007581,391,1,0,0,0,392
S01007582,529,0,2,1,1,533
S01007583,820,3,9,1,0,833
S01007584,481,3,7,2,0,493
S01007585,803,3,3,1,1,811
S01007586,658,2,9,0,1,670
S01007587,714,2,15,1,0,732
S01007588,696,5,6,4,0,711
S01007589,661,3,10,1,4,679
S01007590,528,1,4,4,2,539
S01007591,483,1,4,0,2,490
S01007592,571,0,9,0,0,580
S01007593,898,1,18,2,3,922
S01007594,709,2,0,1,0,712
S01007595,891,4,2,4,0,901
S01007596,481,0,0,0,2,483
S01007597,528,1,0,0,0,529
S01007598,543,1,6,1,0,551
S01007599,668,2,20,6,1,697
S01007600,901,3,42,2,4,952
S01007601,518,0,8,0,0,526
S01007602,522,0,3,3,0,528
S01007603,635,0,11,0,0,646
S01007604,740,1,18,0,1,760
S01007605,703,0,10,0,0,713
S01007606,514,2,5,1,0,522
S01007607,585,1,4,0,0,590
S01007608,630,0,10,0,0,640
S01007609,730,0,6,2,0,738
S01007610,447,0,3,0,0,450
S01007611,779,1,12,2,1,795
S01007612,889,3,41,3,2,938
S01007613,648,5,6,1,2,662
S01007614,679,2,12,1,1,695
S01007615,871,3,2,5,0,881
S01007616,597,5,7,1,0,610
S01007617,439,0,2,0,0,441
S01007618,516,0,1,0,0,517
S01007619,515,0,3,0,0,518
S01007620,506,0,1,0,0,507
S01007621,556,0,0,1,1,558
S01007622,465,1,2,0,3,471
S01007623,489,3,13,0,5,510
S01007624,536,0,3,0,0,539
S01007625,421,0,8,2,0,431
S01007626,492,1,8,0,0,501
S01007627,426,0,16,1,2,445
S01007628,599,1,2,0,3,605
S01007629,578,0,0,0,0,578
S01007630,692,2,1,1,0,696
S01007631,515,2,0,1,0,518
S01007632,797,1,3,2,0,803
S01007633,811,3,6,0,2,822
S01007634,484,0,1,0,0,485
S01007635,645,0,4,0,0,649
S01007636,739,2,2,0,0,743
S01007637,700,1,1,1,0,703
S01007638,647,2,3,0,1,653
S01007639,837,1,7,0,1,846
S01007640,598,1,1,0,0,600
S01007641,669,1,5,4,0,679
S01007642,712,0,2,3,1,718
S01007643,757,1,3,0,0,761
S01007644,692,0,3,3,0,698
S01007645,445,2,1,0,1,449
S01007646,526,0,8,0,0,534
S01007647,616,0,3,0,1,620
S01007648,732,1,9,0,1,743
S01007649,620,0,0,0,0,620
S01007650,818,3,4,0,2,827
S01007651,470,1,4,0,0,475
S01007652,502,0,0,0,1,503
S01007653,757,0,0,1,0,758
S01007654,902,0,2,3,0,907
S01007655,656,4,2,1,0,663
S01007656,712,0,1,3,0,716
S01007657,358,2,0,0,0,360
S01007658,427,1,0,0,1,429
S01007659,663,0,4,0,0,667
S01007660,680,0,0,0,0,680
S01007661,551,0,9,3,1,564
S01007662,768,1,5,1,0,775
S01007663,714,0,11,0,0,725
S01007664,479,1,1,4,0,485
S01007665,500,0,2,0,0,502
S01007666,414,0,1,0,0,415
S01007667,577,0,8,1,0,586
S01007668,879,0,0,0,0,879
S01007669,477,0,3,0,0,480
S01007670,536,0,2,1,0,539
S01007671,623,0,0,0,0,623
S01007672,768,1,1,0,0,770
S01007673,580,0,3,1,2,586
S01007674,663,0,2,0,0,665
S01007675,524,0,1,0,0,525
S01007676,571,0,2,0,0,573
S01007677,410,0,2,0,0,412
S01007678,667,1,0,0,0,668
S01007679,680,0,3,0,0,683
S01007680,772,0,11,0,0,783
S01007681,358,1,4,2,0,365
S01007682,683,2,60,3,18,766
S01007683,444,5,116,6,13,584
S01007684,650,3,35,4,2,694
S01007685,718,4,60,13,6,801
S01007686,558,3,30,0,0,591
S01007687,721,6,43,5,1,776
S01007688,827,9,67,15,12,930
S01007689,478,2,52,19,8,559
S01007690,734,7,69,7,5,822
S01007691,2260,27,311,171,50,2819
S01007692,781,11,46,10,17,865
S01007693,795,16,99,11,10,931
S01007694,876,8,69,38,20,1011
S01007695,789,5,60,24,16,894
S01007696,579,6,94,32,8,719
S01007697,833,6,37,7,3,886
S01007698,827,7,67,71,12,984
S01007699,559,4,95,24,9,691
S01007700,806,3,37,6,6,858
S01007701,443,0,24,19,6,492
S01007702,865,11,47,28,12,963
S01007703,659,1,34,2,0,696
S01007704,716,1,56,24,2,799
S01007705,588,8,98,26,15,735
S01007706,624,9,85,31,8,757
S01007707,623,8,70,30,35,766
S01007708,498,4,46,1,1,550
S01007709,488,3,27,3,9,530
S01007710,636,5,70,25,5,741
S01007711,852,8,105,13,2,980
S01007712,550,2,63,7,9,631
S01007713,347,2,60,2,6,417
S01007714,516,0,24,2,5,547
S01007715,362,4,42,23,3,434
S01007716,827,4,67,36,9,943
S01007717,765,5,60,5,5,840
S01007718,580,3,27,18,5,633
S01007719,840,2,21,13,4,880
S01007720,634,0,12,1,0,647
S01007721,631,1,7,5,2,646
S01007722,689,1,32,6,5,733
S01007723,800,2,43,5,1,851
S01007724,450,1,62,12,3,528
S01007725,659,3,20,5,3,690
S01007726,595,1,70,9,2,677
S01007727,796,7,56,11,6,876
S01007728,612,1,57,9,5,684
S01007729,586,0,60,14,4,664
S01007730,631,6,25,8,4,674
S01007731,582,3,25,2,3,615
S01007732,543,2,36,11,2,594
S01007733,591,1,87,3,3,685
S01007734,688,2,34,0,1,725
S01007735,651,1,62,1,1,716
S01007736,532,1,85,0,0,618
S01007737,809,2,58,8,10,887
S01007738,606,1,15,2,2,626
S01007739,536,0,5,0,0,541
S01007740,478,0,16,1,2,497
S01007741,638,2,15,1,2,658
S01007742,540,1,11,0,0,552
S01007743,710,2,8,2,2,724
S01007744,610,0,4,3,0,617
S01007745,578,0,4,1,0,583
S01007746,710,2,3,3,2,720
S01007747,408,1,3,5,0,417
S01007748,538,1,0,4,0,543
S01007749,539,1,39,2,2,583
S01007750,677,3,35,2,3,720
S01007751,637,2,36,0,1,676
S01007752,649,3,5,0,1,658
S01007753,406,2,6,1,1,416
S01007754,685,0,3,0,2,690
S01007755,673,0,3,0,0,676
S01007756,475,0,4,1,1,481
S01007757,702,1,15,0,0,718
S01007758,771,1,11,2,6,791
S01007759,848,1,14,2,4,869
S01007760,514,0,2,2,0,518
S01007761,703,3,9,7,5,727
S01007762,723,1,2,3,0,729
S01007763,472,1,9,0,1,483
S01007764,619,1,12,1,1,634
S01007765,559,1,7,0,1,568
S01007766,752,1,20,4,0,777
S01007767,742,7,12,1,0,762
S01007768,555,3,6,0,8,572
S01007769,633,0,5,3,0,641
S01007770,605,2,6,0,0,613
S01007771,442,1,7,0,0,450
S01007772,830,0,10,6,0,846
S01007773,633,0,8,0,1,642
S01007774,671,1,9,0,0,681
S01007775,735,1,11,2,6,755
S01007776,532,1,22,6,0,561
S01007777,636,2,29,3,1,671
S01007778,362,0,9,1,0,372
S01007779,602,1,4,1,0,608
S01007780,647,0,2,0,0,649
S01007781,732,0,2,2,0,736
S01007782,363,0,5,4,3,375
S01007783,627,1,8,1,0,637
S01007784,523,0,8,0,0,531
S01007785,436,1,1,0,0,438
S01007786,609,0,3,0,0,612
S01007787,521,0,1,0,0,522
S01007788,462,0,1,2,1,466
S01007789,454,0,0,3,2,459
S01007790,559,0,1,0,0,560
S01007791,397,0,2,1,0,400
S01007792,703,1,3,2,0,709
S01007793,720,0,1,2,1,724
S01007794,441,0,7,0,0,448
S01007795,456,1,0,0,1,458
S01007796,521,0,4,2,1,528
S01007797,397,1,5,2,1,406
S01007798,459,3,29,1,2,494
S01007799,392,1,28,9,0,430
S01007800,712,0,2,5,1,720
S01007801,784,2,7,6,0,799
S01007802,371,2,26,1,3,403
S01007803,793,2,5,7,1,808
S01007804,443,3,2,1,3,452
S01007805,358,3,4,0,1,366
S01007806,518,0,1,0,1,520
S01007807,540,0,7,0,1,548
S01007808,628,1,3,2,1,635
S01007809,775,3,12,0,0,790
S01007810,688,0,1,0,1,690
S01007811,631,1,1,4,1,638
S01007812,580,0,4,5,0,589
S01007813,574,0,3,1,2,580
S01007814,462,0,6,0,0,468
S01007815,799,0,7,0,2,808
S01007816,556,1,0,1,0,558
S01007817,388,0,1,4,0,393
S01007818,601,0,5,0,1,607
S01007819,672,1,2,0,0,675
S01007820,776,2,18,12,0,808
S01007821,465,0,3,1,0,469
S01007822,631,0,3,0,0,634
S01007823,600,1,9,1,0,611
S01007824,591,0,36,2,3,632
S01007825,832,1,32,1,10,876
S01007826,461,0,2,2,0,465
S01007827,480,1,9,2,3,495
S01007828,863,6,13,6,1,889
S01007829,521,2,11,5,0,539
S01007830,765,5,42,3,3,818
S01007831,710,2,24,3,3,742
S01007832,519,0,26,4,2,551
S01007833,712,2,16,1,0,731
S01007834,585,4,26,3,7,625
S01007835,556,2,13,4,5,580
S01007836,440,3,19,1,5,468
S01007837,678,0,16,0,1,695
S01007838,713,0,20,2,3,738
S01007839,562,2,68,11,8,651
S01007840,610,7,28,2,0,647
S01007841,547,0,8,9,2,566
S01007842,545,1,12,10,7,575
S01007843,535,0,34,7,2,578
S01007844,703,7,48,10,5,773
S01007845,658,0,8,3,0,669
S01007846,557,1,6,6,6,576
S01007847,723,0,6,8,0,737
S01007848,614,1,18,5,5,643
S01007849,676,5,1,1,5,688
S01007850,610,1,3,1,0,615
S01007851,804,2,4,1,0,811
S01007852,531,1,8,0,0,540
S01007853,560,3,10,2,1,576
S01007854,864,1,5,14,7,891
S01007855,414,2,6,4,2,428
S01007856,664,3,4,1,2,674
S01007857,382,1,0,1,0,384
S01007858,867,0,9,1,2,879
S01007859,384,2,0,3,0,389
S01007860,440,0,5,0,0,445
S01007861,530,0,0,0,3,533
S01007862,573,0,2,0,0,575
S01007863,673,0,2,1,0,676
S01007864,767,1,1,1,1,771
S01007865,474,0,6,2,5,487
S01007866,445,2,2,1,0,450
S01007867,398,0,11,2,0,411
S01007868,731,3,17,2,5,758
S01007869,670,3,94,1,14,782
S01007870,457,0,1,0,0,458
S01007871,521,0,3,0,0,524
S01007872,553,0,5,0,0,558
S01007873,594,0,4,0,0,598
S01007874,630,1,5,1,1,638
S01007875,441,0,0,0,1,442
S01007876,773,0,3,0,0,776
S01007877,641,1,0,0,0,642
S01007878,560,0,0,0,0,560
S01007879,586,1,0,0,1,588
S01007880,334,0,1,1,0,336
S01007881,448,1,0,2,1,452
S01007882,604,4,6,0,0,614
S01007883,866,0,6,1,0,873
S01007884,511,0,2,1,0,514
S01007885,612,1,0,0,0,613
S01007886,741,1,0,0,0,742
S01007887,480,0,0,1,0,481
S01007888,827,0,2,0,0,829
S01007889,443,0,0,0,0,443
S01007890,591,1,1,1,0,594
S01007891,712,2,0,0,0,714
S01007892,632,0,0,1,1,634
S01007893,857,1,9,1,0,868
S01007894,760,1,0,0,0,761
S01007895,456,1,5,0,0,462
S01007896,700,1,0,0,0,701
S01007897,355,1,1,1,0,358
S01007898,363,0,0,0,0,363
S01007899,307,0,0,1,0,308
S01007900,451,0,0,0,0,451
S01007901,574,1,0,1,0,576
S01007902,730,2,0,0,0,732
S01007903,561,0,1,1,0,563
S01007904,693,1,3,0,0,697
S01007905,546,0,1,0,0,547
S01007906,621,0,3,1,0,625
S01007907,475,0,0,0,0,475
S01007908,791,2,3,0,0,796
S01007909,422,0,0,0,0,422
S01007910,690,0,4,1,0,695
S01007911,631,0,1,0,1,633
S01007912,659,3,0,0,0,662
S01007913,509,0,0,0,0,509
S01007914,516,0,1,0,0,517
S01007915,683,2,0,1,0,686
S01007916,701,1,2,0,0,704
S01007917,730,0,0,1,0,731
S01007918,789,0,4,1,0,794
S01007919,636,2,11,0,0,649
S01007920,464,1,28,0,0,493
S01007921,770,0,2,0,4,776
S01007922,709,0,7,2,0,718
S01007923,800,0,6,8,0,814
S01007924,811,2,11,2,0,826
S01007925,385,1,0,1,0,387
S01007926,391,0,2,0,0,393
S01007927,516,1,8,0,0,525
S01007928,845,0,5,0,0,850
S01007929,597,0,0,1,0,598
S01007930,471,2,0,0,0,473
S01007931,896,0,13,1,2,912
S01007932,718,1,1,5,0,725
S01007933,648,0,2,0,0,650
S01007934,559,1,1,0,0,561
S01007935,667,6,1,4,0,678
S01007936,789,0,1,1,0,791
S01007937,848,0,16,1,0,865
S01007938,630,0,1,0,1,632
S01007939,709,0,3,1,0,713
S01007940,867,3,0,0,1,871
S01007941,541,0,3,0,0,544
S01007942,358,2,1,1,0,362
S01007943,562,0,1,0,1,564
S01007944,761,0,2,1,0,764
S01007945,716,0,3,2,2,723
S01007946,660,0,3,0,0,663
S01007947,613,1,1,1,2,618
S01007948,524,0,2,0,0,526
S01007949,651,1,1,0,1,654
S01007950,728,0,5,1,1,735
S01007951,615,0,4,0,0,619
S01007952,541,1,1,0,0,543
S01007953,762,0,0,1,0,763
S01007954,581,2,3,0,0,586
S01007955,633,1,1,1,0,636
S01007956,577,0,0,0,0,577
S01007957,790,0,5,0,0,795
S01007958,734,0,4,2,0,740
S01007959,678,0,11,0,1,690
S01007960,571,0,0,0,0,571
S01007961,1087,1,10,2,3,1103
S01007962,442,0,0,1,0,443
S01007963,697,0,3,2,0,702
S01007964,639,0,1,1,2,643
S01007965,456,0,0,0,0,456
S01007966,722,1,9,0,1,733
S01007967,463,0,0,0,1,464
S01007968,741,0,0,0,0,741
S01007969,697,0,3,0,0,700
S01007970,706,1,0,0,0,707
S01007971,789,1,4,1,1,796
S01007972,701,2,2,0,0,705
S01007973,720,2,1,0,1,724
S01007974,691,0,6,2,0,699
S01007975,558,0,1,0,2,561
S01007976,640,1,3,1,0,645
S01007977,555,2,1,0,0,558
S01007978,495,3,7,0,0,505
S01007979,695,1,10,1,0,707
S01007980,607,0,3,1,0,611
S01007981,481,0,5,2,0,488
S01007982,438,1,0,0,0,439
S01007983,642,0,5,1,1,649
S01007984,677,0,2,0,2,681
S01007985,742,0,2,0,0,744
S01007986,472,0,3,0,0,475
S01007987,618,2,1,0,0,621
S01007988,660,0,7,0,0,667
S01007989,547,0,4,0,0,551
S01007990,675,1,6,1,0,683
S01007991,682,1,33,4,0,720
S01007992,465,0,29,0,0,494
S01007993,700,1,2,0,0,703
S01007994,586,0,15,0,4,605
S01007995,675,1,6,0,1,683
S01007996,376,5,10,1,0,392
S01007997,562,2,13,1,3,581
S01007998,436,0,14,1,0,451
S01007999,543,0,0,1,0,544
S01008000,730,1,0,1,1,733
S01008001,651,1,3,0,0,655
S01008002,603,4,3,1,0,611
S01008003,503,3,21,1,5,533
S01008004,443,0,22,0,0,465
S01008005,377,2,15,1,2,397
S01008006,441,1,0,3,0,445
S01008007,330,0,6,0,0,336
S01008008,449,1,8,1,0,459
S01008009,585,1,4,0,0,590
S01008010,740,0,7,0,0,747
S01008011,605,2,3,1,1,612
S01008012,691,1,6,3,0,701
S01008013,611,2,2,3,2,620
S01008014,539,1,3,0,2,545
S01008015,651,4,7,1,0,663
S01008016,683,1,4,1,0,689
S01008017,780,1,4,0,2,787
S01008018,563,0,6,0,4,573
S01008019,614,2,4,0,0,620
S01008020,511,0,12,0,1,524
S01008021,479,0,2,1,0,482
S01008022,587,0,18,0,0,605
S01008023,529,0,20,0,0,549
S01008024,472,1,7,0,2,482
S01008025,580,0,3,0,0,583
S01008026,852,1,0,0,0,853
S01008027,464,3,6,2,0,475
S01008028,460,1,7,0,1,469
S01008029,778,0,3,3,0,784
S01008030,909,1,0,2,0,912
S01008031,724,3,0,1,2,730
S01008032,729,1,3,0,0,733
S01008033,593,2,28,2,0,625
S01008034,555,2,37,0,5,599
S01008035,516,0,11,1,3,531
S01008036,561,1,3,0,2,567
S01008037,819,2,11,0,1,833
S01008038,585,1,5,0,1,592
S01008039,684,1,18,6,6,715
S01008040,641,0,11,0,1,653
S01008041,580,3,16,1,0,600
S01008042,461,1,14,3,1,480
S01008043,759,1,7,0,0,767
S01008044,801,6,4,2,2,815
S01008045,785,3,39,1,0,828
S01008046,739,1,15,0,0,755
S01008047,566,0,13,2,0,581
S01008048,481,0,7,0,0,488
S01008049,678,1,14,9,7,709
S01008050,468,1,35,4,0,508
S01008051,665,1,21,2,1,690
S01008052,650,0,12,2,4,668
S01008053,497,0,7,0,3,507
S01008054,625,2,31,1,3,662
S01008055,809,3,19,1,3,835
S01008056,571,5,40,0,7,623
S01008057,720,3,32,1,2,758
S01008058,624,1,87,6,0,718
S01008059,529,0,28,1,1,559
S01008060,677,0,45,0,3,725
S01008061,588,1,31,1,6,627
S01008062,682,2,25,1,4,714
S01008063,705,2,47,5,5,764
S01008064,528,4,33,2,1,568
S01008065,718,5,42,2,8,775
S01008066,705,1,14,2,5,727
S01008067,501,1,21,1,0,524
S01008068,728,3,35,4,7,777
S01008069,745,0,32,0,0,777
S01008070,715,1,23,3,0,742
S01008071,555,5,13,3,4,580
S01008072,646,4,51,2,3,706
S01008073,353,0,49,1,0,403
S01008074,772,1,27,1,8,809
S01008075,456,2,28,2,4,492
S01008076,558,1,22,0,1,582
S01008077,633,4,41,0,1,679
S01008078,631,2,62,4,0,699
S01008079,673,5,53,3,1,735
S01008080,532,0,27,1,0,560
S01008081,427,4,55,2,4,492
S01008082,599,2,79,0,6,686
S01008083,511,5,66,3,1,586
S01008084,705,0,5,1,1,712
S01008085,784,0,9,1,0,794
S01008086,856,1,4,0,0,861
S01008087,645,1,43,1,4,694
S01008088,756,3,19,0,2,780
S01008089,520,2,17,0,4,543
S01008090,597,1,20,1,3,622
S01008091,328,0,2,2,0,332
S01008092,731,1,31,1,3,767
S01008093,656,0,12,0,4,672
S01008094,527,0,26,0,2,555
S01008095,634,2,8,0,1,645
S01008096,664,2,10,0,0,676
S01008097,529,1,10,3,0,543
S01008098,600,5,14,1,0,620
S01008099,439,0,4,1,0,444
S01008100,718,0,76,5,1,800
S01008101,604,2,19,0,4,629
S01008102,666,1,23,0,5,695
S01008103,517,2,5,0,0,524
S01008104,705,1,5,2,5,718
S01008105,833,1,14,2,6,856
S01008106,625,1,12,0,1,639
S01008107,514,3,104,2,2,625
S01008108,504,0,30,1,5,540
S01008109,726,2,28,0,0,756
S01008110,643,3,35,1,15,697
S01008111,729,0,19,1,2,751
S01008112,677,1,34,0,1,713
S01008113,727,1,47,0,4,779
S01008114,559,1,17,0,1,578
S01008115,681,1,78,0,1,761
S01008116,714,2,31,4,2,753
S01008117,655,2,19,0,0,676
S01008118,670,0,15,3,2,690
S01008119,527,4,9,0,2,542
S01008120,497,0,18,0,3,518
S01008121,550,0,4,2,0,556
S01008122,573,2,14,3,0,592
S01008123,742,2,17,0,2,763
S01008124,649,1,16,0,1,667
S01008125,709,0,16,2,1,728
S01008126,654,0,8,6,0,668
S01008127,397,2,11,0,1,411
S01008128,742,1,3,3,1,750
S01008129,728,2,13,0,5,748
S01008130,802,0,10,2,1,815
S01008131,631,3,8,0,0,642
S01008132,837,1,9,3,0,850
S01008133,521,0,14,1,4,540
S01008134,509,0,11,0,0,520
S01008135,889,1,22,1,3,916
S01008136,749,2,5,0,0,756
S01008137,664,0,2,1,0,667
S01008138,639,2,3,0,1,645
S01008139,703,0,9,0,1,713
S01008140,402,1,3,0,1,407
S01008141,701,1,9,1,0,712
S01008142,650,0,9,5,0,664
S01008143,750,0,4,0,1,755
S01008144,501,0,2,2,0,505
S01008145,639,0,6,1,0,646
S01008146,413,0,1,0,0,414
S01008147,656,0,6,2,0,664
S01008148,638,0,6,1,3,648
S01008149,560,1,6,0,1,568
S01008150,759,0,5,0,0,764
S01008151,588,0,0,0,1,589
S01008152,885,0,5,0,1,891
S01008153,760,2,4,2,1,769
S01008154,705,5,0,0,0,710
S01008155,566,3,7,0,0,576
S01008156,764,2,1,4,0,771
S01008157,584,0,5,2,1,592
S01008158,617,1,8,0,1,627
S01008159,771,1,8,1,0,781
S01008160,763,2,4,2,0,771
S01008161,802,0,12,1,0,815
S01008162,820,6,2,3,0,831
S01008163,596,0,2,3,0,601
S01008164,1162,20,101,24,11,1318
S01008165,554,1,24,1,0,580
S01008166,443,0,0,0,0,443
S01008167,557,0,2,2,0,561
S01008168,662,1,1,2,2,668
S01008169,578,0,3,2,1,584
S01008170,486,1,4,0,1,492
S01008171,600,2,4,9,1,616
S01008172,451,1,2,3,0,457
S01008173,513,0,8,0,0,521
S01008174,447,0,1,0,0,448
S01008175,611,1,0,3,0,615
S01008176,602,1,3,2,2,610
S01008177,628,0,6,1,0,635
S01008178,552,1,5,2,0,560
S01008179,373,1,15,1,0,390
S01008180,372,0,9,0,0,381
S01008181,565,1,5,8,0,579
S01008182,824,2,1,1,5,833
S01008183,504,5,9,1,2,521
S01008184,712,0,17,4,2,735
S01008185,860,2,13,12,0,887
S01008186,674,6,33,6,3,722
S01008187,491,0,7,2,1,501
S01008188,743,3,15,7,1,769
S01008189,483,0,5,2,1,491
S01008190,699,0,7,3,0,709
S01008191,381,2,2,1,1,387
S01008192,642,1,21,10,6,680
S01008193,663,1,5,7,2,678
S01008194,496,1,12,0,0,509
S01008195,609,0,10,4,0,623
S01008196,583,1,11,1,0,596
S01008197,735,1,3,0,1,740
S01008198,571,0,3,1,0,575
S01008199,599,2,6,1,0,608
S01008200,508,0,3,0,0,511
S01008201,617,4,3,2,6,632
S01008202,480,0,4,3,0,487
S01008203,454,0,6,0,0,460
S01008204,770,1,1,4,0,776
S01008205,562,1,2,0,0,565
S01008206,527,0,0,1,1,529
S01008207,449,1,3,0,0,453
S01008208,618,0,3,1,0,622
S01008209,396,3,11,2,0,412
S01008210,745,1,6,1,0,753
S01008211,739,1,4,0,0,744
S01008212,444,0,0,3,0,447
S01008213,770,0,7,0,0,777
S01008214,601,3,5,2,0,611
S01008215,609,1,8,0,2,620
S01008216,413,0,6,0,0,419
S01008217,471,0,1,0,0,472
S01008218,820,0,0,1,0,821
S01008219,848,0,9,0,0,857
S01008220,449,0,10,0,0,459
S01008221,532,1,4,1,1,539
S01008222,506,0,0,0,0,506
S01008223,506,1,2,1,0,510
S01008224,777,3,0,3,0,783
S01008225,588,0,1,4,1,594
S01008226,631,1,5,0,1,638
S01008227,674,0,3,2,2,681
S01008228,531,1,5,0,2,539
S01008229,550,0,0,1,0,551
S01008230,589,1,23,1,0,614
S01008231,515,1,7,1,0,524
S01008232,472,2,12,0,0,486
S01008233,337,2,9,2,0,350
S01008234,339,1,0,0,0,340
S01008235,686,1,2,0,1,690
S01008236,682,2,6,1,0,691
S01008237,686,4,2,1,2,695
S01008238,623,0,3,0,5,631
S01008239,628,0,1,1,0,630
S01008240,731,0,0,0,1,732
S01008241,555,1,1,0,0,557
S01008242,780,2,2,0,3,787
S01008243,691,5,9,0,0,705
S01008244,463,3,3,1,0,470
S01008245,785,0,2,2,1,790
S01008246,769,0,13,5,0,787
S01008247,640,0,0,2,0,642
S01008248,737,2,2,0,1,742
S01008249,744,2,1,0,0,747
S01008250,829,1,4,1,0,835
S01008251,538,1,5,0,0,544
S01008252,685,1,1,2,0,689
S01008253,640,2,6,0,0,648
S01008254,815,2,0,1,1,819
S01008255,567,2,6,0,1,576
S01008256,652,5,5,3,0,665
S01008257,573,3,4,1,0,581
S01008258,705,0,3,1,1,710
S01008259,620,2,14,1,0,637
S01008260,647,1,0,1,1,650
S01008261,705,0,3,0,0,708
S01008262,488,1,3,1,0,493
S01008263,516,2,4,0,0,522
S01008264,568,1,0,6,0,575
S01008265,555,1,5,2,0,563
S01008266,570,1,6,0,0,577
S01008267,656,3,2,6,0,667
S01008268,703,0,9,12,0,724
S01008269,751,1,0,0,2,754
S01008270,696,3,3,1,2,705
S01008271,570,7,7,2,0,586
S01008272,805,3,5,2,1,816
S01008273,666,1,5,1,0,673
S01008274,586,1,3,3,0,593
S01008275,461,0,1,0,0,462
S01008276,423,0,0,0,0,423
S01008277,406,1,1,0,0,408
S01008278,629,2,5,0,1,637
S01008279,601,2,0,1,1,605
S01008280,771,5,1,0,1,778
S01008281,580,1,0,3,0,584
S01008282,580,0,4,1,2,587
S01008283,389,0,4,2,0,395
S01008284,664,1,7,0,0,672
S01008285,620,2,4,2,0,628
S01008286,618,1,0,1,0,620
S01008287,606,1,8,2,0,617
S01008288,731,2,17,2,1,753
S01008289,517,2,0,6,0,525
S01008290,720,3,12,1,1,737
S01008291,642,1,1,0,0,644
S01008292,586,4,1,0,1,592
S01008293,419,4,2,3,0,428
S01008294,669,2,8,4,0,683
S01008295,790,0,3,2,0,795
S01008296,564,0,3,0,0,567
S01008297,581,0,4,1,0,586
S01008298,602,0,6,0,0,608
S01008299,607,1,6,0,2,616
S01008300,706,1,2,0,1,710
S01008301,682,2,2,1,0,687
S01008302,608,3,4,2,0,617
S01008303,469,0,2,0,0,471
S01008304,393,0,13,2,3,411
S01008305,674,0,4,0,0,678
S01008306,537,0,0,1,0,538
S01008307,492,0,1,0,0,493
S01008308,491,0,7,0,3,501
S01008309,594,0,8,1,0,603
S01008310,808,0,9,0,1,818
S01008311,311,0,2,0,0,313
S01008312,319,3,4,2,1,329
S01008313,727,1,19,1,0,748
S01008314,456,8,4,1,1,470
S01008315,609,3,4,1,0,617
S01008316,412,1,7,1,0,421
S01008317,532,3,20,5,0,560
S01008318,776,0,19,2,2,799
S01008319,619,2,0,0,1,622
S01008320,574,0,0,0,0,574
S01008321,428,0,8,0,0,436
S01008322,830,0,8,0,1,839
S01008323,593,3,8,3,3,610
S01008324,487,0,5,1,3,496
S01008325,530,2,20,2,0,554
S01008326,737,0,16,0,0,753
S01008327,706,1,4,0,1,712
S01008328,454,1,42,0,4,501
S01008329,575,0,95,5,4,679
S01008330,575,1,93,5,11,685
S01008331,414,2,52,3,6,477
S01008332,707,3,101,0,3,814
S01008333,801,2,53,0,3,859
S01008334,537,0,59,0,6,602
S01008335,547,3,36,2,2,590
S01008336,449,1,54,0,4,508
S01008337,615,1,42,1,4,663
S01008338,518,4,95,1,2,620
S01008339,444,2,35,9,3,493
S01008340,545,3,94,0,1,643
S01008341,438,1,44,0,1,484
S01008342,626,1,55,2,10,694
S01008343,653,1,43,0,5,702
S01008344,648,2,51,2,8,711
S01008345,690,2,71,0,2,765
S01008346,729,0,43,0,2,774
S01008347,788,2,40,0,2,832
S01008348,583,3,27,0,5,618
S01008349,639,3,52,2,0,696
S01008350,485,0,19,0,0,504
S01008351,702,3,16,6,0,727
S01008352,489,1,37,0,2,529
S01008353,364,2,30,1,9,406
S01008354,490,0,45,5,0,540
S01008355,540,0,0,0,0,540
S01008356,453,0,1,2,1,457
S01008357,564,0,1,1,0,566
S01008358,576,1,5,0,0,582
S01008359,488,1,3,0,0,492
S01008360,664,4,15,1,3,687
S01008361,420,0,1,2,1,424
S01008362,666,1,53,1,0,721
S01008363,578,1,21,0,1,601
S01008364,577,2,45,4,0,628
S01008365,537,1,24,3,2,567
S01008366,713,3,27,2,1,746
S01008367,584,2,24,2,5,617
S01008368,525,1,13,0,2,541
S01008369,408,2,9,0,2,421
S01008370,530,2,18,1,2,553
S01008371,603,1,14,0,0,618
S01008372,580,0,29,2,2,613
S01008373,588,1,20,5,0,614
S01008374,546,1,10,0,1,558
S01008375,616,1,16,0,0,633
S01008376,414,1,0,0,0,415
S01008377,557,0,25,0,2,584
S01008378,793,3,14,1,0,811
S01008379,417,0,17,0,0,434
S01008380,501,2,8,0,1,512
S01008381,479,1,9,0,0,489
S01008382,483,1,16,0,2,502
S01008383,361,2,14,0,1,378
S01008384,769,0,9,1,0,779
S01008385,522,2,16,2,0,542
S01008386,644,2,12,1,2,661
S01008387,462,2,12,0,0,476
S01008388,477,2,8,1,0,488
S01008389,558,0,8,0,4,570
S01008390,510,0,5,0,0,515
S01008391,607,1,18,0,1,627
S01008392,693,5,7,0,2,707
S01008393,645,0,24,0,0,669
S01008394,573,0,25,1,1,600
S01008395,361,0,51,1,0,413
S01008396,516,0,37,1,0,554
S01008397,715,1,42,1,3,762
S01008398,452,5,19,0,3,479
S01008399,419,1,42,1,0,463
S01008400,449,1,86,0,0,536
S01008401,712,3,88,1,3,807
S01008402,849,1,47,1,2,900
S01008403,456,1,16,0,0,473
S01008404,774,2,20,2,1,799
S01008405,562,0,21,0,1,584
S01008406,731,0,48,3,9,791
S01008407,415,3,37,1,0,456
S01008408,479,2,31,0,0,512
S01008409,686,0,28,1,4,719
S01008410,405,2,79,5,4,495
S01008411,471,1,27,0,1,500
S01008412,507,1,52,1,0,561
S01008413,417,0,25,0,0,442
S01008414,321,0,40,0,0,361
S01008415,566,3,108,1,2,680
S01008416,714,2,63,1,0,780
S01008417,576,2,5,3,0,586
S01008418,564,2,10,3,5,584
S01008419,362,0,9,2,0,373
S01008420,380,4,2,3,7,396
S01008421,666,4,10,2,5,687
S01008422,485,0,3,0,2,490
S01008423,810,2,13,0,1,826
S01008424,684,1,13,0,0,698
S01008425,1732,20,359,120,77,2308
S01008426,467,1,11,1,2,482
S01008427,838,3,20,4,3,868
S01008428,549,0,7,2,3,561
S01008429,701,0,6,0,0,707
S01008430,539,0,15,0,1,555
S01008431,689,2,7,0,0,698
S01008432,581,1,2,5,1,590
S01008433,670,1,8,4,2,685
S01008434,631,0,29,0,1,661
S01008435,613,0,28,7,4,652
S01008436,704,1,16,1,1,723
S01008437,593,1,9,2,1,606
S01008438,355,1,7,0,0,363
S01008439,827,0,18,1,2,848
S01008440,794,1,13,0,0,808
S01008441,365,0,9,0,0,374
S01008442,546,1,5,1,1,554
S01008443,474,1,11,0,0,486
S01008444,488,1,18,6,0,513
S01008445,641,1,12,13,23,690
S01008446,760,8,36,3,3,810
S01008447,547,0,8,1,0,556
S01008448,597,0,36,2,2,637
S01008449,487,1,41,60,5,594
S01008450,375,1,18,35,0,429
S01008451,427,5,31,27,15,505
S01008452,360,1,15,52,14,442
S01008453,294,3,17,60,5,379
S01008454,627,3,24,26,8,688
S01008455,690,2,47,53,14,806
S01008456,679,6,28,46,16,775
S01008457,497,0,17,14,6,534
S01008458,733,4,26,6,10,779
S01008459,548,2,22,26,8,606
S01008460,537,4,5,19,2,567
S01008461,644,4,33,24,3,708
S01008462,455,1,14,13,3,486
S01008463,503,2,25,19,3,552
S01008464,668,1,15,5,6,695
S01008465,576,2,23,8,1,610
S01008466,541,0,37,12,6,596
S01008467,610,0,22,4,3,639
S01008468,488,1,23,8,9,529
S01008469,366,5,88,11,10,480
S01008470,523,1,31,15,16,586
S01008471,573,2,34,17,0,626
S01008472,486,1,30,8,16,541
S01008473,503,2,19,18,8,550
S01008474,618,1,30,10,7,666
S01008475,469,2,26,3,0,500
S01008476,588,2,19,5,0,614
S01008477,648,1,23,7,1,680
S01008478,651,5,33,10,7,706
S01008479,621,3,25,10,1,660
S01008480,445,0,37,11,10,503
S01008481,1348,4,40,10,6,1408
S01008482,493,0,19,9,1,522
S01008483,491,0,8,19,13,531
S01008484,597,1,29,1,0,628
S01008485,763,3,15,7,10,798
S01008486,721,1,39,5,11,777
S01008487,622,4,28,14,10,678
S01008488,601,8,45,5,16,675
S01008489,501,0,35,3,5,544
S01008490,742,1,44,1,7,795
S01008491,643,3,113,24,43,826
S01008492,721,5,57,19,12,814
S01008493,635,3,48,5,2,693
S01008494,503,9,67,9,10,598
S01008495,681,10,136,11,12,850
S01008496,752,5,144,17,11,929
S01008497,666,3,68,11,6,754
S01008498,653,6,50,19,4,732
S01008499,806,10,92,12,15,935
S01008500,297,0,42,13,0,352
S01008501,460,3,86,6,1,556
S01008502,472,2,103,5,22,604
S01008503,694,3,40,8,6,751
S01008504,882,3,49,6,10,950
S01008505,563,6,27,3,0,599
S01008506,728,5,24,3,0,760
S01008507,751,11,24,9,6,801
S01008508,646,2,31,2,1,682
S01008509,825,2,26,2,7,862
S01008510,707,4,29,1,14,755
S01008511,658,3,40,5,3,709
S01008512,393,2,11,2,2,410
S01008513,543,1,19,3,1,567
S01008514,732,3,21,1,0,757
S01008515,548,6,4,5,0,563
S01008516,757,4,54,6,6,827
S01008517,722,13,43,7,4,789
S01008518,687,7,35,3,1,733
S01008519,608,2,13,1,1,625
S01008520,838,4,21,4,1,868
S01008521,687,2,15,0,2,706
S01008522,408,0,23,0,3,434
S01008523,719,3,32,2,0,756
S01008524,681,2,23,6,2,714
S01008525,558,1,18,17,8,602
S01008526,692,0,36,6,3,737
S01008527,566,3,19,4,3,595
S01008528,516,1,15,4,4,540
S01008529,613,0,9,1,0,623
S01008530,536,2,20,7,5,570
S01008531,598,1,7,7,6,619
S01008532,356,2,11,0,0,369
S01008533,328,6,5,13,20,372
S01008534,527,3,22,10,14,576
S01008535,579,0,15,1,2,597
S01008536,466,2,14,2,0,484
S01008537,554,3,11,1,1,570
S01008538,461,0,6,0,0,467
S01008539,650,2,36,0,3,691
S01008540,711,2,8,3,4,728
S01008541,643,2,23,7,1,676
S01008542,693,0,24,3,1,721
S01008543,520,3,35,1,4,563
S01008544,460,3,14,0,2,479
S01008545,653,5,24,5,2,689
S01008546,682,0,17,1,1,701
S01008547,711,4,90,8,4,817
S01008548,597,1,45,4,6,653
S01008549,751,9,29,9,3,801
S01008550,579,4,70,3,4,660
S01008551,795,5,63,9,1,873
S01008552,697,0,40,4,4,745
S01008553,446,0,13,0,1,460
S01008554,701,4,25,16,19,765
S01008555,742,1,40,10,3,796
S01008556,548,2,35,0,5,590
S01008557,622,1,35,13,11,682
S01008558,671,0,34,5,2,712
S01008559,527,3,20,2,2,554
S01008560,501,1,38,4,6,550
S01008561,502,2,14,3,7,528
S01008562,472,1,9,7,0,489
S01008563,617,2,29,2,2,652
S01008564,508,2,14,0,3,527
S01008565,657,0,40,15,9,721
S01008566,771,0,38,5,3,817
S01008567,519,1,38,7,9,574
S01008568,546,3,63,8,7,627
S01008569,463,3,36,12,3,517
S01008570,674,1,29,7,8,719
S01008571,524,1,31,7,1,564
S01008572,663,2,54,6,10,735
S01008573,570,1,116,4,9,700
S01008574,541,2,68,6,7,624
S01008575,565,6,64,0,9,644
S01008576,683,3,26,3,10,725
S01008577,757,2,22,1,5,787
S01008578,630,2,18,0,9,659
S01008579,654,2,13,4,4,677
S01008580,402,1,57,6,0,466
S01008581,702,3,46,18,2,771
S01008582,784,2,41,6,4,837
S01008583,515,1,51,8,20,595
S01008584,618,2,32,6,27,685
S01008585,408,4,55,2,0,469
S01008586,619,6,25,11,4,665
S01008587,600,8,174,12,8,802
S01008588,587,6,24,1,3,621
S01008589,285,0,26,1,1,313
S01008590,595,3,38,3,7,646
S01008591,592,6,76,1,2,677
S01008592,527,2,77,5,1,612
S01008593,565,6,49,0,2,622
S01008594,814,3,49,6,9,881
S01008595,738,2,59,11,8,818
S01008596,673,8,44,7,14,746
S01008597,700,2,32,2,4,740
S01008598,653,4,76,5,8,746
S01008599,735,5,48,1,17,806
S01008600,570,10,59,13,13,665
S01008601,2063,63,297,28,20,2471
S01008602,516,10,62,3,17,608
S01008603,955,12,89,6,7,1069
S01008604,697,14,80,10,29,830
S01008605,578,3,39,8,1,629
S01008606,552,3,40,6,6,607
S01008607,483,7,18,5,0,513
S01008608,612,6,14,4,1,637
S01008609,765,5,28,2,0,800
S01008610,690,5,30,5,4,734
S01008611,1156,17,137,12,7,1329
S01008612,660,19,37,5,4,725
S01008613,624,7,45,1,16,693
S01008614,605,9,25,3,1,643
S01008615,705,12,60,3,2,782
S01008616,617,12,41,3,3,676
S01008617,687,17,37,6,7,754
S01008618,627,15,31,4,4,681
S01008619,444,10,32,4,3,493
S01008620,704,10,41,6,5,766
S01008621,646,10,44,5,5,710
S01008622,425,3,35,2,3,468
S01008623,756,11,79,10,2,858
S01008624,648,3,17,1,1,670
S01008625,451,1,12,0,0,464
S01008626,718,5,16,2,3,744
S01008627,547,2,30,2,0,581
S01008628,520,7,12,8,4,551
S01008629,459,3,27,3,0,492
S01008630,477,8,9,2,7,503
S01008631,666,6,30,6,4,712
S01008632,824,10,20,7,4,865
S01008633,736,4,30,4,11,785
S01008634,552,7,43,6,4,612
S01008635,676,12,44,6,8,746
S01008636,701,6,40,1,1,749
S01008637,583,5,16,1,3,608
S01008638,681,10,73,5,6,775
S01008639,726,12,41,9,7,795
S01008640,663,8,21,4,3,699
S01008641,738,6,34,2,4,784
S01008642,753,11,59,3,4,830
S01008643,559,9,30,3,7,608
S01008644,607,7,82,8,2,706
S01008645,651,4,73,1,1,730
S01008646,670,7,37,16,9,739
S01008647,487,2,43,7,9,548
S01008648,512,5,48,1,6,572
S01008649,768,9,59,12,21,869
S01008650,646,7,43,5,2,703
S01008651,848,14,60,16,8,946
S01008652,492,10,29,12,5,548
S01008653,538,9,71,8,14,640
S01008654,719,7,137,9,15,887
S01008655,599,10,126,10,9,754
S01008656,528,5,56,9,8,606
S01008657,639,4,37,9,1,690
S01008658,963,12,66,21,4,1066
S01008659,697,6,72,6,3,784
S01008660,780,6,73,13,5,877
S01008661,849,12,69,11,7,948
S01008662,640,11,65,7,4,727
S01008663,724,8,63,9,13,817
S01008664,588,6,56,15,6,671
S01008665,978,9,111,11,4,1113
S01008666,810,19,91,14,7,941
S01008667,792,4,102,14,10,922
S01008668,475,14,94,3,7,593
S01008669,493,5,39,4,3,544
S01008670,701,26,104,8,5,844
S01008671,627,17,81,3,10,738
S01008672,516,13,105,8,12,654
S01008673,748,23,192,8,19,990
S01008674,716,18,175,10,10,929
S01008675,627,3,44,6,11,691
S01008676,663,16,44,14,2,739
S01008677,693,13,63,4,18,791
S01008678,879,18,236,10,20,1163
S01008679,946,18,133,16,19,1132
S01008680,471,10,94,6,19,600
S01008681,775,9,132,11,6,933
S01008682,608,9,83,8,9,717
S01008683,940,8,370,33,19,1370
S01008684,733,11,88,17,13,862
S01008685,884,14,54,17,6,975
S01008686,817,13,38,3,7,878
S01008687,568,3,40,3,7,621
S01008688,744,5,49,9,4,811
S01008689,770,7,19,4,5,805
S01008690,840,10,42,10,8,910
S01008691,935,15,27,5,7,989
S01008692,611,4,30,6,5,656
S01008693,417,0,5,0,0,422
S01008694,847,9,34,7,1,898
S01008695,541,7,27,3,0,578
S01008696,515,1,22,5,7,550
S01008697,859,3,40,4,1,907
S01008698,397,2,18,2,1,420
S01008699,729,1,28,3,1,762
S01008700,433,5,25,2,4,469
S01008701,279,3,8,5,9,304
S01008702,429,3,46,11,7,496
S01008703,625,2,90,35,5,757
S01008704,486,3,31,8,7,535
S01008705,345,2,35,9,4,395
S01008706,370,0,21,12,1,404
S01008707,563,3,20,15,3,604
S01008708,680,7,11,25,10,733
S01008709,509,0,28,8,1,546
S01008710,303,0,54,8,0,365
S01008711,522,2,24,18,4,570
S01008712,861,3,41,17,6,928
S01008713,454,1,6,7,2,470
S01008714,452,4,25,3,1,485
S01008715,639,1,5,2,1,648
S01008716,453,0,10,3,2,468
S01008717,297,1,37,2,2,339
S01008718,395,1,28,2,3,429
S01008719,678,3,92,8,2,783
S01008720,435,0,7,1,0,443
S01008721,613,1,25,1,1,641
S01008722,874,1,25,2,1,903
S01008723,543,1,26,9,2,581
S01008724,759,1,18,2,0,780
S01008725,601,3,6,4,0,614
S01008726,449,1,1,1,0,452
S01008727,885,3,17,2,3,910
S01008728,397,1,0,2,0,400
S01008729,533,3,12,3,0,551
S01008730,624,5,12,4,4,649
S01008731,373,0,12,1,0,386
S01008732,488,1,5,3,6,503
S01008733,684,5,14,10,3,716
S01008734,450,2,10,4,1,467
S01008735,750,0,51,4,1,806
S01008736,534,3,68,1,0,606
S01008737,649,5,17,0,3,674
S01008738,614,2,29,0,3,648
S01008739,456,2,9,1,3,471
S01008740,443,1,15,6,0,465
S01008741,776,1,11,4,0,792
S01008742,426,2,17,1,0,446
S01008743,737,2,25,2,7,773
S01008744,855,0,22,4,0,881
S01008745,384,2,9,7,0,402
S01008746,781,9,69,18,18,895
S01008747,405,2,10,3,1,421
S01008748,544,1,18,0,4,567
S01008749,769,0,65,2,5,841
S01008750,586,1,21,1,2,611
S01008751,496,1,4,3,0,504
S01008752,638,6,10,7,3,664
S01008753,439,1,11,5,2,458
S01008754,519,8,12,4,0,543
S01008755,773,6,18,11,7,815
S01008756,573,2,31,13,5,624
S01008757,518,0,13,8,0,539
S01008758,648,5,23,16,2,694
S01008759,441,4,12,5,2,464
S01008760,695,5,48,15,0,763
S01008761,551,3,27,14,4,599
S01008762,512,1,12,2,0,527
S01008763,744,4,10,5,3,766
S01008764,551,8,25,1,1,586
S01008765,649,1,29,6,3,688
S01008766,841,2,18,2,0,863
S01008767,445,0,12,2,3,462
S01008768,422,9,14,8,0,453
S01008769,568,8,33,8,4,621
S01008770,620,11,55,15,24,725
S01008771,571,7,44,12,10,644
S01008772,639,1,21,3,5,669
S01008773,869,7,22,4,6,908
S01008774,735,7,28,13,6,789
S01008775,393,2,16,0,1,412
S01008776,691,13,32,12,7,755
S01008777,855,8,51,26,9,949
S01008778,918,9,49,15,8,999
S01008779,629,8,16,3,6,662
S01008780,497,4,16,11,1,529
S01008781,709,9,33,27,9,787
S01008782,654,1,26,9,7,697
S01008783,359,0,3,3,1,366
S01008784,368,1,22,3,1,395
S01008785,660,3,40,19,10,732
S01008786,786,13,33,23,2,857
S01008787,251,1,24,4,0,280
S01008788,571,7,25,7,4,614
S01008789,528,8,39,3,4,582
S01008790,508,8,41,11,8,576
S01008791,659,2,108,9,1,779
S01008792,641,1,35,6,2,685
S01008793,356,3,25,4,0,388
S01008794,731,5,35,1,1,773
S01008795,921,4,69,5,1,1000
S01008796,868,12,54,7,9,950
S01008797,801,6,72,7,2,888
S01008798,668,5,42,5,4,724
S01008799,480,6,67,11,1,565
S01008800,906,6,43,11,4,970
S01008801,794,9,50,11,6,870
S01008802,814,12,47,13,6,892
S01008803,778,7,69,6,2,862
S01008804,493,4,100,8,3,608
S01008805,467,6,108,7,1,589
S01008806,785,13,99,15,7,919
S01008807,685,5,42,6,4,742
S01008808,579,5,20,9,1,614
S01008809,543,5,15,5,2,570
S01008810,616,8,24,3,3,654
S01008811,731,6,52,4,1,794
S01008812,403,9,21,2,1,436
S01008813,706,8,94,14,6,828
S01008814,623,10,90,3,6,732
S01008815,715,11,69,9,2,806
S01008816,437,1,16,11,8,473
S01008817,595,2,37,22,2,658
S01008818,601,4,25,4,7,641
S01008819,629,3,10,3,1,646
S01008820,874,5,59,21,3,962
S01008821,499,2,44,3,2,550
S01008822,552,2,30,1,0,585
S01008823,525,0,28,3,0,556
S01008824,815,2,10,4,2,833
S01008825,506,0,3,0,3,512
S01008826,569,6,10,3,1,589
S01008827,557,1,10,2,0,570
S01008828,735,3,7,5,1,751
S01008829,515,5,34,1,9,564
S01008830,544,2,14,1,0,561
S01008831,652,0,4,0,2,658
S01008832,606,2,38,3,6,655
S01008833,821,6,32,2,2,863
S01008834,928,5,36,5,3,977
S01008835,666,1,17,4,7,695
S01008836,541,4,48,5,8,606
S01008837,867,4,50,10,8,939
S01008838,867,6,49,9,2,933
S01008839,872,5,35,4,2,918
S01008840,871,9,43,7,4,934
S01008841,461,2,36,1,2,502
S01008842,668,8,106,3,4,789
S01008843,773,12,116,6,5,912
S01008844,533,0,75,4,5,617
S01008845,687,14,70,14,10,795
S01008846,669,17,48,7,0,741
S01008847,497,7,28,3,2,537
S01008848,683,8,16,1,3,711
S01008849,626,8,17,7,5,663
S01008850,717,8,11,2,1,739
S01008851,897,12,24,13,6,952
S01008852,843,10,23,6,2,884
S01008853,552,9,37,5,4,607
S01008854,791,8,29,11,7,846
S01008855,920,7,48,6,4,985
S01008856,451,3,47,5,1,507
S01008857,673,9,9,1,1,693
S01008858,490,0,7,2,0,499
S01008859,991,11,31,4,4,1041
S01008860,754,11,35,1,5,806
S01008861,621,6,11,1,0,639
S01008862,790,17,17,4,0,828
S01008863,610,4,22,3,2,641
S01008864,780,10,82,7,1,880
S01008865,682,5,47,6,4,744
S01008866,664,10,32,2,3,711
S01008867,671,4,11,8,3,697
S01008868,671,6,40,3,8,728
S01008869,883,10,34,3,7,937
S01008870,658,7,21,2,9,697
S01008871,916,4,40,4,9,973
S01008872,712,8,40,2,5,767
S01008873,561,5,20,0,2,588
S01008874,699,2,64,4,5,774
S01008875,685,7,52,11,1,756
S01008876,487,1,8,0,1,497
S01008877,431,1,7,4,1,444
S01008878,749,0,23,4,2,778
S01008879,667,3,16,6,4,696
S01008880,515,3,14,0,1,533
S01008881,491,2,22,2,1,518
S01008882,823,3,18,6,1,851
S01008883,775,1,11,1,2,790
S01008884,569,1,16,3,1,590
S01008885,656,2,17,1,4,680
S01008886,640,6,55,4,7,712
S01008887,607,1,28,2,5,643
S01008888,491,1,40,7,3,542
S01008889,416,1,38,4,0,459
S01008890,567,2,24,4,2,599
S01008891,599,2,25,2,0,628
S01008892,802,2,25,5,3,837
S01008893,685,1,33,2,3,724
S01008894,676,4,5,2,1,688
S01008895,612,1,16,3,0,632
S01008896,383,0,26,1,0,410
S01008897,499,1,45,4,2,551
S01008898,649,3,34,0,3,689
S01008899,647,4,8,8,2,669
S01008900,738,1,40,10,0,789
S01008901,643,1,33,3,5,685
S01008902,755,3,36,25,12,831
S01008903,776,2,27,2,4,811
S01008904,621,6,131,49,3,810
S01008905,763,5,48,25,2,843
S01008906,518,6,43,43,6,616
S01008907,396,3,8,25,5,437
S01008908,630,6,47,26,8,717
S01008909,620,1,13,3,2,639
S01008910,353,0,14,5,2,374
S01008911,717,0,50,11,9,787
S01008912,615,4,9,3,9,640
S01008913,479,6,25,3,1,514
S01008914,720,0,17,1,1,739
S01008915,437,2,22,1,1,463
S01008916,854,2,19,21,10,906
S01008917,518,5,20,16,3,562
S01008918,369,1,29,17,7,423
S01008919,349,2,33,14,6,404
S01008920,863,8,47,23,7,948
S01008921,533,1,24,21,10,589
S01008922,605,3,22,16,2,648
S01008923,578,1,16,12,4,611
S01008924,639,7,33,18,7,704
S01008925,450,0,33,17,2,502
S01008926,447,1,22,4,1,475
S01008927,607,4,21,21,4,657
S01008928,594,0,24,10,0,628
S01008929,578,4,24,18,7,631
S01008930,642,2,17,22,0,683
S01008931,569,3,11,9,2,594
S01008932,602,6,58,21,7,694
S01008933,454,0,16,31,4,505
S01008934,532,5,35,16,6,594
S01008935,696,1,33,2,0,732
S01008936,288,0,10,1,1,300
S01008937,659,2,26,7,0,694
S01008938,561,1,19,0,2,583
S01008939,642,0,12,2,3,659
S01008940,489,2,13,2,2,508
S01008941,635,1,23,0,0,659
S01008942,562,4,12,1,2,581
S01008943,645,3,20,4,0,672
S01008944,768,4,30,4,3,809
S01008945,589,3,28,5,5,630
S01008946,712,1,56,0,0,769
S01008947,818,2,42,2,6,870
S01008948,525,3,42,0,3,573
S01008949,730,1,14,4,3,752
S01008950,738,2,28,5,2,775
S01008951,675,2,20,10,1,708
S01008952,629,3,25,3,3,663
S01008953,716,2,29,3,2,752
S01008954,709,1,31,6,0,747
S01008955,493,0,31,2,1,527
S01008956,703,2,16,1,5,727
S01008957,750,1,36,22,0,809
S01008958,564,1,36,2,2,605
S01008959,680,3,33,0,3,719
S01008960,602,3,65,1,1,672
S01008961,575,4,20,1,1,601
S01008962,512,1,10,5,2,530
S01008963,649,1,11,3,6,670
S01008964,411,1,25,0,0,437
S01008965,614,0,13,1,0,628
S01008966,470,1,11,0,1,483
S01008967,815,0,29,3,1,848
S01008968,800,0,22,2,0,824
S01008969,863,0,24,7,3,897
S01008970,825,2,10,0,1,838
S01008971,550,1,15,0,2,568
S01008972,620,2,6,1,4,633
S01008973,700,4,16,3,4,727
S01008974,615,1,30,2,4,652
S01008975,635,0,18,2,2,657
S01008976,419,1,4,0,2,426
S01008977,504,1,7,1,1,514
S01008978,450,0,16,6,1,473
S01008979,523,1,41,7,1,573
S01008980,593,4,16,3,4,620
S01008981,591,1,7,2,0,601
S01008982,599,2,19,6,3,629
S01008983,507,0,17,4,1,529
S01008984,378,1,9,1,1,390
S01008985,559,0,23,0,3,585
S01008986,651,0,10,0,0,661
S01008987,694,3,12,1,0,710
S01008988,888,1,29,5,5,928
S01008989,522,1,28,5,1,557
S01008990,596,0,44,2,1,643
S01008991,691,0,59,0,8,758
S01008992,456,0,27,4,0,487
S01008993,841,0,36,1,2,880
S01008994,626,0,2,0,0,628
S01008995,682,2,7,5,3,699
S01008996,468,0,15,0,0,483
S01008997,752,3,18,6,1,780
S01008998,462,1,0,1,0,464
S01008999,703,1,2,2,0,708
S01009000,751,0,4,2,0,757
S01009001,637,1,11,3,1,653
S01009002,649,2,2,3,1,657
S01009003,741,1,3,6,0,751
S01009004,529,3,0,1,1,534
S01009005,574,4,9,2,1,590
S01009006,591,0,5,5,1,602
S01009007,540,5,2,3,2,552
S01009008,775,1,2,2,0,780
S01009009,375,1,2,2,1,381
S01009010,808,0,8,3,1,820
S01009011,681,0,8,1,2,692
S01009012,601,2,4,1,1,609
S01009013,720,1,13,3,2,739
S01009014,495,0,2,0,0,497
S01009015,511,0,0,0,0,511
S01009016,436,0,0,0,0,436
S01009017,498,1,0,0,0,499
S01009018,597,2,2,0,0,601
S01009019,418,1,1,1,0,421
S01009020,628,2,4,1,0,635
S01009021,629,2,1,1,1,634
S01009022,783,2,1,1,1,788
S01009023,808,0,2,0,0,810
S01009024,837,1,6,0,0,844
S01009025,758,0,1,2,0,761
S01009026,764,0,5,0,1,770
S01009027,670,0,0,0,0,670
S01009028,430,0,0,0,0,430
S01009029,525,3,1,0,0,529
S01009030,609,1,1,0,0,611
S01009031,656,0,0,0,0,656
S01009032,558,0,0,0,1,559
S01009033,654,2,0,1,0,657
S01009034,556,0,1,1,0,558
S01009035,756,2,1,1,0,760
S01009036,808,3,2,0,1,814
S01009037,703,0,2,0,0,705
S01009038,857,2,9,0,0,868
S01009039,530,0,4,1,0,535
S01009040,543,0,15,0,2,560
S01009041,742,1,20,0,2,765
S01009042,710,1,9,1,3,724
S01009043,539,2,4,0,2,547
S01009044,742,2,5,0,0,749
S01009045,548,2,5,1,0,556
S01009046,710,0,0,0,0,710
S01009047,645,0,1,1,1,648
S01009048,684,0,1,0,1,686
S01009049,496,0,3,3,0,502
S01009050,674,2,0,0,0,676
S01009051,562,0,2,0,0,564
S01009052,535,0,4,0,0,539
S01009053,414,0,10,0,0,424
S01009054,472,1,6,0,1,480
S01009055,690,1,2,0,0,693
S01009056,423,1,8,0,0,432
S01009057,452,0,9,0,0,461
S01009058,656,0,10,8,0,674
S01009059,680,0,20,0,0,700
S01009060,398,0,12,0,1,411
S01009061,642,0,7,0,1,650
S01009062,537,1,0,0,0,538
S01009063,606,1,7,0,0,614
S01009064,469,1,2,1,0,473
S01009065,542,1,0,1,0,544
S01009066,589,0,5,0,0,594
S01009067,639,0,6,3,1,649
S01009068,729,1,2,0,0,732
S01009069,519,0,4,2,0,525
S01009070,509,2,9,4,1,525
S01009071,404,0,9,0,0,413
S01009072,393,0,19,0,1,413
S01009073,534,0,3,2,0,539
S01009074,572,5,5,0,0,582
S01009075,450,1,2,0,0,453
S01009076,756,1,9,2,0,768
S01009077,507,0,14,0,0,521
S01009078,558,0,9,4,0,571
S01009079,747,2,8,0,0,757
S01009080,769,0,4,1,1,775
S01009081,554,1,7,2,1,565
S01009082,828,0,0,3,1,832
S01009083,620,2,1,2,0,625
S01009084,380,1,3,1,0,385
S01009085,572,0,2,0,1,575
S01009086,556,2,2,0,4,564
S01009087,472,0,1,1,0,474
S01009088,817,4,16,0,1,838
S01009089,642,0,47,1,2,692
S01009090,621,2,15,4,1,643
S01009091,456,0,18,2,0,476
S01009092,867,1,4,0,0,872
S01009093,590,0,8,1,1,600
S01009094,569,0,6,1,0,576
S01009095,660,1,0,1,2,664
S01009096,760,4,12,1,2,779
S01009097,694,0,4,0,1,699
S01009098,426,0,0,0,0,426
S01009099,659,0,1,2,0,662
S01009100,644,0,4,3,0,651
S01009101,757,0,5,0,1,763
S01009102,591,1,7,1,0,600
S01009103,483,3,1,0,0,487
S01009104,645,0,4,1,0,650
S01009105,633,0,4,1,1,639
S01009106,455,0,2,0,0,457
S01009107,662,1,5,4,0,672
S01009108,595,2,12,3,0,612
S01009109,564,1,2,0,2,569
S01009110,498,0,1,0,0,499
S01009111,680,0,16,2,0,698
S01009112,464,1,4,0,1,470
S01009113,769,0,21,0,0,790
S01009114,591,0,22,0,2,615
S01009115,463,1,10,0,0,474
S01009116,404,0,0,0,1,405
S01009117,662,1,7,1,0,671
S01009118,454,0,16,1,0,471
S01009119,594,1,5,0,0,600
S01009120,444,0,0,0,0,444
S01009121,686,1,2,1,0,690
S01009122,775,1,0,0,2,778
S01009123,436,0,10,0,0,446
S01009124,404,1,0,2,0,407
S01009125,602,0,5,1,0,608
S01009126,456,2,3,0,0,461
S01009127,457,0,4,2,0,463
S01009128,674,1,10,1,1,687
S01009129,368,0,15,3,0,386
S01009130,492,1,7,0,4,504
S01009131,408,1,3,1,0,413
S01009132,603,0,26,3,1,633
S01009133,473,3,4,0,0,480
S01009134,753,1,5,4,1,764
S01009135,436,0,9,1,1,447
S01009136,573,3,42,1,1,620
S01009137,427,1,8,1,0,437
S01009138,698,0,7,1,6,712
S01009139,340,1,1,6,2,350
S01009140,588,1,16,6,5,616
S01009141,705,0,14,0,0,719
S01009142,527,2,18,1,0,548
S01009143,498,0,3,0,0,501
S01009144,511,0,19,4,8,542
S01009145,865,3,9,3,3,883
S01009146,723,1,20,4,10,758
S01009147,636,0,11,1,0,648
S01009148,543,3,3,0,0,549
S01009149,656,3,22,1,0,682
S01009150,740,4,0,1,0,745
S01009151,757,2,7,0,0,766
S01009152,610,3,5,4,3,625
S01009153,383,2,28,2,5,420
S01009154,830,1,19,2,0,852
S01009155,445,1,4,0,0,450
S01009156,452,3,6,0,0,461
S01009157,671,0,12,1,0,684
S01009158,459,0,6,0,0,465
S01009159,392,0,5,2,0,399
S01009160,574,1,8,0,0,583
S01009161,521,1,13,6,2,543
S01009162,624,1,17,1,0,643
S01009163,424,0,13,3,0,440
S01009164,592,2,2,2,0,598
S01009165,572,2,15,0,2,591
S01009166,664,0,7,2,0,673
S01009167,402,0,5,3,0,410
S01009168,557,1,1,1,2,562
S01009169,687,1,1,0,0,689
S01009170,527,0,2,0,0,529
S01009171,512,2,13,1,1,529
S01009172,548,1,6,0,1,556
S01009173,610,0,13,0,3,626
S01009174,336,0,10,0,0,346
S01009175,624,1,9,1,2,637
S01009176,793,0,7,1,0,801
S01009177,625,0,19,4,0,648
S01009178,553,0,13,1,1,568
S01009179,525,0,12,2,0,539
S01009180,791,5,8,1,0,805
S01009181,684,2,1,3,1,691
S01009182,801,0,7,0,0,808
S01009183,591,0,7,0,0,598
S01009184,686,0,7,0,0,693
S01009185,688,0,0,7,1,696
S01009186,644,1,6,4,1,656
S01009187,412,0,4,2,0,418
S01009188,706,1,4,1,1,713
S01009189,606,0,1,2,1,610
S01009190,627,1,8,2,1,639
S01009191,478,1,19,1,0,499
S01009192,977,2,10,4,1,994
S01009193,237,0,3,0,0,240
S01009194,668,1,2,2,0,673
S01009195,665,1,11,2,0,679
S01009196,573,0,5,2,4,584
S01009197,787,1,5,0,1,794
S01009198,607,1,2,1,1,612
S01009199,480,1,4,1,0,486
S01009200,874,1,15,2,0,892
S01009201,476,1,35,1,0,513
S01009202,388,0,14,0,0,402
S01009203,481,1,3,0,0,485
S01009204,664,2,11,1,7,685
S01009205,600,0,10,0,0,610
S01009206,684,0,4,0,1,689
S01009207,673,1,7,2,3,686
S01009208,537,0,3,0,0,540
S01009209,589,0,3,1,0,593
S01009210,467,0,4,1,0,472
S01009211,490,0,9,3,0,502
S01009212,673,0,8,1,1,683
S01009213,739,0,7,0,0,746
S01009214,812,0,10,1,2,825
S01009215,744,1,16,0,0,761
S01009216,743,0,9,2,1,755
S01009217,486,0,2,0,0,488
S01009218,712,2,2,0,1,717
S01009219,542,0,4,1,1,548
S01009220,435,3,8,0,0,446
S01009221,460,0,0,0,0,460
S01009222,414,0,0,0,0,414
S01009223,452,0,11,0,0,463
S01009224,517,1,0,1,0,519
S01009225,453,1,4,0,0,458
S01009226,789,0,4,1,2,796
S01009227,526,0,1,2,0,529
S01009228,497,2,0,0,0,499
S01009229,478,0,8,0,0,486
S01009230,491,0,0,0,0,491
S01009231,805,0,3,1,1,810
S01009232,452,2,8,1,3,466
S01009233,486,0,1,1,0,488
S01009234,760,1,8,11,1,781
S01009235,745,0,10,4,0,759
S01009236,414,1,4,0,0,419
S01009237,740,0,10,0,0,750
S01009238,628,1,0,0,1,630
S01009239,694,0,4,3,1,702
S01009240,533,0,1,6,1,541
S01009241,715,1,2,0,3,721
S01009242,620,0,11,2,0,633
S01009243,763,0,7,0,0,770
S01009244,692,0,0,0,2,694
S01009245,704,0,5,1,1,711
S01009246,682,0,3,1,1,687
S01009247,821,0,1,0,0,822
S01009248,586,2,0,1,0,589
S01009249,639,0,14,1,1,655
S01009250,522,0,1,0,0,523
S01009251,452,1,5,4,0,462
S01009252,355,0,4,0,0,359
S01009253,397,0,2,0,0,399
S01009254,644,0,12,0,0,656
S01009255,543,0,6,0,0,549
S01009256,412,0,0,0,0,412
S01009257,588,1,8,1,0,598
S01009258,539,0,0,1,0,540
S01009259,762,0,1,0,0,763
S01009260,959,1,4,0,1,965
S01009261,622,0,3,1,0,626
S01009262,457,0,1,0,1,459
S01009263,642,1,4,2,0,649
S01009264,454,1,10,0,0,465
S01009265,662,1,7,1,0,671
S01009266,709,0,1,0,0,710
S01009267,711,0,4,0,0,715
S01009268,769,0,4,1,0,774
S01009269,666,0,2,3,0,671
S01009270,498,2,1,0,0,501
S01009271,733,0,9,2,0,744
S01009272,550,0,1,1,0,552
S01009273,414,0,2,0,0,416
S01009274,506,1,4,1,2,514
S01009275,550,3,4,4,2,563
S01009276,747,1,8,0,0,756
S01009277,443,1,0,0,1,445
S01009278,433,2,2,0,0,437
S01009279,493,1,6,0,0,500
S01009280,693,1,3,1,0,698
S01009281,666,0,0,2,0,668
S01009282,613,1,3,8,0,625
S01009283,353,0,3,0,0,356
S01009284,634,0,14,1,1,650
S01009285,687,1,10,6,1,705
S01009286,646,0,7,0,0,653
S01009287,620,2,4,1,0,627
S01009288,689,1,9,0,1,700
S01009289,759,2,0,0,1,762
S01009290,537,0,1,0,0,538
S01009291,805,1,4,0,0,810
S01009292,419,0,1,1,4,425
S01009293,559,0,14,1,0,574
S01009294,399,0,2,0,0,401
S01009295,524,1,4,1,0,530
S01009296,417,0,8,1,0,426
S01009297,664,1,9,1,0,675
S01009298,819,4,13,5,4,845
S01009299,794,2,14,1,0,811
S01009300,424,3,17,0,0,444
S01009301,822,0,5,5,2,834
S01009302,658,0,25,3,4,690
S01009303,646,0,13,6,1,666
S01009304,765,0,2,1,2,770
S01009305,649,1,2,0,0,652
S01009306,882,6,5,3,1,897
S01009307,873,1,22,3,1,900
S01009308,418,0,14,4,0,436
S01009309,613,0,8,1,3,625
S01009310,775,0,24,3,2,804
S01009311,558,0,10,2,0,570
S01009312,562,0,5,8,3,578
S01009313,454,2,1,3,0,460
S01009314,530,1,7,3,0,541
S01009315,532,2,7,0,1,542
S01009316,610,1,5,5,0,621
S01009317,702,2,1,2,3,710
S01009318,496,0,4,0,0,500
S01009319,765,1,9,0,1,776
S01009320,578,1,14,3,3,599
S01009321,548,2,16,0,0,566
S01009322,668,1,3,0,1,673
S01009323,554,0,3,0,0,557
S01009324,442,0,2,4,0,448
S01009325,616,0,2,0,0,618
S01009326,440,2,5,1,0,448
S01009327,479,0,5,2,0,486
S01009328,461,2,12,2,1,478
S01009329,324,4,7,2,0,337
S01009330,344,2,4,1,2,353
S01009331,388,0,11,0,0,399
S01009332,738,1,10,1,0,750
S01009333,578,0,8,2,1,589
S01009334,505,0,4,1,1,511
S01009335,619,1,5,7,2,634
S01009336,510,1,7,0,0,518
S01009337,555,1,5,0,3,564
S01009338,621,0,2,3,0,626
S01009339,630,0,6,1,1,638
S01009340,478,0,2,2,1,483
S01009341,490,0,5,0,0,495
S01009342,597,1,10,1,0,609
S01009343,441,1,10,1,0,453
S01009344,520,1,5,4,0,530
S01009345,731,0,3,7,1,742
S01009346,452,2,18,7,0,479
S01009347,443,1,10,4,4,462
S01009348,336,1,8,6,0,351
S01009349,533,1,17,7,6,564
S01009350,416,6,22,2,0,446
S01009351,366,0,19,3,3,391
S01009352,539,2,19,2,1,563
S01009353,285,0,9,1,0,295
S01009354,591,1,38,4,1,635
S01009355,731,0,0,2,1,734
S01009356,812,2,11,2,1,828
S01009357,346,4,12,1,0,363
S01009358,527,0,23,3,3,556
S01009359,559,0,14,3,1,577
S01009360,687,0,16,0,1,704
S01009361,633,1,16,1,0,651
S01009362,849,3,13,2,1,868
S01009363,676,1,7,2,0,686
S01009364,685,0,8,1,0,694
S01009365,477,0,2,0,0,479
S01009366,615,1,10,1,1,628
S01009367,504,2,6,1,0,513
S01009368,432,2,6,3,2,445
S01009369,481,1,1,2,0,485
S01009370,723,1,9,4,0,737
S01009371,432,0,4,1,1,438
S01009372,425,0,3,0,0,428
S01009373,641,2,1,1,0,645
S01009374,736,1,6,2,0,745
S01009375,629,1,0,0,1,631
S01009376,474,0,3,2,0,479
S01009377,989,3,24,0,0,1016
S01009378,729,1,11,0,0,741
S01009379,667,3,12,4,2,688
S01009380,462,2,6,1,0,471
S01009381,530,0,6,3,0,539
S01009382,676,0,1,1,0,678
S01009383,676,0,7,2,1,686
S01009384,459,0,7,0,0,466
S01009385,410,0,1,1,1,413
S01009386,528,2,4,0,1,535
S01009387,474,1,3,3,0,481
S01009388,669,1,10,3,0,683
S01009389,800,2,4,1,0,807
S01009390,540,2,13,3,0,558
S01009391,502,2,5,3,1,513
S01009392,370,2,5,1,1,379
S01009393,556,1,4,0,1,562
S01009394,761,2,23,4,2,792
S01009395,570,1,6,1,3,581
S01009396,592,2,14,1,4,613
S01009397,582,0,12,0,3,597
S01009398,551,3,6,1,0,561
S01009399,591,2,3,0,0,596
S01009400,418,1,6,1,1,427
S01009401,573,0,4,0,0,577
S01009402,760,0,20,1,0,781
S01009403,412,1,3,2,1,419
S01009404,424,1,15,5,0,445
S01009405,330,0,1,0,0,331
S01009406,815,0,7,0,0,822
S01009407,420,0,7,0,0,427
S01009408,597,0,1,0,1,599
S01009409,554,1,2,0,0,557
S01009410,694,0,2,2,0,698
S01009411,684,0,9,0,0,693
S01009412,708,0,1,3,0,712
S01009413,834,0,7,7,0,848
S01009414,553,1,2,0,3,559
S01009415,675,0,7,4,0,686
S01009416,432,0,8,0,0,440
S01009417,225,0,4,0,0,229
S01009418,919,2,11,3,0,935
S01009419,456,0,2,0,0,458
S01009420,477,0,0,0,0,477
S01009421,543,0,6,4,0,553
S01009422,674,0,0,0,1,675
S01009423,686,1,9,7,0,703
S01009424,508,0,2,1,0,511
S01009425,636,0,8,5,0,649
S01009426,646,0,9,0,0,655
S01009427,498,0,4,2,0,504
S01009428,520,0,2,0,0,522
S01009429,587,1,1,0,1,590
S01009430,599,1,2,2,0,604
S01009431,547,0,6,0,0,553
S01009432,621,1,3,0,1,626
S01009433,626,0,5,1,0,632
S01009434,441,1,2,0,0,444
S01009435,584,0,1,0,0,585
S01009436,538,1,0,2,1,542
S01009437,567,0,0,1,0,568
S01009438,702,0,19,0,0,721
S01009439,730,0,4,0,0,734
S01009440,557,1,7,0,1,566
S01009441,625,0,2,6,1,634
S01009442,432,0,0,1,0,433
S01009443,559,0,5,1,3,568
S01009444,662,0,10,0,0,672
S01009445,641,0,0,0,1,642
S01009446,739,2,9,1,0,751
S01009447,415,0,6,0,0,421
S01009448,666,1,0,0,1,668
S01009449,425,0,1,0,0,426
S01009450,473,2,2,2,0,479
S01009451,767,1,6,1,0,775
S01009452,425,0,3,1,0,429
S01009453,876,0,1,0,0,877
S01009454,713,0,1,0,2,716
S01009455,713,2,0,2,0,717
S01009456,574,1,6,0,0,581
S01009457,521,0,0,0,1,522
S01009458,564,2,2,0,0,568
S01009459,711,2,3,1,1,718
S01009460,649,0,1,0,0,650
S01009461,408,1,2,1,1,413
S01009462,550,1,3,1,0,555
S01009463,555,1,1,2,1,560
S01009464,682,1,6,0,2,691
S01009465,484,0,5,0,0,489
S01009466,481,1,8,1,2,493
S01009467,647,0,8,1,0,656
S01009468,630,2,4,0,2,638
S01009469,682,2,3,3,2,692
S01009470,397,0,0,2,0,399
S01009471,585,0,6,2,2,595
S01009472,678,4,40,4,4,730
S01009473,705,0,18,13,3,739
S01009474,670,0,7,5,3,685
S01009475,406,0,40,1,0,447
S01009476,333,0,18,2,2,355
S01009477,606,3,15,4,1,629
S01009478,701,2,27,4,2,736
S01009479,718,1,23,6,2,750
S01009480,706,1,9,2,2,720
S01009481,774,1,16,8,2,801
S01009482,540,7,14,4,1,566
S01009483,593,1,12,8,0,614
S01009484,669,0,8,2,4,683
S01009485,642,1,9,2,0,654
S01009486,555,2,4,5,3,569
S01009487,654,2,7,5,0,668
S01009488,532,0,3,1,0,536
S01009489,661,0,7,4,1,673
S01009490,642,1,7,4,1,655
S01009491,590,0,2,2,0,594
S01009492,610,0,2,0,1,613
S01009493,723,2,9,2,1,737
S01009494,718,1,19,4,1,743
S01009495,717,0,8,2,0,727
S01009496,656,0,3,1,0,660
S01009497,799,0,7,2,0,808
S01009498,532,0,21,1,0,554
S01009499,661,0,4,0,0,665
S01009500,618,0,11,0,5,634
S01009501,565,1,3,1,0,570
S01009502,662,3,2,1,0,668
S01009503,585,0,4,1,1,591
S01009504,520,2,5,0,0,527
S01009505,587,2,2,2,2,595
S01009506,562,0,5,2,1,570
S01009507,628,2,31,1,2,664
S01009508,670,1,4,1,0,676
S01009509,777,1,16,2,1,797
S01009510,588,0,12,1,1,602
S01009511,520,1,5,0,0,526
S01009512,614,1,16,1,0,632
S01009513,482,1,2,2,0,487
S01009514,565,1,11,5,2,584
S01009515,606,3,3,3,0,615
S01009516,736,1,21,0,0,758
S01009517,641,1,44,4,13,703
S01009518,609,2,45,5,0,661
S01009519,370,0,29,2,0,401
S01009520,615,2,30,4,8,659
S01009521,687,0,9,3,3,702
S01009522,716,3,33,5,1,758
S01009523,469,1,7,5,0,482
S01009524,522,0,7,0,2,531
S01009525,419,2,21,5,0,447
S01009526,555,4,9,4,4,576
S01009527,567,1,3,0,2,573
S01009528,483,1,4,2,1,491
S01009529,503,0,0,2,0,505
S01009530,491,0,4,1,1,497
S01009531,670,0,8,2,0,680
S01009532,696,1,7,2,0,706
S01009533,636,5,9,1,2,653
S01009534,628,2,11,1,9,651
S01009535,479,2,1,4,0,486
S01009536,412,2,2,1,0,417
S01009537,447,1,3,0,0,451
S01009538,659,0,9,1,2,671
S01009539,719,1,9,9,0,738
S01009540,710,0,3,2,1,716
S01009541,632,0,6,0,1,639
S01009542,580,1,5,0,0,586
S01009543,479,0,1,0,0,480
S01009544,720,1,1,1,1,724
S01009545,644,0,0,2,0,646
S01009546,780,0,11,0,1,792
S01009547,588,1,7,4,0,600
S01009548,568,0,3,0,1,572
S01009549,641,1,5,2,0,649
S01009550,409,0,1,5,0,415
S01009551,398,3,15,3,2,421
S01009552,768,0,8,0,0,776
S01009553,696,0,3,1,1,701
S01009554,536,0,16,1,1,554
S01009555,610,1,19,2,1,633
S01009556,599,1,3,2,0,605
S01009557,517,2,6,1,0,526
S01009558,508,0,5,0,0,513
S01009559,675,2,5,0,0,682
S01009560,584,0,8,2,0,594
S01009561,401,2,14,6,0,423
S01009562,598,0,13,1,0,612
S01009563,641,0,2,0,0,643
S01009564,557,2,6,0,1,566
S01009565,449,0,7,1,0,457
S01009566,801,0,15,0,0,816
S01009567,703,2,2,8,0,715
S01009568,574,1,8,1,0,584
S01009569,660,0,5,1,0,666
S01009570,442,2,5,0,0,449
S01009571,539,0,1,0,0,540
S01009572,823,0,10,8,1,842
S01009573,567,1,17,0,0,585
S01009574,855,0,3,2,0,860
S01009575,428,0,1,0,0,429
S01009576,437,2,19,1,0,459
S01009577,565,0,33,0,0,598
S01009578,608,1,2,2,0,613
S01009579,821,2,12,7,0,842
S01009580,729,2,13,4,0,748
S01009581,470,1,2,0,0,473
S01009582,403,0,11,0,0,414
S01009583,617,0,4,1,1,623
S01009584,420,0,11,0,1,432
S01009585,768,0,6,1,0,775
S01009586,583,1,3,2,0,589
S01009587,606,1,10,1,1,619
S01009588,895,0,2,0,0,897
S01009589,729,0,12,3,0,744
S01009590,559,4,17,2,0,582
S01009591,555,1,7,3,1,567
S01009592,481,1,11,0,0,493
S01009593,479,0,13,0,0,492
S01009594,540,0,3,0,0,543
S01009595,366,3,29,0,0,398
S01009596,633,0,6,1,0,640
S01009597,610,3,14,5,1,633
S01009598,512,1,4,1,0,518
S01009599,709,1,4,7,2,723
S01009600,504,2,2,3,0,511
S01009601,530,0,4,0,0,534
S01009602,607,1,5,1,0,614
S01009603,451,0,17,0,3,471
S01009604,692,3,6,3,0,704
S01009605,637,0,5,1,1,644
S01009606,463,1,3,1,0,468
S01009607,431,0,13,0,1,445
S01009608,486,1,2,0,0,489
S01009609,665,0,0,0,0,665
S01009610,827,0,8,0,0,835
S01009611,446,0,1,0,0,447
S01009612,506,0,0,0,0,506
S01009613,361,1,18,0,0,380
S01009614,434,0,0,0,0,434
S01009615,344,0,0,0,0,344
S01009616,605,2,3,1,0,611
S01009617,587,0,5,0,5,597
S01009618,569,0,0,0,0,569
S01009619,514,0,5,1,0,520
S01009620,651,0,10,0,1,662
S01009621,640,2,10,2,1,655
S01009622,584,0,3,0,0,587
S01009623,405,1,4,0,0,410
S01009624,721,0,11,1,0,733
S01009625,680,0,4,0,1,685
S01009626,443,0,8,0,1,452
S01009627,651,0,3,2,0,656
S01009628,470,0,3,0,0,473
S01009629,822,3,2,0,0,827
S01009630,628,1,3,0,0,632
S01009631,583,0,2,0,2,587
S01009632,440,1,11,0,0,452
S01009633,542,2,1,3,0,548
S01009634,467,0,2,0,0,469
S01009635,696,0,8,0,2,706
S01009636,741,0,11,0,0,752
S01009637,599,1,13,1,1,615
S01009638,549,0,6,0,0,555
S01009639,682,2,7,3,0,694
S01009640,502,2,3,4,1,512
S01009641,669,1,8,2,4,684
S01009642,760,3,17,1,1,782
S01009643,430,1,4,1,0,436
S01009644,654,0,5,1,1,661
S01009645,526,0,4,1,1,532
S01009646,467,0,1,1,2,471
S01009647,509,1,2,0,0,512
S01009648,716,0,1,0,0,717
S01009649,843,0,2,0,0,845
S01009650,681,0,8,3,0,692
S01009651,783,2,3,1,1,790
S01009652,689,4,5,1,0,699
S01009653,440,1,3,1,0,445
S01009654,466,4,3,1,1,475
S01009655,682,0,2,1,1,686
S01009656,608,0,4,1,0,613
S01009657,638,1,18,0,0,657
S01009658,566,0,1,0,0,567
S01009659,414,0,0,1,0,415
S01009660,829,1,12,2,1,845
S01009661,700,4,3,0,1,708
S01009662,583,1,3,0,1,588
S01009663,531,0,0,0,0,531
S01009664,730,1,2,0,1,734
S01009665,529,2,2,2,0,535
S01009666,629,4,5,1,1,640
S01009667,433,1,2,0,1,437
S01009668,457,2,3,1,0,463
S01009669,434,0,1,1,2,438
S01009670,647,1,2,0,1,651
S01009671,523,0,0,0,1,524
S01009672,643,4,2,0,1,650
S01009673,668,2,3,1,0,674
S01009674,727,0,1,0,0,728
S01009675,737,5,5,1,0,748
S01009676,654,1,3,1,0,659
S01009677,480,0,1,1,2,484
S01009678,503,1,1,4,0,509
S01009679,741,4,3,4,0,752
S01009680,663,0,2,2,0,667
S01009681,584,2,2,4,0,592
S01009682,500,2,3,0,0,505
S01009683,735,3,15,4,2,759
S01009684,835,3,0,2,0,840
S01009685,518,0,5,0,0,523
S01009686,894,2,19,2,6,923
S01009687,571,0,0,1,0,572
S01009688,691,4,6,5,0,706
S01009689,495,2,17,5,0,519
S01009690,581,6,6,0,0,593
S01009691,491,0,1,3,7,502
S01009692,912,0,4,2,0,918
S01009693,519,1,1,1,0,522
S01009694,866,0,6,1,1,874
S01009695,518,0,1,2,0,521
S01009696,790,1,2,0,0,793
S01009697,583,4,1,1,0,589
S01009698,480,2,3,0,1,486
S01009699,408,0,2,0,2,412
S01009700,547,0,2,1,1,551
S01009701,401,0,4,0,0,405
S01009702,510,1,4,3,0,518
S01009703,482,2,1,0,0,485
S01009704,780,0,2,1,1,784
S01009705,608,2,2,3,3,618
S01009706,506,1,2,0,0,509
S01009707,395,1,8,0,0,404
S01009708,516,2,0,1,0,519
S01009709,677,4,11,1,0,693
S01009710,428,0,12,2,0,442
S01009711,641,1,13,3,1,659
S01009712,492,4,6,0,0,502
S01009713,772,1,0,0,2,775
S01009714,793,1,4,4,0,802
S01009715,553,2,6,0,3,564
S01009716,629,1,16,3,2,651
S01009717,808,15,74,4,4,905
S01009718,609,1,16,0,0,626
S01009719,625,3,12,5,2,647
S01009720,678,3,28,1,1,711
S01009721,504,13,41,4,2,564
S01009722,984,17,59,7,11,1078
S01009723,632,14,86,15,9,756
S01009724,828,5,50,4,4,891
S01009725,598,13,40,2,6,659
S01009726,925,25,62,7,7,1026
S01009727,655,4,14,2,0,675
S01009728,612,12,12,3,1,640
S01009729,538,5,8,3,0,554
S01009730,475,3,30,0,2,510
S01009731,502,6,22,0,0,530
S01009732,692,10,33,7,3,745
S01009733,417,4,0,0,0,421
S01009734,712,6,13,2,1,734
S01009735,848,14,244,12,15,1133
S01009736,2058,60,467,25,25,2635
S01009737,629,1,3,1,2,636
S01009738,363,0,4,4,0,371
S01009739,561,2,6,3,0,572
S01009740,439,0,7,1,0,447
S01009741,692,3,6,3,0,704
S01009742,413,4,0,0,1,418
S01009743,786,4,5,0,0,795
S01009744,589,0,1,1,3,594
S01009745,854,2,14,1,0,871
S01009746,455,2,0,0,0,457
S01009747,547,3,4,3,1,558
S01009748,583,0,4,1,0,588
S01009749,798,1,13,2,1,815
S01009750,549,1,9,0,1,560
S01009751,668,1,3,7,1,680
S01009752,487,2,5,0,1,495
S01009753,585,5,8,1,3,602
S01009754,712,2,4,1,1,720
S01009755,531,7,7,0,2,547
S01009756,616,0,6,0,0,622
S01009757,533,2,3,0,1,539
S01009758,481,4,26,1,2,514
S01009759,627,1,15,38,2,683
S01009760,639,2,28,13,0,682
S01009761,671,1,68,1,0,741
S01009762,677,1,20,36,0,734
S01009763,460,0,123,4,0,587
S01009764,435,0,59,5,0,499
S01009765,630,1,130,1,5,767
S01009766,440,1,15,0,2,458
S01009767,448,0,21,0,1,470
S01009768,418,2,42,2,1,465
S01009769,506,0,58,2,1,567
S01009770,393,1,161,6,1,562
S01009771,454,1,211,0,5,671
S01009772,460,1,35,7,0,503
S01009773,226,3,181,5,6,421
S01009774,196,0,156,3,0,355
S01009775,659,0,15,8,0,682
S01009776,519,0,9,1,0,529
S01009777,356,1,22,4,4,387
S01009778,684,1,23,3,0,711
S01009779,426,2,17,4,0,449
S01009780,420,0,13,12,0,445
S01009781,418,2,4,2,0,426
S01009782,353,0,26,12,5,396
S01009783,551,1,11,3,0,566
S01009784,573,0,15,3,0,591
S01009785,628,2,6,13,3,652
S01009786,715,1,10,20,0,746
S01009787,694,1,1,4,0,700
S01009788,701,0,11,4,1,717
S01009789,727,2,6,8,5,748
S01009790,517,0,2,0,0,519
S01009791,512,3,10,6,0,531
S01009792,537,0,169,8,4,718
S01009793,720,1,33,5,2,761
S01009794,387,1,9,2,0,399
S01009795,593,4,46,2,0,645
S01009796,526,2,94,1,0,623
S01009797,554,0,74,1,1,630
S01009798,527,1,23,1,3,555
S01009799,658,0,9,2,7,676
S01009800,821,3,15,6,1,846
S01009801,675,1,18,4,0,698
S01009802,745,3,18,4,2,772
S01009803,603,1,29,3,0,636
S01009804,438,0,14,4,0,456
S01009805,708,1,24,8,2,743
S01009806,748,0,25,13,0,786
S01009807,739,1,36,19,0,795
S01009808,544,6,62,80,1,693
S01009809,543,0,12,6,1,562
S01009810,630,1,31,5,4,671
S01009811,887,5,13,1,2,908
S01009812,610,0,16,0,1,627
S01009813,466,2,41,33,20,562
S01009814,660,1,29,6,0,696
S01009815,581,2,4,2,1,590
S01009816,571,0,10,1,5,587
S01009817,582,1,2,0,0,585
S01009818,838,0,13,1,0,852
S01009819,546,0,17,1,2,566
S01009820,765,1,20,2,2,790
S01009821,510,1,21,1,0,533
S01009822,345,0,13,2,0,360
S01009823,581,0,8,8,3,600
S01009824,622,3,29,4,1,659
S01009825,773,0,28,4,1,806
S01009826,442,1,10,3,0,456
S01009827,670,3,12,10,0,695
S01009828,627,1,24,6,0,658
S01009829,746,0,38,6,3,793
S01009830,597,1,19,0,2,619
S01009831,572,1,17,3,1,594
S01009832,777,0,37,6,5,825
S01009833,438,0,17,6,1,462
S01009834,588,1,28,13,0,630
S01009835,410,1,5,1,0,417
S01009836,780,0,32,1,2,815
S01009837,600,0,5,5,0,610
S01009838,601,1,21,9,3,635
S01009839,777,3,17,17,4,818
S01009840,841,1,4,2,0,848
S01009841,600,0,28,49,18,695
S01009842,433,2,36,51,2,524
S01009843,459,2,17,17,1,496
S01009844,427,1,11,35,3,477
S01009845,492,2,56,57,5,612
S01009846,636,0,48,23,7,714
S01009847,437,1,14,17,0,469
S01009848,700,0,30,8,0,738
S01009849,649,2,4,4,3,662
S01009850,740,1,15,8,1,765
S01009851,723,0,12,2,2,739
S01009852,469,1,23,2,0,495
S01009853,679,2,24,3,0,708
S01009854,645,1,36,5,3,690
S01009855,463,2,24,0,1,490
S01009856,505,0,39,4,0,548
S01009857,706,3,19,3,1,732
S01009858,604,0,17,12,0,633
S01009859,817,2,32,28,5,884
S01009860,749,3,16,23,2,793
S01009861,775,5,65,45,6,896
S01009862,801,5,118,36,1,961
S01009863,486,1,138,52,9,686
S01009864,466,2,37,6,2,513
S01009865,337,1,48,7,2,395
S01009866,672,4,79,18,9,782
S01009867,828,0,94,24,2,948
S01009868,471,2,136,11,2,622
S01009869,278,2,172,9,3,464
S01009870,325,4,153,15,1,498
S01009871,664,6,144,31,8,853
S01009872,413,4,180,5,3,605
S01009873,612,6,152,10,8,788
S01009874,738,2,107,16,5,868
S01009875,266,1,207,23,20,517
S01009876,311,5,131,67,12,526
S01009877,549,4,192,11,5,761
S01009878,189,1,330,15,7,542
S01009879,588,6,131,3,5,733
S01009880,222,1,374,12,3,612
S01009881,151,0,244,5,2,402
S01009882,668,7,211,31,19,936
S01009883,233,7,345,9,8,602
S01009884,326,3,290,10,5,634
S01009885,272,10,366,5,10,663
S01009886,280,3,317,15,11,626
S01009887,466,6,256,29,17,774
S01009888,225,5,287,4,6,527
S01009889,385,9,220,23,15,652
S01009890,341,1,84,10,3,439
S01009891,504,4,117,6,4,635
S01009892,525,3,140,31,9,708
S01009893,453,2,208,3,6,672
S01009894,552,4,115,13,5,689
S01009895,464,1,130,17,8,620
S01009896,573,5,175,12,4,769
S01009897,668,7,110,21,4,810
S01009898,372,0,107,4,7,490
S01009899,645,3,16,8,12,684
S01009900,702,5,22,12,0,741
S01009901,675,4,39,19,4,741
S01009902,698,1,99,3,3,804
S01009903,402,0,246,2,2,652
S01009904,626,5,54,9,2,696
S01009905,425,5,173,14,5,622
S01009906,423,3,120,9,2,557
S01009907,546,6,139,36,3,730
S01009908,718,10,119,7,2,856
S01009909,648,6,84,15,14,767
S01009910,389,4,54,8,0,455
S01009911,759,1,75,5,0,840
S01009912,610,3,165,10,2,790
S01009913,310,2,272,1,6,591
S01009914,631,5,170,4,9,819
S01009915,578,2,168,2,2,752
S01009916,377,0,385,6,8,776
S01009917,512,2,71,6,1,592
S01009918,514,3,56,4,1,578
S01009919,797,1,128,21,1,948
S01009920,733,2,43,2,2,782
S01009921,549,4,38,1,1,593
S01009922,853,9,63,13,2,940
S01009923,722,7,50,9,0,788
S01009924,758,3,121,13,1,896
S01009925,546,5,45,1,5,602
S01009926,569,6,79,3,3,660
S01009927,420,1,20,1,1,443
S01009928,736,2,23,1,1,763
S01009929,385,1,31,4,2,423
S01009930,677,10,63,4,4,758
S01009931,676,2,12,2,0,692
S01009932,549,3,19,2,3,576
S01009933,639,4,72,36,11,762
S01009934,670,0,64,11,8,753
S01009935,482,4,9,5,2,502
S01009936,493,5,55,11,4,568
S01009937,292,5,33,64,7,401
S01009938,771,2,28,14,3,818
S01009939,516,4,83,79,5,687
S01009940,672,0,6,0,0,678
S01009941,430,5,315,4,0,754
S01009942,778,1,36,18,3,836
S01009943,646,0,19,6,0,671
S01009944,603,2,52,0,1,658
S01009945,750,0,27,8,5,790
S01009946,605,3,51,9,4,672
S01009947,440,0,26,4,0,470
S01009948,581,1,43,37,9,671
S01009949,599,4,39,22,3,667
S01009950,497,2,86,6,2,593
S01009951,526,0,84,4,1,615
S01009952,564,1,33,1,0,599
S01009953,625,1,102,6,0,734
S01009954,347,3,155,2,4,511
S01009955,760,7,83,1,3,854
S01009956,561,2,47,7,0,617
S01009957,571,2,34,1,3,611
S01009958,706,2,38,1,0,747
S01009959,505,1,48,0,2,556
S01009960,695,3,57,0,3,758
S01009961,562,1,13,4,0,580
S01009962,860,2,24,2,0,888
S01009963,639,4,19,0,3,665
S01009964,657,0,83,3,0,743
S01009965,591,1,21,0,0,613
S01009966,626,0,13,6,0,645
S01009967,684,0,12,3,1,700
S01009968,508,1,14,0,0,523
S01009969,683,1,14,1,1,700
S01009970,713,1,11,7,1,733
S01009971,838,0,22,0,0,860
S01009972,658,1,14,4,3,680
S01009973,551,0,6,8,0,565
S01009974,463,0,3,2,0,468
S01009975,619,1,2,7,0,629
S01009976,380,0,3,2,0,385
S01009977,800,1,6,6,0,813
S01009978,739,0,20,14,0,773
S01009979,505,0,5,6,0,516
S01009980,532,0,9,0,0,541
S01009981,523,0,4,1,4,532
S01009982,716,1,44,3,3,767
S01009983,372,1,6,45,2,426
S01009984,538,0,14,28,0,580
S01009985,436,1,2,25,3,467
S01009986,437,0,2,6,1,446
S01009987,732,0,4,9,2,747
S01009988,431,1,9,2,4,447
S01009989,651,0,14,5,0,670
S01009990,547,0,6,0,0,553
S01009991,599,0,22,3,1,625
S01009992,559,0,8,6,0,573
S01009993,652,0,7,0,0,659
S01009994,528,0,4,0,0,532
S01009995,518,2,11,3,1,535
S01009996,549,1,16,5,1,572
S01009997,455,3,9,2,1,470
S01009998,466,2,55,0,1,524
S01009999,570,0,26,1,0,597
S01010000,468,0,19,4,0,491
S01010001,567,1,47,1,1,617
S01010002,583,2,56,3,0,644
S01010003,560,1,10,0,0,571
S01010004,563,2,46,6,0,617
S01010005,655,1,20,2,4,682
S01010006,757,4,40,6,3,810
S01010007,770,1,32,1,1,805
S01010008,530,2,27,2,6,567
S01010009,496,0,25,5,2,528
S01010010,817,2,36,2,1,858
S01010011,678,2,16,6,1,703
S01010012,634,0,49,0,2,685
S01010013,673,1,23,0,1,698
S01010014,768,3,85,16,2,874
S01010015,636,2,65,7,1,711
S01010016,598,1,11,1,0,611
S01010017,587,1,11,6,1,606
S01010018,743,0,40,10,5,798
S01010019,550,0,11,21,4,586
S01010020,610,0,15,0,2,627
S01010021,467,2,63,84,8,624
S01010022,694,1,52,19,7,773
S01010023,518,0,9,9,0,536
S01010024,565,4,25,25,6,625
S01010025,391,0,35,43,2,471
S01010026,684,5,29,34,6,758
S01010027,671,2,77,10,1,761
S01010028,500,5,22,19,1,547
S01010029,544,0,10,17,3,574
S01010030,638,1,51,12,2,704
S01010031,583,5,101,34,7,730
S01010032,559,5,168,64,8,804
S01010033,576,1,153,23,16,769
S01010034,777,5,49,43,8,882
S01010035,399,3,82,79,10,573
S01010036,525,4,172,60,6,767
S01010037,549,1,3,11,1,565
S01010038,799,4,26,34,4,867
S01010039,811,7,82,24,7,931
S01010040,588,0,54,17,7,666
S01010041,592,1,20,10,4,627
S01010042,844,1,41,76,12,974
S01010043,591,3,54,8,0,656
S01010044,928,1,44,16,4,993
S01010045,394,2,5,14,3,418
S01010046,622,1,9,13,2,647
S01010047,675,0,8,11,0,694
S01010048,779,3,13,15,0,810
S01010049,580,0,7,13,4,604
S01010050,772,2,16,15,2,807
S01010051,565,1,8,29,3,606
S01010052,500,1,13,40,1,555
S01010053,616,0,43,39,2,700
S01010054,395,0,1,15,0,411
S01010055,908,1,32,13,7,961
S01010056,357,0,2,1,0,360
S01010057,313,0,12,7,2,334
S01010058,586,1,11,12,3,613
S01010059,520,1,11,14,2,548
S01010060,753,0,9,6,0,768
S01010061,404,1,7,7,0,419
S01010062,574,1,7,11,1,594
S01010063,834,1,10,6,3,854
S01010064,427,0,3,12,0,442
S01010065,699,0,4,4,2,709
S01010066,574,0,20,14,0,608
S01010067,457,1,6,2,2,468
S01010068,463,1,26,22,12,524
S01010069,655,0,41,2,0,698
S01010070,519,2,29,6,0,556
S01010071,644,0,33,3,0,680
S01010072,683,0,9,0,1,693
S01010073,657,0,11,2,1,671
S01010074,669,1,23,1,0,694
S01010075,539,0,2,0,0,541
S01010076,549,0,4,0,0,553
S01010077,502,0,7,2,0,511
S01010078,475,0,30,5,0,510
S01010079,782,0,11,0,0,793
S01010080,570,0,7,0,0,577
S01010081,603,0,5,6,3,617
S01010082,728,1,8,4,1,742
S01010083,597,3,8,1,0,609
S01010084,741,2,6,1,0,750
S01010085,645,1,10,0,1,657
S01010086,770,0,5,3,0,778
S01010087,500,0,6,0,0,506
S01010088,574,0,34,2,2,612
S01010089,588,0,23,7,0,618
S01010090,861,0,10,4,0,875
S01010091,643,2,28,0,1,674
S01010092,792,2,22,6,0,822
S01010093,703,0,23,5,0,731
S01010094,563,0,0,1,0,564
S01010095,592,1,0,0,1,594
S01010096,603,0,13,1,0,617
S01010097,587,1,15,0,0,603
S01010098,593,0,7,0,0,600
S01010099,591,0,0,1,0,592
S01010100,732,0,32,2,0,766
S01010101,616,2,21,3,2,644
S01010102,693,1,52,1,2,749
S01010103,736,1,30,7,0,774
S01010104,532,1,21,0,0,554
S01010105,300,1,5,6,1,313
S01010106,356,0,1,0,0,357
S01010107,621,0,21,5,0,647
S01010108,617,0,4,2,0,623
S01010109,647,0,6,5,1,659
S01010110,675,0,6,3,0,684
S01010111,744,0,5,3,2,754
S01010112,717,2,6,3,0,728
S01010113,385,1,5,4,0,395
S01010114,604,1,2,7,0,614
S01010115,481,1,3,1,0,486
S01010116,744,0,45,5,0,794
S01010117,470,2,20,10,0,502
S01010118,467,0,5,5,1,478
S01010119,367,1,6,14,1,389
S01010120,750,0,7,14,1,772
S01010121,524,0,4,3,1,532
S01010122,377,0,1,2,0,380
S01010123,515,1,6,13,0,535
S01010124,491,1,11,2,1,506
S01010125,391,0,5,5,1,402
S01010126,589,0,1,3,0,593
S01010127,518,0,1,3,4,526
S01010128,335,0,1,7,0,343
S01010129,531,1,14,4,0,550
S01010130,338,0,3,0,0,341
S01010131,817,1,22,0,0,840
S01010132,785,1,16,4,3,809
S01010133,597,0,10,0,0,607
S01010134,827,3,8,2,0,840
S01010135,635,0,4,0,0,639
S01010136,673,0,1,2,3,679
S01010137,835,2,8,4,0,849
S01010138,772,4,16,30,19,841
S01010139,884,0,12,1,0,897
S01010140,566,1,23,6,0,596
S01010141,650,1,7,4,0,662
S01010142,478,1,9,3,0,491
S01010143,627,1,4,0,0,632
S01010144,560,0,11,2,2,575
S01010145,627,0,13,10,0,650
S01010146,591,0,15,20,1,627
S01010147,734,1,10,1,0,746
S01010148,574,0,10,16,1,601
S01010149,487,0,7,0,2,496
S01010150,531,0,6,3,0,540
S01010151,536,0,10,1,3,550
S01010152,706,0,8,19,3,736
S01010153,805,0,14,6,0,825
S01010154,770,0,10,3,0,783
S01010155,657,2,5,0,0,664
S01010156,468,0,6,3,0,477
S01010157,486,0,1,0,0,487
S01010158,769,0,21,0,0,790
S01010159,623,0,5,0,0,628
S01010160,390,1,31,40,11,473
S01010161,460,0,17,7,0,484
S01010162,620,0,15,4,0,639
S01010163,463,0,1,1,0,465
S01010164,613,2,13,0,0,628
S01010165,475,0,9,3,3,490
S01010166,593,1,3,8,1,606
S01010167,683,0,2,7,0,692
S01010168,396,0,0,1,0,397
S01010169,637,0,6,23,0,666
S01010170,419,0,4,10,2,435
S01010171,768,1,7,7,0,783
S01010172,612,0,11,0,1,624
S01010173,620,2,5,12,0,639
S01010174,1274,0,26,7,2,1309
S01010175,377,0,6,1,0,384
S01010176,571,0,10,9,0,590
S01010177,548,0,3,20,0,571
S01010178,703,0,3,30,3,739
S01010179,659,0,16,13,2,690
S01010180,334,0,48,12,5,399
S01010181,483,0,2,4,0,489
S01010182,529,2,47,1,1,580
S01010183,388,0,1,2,0,391
S01010184,505,0,1,11,0,517
S01010185,464,1,11,10,1,487
S01010186,421,0,98,2,2,523
S01010187,542,0,3,3,0,548
S01010188,578,0,30,1,1,610
S01010189,653,2,67,8,9,739
S01010190,430,0,129,5,17,581
S01010191,486,1,30,4,10,531
S01010192,491,1,126,9,4,631
S01010193,634,1,42,4,4,685
S01010194,548,0,0,0,0,548
S01010195,420,2,5,4,0,431
S01010196,626,1,7,0,0,634
S01010197,542,0,4,1,1,548
S01010198,833,0,11,2,4,850
S01010199,394,1,5,12,0,412
S01010200,576,0,4,0,0,580
S01010201,510,1,0,0,0,511
S01010202,454,0,47,32,2,535
S01010203,469,0,45,3,0,517
S01010204,597,3,11,16,1,628
S01010205,524,0,14,30,0,568
S01010206,64,1,163,96,17,341
S01010207,239,2,99,112,24,476
S01010208,725,2,47,20,0,794
S01010209,770,1,35,10,4,820
S01010210,739,1,6,7,0,753
S01010211,686,0,22,5,0,713
S01010212,791,2,26,55,3,877
S01010213,786,0,3,1,6,796
S01010214,720,2,68,2,8,800
S01010215,649,2,16,36,2,705
S01010216,465,1,37,25,0,528
S01010217,526,1,31,60,4,622
S01010218,724,2,52,53,8,839
S01010219,186,4,75,126,9,400
S01010220,338,4,70,18,4,434
S01010221,439,0,14,16,1,470
S01010222,408,0,18,10,1,437
S01010223,450,1,26,16,2,495
S01010224,709,0,28,57,5,799
S01010225,520,1,68,71,4,664
S01010226,248,2,126,185,28,589
S01010227,201,2,129,121,13,466
S01010228,600,0,7,6,2,615
S01010229,776,2,30,17,2,827
S01010230,508,2,101,209,14,834
S01010231,641,2,45,77,17,782
S01010232,620,1,55,125,4,805
S01010233,534,0,74,122,8,738
S01010234,754,6,81,18,9,868
S01010235,714,5,96,18,4,837
S01010236,582,6,49,10,5,652
S01010237,542,2,24,4,3,575
S01010238,690,2,22,23,7,744
S01010239,613,3,18,22,18,674
S01010240,590,2,16,4,4,616
S01010241,878,3,21,27,7,936
S01010242,628,0,20,7,1,656
S01010243,765,3,38,38,4,848
S01010244,545,0,37,43,8,633
S01010245,769,1,6,7,1,784
S01010246,636,0,18,20,4,678
S01010247,610,0,37,0,0,647
S01010248,715,9,39,13,2,778
S01010249,596,1,24,13,0,634
S01010250,623,4,57,14,2,700
S01010251,490,3,38,30,5,566
S01010252,487,3,42,11,0,543
S01010253,492,0,20,9,6,527
S01010254,888,0,16,26,3,933
S01010255,488,1,22,45,2,558
S01010256,710,3,7,1,0,721
S01010257,607,4,168,9,5,793
S01010258,1007,19,356,44,43,1469
S01010259,902,3,194,42,22,1163
S01010260,1339,19,388,51,30,1827
S01010261,1872,21,384,121,71,2469
S01010262,734,2,56,4,15,811
S01010263,554,7,131,23,6,721
S01010264,693,11,79,26,6,815
S01010265,864,14,106,10,25,1019
S01010266,384,7,82,4,13,490
S01010267,431,3,132,5,12,583
S01010268,574,12,159,17,11,773
S01010269,346,3,141,3,13,506
S01010270,946,3,119,17,37,1122
S01010271,544,8,147,13,10,722
S01010272,722,10,135,48,13,928
S01010273,490,3,134,9,7,643
S01010274,485,0,45,12,10,552
S01010275,473,4,70,8,24,579
S01010276,704,9,163,33,17,926
S01010277,458,0,47,7,9,521
S01010278,377,1,97,29,4,508
S01010279,398,9,108,18,4,537
S01010280,617,8,73,30,2,730
S01010281,559,4,131,11,26,731
S01010282,774,8,104,9,7,902
S01010283,394,4,91,4,3,496
S01010284,912,14,374,32,22,1354
S01010285,616,5,95,10,10,736
S01010286,871,23,499,46,16,1455
S01010287,705,6,101,9,6,827
S01010288,638,5,98,6,7,754
S01010289,637,11,31,7,3,689
S01010290,400,7,67,3,16,493
S01010291,769,10,178,13,27,997
S01010292,657,15,119,46,7,844
S01010293,557,2,163,18,16,756
S01010294,489,6,137,5,6,643
S01010295,636,11,218,9,18,892
S01010296,370,8,163,11,23,575
S01010297,798,6,133,33,19,989
S01010298,710,6,87,13,4,820
S01010299,327,1,115,8,5,456
S01010300,638,7,159,16,17,837
S01010301,335,1,105,13,12,466
S01010302,418,2,91,36,10,557
S01010303,227,4,125,32,10,398
S01010304,395,3,57,25,1,481
S01010305,693,5,56,7,5,766
S01010306,610,4,64,9,5,692
S01010307,702,5,38,7,2,754
S01010308,740,6,118,9,3,876
S01010309,360,0,20,8,0,388
S01010310,440,0,77,38,1,556
S01010311,533,2,18,27,2,582
S01010312,626,3,18,25,4,676
S01010313,529,0,9,9,1,548
S01010314,907,13,108,65,19,1112
S01010315,620,1,52,20,10,703
S01010316,361,6,28,24,3,422
S01010317,647,6,26,9,2,690
S01010318,1359,21,87,33,13,1513
S01010319,561,7,58,19,2,647
S01010320,531,1,56,31,5,624
S01010321,742,5,24,11,2,784
S01010322,881,14,41,13,3,952
S01010323,475,2,15,20,0,512
S01010324,652,0,11,0,0,663
S01010325,821,0,3,0,0,824
S01010326,702,0,17,16,7,742
S01010327,701,4,51,9,5,770
S01010328,741,0,61,6,3,811
S01010329,479,0,10,3,3,495
S01010330,484,1,7,7,7,506
S01010331,755,0,1,17,3,776
S01010332,572,0,4,2,0,578
S01010333,765,1,12,11,4,793
S01010334,730,3,1,2,0,736
S01010335,676,4,15,0,0,695
S01010336,495,0,1,4,2,502
S01010337,522,0,4,2,1,529
S01010338,556,0,9,4,1,570
S01010339,544,0,3,4,1,552
S01010340,558,1,16,20,0,595
S01010341,446,0,20,2,0,468
S01010342,508,2,17,3,2,532
S01010343,728,1,22,6,0,757
S01010344,576,1,3,4,0,584
S01010345,297,1,42,5,5,350
S01010346,815,3,55,3,0,876
S01010347,861,8,54,11,5,939
S01010348,775,5,24,2,0,806
S01010349,734,0,8,3,0,745
S01010350,684,1,13,25,6,729
S01010351,610,5,45,30,1,691
S01010352,433,0,14,7,0,454
S01010353,657,3,38,63,3,764
S01010354,555,2,16,34,6,613
S01010355,586,1,19,13,2,621
S01010356,505,1,24,19,0,549
S01010357,459,0,17,25,2,503
S01010358,686,0,15,10,3,714
S01010359,589,1,24,32,2,648
S01010360,398,2,17,27,1,445
S01010361,454,3,12,46,3,518
S01010362,617,2,30,89,4,742
S01010363,591,3,45,13,3,655
S01010364,654,7,96,4,1,762
S01010365,789,6,63,5,6,869
S01010366,804,6,82,11,6,909
S01010367,1091,21,312,47,17,1488
S01010368,594,3,38,2,2,639
S01010369,598,7,44,17,6,672
S01010370,573,8,38,10,1,630
S01010371,836,8,47,6,11,908
S01010372,401,10,41,0,2,454
S01010373,618,5,44,16,4,687
S01010374,764,6,56,3,1,830
S01010375,446,3,36,9,7,501
S01010376,503,6,133,5,20,667
S01010377,651,14,160,21,11,857
S01010378,609,9,64,4,3,689
S01010379,913,13,134,10,6,1076
S01010380,837,12,26,10,4,889
S01010381,475,4,73,4,13,569
S01010382,744,2,36,9,2,793
S01010383,509,5,70,7,4,595
S01010384,663,8,85,9,5,770
S01010385,722,6,47,6,2,783
S01010386,744,6,53,13,6,822
S01010387,833,10,102,17,10,972
S01010388,874,4,42,4,1,925
S01010389,763,10,146,33,21,973
S01010390,930,7,53,9,3,1002
S01010391,678,9,32,11,7,737
S01010392,510,4,90,9,21,634
S01010393,894,11,42,2,2,951
S01010394,675,0,36,11,9,731
S01010395,837,8,53,16,3,917
S01010396,880,7,48,4,6,945
S01010397,482,3,12,3,0,500
S01010398,931,8,54,3,4,1000
S01010399,908,9,40,14,8,979
S01010400,886,6,48,5,4,949
S01010401,635,5,16,10,3,669
S01010402,867,13,31,7,3,921
S01010403,871,9,36,9,5,930
S01010404,652,3,24,8,4,691
S01010405,655,5,23,3,3,689
S01010406,703,7,36,8,4,758
S01010407,754,7,70,4,9,844
S01010408,412,1,18,4,1,436
S01010409,490,1,47,0,3,541
S01010410,428,5,35,2,0,470
S01010411,743,0,50,4,1,798
S01010412,705,5,48,4,0,762
S01010413,561,3,41,5,2,612
S01010414,814,1,49,8,0,872
S01010415,814,2,67,2,1,886
S01010416,539,4,32,10,1,586
S01010417,449,0,37,2,0,488
S01010418,896,3,33,5,0,937
S01010419,818,4,7,4,3,836
S01010420,536,3,38,1,0,578
S01010421,672,0,29,0,3,704
S01010422,851,4,33,6,1,895
S01010423,637,2,28,32,3,702
S01010424,682,1,13,7,4,707
S01010425,826,1,22,24,2,875
S01010426,568,0,13,17,5,603
S01010427,649,1,89,49,14,802
S01010428,555,1,19,2,0,577
S01010429,736,2,23,11,0,772
S01010430,592,5,51,47,3,698
S01010431,530,4,11,4,0,549
S01010432,656,3,36,23,9,727
S01010433,293,5,107,101,40,546
S01010434,419,1,32,33,8,493
S01010435,505,0,12,9,2,528
S01010436,601,1,26,25,7,660
S01010437,441,0,7,18,1,467
S01010438,512,1,41,49,7,610
S01010439,723,2,19,52,2,798
S01010440,499,0,14,21,0,534
S01010441,665,0,16,11,2,694
S01010442,538,2,34,21,0,595
S01010443,431,0,4,0,1,436
S01010444,548,1,3,4,2,558
S01010445,757,1,15,12,0,785
S01010446,686,0,10,3,1,700
S01010447,755,0,33,22,6,816
S01010448,679,0,23,5,3,710
S01010449,632,0,11,8,3,654
S01010450,676,0,4,9,2,691
S01010451,629,3,29,39,3,703
S01010452,683,1,12,4,1,701
S01010453,465,1,33,37,3,539
S01010454,721,2,3,8,0,734
S01010455,766,1,27,35,4,833
S01010456,473,1,11,2,0,487
S01010457,479,0,19,34,3,535
S01010458,611,1,10,19,9,650
S01010459,457,1,7,8,1,474
S01010460,501,6,67,15,3,592
S01010461,563,1,24,28,0,616
S01010462,384,3,91,133,15,626
S01010463,655,1,9,0,0,665
S01010464,437,2,4,5,0,448
S01010465,731,6,56,5,0,798
S01010466,691,9,61,16,3,780
S01010467,718,3,53,6,6,786
S01010468,641,4,124,10,4,783
S01010469,479,3,23,13,2,520
S01010470,659,1,13,1,0,674
S01010471,512,2,18,4,0,536
S01010472,427,5,26,2,2,462
S01010473,607,4,45,8,4,668
S01010474,631,2,57,20,4,714
S01010475,536,2,46,4,3,591
S01010476,891,2,30,5,0,928
S01010477,601,0,17,7,3,628
S01010478,800,2,34,24,4,864
S01010479,811,3,9,11,5,839
S01010480,493,1,5,3,3,505
S01010481,454,2,8,10,2,476
S01010482,634,1,13,4,3,655
S01010483,842,2,8,5,1,858
S01010484,456,0,2,2,0,460
S01010485,756,0,35,2,1,794
S01010486,747,2,28,3,4,784
S01010487,803,0,9,3,0,815
S01010488,559,0,12,12,0,583
S01010489,838,0,7,25,7,877
S01010490,492,0,7,24,3,526
S01010491,606,0,4,21,2,633
S01010492,419,1,5,0,0,425
S01010493,478,0,2,6,1,487
S01010494,440,0,22,5,0,467
S01010495,628,1,7,8,0,644
S01010496,617,1,11,18,4,651
S01010497,533,3,15,1,0,552
S01010498,631,0,8,1,2,642
S01010499,618,3,27,41,3,692
S01010500,716,0,23,4,4,747
S01010501,716,0,7,3,2,728
S01010502,600,1,7,4,0,612
S01010503,535,0,6,6,0,547
S01010504,431,0,2,0,0,433
S01010505,451,1,1,0,0,453
S01010506,686,0,3,1,0,690
S01010507,641,3,2,2,1,649
S01010508,813,1,5,0,1,820
S01010509,788,1,2,2,0,793
S01010510,689,2,2,2,1,696
S01010511,664,2,3,0,0,669
S01010512,496,0,5,0,0,501
S01010513,613,1,3,1,0,618
S01010514,557,0,1,0,0,558
S01010515,657,0,4,1,0,662
S01010516,504,0,10,0,1,515
S01010517,676,2,6,1,0,685
S01010518,527,3,11,0,2,543
S01010519,566,1,0,1,0,568
S01010520,745,0,6,1,3,755
S01010521,599,2,5,1,1,608
S01010522,507,3,4,0,0,514
S01010523,447,0,9,1,0,457
S01010524,450,1,10,0,1,462
S01010525,539,0,4,1,1,545
S01010526,671,0,1,3,0,675
S01010527,734,0,6,0,2,742
S01010528,496,0,3,4,0,503
S01010529,574,0,9,1,0,584
S01010530,543,0,2,2,0,547
S01010531,920,3,6,1,0,930
S01010532,458,0,3,0,1,462
S01010533,511,1,1,4,1,518
S01010534,699,1,4,2,0,706
S01010535,568,0,0,4,0,572
S01010536,697,1,4,0,1,703
S01010537,656,3,11,2,0,672
S01010538,595,2,2,0,1,600
S01010539,947,3,5,1,6,962
S01010540,536,1,2,1,0,540
S01010541,698,0,7,1,0,706
S01010542,752,1,0,2,0,755
S01010543,505,1,2,0,0,508
S01010544,689,0,1,0,2,692
S01010545,576,1,6,1,2,586
S01010546,699,2,6,1,2,710
S01010547,620,2,0,0,0,622
S01010548,569,4,1,0,0,574
S01010549,707,1,2,0,0,710
S01010550,444,0,2,0,1,447
S01010551,507,0,2,1,1,511
S01010552,626,1,0,2,1,630
S01010553,508,3,2,0,1,514
S01010554,607,3,18,7,2,637
S01010555,734,1,31,3,2,771
S01010556,799,1,9,0,1,810
S01010557,510,0,0,0,0,510
S01010558,657,2,6,3,1,669
S01010559,667,0,4,3,0,674
S01010560,556,0,6,1,1,564
S01010561,600,0,4,0,0,604
S01010562,619,1,3,0,0,623
S01010563,414,0,0,1,0,415
S01010564,442,0,0,0,0,442
S01010565,543,0,0,0,0,543
S01010566,872,1,3,0,0,876
S01010567,880,1,4,0,0,885
S01010568,784,2,1,1,1,789
S01010569,705,3,7,6,1,722
S01010570,853,1,3,3,0,860
S01010571,641,3,8,3,0,655
S01010572,608,0,4,0,1,613
S01010573,421,0,2,3,0,426
S01010574,461,2,9,1,0,473
S01010575,566,1,1,7,2,577
S01010576,674,2,3,0,1,680
S01010577,680,0,8,3,0,691
S01010578,456,1,3,1,0,461
S01010579,624,0,5,2,0,631
S01010580,443,4,12,4,1,464
S01010581,411,2,9,1,0,423
S01010582,405,0,5,0,0,410
S01010583,800,2,7,0,1,810
S01010584,579,2,13,0,2,596
S01010585,588,3,5,2,1,599
S01010586,607,1,11,0,2,621
S01010587,572,0,11,4,1,588
S01010588,494,0,15,0,0,509
S01010589,494,3,5,1,1,504
S01010590,623,0,4,0,0,627
S01010591,533,1,3,3,0,540
S01010592,419,2,3,4,1,429
S01010593,492,0,16,4,0,512
S01010594,481,0,24,3,0,508
S01010595,530,2,16,11,2,561
S01010596,616,1,8,3,0,628
S01010597,472,0,13,0,0,485
S01010598,723,2,13,2,0,740
S01010599,468,1,4,1,0,474
S01010600,791,0,11,5,1,808
S01010601,591,2,9,0,1,603
S01010602,443,1,0,5,0,449
S01010603,690,0,5,0,2,697
S01010604,390,0,2,0,1,393
S01010605,756,0,8,1,0,765
S01010606,655,0,0,0,4,659
S01010607,680,1,9,2,3,695
S01010608,492,1,10,0,0,503
S01010609,448,1,1,2,0,452
S01010610,603,5,7,1,0,616
S01010611,773,1,4,0,1,779
S01010612,619,1,0,0,0,620
S01010613,597,1,4,0,0,602
S01010614,434,1,6,2,0,443
S01010615,637,1,17,1,2,658
S01010616,709,5,13,2,2,731
S01010617,735,1,1,0,0,737
S01010618,630,0,2,1,0,633
S01010619,509,0,9,1,0,519
S01010620,538,2,19,0,1,560
S01010621,779,1,17,6,0,803
S01010622,517,1,1,0,1,520
S01010623,512,10,12,11,9,554
S01010624,501,2,41,4,5,553
S01010625,676,0,9,0,2,687
S01010626,789,0,4,0,1,794
S01010627,717,1,11,0,0,729
S01010628,867,3,20,4,1,895
S01010629,801,3,7,1,0,812
S01010630,478,0,7,1,0,486
S01010631,542,2,11,3,0,558
S01010632,791,1,10,1,2,805
S01010633,809,1,1,1,2,814
S01010634,529,0,4,2,0,535
S01010635,636,0,5,0,0,641
S01010636,684,1,6,1,0,692
S01010637,488,4,10,2,5,509
S01010638,720,3,17,1,0,741
S01010639,938,1,7,6,0,952
S01010640,683,2,38,2,2,727
S01010641,766,5,9,1,1,782
S01010642,718,3,12,2,1,736
S01010643,511,5,4,0,0,520
S01010644,509,1,4,1,0,515
S01010645,471,0,3,1,1,476
S01010646,562,2,9,2,2,577
S01010647,623,1,9,0,0,633
S01010648,554,1,5,1,0,561
S01010649,514,0,5,0,0,519
S01010650,410,0,5,0,1,416
S01010651,555,1,8,1,1,566
S01010652,608,1,3,2,0,614
S01010653,532,0,1,1,0,534
S01010654,636,0,2,0,0,638
S01010655,721,2,5,0,1,729
S01010656,362,0,2,0,0,364
S01010657,533,0,1,0,0,534
S01010658,591,0,7,1,3,602
S01010659,537,0,3,3,1,544
S01010660,511,0,0,0,0,511
S01010661,517,0,1,0,0,518
S01010662,605,1,5,3,0,614
S01010663,769,3,4,1,0,777
S01010664,673,2,2,0,1,678
S01010665,770,1,2,0,1,774
S01010666,759,5,1,4,0,769
S01010667,562,1,5,0,2,570
S01010668,939,3,5,0,1,948
S01010669,488,1,0,0,0,489
S01010670,574,1,1,0,0,576
S01010671,621,4,2,1,0,628
S01010672,529,0,2,1,0,532
S01010673,767,2,0,3,0,772
S01010674,752,3,3,1,0,759
S01010675,531,0,2,0,1,534
S01010676,765,0,2,3,0,770
S01010677,420,0,0,0,0,420
S01010678,529,0,1,1,0,531
S01010679,503,2,3,0,0,508
S01010680,529,0,4,0,0,533
S01010681,822,4,5,0,0,831
S01010682,772,2,0,1,2,777
S01010683,831,1,1,0,0,833
S01010684,678,0,5,1,0,684
S01010685,530,0,1,1,0,532
S01010686,581,2,2,0,0,585
S01010687,695,1,2,0,1,699
S01010688,609,3,5,2,0,619
S01010689,665,2,2,0,0,669
S01010690,558,0,7,1,0,566
S01010691,614,4,1,2,1,622
S01010692,594,0,3,2,0,599
S01010693,394,0,3,0,0,397
S01010694,513,1,6,0,0,520
S01010695,611,2,1,0,0,614
S01010696,828,4,6,0,0,838
S01010697,916,0,1,3,1,921
S01010698,604,2,2,2,0,610
S01010699,489,1,0,0,1,491
S01010700,500,1,1,0,1,503
S01010701,837,1,2,1,0,841
S01010702,867,1,7,0,0,875
S01010703,706,1,1,0,0,708
S01010704,532,1,4,0,0,537
S01010705,892,0,2,1,2,897
S01010706,544,1,7,1,0,553
S01010707,589,1,3,0,0,593
S01010708,461,1,2,0,0,464
S01010709,585,0,3,2,1,591
S01010710,610,0,0,0,0,610
S01010711,614,1,3,0,0,618
S01010712,554,0,2,0,0,556
S01010713,624,0,8,0,1,633
S01010714,606,1,6,0,0,613
S01010715,577,0,9,2,0,588
S01010716,758,1,21,1,1,782
S01010717,529,1,7,2,0,539
S01010718,750,2,3,0,0,755
S01010719,559,0,4,1,0,564
S01010720,626,1,2,0,0,629
S01010721,542,0,3,1,0,546
S01010722,705,0,3,1,1,710
S01010723,705,0,4,1,0,710
S01010724,701,2,0,2,1,706
S01010725,599,0,1,0,0,600
S01010726,791,0,3,0,0,794
S01010727,526,0,0,1,1,528
S01010728,414,0,3,1,0,418
S01010729,586,1,2,0,1,590
S01010730,692,0,5,0,1,698
S01010731,745,0,5,2,0,752
S01010732,635,1,13,1,1,651
S01010733,431,0,6,0,0,437
S01010734,718,0,5,0,0,723
S01010735,455,0,0,0,0,455
S01010736,419,0,0,0,0,419
S01010737,876,2,7,0,4,889
S01010738,457,1,0,0,0,458
S01010739,684,2,9,0,0,695
S01010740,384,2,1,0,0,387
S01010741,506,1,4,1,1,513
S01010742,566,1,3,0,1,571
S01010743,525,0,5,1,0,531
S01010744,896,3,0,1,1,901
S01010745,514,0,12,3,0,529
S01010746,838,0,1,2,1,842
S01010747,658,1,1,0,0,660
S01010748,525,0,0,1,0,526
S01010749,504,0,0,0,0,504
S01010750,539,1,1,1,0,542
S01010751,582,0,1,0,0,583
S01010752,582,2,2,0,0,586
S01010753,796,1,1,1,0,799
S01010754,568,1,3,0,0,572
S01010755,536,1,4,1,0,542
S01010756,540,0,4,0,0,544
S01010757,657,0,0,1,1,659
S01010758,598,0,4,1,1,604
S01010759,486,1,4,3,0,494
S01010760,533,0,4,2,1,540
S01010761,442,0,1,0,0,443
S01010762,496,1,1,2,0,500
S01010763,547,0,1,1,0,549
S01010764,494,1,2,0,0,497
S01010765,850,0,5,0,0,855
S01010766,644,0,7,1,1,653
S01010767,581,0,1,0,0,582
S01010768,483,0,5,0,2,490
S01010769,423,1,0,0,0,424
S01010770,715,1,4,0,0,720
S01010771,748,1,0,0,0,749
S01010772,695,1,0,1,0,697
S01010773,649,0,1,0,1,651
S01010774,586,2,1,0,1,590
S01010775,522,1,0,1,2,526
S01010776,451,0,4,1,0,456
S01010777,448,0,1,0,0,449
S01010778,369,1,1,0,0,371
S01010779,602,1,7,2,0,612
S01010780,475,0,4,0,0,479
S01010781,630,2,12,2,0,646
S01010782,505,4,3,1,0,513
S01010783,464,0,0,0,0,464
S01010784,578,1,3,0,0,582
S01010785,576,1,3,0,0,580
S01010786,533,0,1,0,0,534
S01010787,732,1,0,0,0,733
S01010788,501,1,4,0,0,506
S01010789,586,0,4,0,0,590
S01010790,569,1,0,0,0,570
S01010791,718,0,2,0,0,720
S01010792,489,0,1,0,0,490
S01010793,528,1,0,1,0,530
S01010794,434,0,1,0,0,435
S01010795,821,0,0,0,0,821
S01010796,677,1,1,1,0,680
S01010797,628,0,2,2,1,633
S01010798,576,3,0,0,0,579
S01010799,808,2,6,1,0,817
S01010800,603,0,5,0,0,608
S01010801,599,0,3,1,0,603
S01010802,468,1,3,2,1,475
S01010803,485,3,9,2,0,499
S01010804,492,0,3,1,1,497
S01010805,700,3,2,0,0,705
S01010806,736,0,2,1,2,741
S01010807,448,0,0,0,2,450
S01010808,422,0,0,0,0,422
S01010809,674,1,0,0,0,675
S01010810,427,1,0,1,0,429
S01010811,742,0,1,2,0,745
S01010812,432,1,1,0,0,434
S01010813,453,0,0,0,1,454
S01010814,532,0,3,0,1,536
S01010815,375,1,0,1,0,377
S01010816,515,3,4,0,1,523
S01010817,692,3,14,3,0,712
S01010818,814,0,10,2,0,826
S01010819,671,0,4,0,1,676
S01010820,430,0,1,0,0,431
S01010821,480,1,16,0,2,499
S01010822,624,2,15,0,0,641
S01010823,354,1,13,0,0,368
S01010824,522,1,8,4,0,535
S01010825,258,1,0,0,0,259
S01010826,598,1,20,1,0,620
S01010827,491,0,0,0,0,491
S01010828,934,0,27,0,0,961
S01010829,797,1,6,4,1,809
S01010830,473,0,3,0,0,476
S01010831,424,1,6,2,3,436
S01010832,607,0,4,1,1,613
S01010833,720,0,18,1,0,739
S01010834,781,2,8,2,1,794
S01010835,570,0,5,0,1,576
S01010836,676,4,15,0,1,696
S01010837,557,1,1,1,0,560
S01010838,661,1,1,1,0,664
S01010839,587,1,5,0,0,593
S01010840,442,2,2,1,1,448
S01010841,639,4,11,3,0,657
S01010842,787,9,5,7,0,808
S01010843,574,0,4,4,0,582
S01010844,568,0,2,1,0,571
S01010845,522,0,6,0,0,528
S01010846,612,1,7,0,0,620
S01010847,510,0,8,0,0,518
S01010848,515,0,4,0,0,519
S01010849,723,2,4,3,0,732
S01010850,704,2,5,0,0,711
S01010851,604,2,0,2,0,608
S01010852,611,0,1,0,0,612
S01010853,724,2,0,0,0,726
S01010854,697,2,0,0,2,701
S01010855,442,1,6,0,0,449
S01010856,750,0,5,0,0,755
S01010857,642,0,1,1,0,644
S01010858,586,1,5,0,0,592
S01010859,577,5,1,1,2,586
S01010860,525,0,3,0,0,528
S01010861,527,1,5,0,0,533
S01010862,436,2,1,0,0,439
S01010863,673,1,1,2,0,677
S01010864,486,1,0,0,0,487
S01010865,633,0,8,1,1,643
S01010866,659,0,11,0,0,670
S01010867,582,1,8,0,0,591
S01010868,736,1,4,2,0,743
S01010869,608,0,24,0,0,632
S01010870,658,1,6,1,1,667
S01010871,737,2,17,2,1,759
S01010872,611,0,11,2,0,624
S01010873,487,0,10,0,0,497
S01010874,615,3,12,2,0,632
S01010875,413,1,11,1,0,426
S01010876,597,0,9,1,1,608
S01010877,779,2,9,1,1,792
S01010878,1041,2,1,3,1,1048
S01010879,702,1,1,1,0,705
S01010880,442,0,0,2,0,444
S01010881,540,2,0,0,0,542
S01010882,454,1,1,0,1,457
S01010883,715,0,21,0,0,736
S01010884,579,0,3,0,0,582
S01010885,766,1,8,3,0,778
S01010886,396,0,2,1,0,399
S01010887,698,1,5,3,0,707
S01010888,677,2,2,1,0,682
S01010889,471,0,1,0,0,472
S01010890,710,0,2,1,0,713
S01010891,384,0,4,2,0,390
S01010892,747,0,4,2,5,758
S01010893,456,1,6,2,0,465
S01010894,576,0,3,0,0,579
S01010895,358,0,0,0,0,358
S01010896,567,0,1,0,0,568
S01010897,669,0,0,1,0,670
S01010898,503,0,2,0,0,505
S01010899,476,0,2,0,0,478
S01010900,506,1,1,0,0,508
S01010901,347,1,2,1,0,351
S01010902,819,1,4,1,0,825
S01010903,666,0,0,0,1,667
S01010904,443,0,3,0,0,446
S01010905,482,0,17,3,0,502
S01010906,746,0,0,0,0,746
S01010907,383,1,8,1,1,394
S01010908,512,0,0,0,0,512
S01010909,607,1,7,1,0,616
S01010910,404,0,1,0,0,405
S01010911,492,0,1,0,2,495
S01010912,584,0,7,0,2,593
S01010913,532,0,3,2,0,537
S01010914,536,0,3,0,0,539
S01010915,586,0,5,1,0,592
S01010916,478,0,7,1,0,486
S01010917,614,1,2,0,3,620
S01010918,610,0,2,0,0,612
S01010919,648,1,6,0,3,658
S01010920,437,1,13,1,0,452
S01010921,515,0,5,1,0,521
S01010922,720,0,1,0,0,721
S01010923,725,1,2,1,0,729
S01010924,509,1,0,2,0,512
S01010925,678,0,0,0,0,678
S01010926,645,3,1,0,0,649
S01010927,458,0,3,0,0,461
S01010928,560,0,1,0,0,561
S01010929,513,0,1,2,0,516
S01010930,702,3,5,2,0,712
S01010931,370,0,1,1,0,372
S01010932,459,1,3,5,0,468
S01010933,561,0,12,3,0,576
S01010934,824,2,7,2,0,835
S01010935,569,4,2,0,0,575
S01010936,624,1,1,0,1,627
S01010937,621,0,6,0,0,627
S01010938,627,4,3,2,0,636
S01010939,418,0,2,1,0,421
S01010940,583,0,4,0,0,587
S01010941,711,1,2,0,2,716
S01010942,555,0,7,0,1,563
S01010943,482,0,4,0,0,486
S01010944,518,0,7,0,0,525
S01010945,437,0,2,2,0,441
S01010946,677,0,3,2,0,682
S01010947,437,1,2,0,0,440
S01010948,552,0,0,0,1,553
S01010949,823,0,5,3,1,832
S01010950,687,2,3,3,0,695
S01010951,505,0,1,1,0,507
S01010952,399,0,8,3,0,410
S01010953,461,3,3,0,0,467
S01010954,504,2,0,16,6,528
S01010955,688,3,9,11,9,720
S01010956,568,2,3,1,1,575
S01010957,465,1,6,1,0,473
S01010958,421,1,2,0,0,424
S01010959,482,0,4,0,0,486
S01010960,863,0,10,3,0,876
S01010961,460,0,10,1,1,472
S01010962,505,0,0,2,1,508
S01010963,759,2,3,1,1,766
S01010964,439,0,5,0,0,444
S01010965,410,1,4,3,1,419
S01010966,575,1,4,2,0,582
S01010967,545,0,5,1,1,552
S01010968,596,0,5,2,0,603
S01010969,528,4,5,8,0,545
S01010970,780,0,9,1,0,790
S01010971,815,0,8,1,1,825
S01010972,636,1,3,3,0,643
S01010973,412,0,6,1,0,419
S01010974,588,0,3,1,1,593
S01010975,372,0,8,0,0,380
S01010976,468,1,8,0,0,477
S01010977,598,0,4,1,1,604
S01010978,578,0,15,5,1,599
S01010979,627,1,22,1,0,651
S01010980,600,0,1,0,0,601
S01010981,600,1,11,0,0,612
S01010982,1029,3,15,1,1,1049
S01010983,659,1,4,1,0,665
S01010984,577,0,1,0,0,578
S01010985,494,0,7,0,2,503
S01010986,380,0,17,0,0,397
S01010987,445,0,7,1,0,453
S01010988,447,0,3,0,0,450
S01010989,672,2,18,0,0,692
S01010990,605,0,27,2,2,636
S01010991,417,1,17,0,0,435
S01010992,368,1,30,3,0,402
S01010993,504,0,3,1,0,508
S01010994,887,2,6,0,1,896
S01010995,596,1,11,0,0,608
S01010996,498,0,14,2,0,514
S01010997,554,1,6,0,0,561
S01010998,489,4,1,1,0,495
S01010999,734,2,5,4,1,746
S01011000,671,0,8,0,1,680
S01011001,531,0,2,1,0,534
S01011002,584,3,6,0,1,594
S01011003,544,1,4,4,0,553
S01011004,463,4,19,0,0,486
S01011005,548,3,3,0,2,556
S01011006,791,1,9,2,1,804
S01011007,538,0,4,0,0,542
S01011008,650,1,1,1,0,653
S01011009,408,5,2,0,1,416
S01011010,486,1,12,10,1,510
S01011011,647,3,3,10,0,663
S01011012,532,1,3,4,0,540
S01011013,662,1,3,2,0,668
S01011014,685,2,2,1,1,691
S01011015,374,1,5,0,0,380
S01011016,590,0,37,5,0,632
S01011017,685,0,4,1,2,692
S01011018,703,1,2,2,1,709
S01011019,787,2,1,2,2,794
S01011020,375,2,1,0,0,378
S01011021,707,2,7,3,0,719
S01011022,442,0,5,0,4,451
S01011023,656,3,5,0,1,665
S01011024,576,0,6,0,4,586
S01011025,544,0,3,7,2,556
S01011026,454,1,0,0,1,456
S01011027,689,3,13,0,1,706
S01011028,738,0,1,0,0,739
S01011029,502,1,3,1,2,509
S01011030,790,3,3,2,0,798
S01011031,575,1,0,0,0,576
S01011032,650,0,1,1,0,652
S01011033,520,0,2,1,1,524
S01011034,561,0,2,0,0,563
S01011035,510,1,5,0,1,517
S01011036,539,1,0,0,1,541
S01011037,734,0,6,1,1,742
S01011038,655,1,5,0,2,663
S01011039,668,0,6,1,1,676
S01011040,558,1,2,1,0,562
S01011041,621,4,3,1,0,629
S01011042,638,0,1,3,0,642
S01011043,552,0,8,1,0,561
S01011044,562,1,1,3,1,568
S01011045,641,2,0,1,0,644
S01011046,711,1,3,2,0,717
S01011047,788,0,1,0,0,789
S01011048,794,0,9,2,0,805
S01011049,580,0,0,1,0,581
S01011050,649,2,0,0,0,651
S01011051,778,1,1,0,0,780
S01011052,703,3,6,0,0,712
S01011053,531,0,4,0,0,535
S01011054,437,0,4,1,0,442
S01011055,446,2,2,1,2,453
S01011056,554,1,0,0,0,555
S01011057,474,0,1,0,0,475
S01011058,522,1,0,0,0,523
S01011059,501,1,8,0,0,510
S01011060,771,0,7,1,1,780
S01011061,695,0,3,1,0,699
S01011062,752,1,1,1,0,755
S01011063,850,2,2,1,0,855
S01011064,856,0,4,0,0,860
S01011065,589,0,3,0,0,592
S01011066,424,0,1,1,1,427
S01011067,476,2,0,0,0,478
S01011068,420,0,0,1,0,421
S01011069,467,0,0,0,0,467
S01011070,510,0,0,0,0,510
S01011071,723,0,2,1,0,726
S01011072,801,0,0,0,0,801
S01011073,594,0,2,0,0,596
S01011074,509,0,0,0,0,509
S01011075,564,1,4,0,1,570
S01011076,599,2,4,0,0,605
S01011077,577,3,3,3,0,586
S01011078,936,0,4,1,0,941
S01011079,875,3,9,0,1,888
S01011080,834,1,3,0,0,838
S01011081,657,0,5,0,0,662
S01011082,474,0,0,0,0,474
S01011083,643,1,1,3,0,648
S01011084,646,2,5,1,0,654
S01011085,741,1,1,1,0,744
S01011086,546,0,0,0,0,546
S01011087,479,0,0,0,0,479
S01011088,797,3,2,0,1,803
S01011089,541,1,0,0,0,542
S01011090,611,0,1,0,0,612
S01011091,523,1,0,1,1,526
S01011092,312,3,2,2,1,320
S01011093,499,1,1,0,1,502
S01011094,442,0,4,0,1,447
S01011095,648,0,1,2,0,651
S01011096,473,1,4,1,0,479
S01011097,555,1,3,0,0,559
S01011098,635,0,0,0,0,635
S01011099,649,1,1,0,0,651
S01011100,391,1,0,0,0,392
S01011101,480,1,1,0,0,482
S01011102,517,1,16,0,0,534
S01011103,496,0,5,1,1,503
S01011104,621,0,5,2,0,628
S01011105,674,3,5,0,0,682
S01011106,641,1,1,1,0,644
S01011107,634,0,1,0,1,636
S01011108,430,0,15,2,0,447
S01011109,681,2,5,2,0,690
S01011110,563,0,3,2,0,568
S01011111,688,2,6,3,0,699
S01011112,647,0,0,1,0,648
S01011113,817,2,1,1,0,821
S01011114,606,0,9,0,0,615
S01011115,740,1,6,4,0,751
S01011116,535,0,9,0,0,544
S01011117,616,1,13,4,1,635
S01011118,712,0,8,3,1,724
S01011119,762,0,25,2,0,789
S01011120,600,0,8,0,0,608
S01011121,459,2,8,3,1,473
S01011122,532,3,4,2,0,541
S01011123,908,2,2,2,2,916
S01011124,496,3,5,1,0,505
S01011125,390,0,1,0,1,392
S01011126,379,0,0,0,0,379
S01011127,319,1,3,4,0,327
S01011128,592,1,7,0,0,600
S01011129,757,3,9,2,0,771
S01011130,491,1,5,1,0,498
S01011131,559,0,1,5,0,565
S01011132,738,0,4,1,2,745
S01011133,371,2,1,1,0,375
S01011134,660,0,4,1,0,665
S01011135,627,1,1,4,0,633
S01011136,559,0,0,2,2,563
S01011137,364,1,1,1,2,369
S01011138,478,1,1,2,0,482
S01011139,1105,1,7,2,2,1117
S01011140,424,0,3,1,0,428
S01011141,433,1,0,1,0,435
S01011142,883,7,28,9,5,932
S01011143,772,2,6,0,0,780
S01011144,590,2,3,2,0,597
S01011145,540,0,0,1,0,541
S01011146,583,0,1,0,2,586
S01011147,837,0,3,0,1,841
S01011148,645,1,3,2,1,652
S01011149,691,3,4,2,1,701
S01011150,318,0,1,0,0,319
S01011151,424,1,3,0,1,429
S01011152,585,2,1,0,1,589
S01011153,729,2,15,2,0,748
S01011154,488,1,4,1,1,495
S01011155,550,2,4,0,0,556
S01011156,488,0,0,0,0,488
S01011157,511,2,0,0,1,514
S01011158,445,0,1,0,0,446
S01011159,464,3,2,2,0,471
S01011160,743,1,0,1,1,746
S01011161,495,0,0,1,0,496
S01011162,363,0,3,0,0,366
S01011163,670,1,0,0,0,671
S01011164,587,3,0,0,0,590
S01011165,615,1,7,1,0,624
S01011166,429,1,4,0,0,434
S01011167,638,0,3,0,0,641
S01011168,705,1,1,0,0,707
S01011169,699,2,5,0,0,706
S01011170,745,1,7,3,0,756
S01011171,782,1,4,0,2,789
S01011172,636,5,5,1,0,647
S01011173,495,2,9,1,0,507
S01011174,405,1,2,0,0,408
S01011175,435,1,1,0,2,439
S01011176,495,1,0,0,0,496
S01011177,727,0,10,3,1,741
S01011178,391,0,2,1,0,394
S01011179,509,0,0,0,0,509
S01011180,539,0,1,0,0,540
S01011181,397,1,2,1,0,401
S01011182,348,1,0,0,0,349
S01011183,455,4,15,0,1,475
S01011184,624,1,24,1,0,650
S01011185,593,0,4,0,3,600
S01011186,782,3,4,1,0,790
S01011187,598,0,0,0,1,599
S01011188,784,0,1,0,0,785
S01011189,695,0,11,0,0,706
S01011190,522,1,2,0,0,525
S01011191,431,0,5,0,0,436
S01011192,551,0,3,0,0,554
S01011193,535,0,4,1,0,540
S01011194,552,0,1,0,0,553
S01011195,586,0,1,0,1,588
S01011196,697,1,1,4,1,704
S01011197,652,0,5,0,0,657
S01011198,482,1,2,1,0,486
S01011199,633,0,4,2,0,639
S01011200,618,0,2,0,0,620
S01011201,503,0,5,0,0,508
S01011202,682,0,7,0,0,689
S01011203,662,2,0,0,0,664
S01011204,464,0,9,0,1,474
S01011205,473,1,18,4,0,496
S01011206,535,2,24,6,0,567
S01011207,615,1,6,0,0,622
S01011208,714,0,12,0,2,728
S01011209,513,1,0,0,0,514
S01011210,561,0,40,0,1,602
S01011211,541,2,4,0,0,547
S01011212,418,0,1,0,0,419
S01011213,810,0,2,1,2,815
S01011214,729,0,0,0,0,729
S01011215,455,0,1,3,0,459
S01011216,373,0,3,0,0,376
S01011217,634,0,9,0,0,643
S01011218,504,0,0,0,0,504
S01011219,641,0,2,0,1,644
S01011220,729,2,5,1,0,737
S01011221,757,0,6,4,0,767
S01011222,554,0,0,1,0,555
S01011223,642,1,3,0,0,646
S01011224,579,0,18,1,0,598
S01011225,550,2,5,4,3,564
S01011226,847,2,7,2,0,858
S01011227,586,1,14,2,0,603
S01011228,665,2,6,1,0,674
S01011229,442,0,3,0,0,445
S01011230,821,2,2,0,0,825
S01011231,494,0,9,0,0,503
S01011232,814,1,4,2,0,821
S01011233,299,1,10,1,0,311
S01011234,783,1,0,4,0,788
S01011235,310,0,1,0,0,311
S01011236,474,0,1,1,0,476
S01011237,595,1,0,0,0,596
S01011238,514,0,2,0,0,516
S01011239,624,0,3,0,1,628
S01011240,626,2,3,2,0,633
S01011241,904,0,8,2,0,914
S01011242,674,0,7,0,0,681
S01011243,750,1,6,0,0,757
S01011244,570,0,5,1,0,576
S01011245,712,0,7,0,1,720
S01011246,742,2,2,1,0,747
S01011247,717,0,2,2,0,721
S01011248,625,2,3,0,0,630
S01011249,613,0,4,0,0,617
S01011250,796,0,0,4,0,800
S01011251,695,0,5,0,0,700
S01011252,631,0,1,0,0,632
S01011253,681,1,10,0,0,692
S01011254,786,0,4,1,0,791
S01011255,568,1,7,0,0,576
S01011256,328,0,8,0,0,336
S01011257,370,0,0,0,2,372
S01011258,479,0,0,0,1,480
S01011259,661,3,0,0,0,664
S01011260,629,0,3,0,1,633
S01011261,611,0,2,1,0,614
S01011262,402,0,1,0,0,403
S01011263,910,4,3,1,0,918
S01011264,510,0,0,0,0,510
S01011265,796,1,1,0,1,799
S01011266,738,0,7,0,0,745
S01011267,492,0,8,0,0,500
S01011268,330,0,3,0,0,333
S01011269,439,0,2,0,0,441
S01011270,565,0,1,1,2,569
S01011271,709,0,5,0,0,714
S01011272,627,1,0,0,0,628
S01011273,648,0,0,0,0,648
S01011274,666,1,8,1,0,676
S01011275,512,1,0,1,0,514
S01011276,768,0,0,1,0,769
S01011277,576,1,1,1,0,579
S01011278,416,0,1,0,0,417
S01011279,558,0,1,0,2,561
S01011280,514,2,1,0,0,517
S01011281,503,1,14,0,1,519
S01011282,680,0,15,0,0,695
S01011283,527,0,20,2,0,549
S01011284,393,0,16,1,0,410
S01011285,540,1,6,2,0,549
S01011286,541,3,6,1,0,551
S01011287,630,1,1,1,0,633
S01011288,593,0,2,0,0,595
S01011289,747,2,2,0,2,753
S01011290,989,1,8,0,0,998
S01011291,665,2,6,0,0,673
S01011292,570,0,1,0,1,572
S01011293,591,0,0,0,0,591
S01011294,743,1,3,0,1,748
S01011295,818,0,2,1,0,821
S01011296,487,2,3,0,0,492
S01011297,647,1,1,0,1,650
S01011298,474,1,3,0,2,480
S01011299,415,0,0,0,0,415
S01011300,762,0,5,0,0,767
S01011301,590,1,3,0,0,594
S01011302,761,0,3,1,0,765
S01011303,841,1,3,0,2,847
S01011304,532,1,7,0,0,540
S01011305,638,0,3,0,0,641
S01011306,472,0,2,0,0,474
S01011307,380,0,1,1,0,382
S01011308,370,2,1,1,0,374
S01011309,617,1,0,0,0,618
S01011310,581,4,4,2,0,591
S01011311,602,2,0,2,0,606
S01011312,948,1,5,0,1,955
S01011313,611,0,1,2,0,614
S01011314,871,0,2,3,0,876
S01011315,318,2,0,0,0,320
S01011316,571,2,1,0,0,574
S01011317,740,0,3,1,0,744
S01011318,864,2,4,0,1,871
S01011319,756,0,2,0,0,758
S01011320,462,0,4,0,0,466
S01011321,483,0,2,0,2,487
S01011322,487,2,0,3,2,494
S01011323,736,1,0,0,0,737
S01011324,357,3,3,0,0,363
S01011325,646,1,2,3,0,652
S01011326,680,2,3,1,0,686
S01011327,619,3,1,1,0,624
S01011328,593,0,2,0,0,595
S01011329,789,0,6,1,0,796
S01011330,613,0,1,0,2,616
S01011331,634,0,0,1,1,636
S01011332,785,1,2,2,1,791
S01011333,667,2,2,1,0,672
S01011334,585,2,3,1,0,591
S01011335,815,1,8,2,0,826
S01011336,471,2,6,2,1,482
S01011337,574,2,10,2,0,588
S01011338,510,0,0,0,0,510
S01011339,452,0,2,0,0,454
S01011340,552,0,1,0,0,553
S01011341,591,0,3,0,1,595
S01011342,581,1,0,1,0,583
S01011343,694,1,3,0,0,698
S01011344,693,0,3,0,0,696
S01011345,597,0,0,0,1,598
S01011346,567,1,0,1,0,569
S01011347,881,0,4,1,0,886
S01011348,736,0,1,1,0,738
S01011349,731,0,9,0,1,741
S01011350,569,0,1,1,0,571
S01011351,575,0,1,0,0,576
S01011352,548,0,4,0,0,552
S01011353,550,1,2,3,0,556
S01011354,607,0,0,0,1,608
S01011355,803,1,1,0,0,805
S01011356,787,0,2,1,1,791
S01011357,708,0,3,0,0,711
S01011358,427,0,6,1,0,434
S01011359,641,2,1,0,2,646
S01011360,570,1,0,2,0,573
S01011361,458,2,4,0,0,464
S01011362,409,0,17,2,0,428
S01011363,758,2,4,0,0,764
S01011364,520,0,1,0,0,521
S01011365,440,1,8,0,0,449
S01011366,453,0,1,0,0,454
S01011367,681,3,2,1,1,688
S01011368,590,0,37,1,0,628
S01011369,661,3,10,3,0,677
S01011370,604,0,22,4,1,631
S01011371,746,3,13,1,0,763
S01011372,561,3,8,2,0,574
S01011373,543,3,7,1,0,554
S01011374,531,1,4,0,1,537
S01011375,522,0,5,8,0,535
S01011376,427,0,3,0,1,431
S01011377,505,0,1,0,0,506
S01011378,667,1,7,1,0,676
S01011379,727,1,11,1,0,740
S01011380,572,0,10,0,1,583
S01011381,520,0,7,0,1,528
S01011382,430,1,5,0,1,437
S01011383,568,0,0,0,0,568
S01011384,517,0,2,2,1,522
S01011385,766,0,3,0,1,770
S01011386,468,0,0,0,0,468
S01011387,638,0,14,5,0,657
S01011388,790,0,18,6,2,816
S01011389,653,1,12,1,0,667
S01011390,662,2,2,0,0,666
S01011391,507,2,0,0,0,509
S01011392,540,0,1,1,0,542
S01011393,710,2,1,0,0,713
S01011394,416,0,3,0,0,419
S01011395,639,0,4,1,2,646
S01011396,660,1,0,2,0,663
S01011397,681,1,6,1,0,689
S01011398,589,1,1,0,0,591
S01011399,420,0,3,0,0,423
S01011400,573,0,7,0,1,581
S01011401,547,1,3,0,1,552
S01011402,817,0,21,2,0,840
S01011403,402,3,18,0,1,424
S01011404,785,1,10,1,0,797
S01011405,507,0,16,2,0,525
S01011406,546,0,5,0,0,551
S01011407,924,2,10,0,0,936
S01011408,685,4,2,0,0,691
S01011409,618,0,11,0,2,631
S01011410,538,1,1,0,0,540
S01011411,551,0,2,2,0,555
S01011412,740,0,7,3,1,751
S01011413,439,0,20,0,0,459
S01011414,653,0,15,0,0,668
S01011415,722,0,4,1,1,728
S01011416,508,1,20,1,0,530
S01011417,675,0,10,1,0,686
S01011418,461,0,1,0,1,463
S01011419,464,0,7,0,0,471
S01011420,400,0,4,0,1,405
S01011421,438,2,5,0,0,445
S01011422,532,0,8,0,0,540
S01011423,408,0,8,0,0,416
S01011424,464,2,0,0,0,466
S01011425,682,0,9,0,0,691
S01011426,798,1,6,0,0,805
S01011427,560,1,0,1,0,562
S01011428,432,0,0,1,0,433
S01011429,1020,2,24,2,0,1048
S01011430,743,1,18,0,0,762
S01011431,909,0,1,1,0,911
S01011432,868,1,1,0,2,872
S01011433,660,0,2,4,0,666
S01011434,481,0,3,0,0,484
S01011435,750,1,10,4,0,765
S01011436,600,2,2,0,0,604
S01011437,606,0,3,0,1,610
S01011438,423,0,0,4,0,427
S01011439,735,1,2,1,0,739
S01011440,477,1,7,0,0,485
S01011441,634,0,6,0,0,640
S01011442,558,1,6,0,2,567
S01011443,507,0,6,0,0,513
S01011444,607,0,3,1,0,611
S01011445,425,0,1,5,0,431
S01011446,421,0,4,0,0,425
S01011447,681,0,1,0,0,682
S01011448,753,0,7,0,0,760
S01011449,443,0,4,0,4,451
S01011450,455,0,38,0,0,493
S01011451,482,2,62,2,0,548
S01011452,746,0,32,0,0,778
S01011453,571,0,12,2,0,585
S01011454,628,2,3,0,1,634
S01011455,616,0,6,0,1,623
S01011456,677,0,13,0,0,690
S01011457,726,0,4,1,0,731
S01011458,823,2,44,3,1,873
S01011459,776,0,7,4,0,787
S01011460,541,0,11,2,0,554
S01011461,559,1,14,6,0,580
S01011462,745,0,13,2,0,760
S01011463,548,0,6,2,0,556
S01011464,403,0,32,0,1,436
S01011465,395,0,9,0,2,406
S01011466,490,1,0,3,0,494
S01011467,385,0,32,1,0,418
S01011468,577,0,45,1,0,623
S01011469,605,0,34,0,0,639
S01011470,891,0,34,2,1,928
S01011471,763,0,11,2,0,776
S01011472,750,1,8,8,1,768
S01011473,605,1,3,2,2,613
S01011474,681,0,7,0,2,690
S01011475,516,0,0,3,1,520
S01011476,412,0,1,0,0,413
S01011477,699,2,9,0,0,710
S01011478,823,0,34,3,1,861
S01011479,684,1,8,0,0,693
S01011480,842,0,13,0,1,856
S01011481,617,0,16,4,0,637
S01011482,734,0,9,3,1,747
S01011483,424,1,10,0,3,438
S01011484,699,0,10,1,0,710
S01011485,742,0,6,6,0,754
S01011486,435,0,0,2,0,437
S01011487,863,0,10,2,2,877
S01011488,514,0,3,2,0,519
S01011489,540,0,2,1,0,543
S01011490,849,3,7,1,4,864
S01011491,412,0,2,0,1,415
S01011492,553,3,18,19,4,597
S01011493,383,1,14,0,0,398
S01011494,608,1,5,3,0,617
S01011495,652,1,10,1,0,664
S01011496,488,2,1,2,1,494
S01011497,453,0,39,0,0,492
S01011498,526,0,13,0,0,539
S01011499,648,1,27,0,0,676
S01011500,422,0,1,0,1,424
S01011501,537,0,0,0,0,537
S01011502,595,0,14,1,0,610
S01011503,506,0,1,1,0,508
S01011504,450,0,32,1,0,483
S01011505,533,2,15,2,0,552
S01011506,430,1,1,0,0,432
S01011507,498,2,12,2,0,514
S01011508,759,0,25,1,3,788
S01011509,515,2,2,1,1,521
S01011510,838,0,2,0,0,840
S01011511,428,1,5,1,0,435
S01011512,689,0,3,1,0,693
S01011513,602,0,7,0,0,609
S01011514,716,0,16,0,0,732
S01011515,446,0,5,0,0,451
S01011516,692,0,26,0,0,718
S01011517,444,0,9,0,0,453
S01011518,549,0,1,0,2,552
S01011519,637,3,1,1,0,642
S01011520,466,0,4,0,0,470
S01011521,736,1,15,1,0,753
S01011522,709,2,29,4,0,744
S01011523,601,0,10,0,0,611
S01011524,754,0,7,1,0,762
S01011525,772,2,9,0,0,783
S01011526,786,2,24,2,0,814
S01011527,595,0,15,0,0,610
S01011528,814,3,9,1,3,830
S01011529,420,0,2,0,0,422
S01011530,807,0,3,0,0,810
S01011531,867,1,40,2,0,910
S01011532,461,2,10,1,1,475
S01011533,557,2,11,0,0,570
S01011534,594,1,0,0,1,596
S01011535,754,2,9,0,0,765
S01011536,543,0,28,0,2,573
S01011537,428,0,16,1,0,445
S01011538,546,0,10,2,1,559
S01011539,614,0,5,0,0,619
S01011540,844,0,4,1,0,849
S01011541,712,0,1,3,0,716
S01011542,732,0,2,1,0,735
S01011543,610,0,0,0,1,611
S01011544,547,0,2,1,0,550
S01011545,488,0,0,0,0,488
S01011546,527,0,20,2,1,550
S01011547,427,0,7,0,0,434
S01011548,606,3,3,2,0,614
S01011549,670,2,6,0,0,678
S01011550,595,1,10,1,0,607
S01011551,438,3,9,0,0,450
S01011552,596,0,5,1,0,602
S01011553,564,1,52,1,0,618
S01011554,728,3,1,1,0,733
S01011555,456,1,1,0,0,458
S01011556,398,0,3,0,1,402
S01011557,593,1,0,0,0,594
S01011558,457,0,0,0,0,457
S01011559,494,0,0,0,0,494
S01011560,613,0,3,2,0,618
S01011561,642,1,1,2,0,646
S01011562,483,1,0,1,0,485
S01011563,580,2,0,3,0,585
S01011564,762,0,7,1,1,771
S01011565,737,2,3,1,0,743
S01011566,687,0,7,1,0,695
S01011567,830,1,0,0,0,831
S01011568,649,0,3,0,0,652
S01011569,795,0,9,0,0,804
S01011570,600,2,3,1,0,606
S01011571,566,0,6,0,0,572
S01011572,473,0,12,0,1,486
S01011573,826,1,13,1,1,842
S01011574,600,1,4,1,0,606
S01011575,405,0,3,0,0,408
S01011576,736,0,1,0,0,737
S01011577,543,0,26,2,1,572
S01011578,664,4,7,1,0,676
S01011579,887,0,15,1,3,906
S01011580,530,0,26,0,1,557
S01011581,685,1,7,0,0,693
S01011582,947,0,8,1,1,957
S01011583,557,0,2,0,0,559
S01011584,585,1,5,0,0,591
S01011585,584,0,0,1,0,585
S01011586,481,1,0,0,0,482
S01011587,447,0,2,2,0,451
S01011588,604,1,4,0,0,609
S01011589,698,1,8,0,0,707
S01011590,551,1,0,0,0,552
S01011591,497,2,0,2,0,501
S01011592,561,1,1,0,0,563
S01011593,592,0,7,2,0,601
S01011594,377,3,5,0,0,385
S01011595,504,1,6,2,0,513
S01011596,861,0,4,0,0,865
S01011597,530,0,7,0,0,537
S01011598,674,2,2,3,1,682
S01011599,656,0,5,1,0,662
S01011600,637,2,2,2,1,644
S01011601,634,1,20,0,1,656
S01011602,489,2,0,2,2,495
S01011603,668,1,2,0,2,673
S01011604,522,0,3,1,2,528
S01011605,709,0,4,2,0,715
S01011606,706,2,20,1,1,730
S01011607,458,6,12,1,0,477
S01011608,719,1,19,1,1,741
S01011609,756,2,4,0,0,762
S01011610,639,0,12,1,1,653
S01011611,585,0,2,0,0,587
S01011612,434,2,17,0,0,453
S01011613,788,1,8,1,0,798
S01011614,376,2,0,1,0,379
S01011615,558,0,1,0,0,559
S01011616,338,0,2,3,0,343
S01011617,709,1,0,1,0,711
S01011618,487,0,4,0,0,491
S01011619,790,0,20,3,0,813
S01011620,767,2,35,2,0,806
S01011621,587,0,4,0,0,591
S01011622,474,0,8,0,0,482
S01011623,548,0,14,0,1,563
S01011624,538,1,7,0,4,550
S01011625,438,1,4,0,0,443
S01011626,626,0,3,3,2,634
S01011627,526,3,3,0,0,532
S01011628,877,0,12,0,0,889
S01011629,485,2,1,1,1,490
S01011630,503,1,1,1,0,506
S01011631,448,0,1,6,0,455
S01011632,573,1,3,2,1,580
S01011633,583,1,8,0,0,592
S01011634,427,0,7,1,0,435
S01011635,519,1,1,2,0,523
S01011636,540,3,5,1,1,550
S01011637,553,0,7,0,0,560
S01011638,419,0,8,2,0,429
S01011639,451,0,2,2,0,455
S01011640,523,0,12,0,0,535
S01011641,405,0,1,0,0,406
S01011642,657,4,5,1,1,668
S01011643,444,2,14,4,0,464
S01011644,601,0,0,1,0,602
S01011645,451,0,1,0,0,452
S01011646,582,1,5,0,1,589
S01011647,692,0,7,2,0,701
S01011648,492,0,22,0,0,514
S01011649,386,3,0,6,0,395
S01011650,579,0,4,0,0,583
S01011651,764,0,6,2,0,772
S01011652,612,1,26,0,3,642
S01011653,714,0,4,0,1,719
S01011654,806,4,14,1,2,827
S01011655,715,1,1,1,0,718
S01011656,484,1,7,0,0,492
S01011657,420,2,4,0,0,426
S01011658,542,0,9,0,1,552
S01011659,660,0,0,0,0,660
S01011660,771,1,17,1,0,790
S01011661,432,0,2,0,0,434
S01011662,483,0,4,0,0,487
S01011663,745,3,4,1,0,753
S01011664,830,0,2,0,2,834
S01011665,712,2,3,1,0,718
S01011666,732,0,4,0,0,736
S01011667,669,1,11,0,0,681
S01011668,777,0,2,3,0,782
S01011669,548,0,10,1,1,560
S01011670,402,2,2,0,0,406
S01011671,586,0,2,0,1,589
S01011672,483,0,11,1,3,498
S01011673,529,0,8,0,0,537
S01011674,819,0,4,2,0,825
S01011675,747,0,2,1,0,750
S01011676,566,0,1,0,0,567
S01011677,459,0,2,1,1,463
S01011678,377,0,3,0,0,380
S01011679,413,0,4,0,0,417
S01011680,860,2,2,0,0,864
S01011681,662,1,3,1,0,667
S01011682,427,1,0,1,0,429
S01011683,611,1,1,0,0,613
S01011684,431,0,6,0,0,437
S01011685,596,3,3,0,0,602
S01011686,687,0,9,6,1,703
S01011687,698,1,2,1,0,702
S01011688,616,1,14,0,0,631
S01011689,528,2,6,1,1,538
S01011690,735,2,8,2,0,747
S01011691,453,0,3,0,0,456
S01011692,857,2,1,0,0,860
S01011693,650,0,10,4,0,664
S01011694,380,1,2,0,0,383
S01011695,677,2,9,1,0,689
S01011696,635,3,84,4,2,728
S01011697,717,0,36,3,1,757
S01011698,530,1,5,0,1,537
S01011699,733,2,28,0,1,764
S01011700,641,0,19,1,0,661
S01011701,794,0,23,2,3,822
S01011702,621,0,2,1,2,626
S01011703,489,1,11,0,1,502
S01011704,540,2,11,1,1,555
S01011705,597,1,4,0,0,602
S01011706,872,0,11,0,0,883
S01011707,575,3,5,1,0,584
S01011708,782,2,11,0,2,797
S01011709,753,1,22,3,3,782
S01011710,475,1,0,1,0,477
S01011711,543,2,4,1,1,551
S01011712,454,0,4,0,3,461
S01011713,755,1,2,0,1,759
S01011714,394,0,1,1,0,396
S01011715,484,0,8,0,1,493
S01011716,694,2,4,1,0,701
S01011717,605,0,8,1,1,615
S01011718,560,2,15,0,0,577
S01011719,511,3,13,2,0,529
S01011720,452,1,11,0,1,465
S01011721,581,0,5,0,0,586
S01011722,587,0,1,0,1,589
S01011723,763,1,2,1,0,767
S01011724,512,0,13,0,0,525
S01011725,488,0,8,2,0,498
S01011726,422,0,2,0,0,424
S01011727,533,1,23,1,0,558
S01011728,759,2,6,0,0,767
S01011729,557,0,2,3,0,562
S01011730,771,3,7,0,1,782
S01011731,712,2,6,0,0,720
S01011732,665,3,11,1,0,680
S01011733,702,0,3,0,0,705
S01011734,641,0,5,0,0,646
S01011735,605,1,14,0,1,621
S01011736,562,1,11,4,0,578
S01011737,512,1,24,13,2,552
S01011738,826,0,23,1,1,851
S01011739,424,0,5,0,1,430
S01011740,576,0,20,5,1,602
S01011741,523,0,9,3,1,536
S01011742,612,0,2,0,0,614
S01011743,654,0,1,1,1,657
S01011744,710,0,3,2,0,715
S01011745,624,4,3,2,0,633
S01011746,408,0,4,0,0,412
S01011747,738,1,13,2,0,754
S01011748,634,1,4,6,2,647
S01011749,540,1,12,7,0,560
S01011750,697,1,10,0,1,709
S01011751,747,2,13,8,10,780
S01011752,737,3,6,4,0,750
S01011753,654,0,5,1,0,660
S01011754,616,1,2,0,0,619
S01011755,752,3,5,1,0,761
S01011756,766,3,9,5,0,783
S01011757,567,2,3,0,1,573
S01011758,495,0,2,0,1,498
S01011759,667,0,3,0,0,670
S01011760,705,0,24,0,0,729
S01011761,493,2,9,3,0,507
S01011762,524,1,6,0,1,532
S01011763,652,1,0,0,0,653
S01011764,323,0,9,0,0,332
S01011765,814,0,2,2,0,818
S01011766,406,0,10,0,0,416
S01011767,726,4,12,1,1,744
S01011768,582,0,8,1,0,591
S01011769,553,1,0,0,0,554
S01011770,665,2,13,0,0,680
S01011771,504,0,24,3,0,531
S01011772,825,3,58,0,0,886
S01011773,436,0,10,1,0,447
S01011774,678,1,11,1,1,692
S01011775,469,0,11,0,0,480
S01011776,734,2,50,3,0,789
S01011777,461,2,14,0,0,477
S01011778,483,2,6,2,0,493
S01011779,635,0,4,0,1,640
S01011780,692,1,35,0,0,728
S01011781,455,0,4,0,0,459
S01011782,565,0,17,0,0,582
S01011783,470,0,15,1,0,486
S01011784,652,0,7,1,0,660
S01011785,699,0,11,1,0,711
S01011786,274,0,19,3,0,296
S01011787,818,0,0,1,3,822
S01011788,462,0,47,0,4,513
S01011789,545,0,0,2,3,550
S01011790,768,2,5,1,2,778
S01011791,602,0,5,3,0,610
S01011792,774,0,8,2,0,784
S01011793,603,1,5,2,0,611
S01011794,703,1,4,0,1,709
S01011795,513,0,0,2,0,515
S01011796,597,1,1,0,0,599
S01011797,858,0,6,0,1,865
S01011798,449,0,3,0,1,453
S01011799,754,1,2,0,0,757
S01011800,421,0,2,1,1,425
S01011801,456,0,0,0,0,456
S01011802,581,1,0,0,0,582
S01011803,462,0,1,2,0,465
S01011804,628,1,2,0,0,631
S01011805,463,2,0,4,0,469
S01011806,626,1,0,0,0,627
S01011807,909,1,2,1,1,914
S01011808,518,2,0,0,1,521
S01011809,593,0,2,0,0,595
S01011810,784,1,0,0,0,785
S01011811,847,1,2,0,1,851
S01011812,542,0,1,0,2,545
S01011813,622,1,1,1,0,625
S01011814,574,1,0,0,0,575
S01011815,605,0,9,0,0,614
S01011816,527,0,3,0,0,530
S01011817,589,0,3,0,0,592
S01011818,887,1,4,1,1,894
S01011819,726,0,2,1,0,729
S01011820,634,1,4,1,0,640
S01011821,348,2,2,1,1,354
S01011822,604,1,7,2,1,615
S01011823,502,1,2,0,1,506
S01011824,552,1,0,0,0,553
S01011825,457,2,3,0,0,462
S01011826,545,1,3,1,0,550
S01011827,471,0,1,0,0,472
S01011828,763,0,1,0,0,764
S01011829,356,0,1,0,0,357
S01011830,471,1,7,1,0,480
S01011831,744,0,8,0,2,754
S01011832,713,3,3,0,0,719
S01011833,800,3,2,0,0,805
S01011834,372,0,3,1,0,376
S01011835,542,1,5,0,1,549
S01011836,654,2,3,2,0,661
S01011837,563,0,3,0,0,566
S01011838,685,0,8,0,0,693
S01011839,812,0,8,5,0,825
S01011840,783,0,3,0,2,788
S01011841,731,0,14,0,0,745
S01011842,787,0,2,1,1,791
S01011843,802,2,5,3,0,812
S01011844,608,1,0,2,0,611
S01011845,670,2,1,1,0,674
S01011846,720,0,3,0,1,724
S01011847,342,0,1,0,0,343
S01011848,583,0,3,2,0,588
S01011849,641,1,6,0,2,650
S01011850,571,1,10,1,0,583
S01011851,728,2,3,1,1,735
S01011852,837,0,5,3,2,847
S01011853,560,1,8,2,0,571
S01011854,700,4,5,1,2,712
S01011855,700,0,4,0,2,706
S01011856,592,3,2,0,0,597
S01011857,568,4,0,0,0,572
S01011858,748,2,1,1,1,753
S01011859,743,1,6,1,1,752
S01011860,516,5,6,1,1,529
S01011861,631,1,3,1,0,636
S01011862,812,0,14,1,0,827
S01011863,714,1,5,2,0,722
S01011864,607,1,0,2,2,612
S01011865,508,3,4,1,0,516
S01011866,634,0,1,1,0,636
S01011867,762,0,2,0,2,766
S01011868,713,0,4,0,0,717
S01011869,655,2,14,6,2,679
S01011870,556,1,5,3,0,565
S01011871,859,2,4,1,0,866
S01011872,719,0,3,1,0,723
S01011873,638,0,3,3,2,646
S01011874,540,0,1,0,1,542
S01011875,568,0,1,0,2,571
S01011876,767,1,2,0,0,770
S01011877,459,3,2,5,0,469
S01011878,926,4,37,4,5,976
S01011879,443,0,1,0,0,444
S01011880,475,2,5,0,0,482
S01011881,660,1,2,0,1,664
S01011882,806,0,0,4,0,810
S01011883,885,8,21,1,1,916
S01011884,344,0,3,0,0,347
S01011885,522,1,0,4,0,527
S01011886,695,0,6,1,1,703
S01011887,464,0,3,0,1,468
S01011888,653,1,12,2,1,669
S01011889,774,1,3,0,1,779
S01011890,564,2,1,2,1,570
S01011891,1081,2,18,19,1,1121
S01011892,798,0,17,2,0,817
S01011893,780,1,11,6,0,798
S01011894,514,3,9,1,4,531
S01011895,574,2,3,0,0,579
S01011896,722,2,1,2,0,727
S01011897,818,0,1,5,2,826
S01011898,512,2,5,1,0,520
S01011899,650,3,7,0,2,662
S01011900,582,0,16,3,1,602
S01011901,715,2,5,1,6,729
S01011902,882,1,13,6,5,907
S01011903,667,2,7,2,0,678
S01011904,689,0,8,1,0,698
S01011905,618,1,20,2,0,641
S01011906,363,0,7,0,0,370
S01011907,612,0,15,3,2,632
S01011908,279,0,15,0,0,294
S01011909,768,1,12,2,0,783
S01011910,707,0,10,2,1,720
S01011911,535,2,1,0,0,538
S01011912,561,1,16,0,0,578
S01011913,574,0,5,2,0,581
S01011914,602,4,9,5,1,621
S01011915,621,4,11,6,1,643
S01011916,456,1,0,0,2,459
S01011917,418,0,3,0,0,421
S01011918,569,3,4,6,0,582
S01011919,706,2,41,8,1,758
S01011920,506,0,11,3,1,521
S01011921,460,0,5,0,0,465
S01011922,603,1,10,6,0,620
S01011923,715,3,9,3,0,730
S01011924,348,0,5,0,1,354
S01011925,524,1,26,0,0,551
S01011926,519,0,3,0,1,523
S01011927,499,0,1,1,1,502
S01011928,604,0,1,0,0,605
S01011929,580,2,4,1,1,588
S01011930,504,1,3,0,0,508
S01011931,455,1,14,2,2,474
S01011932,488,0,18,1,5,512
S01011933,525,3,32,0,1,561
S01011934,851,5,33,12,40,941
S01011935,684,1,55,7,4,751
S01011936,668,2,10,1,3,684
S01011937,558,1,40,10,6,615
S01011938,597,1,8,3,2,611
S01011939,626,2,33,4,1,666
S01011940,343,5,31,1,1,381
S01011941,589,2,48,2,9,650
S01011942,730,8,23,8,15,784
S01011943,977,1,62,5,10,1055
S01011944,379,2,1,2,0,384
S01011945,690,0,8,1,0,699
S01011946,665,2,3,0,1,671
S01011947,414,0,1,0,0,415
S01011948,972,3,14,6,1,996
S01011949,708,1,3,0,1,713
S01011950,663,2,1,2,1,669
S01011951,558,0,4,0,1,563
S01011952,390,0,1,0,2,393
S01011953,601,1,2,5,0,609
S01011954,398,1,2,0,1,402
S01011955,829,2,5,0,0,836
S01011956,772,1,9,0,1,783
S01011957,749,3,7,0,6,765
S01011958,898,4,0,0,1,903
S01011959,742,1,6,0,1,750
S01011960,628,0,7,0,2,637
S01011961,560,0,8,0,5,573
S01011962,535,0,3,1,2,541
S01011963,404,0,7,1,2,414
S01011964,824,1,2,0,0,827
S01011965,672,0,6,0,0,678
S01011966,646,2,23,3,1,675
S01011967,946,0,11,6,0,963
S01011968,798,1,27,5,1,832
S01011969,864,5,3,1,0,873
S01011970,754,3,4,0,0,761
S01011971,438,4,0,3,0,445
S01011972,972,1,3,0,2,978
S01011973,542,1,1,3,0,547
S01011974,642,0,3,2,2,649
S01011975,392,0,1,0,0,393
S01011976,641,2,1,1,0,645
S01011977,959,1,1,1,3,965
S01011978,579,0,1,5,2,587
S01011979,823,3,8,0,1,835
S01011980,340,0,1,1,0,342
S01011981,779,0,9,1,0,789
S01011982,778,3,3,2,0,786
S01011983,655,1,1,0,0,657
S01011984,527,0,12,0,0,539
S01011985,618,3,1,1,0,623
S01011986,525,0,4,1,0,530
S01011987,768,2,1,0,0,771
S01011988,595,0,7,0,0,602
S01011989,707,1,7,3,1,719
S01011990,644,2,4,0,4,654
S01011991,592,1,1,0,0,594
S01011992,837,0,17,2,0,856
S01011993,693,1,17,2,2,715
S01011994,648,1,5,0,1,655
S01011995,657,0,4,2,1,664
S01011996,458,0,0,3,1,462
S01011997,737,2,4,2,0,745
S01011998,425,0,0,1,0,426
S01011999,524,0,3,0,0,527
S01012000,370,1,2,1,1,375
S01012001,516,1,4,0,1,522
S01012002,483,0,0,1,0,484
S01012003,455,0,0,2,0,457
S01012004,750,2,1,2,0,755
S01012005,666,3,6,0,0,675
S01012006,716,4,20,2,3,745
S01012007,695,1,8,0,0,704
S01012008,790,3,8,0,3,804
S01012009,615,1,1,1,0,618
S01012010,1057,2,15,5,1,1080
S01012011,932,2,11,3,12,960
S01012012,585,1,1,1,0,588
S01012013,646,0,2,0,1,649
S01012014,712,0,3,0,0,715
S01012015,777,0,1,1,1,780
S01012016,727,3,9,1,0,740
S01012017,427,1,0,2,2,432
S01012018,715,1,6,2,1,725
S01012019,649,3,7,1,1,661
S01012020,573,2,10,1,0,586
S01012021,469,1,2,0,0,472
S01012022,526,0,2,0,1,529
S01012023,446,1,0,2,0,449
S01012024,684,1,4,1,0,690
S01012025,559,2,2,0,0,563
S01012026,434,0,30,1,0,465
S01012027,820,1,14,6,0,841
S01012028,772,0,8,0,0,780
S01012029,1064,0,11,2,1,1078
S01012030,521,1,8,3,1,534
S01012031,455,0,5,0,1,461
S01012032,298,1,2,0,0,301
S01012033,692,1,3,0,0,696
S01012034,655,0,1,2,0,658
S01012035,766,1,4,1,0,772
S01012036,730,1,2,2,0,735
S01012037,749,5,6,1,1,762
S01012038,615,1,0,11,3,630
S01012039,792,0,1,8,0,801
S01012040,544,1,6,5,2,558
S01012041,717,0,3,0,1,721
S01012042,752,0,0,2,0,754
S01012043,673,2,3,4,5,687
S01012044,747,0,2,7,0,756
S01012045,881,1,13,8,0,903
S01012046,561,1,2,7,0,571
S01012047,796,0,4,2,3,805
S01012048,599,1,9,3,3,615
S01012049,564,1,9,1,0,575
S01012050,792,1,8,0,0,801
S01012051,416,0,11,0,0,427
S01012052,755,0,7,1,0,763
S01012053,744,0,5,1,0,750
S01012054,637,3,3,7,0,650
S01012055,732,0,0,2,1,735
S01012056,659,1,1,10,0,671
S01012057,643,1,21,4,0,669
S01012058,618,1,12,1,1,633
S01012059,702,0,2,1,1,706
S01012060,708,0,4,1,0,713
S01012061,816,1,7,2,4,830
S01012062,667,3,22,0,0,692
S01012063,396,0,7,2,1,406
S01012064,452,1,9,11,0,473
S01012065,405,0,3,8,0,416
S01012066,606,1,25,2,1,635
S01012067,412,2,3,1,1,419
S01012068,424,1,4,2,2,433
S01012069,400,1,1,1,0,403
S01012070,591,0,20,4,0,615
S01012071,859,2,22,28,4,915
S01012072,940,2,20,8,1,971
S01012073,533,1,27,0,3,564
S01012074,565,1,16,4,2,588
S01012075,579,0,3,0,0,582
S01012076,607,2,4,1,1,615
S01012077,574,0,2,11,0,587
S01012078,774,0,6,2,1,783
S01012079,755,1,2,5,0,763
S01012080,532,2,4,20,6,564
S01012081,573,1,3,2,2,581
S01012082,508,1,1,1,1,512
S01012083,640,1,2,0,0,643
S01012084,483,0,2,1,1,487
S01012085,586,0,1,1,0,588
S01012086,747,0,2,1,0,750
S01012087,606,1,0,1,0,608
S01012088,540,0,11,3,1,555
S01012089,681,1,9,1,0,692
S01012090,762,2,5,0,1,770
S01012091,458,1,4,2,0,465
S01012092,428,0,2,3,0,433
S01012093,471,0,3,4,0,478
S01012094,660,1,11,4,7,683
S01012095,861,3,6,4,0,874
S01012096,723,1,1,0,0,725
S01012097,533,0,0,3,1,537
S01012098,506,0,0,3,0,509
S01012099,721,0,16,0,0,737
S01012100,868,0,7,1,0,876
S01012101,653,1,6,1,1,662
S01012102,487,0,9,2,3,501
S01012103,748,0,11,3,1,763
S01012104,685,4,8,2,1,700
S01012105,911,1,9,5,2,928
S01012106,867,5,19,5,1,897
S01012107,563,2,19,0,3,587
S01012108,844,0,6,2,0,852
S01012109,729,1,16,16,4,766
S01012110,631,0,2,1,1,635
S01012111,438,0,2,21,0,461
S01012112,663,2,0,1,0,666
S01012113,855,1,6,1,3,866
S01012114,797,2,28,5,2,834
S01012115,425,0,2,0,2,429
S01012116,490,1,7,0,0,498
S01012117,570,0,3,0,2,575
S01012118,474,2,13,5,0,494
S01012119,728,0,11,2,0,741
S01012120,454,3,5,2,4,468
S01012121,767,1,11,7,1,787
S01012122,667,1,3,0,0,671
S01012123,400,1,28,0,0,429
S01012124,426,1,12,8,0,447
S01012125,653,1,6,5,0,665
S01012126,641,1,24,7,0,673
S01012127,677,2,49,9,8,745
S01012128,392,3,17,7,2,421
S01012129,599,0,5,3,0,607
S01012130,962,1,10,3,6,982
S01012131,842,4,109,37,5,997
S01012132,551,2,21,12,6,592
S01012133,708,4,65,7,4,788
S01012134,1011,2,32,11,4,1060
S01012135,726,0,5,11,2,744
S01012136,635,3,35,40,2,715
S01012137,579,4,18,6,1,608
S01012138,745,3,32,3,2,785
S01012139,768,0,15,0,0,783
S01012140,431,0,10,0,0,441
S01012141,812,2,12,3,0,829
S01012142,787,0,6,2,5,800
S01012143,743,1,22,0,0,766
S01012144,850,1,23,0,0,874
S01012145,818,1,12,4,1,836
S01012146,790,2,17,8,2,819
S01012147,617,1,4,0,0,622
S01012148,565,2,6,1,0,574
S01012149,640,1,45,4,3,693
S01012150,612,0,5,6,0,623
S01012151,622,1,2,1,0,626
S01012152,590,1,4,2,4,601
S01012153,419,0,6,12,10,447
S01012154,656,2,13,15,2,688
S01012155,481,0,12,2,2,497
S01012156,519,1,7,1,1,529
S01012157,765,0,20,14,3,802
S01012158,835,0,32,4,6,877
S01012159,453,0,0,0,1,454
S01012160,562,0,7,0,0,569
S01012161,327,0,15,1,0,343
S01012162,691,3,25,11,1,731
S01012163,540,2,39,5,0,586
S01012164,759,1,42,2,0,804
S01012165,697,0,6,6,3,712
S01012166,480,4,5,0,1,490
S01012167,680,0,10,0,0,690
S01012168,693,0,21,0,0,714
S01012169,717,1,5,1,1,725
S01012170,843,0,6,0,0,849
S01012171,820,0,11,0,1,832
S01012172,593,0,18,0,0,611
S01012173,599,1,28,3,2,633
S01012174,619,2,42,1,1,665
S01012175,646,0,29,5,6,686
S01012176,675,2,46,3,1,727
S01012177,480,1,36,4,2,523
S01012178,441,1,7,0,2,451
S01012179,501,0,18,0,1,520
S01012180,474,1,5,0,0,480
S01012181,621,3,19,5,0,648
S01012182,784,2,64,0,3,853
S01012183,591,0,24,1,0,616
S01012184,415,2,24,3,3,447
S01012185,566,3,54,0,3,626
S01012186,586,0,5,2,0,593
S01012187,575,0,6,1,2,584
S01012188,504,0,1,0,1,506
S01012189,468,0,0,1,0,469
S01012190,400,1,0,1,0,402
S01012191,700,1,15,1,1,718
S01012192,399,1,24,2,0,426
S01012193,417,0,10,0,0,427
S01012194,420,0,6,1,0,427
S01012195,891,1,6,1,0,899
S01012196,413,0,24,0,1,438
S01012197,572,1,4,1,1,579
S01012198,764,0,5,1,0,770
S01012199,600,1,0,1,0,602
S01012200,509,2,4,1,0,516
S01012201,607,1,1,1,0,610
S01012202,462,0,9,2,0,473
S01012203,660,0,16,0,0,676
S01012204,657,0,3,1,1,662
S01012205,557,0,11,1,3,572
S01012206,680,1,0,1,0,682
S01012207,722,1,1,0,0,724
S01012208,818,0,11,1,0,830
S01012209,586,0,2,0,0,588
S01012210,642,0,5,0,0,647
S01012211,723,2,10,1,3,739
S01012212,664,0,0,1,0,665
S01012213,706,1,0,0,0,707
S01012214,565,0,1,1,0,567
S01012215,720,2,0,0,0,722
S01012216,583,1,2,0,0,586
S01012217,427,1,1,11,0,440
S01012218,349,0,2,1,2,354
S01012219,713,0,1,6,1,721
S01012220,531,0,9,4,0,544
S01012221,538,1,3,4,0,546
S01012222,671,1,11,2,0,685
S01012223,576,1,0,6,1,584
S01012224,582,0,4,3,0,589
S01012225,801,1,9,3,3,817
S01012226,577,0,3,0,0,580
S01012227,525,0,1,0,1,527
S01012228,537,1,1,3,0,542
S01012229,567,1,7,4,1,580
S01012230,718,2,13,0,2,735
S01012231,616,0,27,0,2,645
S01012232,668,1,4,1,0,674
S01012233,728,1,20,4,0,753
S01012234,824,2,11,1,5,843
S01012235,405,0,1,0,1,407
S01012236,488,1,11,0,0,500
S01012237,607,6,21,1,0,635
S01012238,500,2,6,0,1,509
S01012239,479,1,5,0,0,485
S01012240,693,0,6,2,0,701
S01012241,432,0,12,0,0,444
S01012242,629,1,3,3,3,639
S01012243,478,0,5,2,0,485
S01012244,744,3,1,1,0,749
S01012245,581,1,4,0,1,587
S01012246,577,0,2,2,0,581
S01012247,606,2,4,1,0,613
S01012248,645,4,4,2,1,656
S01012249,688,1,3,1,1,694
S01012250,560,1,1,1,0,563
S01012251,767,1,10,2,0,780
S01012252,560,2,0,4,0,566
S01012253,771,4,12,2,0,789
S01012254,693,0,0,6,1,700
S01012255,802,0,9,4,0,815
S01012256,665,1,3,1,1,671
S01012257,756,3,4,1,0,764
S01012258,580,2,3,0,0,585
S01012259,514,0,4,0,0,518
S01012260,708,0,2,3,0,713
S01012261,628,1,3,0,0,632
S01012262,651,1,0,1,0,653
S01012263,589,0,5,0,2,596
S01012264,378,0,7,0,0,385
S01012265,634,0,2,2,0,638
S01012266,901,1,2,0,0,904
S01012267,595,0,0,1,0,596
S01012268,501,0,1,2,0,504
S01012269,825,3,2,0,0,830
S01012270,616,2,4,1,3,626
S01012271,810,3,3,0,1,817
S01012272,564,0,5,0,0,569
S01012273,589,0,3,0,0,592
S01012274,758,1,2,2,0,763
S01012275,686,2,21,15,0,724
S01012276,796,0,8,2,1,807
S01012277,831,4,5,2,0,842
S01012278,639,2,7,1,0,649
S01012279,629,0,6,4,0,639
S01012280,761,0,0,3,0,764
S01012281,607,0,7,3,0,617
S01012282,939,5,28,2,4,978
S01012283,698,1,10,0,4,713
S01012284,647,3,14,3,2,669
S01012285,481,0,5,1,0,487
S01012286,860,2,6,2,9,879
S01012287,745,0,12,3,4,764
S01012288,610,0,7,4,2,623
S01012289,723,3,10,3,1,740
S01012290,469,1,3,2,0,475
S01012291,709,8,9,7,1,734
S01012292,618,3,3,1,0,625
S01012293,366,1,9,3,1,380
S01012294,695,2,4,3,0,704
S01012295,549,0,20,0,0,569
S01012296,625,1,2,1,2,631
S01012297,473,0,0,2,1,476
S01012298,676,1,1,1,0,679
S01012299,501,1,0,3,1,506
S01012300,529,0,5,4,0,538
S01012301,779,1,6,2,0,788
S01012302,482,0,1,0,0,483
S01012303,713,0,0,2,5,720
S01012304,785,0,3,0,1,789
S01012305,588,0,3,1,0,592
S01012306,474,1,11,0,0,486
S01012307,528,0,0,4,1,533
S01012308,669,3,1,4,0,677
S01012309,460,1,2,0,2,465
S01012310,775,0,1,1,1,778
S01012311,492,0,2,0,0,494
S01012312,860,1,9,0,0,870
S01012313,637,1,3,2,0,643
S01012314,665,1,5,0,2,673
S01012315,655,1,7,0,0,663
S01012316,515,0,0,1,1,517
S01012317,394,1,10,0,1,406
S01012318,642,2,0,2,0,646
S01012319,640,1,1,0,0,642
S01012320,553,1,0,0,0,554
S01012321,617,1,2,0,3,623
S01012322,826,0,6,0,1,833
S01012323,757,2,2,2,0,763
S01012324,690,0,1,1,0,692
S01012325,528,0,5,0,0,533
S01012326,485,0,4,0,0,489
S01012327,654,0,2,2,1,659
S01012328,487,0,2,0,0,489
S01012329,687,0,6,1,0,694
S01012330,505,0,1,2,0,508
S01012331,486,2,2,2,0,492
S01012332,825,0,1,4,0,830
S01012333,813,0,2,1,1,817
S01012334,707,0,1,2,1,711
S01012335,792,0,3,4,0,799
S01012336,510,2,0,0,0,512
S01012337,738,2,3,5,0,748
S01012338,624,0,4,3,0,631
S01012339,514,1,4,5,1,525
S01012340,829,0,1,0,0,830
S01012341,793,3,0,0,0,796
S01012342,783,2,0,1,0,786
S01012343,813,2,3,2,1,821
S01012344,476,1,0,6,0,483
S01012345,583,0,2,1,0,586
S01012346,698,1,6,2,1,708
S01012347,631,1,7,0,0,639
S01012348,583,1,2,1,0,587
S01012349,742,1,0,3,0,746
S01012350,622,0,1,2,0,625
S01012351,669,2,2,1,0,674
S01012352,628,1,1,0,0,630
S01012353,658,1,10,1,0,670
S01012354,661,0,4,2,1,668
S01012355,761,1,4,1,1,768
S01012356,554,0,0,1,0,555
S01012357,733,1,5,1,0,740
S01012358,677,0,1,0,2,680
S01012359,613,0,4,2,0,619
S01012360,580,1,1,6,2,590
S01012361,485,0,2,0,0,487
S01012362,575,2,1,0,1,579
S01012363,824,2,18,1,0,845
S01012364,594,0,1,0,0,595
S01012365,788,1,2,0,1,792
S01012366,778,1,4,0,0,783
S01012367,784,0,3,0,0,787
S01012368,524,0,6,0,1,531
S01012369,724,0,1,1,0,726
S01012370,808,0,3,1,6,818
S01012371,805,0,5,1,2,813
S01012372,650,1,0,6,0,657
S01012373,841,2,4,1,0,848
S01012374,736,2,0,0,4,742
S01012375,748,3,0,4,0,755
S01012376,778,0,2,7,3,790
S01012377,582,1,18,6,1,608
S01012378,487,0,5,1,1,494
S01012379,420,0,5,2,0,427
S01012380,727,2,1,1,0,731
S01012381,691,2,18,0,2,713
S01012382,811,0,0,0,0,811
S01012383,729,1,2,1,1,734
S01012384,428,0,2,2,1,433
S01012385,592,1,1,0,1,595
S01012386,798,1,4,1,2,806
S01012387,744,0,9,1,1,755
S01012388,568,3,4,3,1,579
S01012389,659,0,1,1,0,661
S01012390,618,1,1,0,0,620
S01012391,768,3,14,0,0,785
S01012392,597,0,9,0,0,606
S01012393,709,3,12,3,1,728
S01012394,524,0,7,0,0,531
S01012395,493,2,16,2,1,514
S01012396,527,1,4,0,1,533
S01012397,716,5,7,1,1,730
S01012398,734,2,26,3,3,768
S01012399,496,1,6,1,1,505
S01012400,465,5,16,0,1,487
S01012401,639,2,14,6,1,662
S01012402,347,0,4,1,0,352
S01012403,858,1,1,0,0,860
S01012404,817,1,5,2,1,826
S01012405,547,1,6,0,0,554
S01012406,497,1,2,0,0,500
S01012407,634,1,3,0,1,639
S01012408,500,1,1,0,0,502
S01012409,560,0,1,2,0,563
S01012410,838,0,4,1,0,843
S01012411,763,0,0,0,0,763
S01012412,535,1,4,0,0,540
S01012413,792,1,1,0,0,794
S01012414,583,2,1,2,1,589
S01012415,449,0,2,0,0,451
S01012416,455,0,1,0,0,456
S01012417,541,1,1,0,1,544
S01012418,672,3,4,0,1,680
S01012419,677,0,1,0,0,678
S01012420,687,4,1,2,0,694
S01012421,625,0,3,1,0,629
S01012422,720,0,5,0,0,725
S01012423,694,0,1,1,0,696
S01012424,747,0,4,1,0,752
S01012425,496,0,0,0,1,497
S01012426,382,0,1,0,0,383
S01012427,520,2,1,0,0,523
S01012428,530,2,6,1,0,539
S01012429,465,0,0,1,0,466
S01012430,470,2,3,0,0,475
S01012431,786,2,2,0,0,790
S01012432,618,0,3,0,1,622
S01012433,434,0,4,2,0,440
S01012434,578,0,0,0,0,578
S01012435,525,0,1,1,0,527
S01012436,590,1,4,0,0,595
S01012437,616,0,0,0,0,616
S01012438,523,1,9,0,1,534
S01012439,640,1,4,0,0,645
S01012440,440,1,2,0,1,444
S01012441,757,0,5,1,1,764
S01012442,791,1,12,2,2,808
S01012443,614,1,1,0,0,616
S01012444,706,0,5,0,1,712
S01012445,385,2,16,0,0,403
S01012446,429,0,1,0,0,430
S01012447,724,0,1,0,0,725
S01012448,695,7,8,1,1,712
S01012449,481,1,0,0,0,482
S01012450,687,2,8,3,0,700
S01012451,780,0,6,0,1,787
S01012452,499,0,6,0,0,505
S01012453,690,1,6,0,2,699
S01012454,575,0,1,1,1,578
S01012455,482,1,14,0,1,498
S01012456,640,1,7,1,0,649
S01012457,751,1,3,1,1,757
S01012458,654,4,11,0,0,669
S01012459,572,0,10,0,2,584
S01012460,461,0,7,5,0,473
S01012461,447,0,2,1,0,450
S01012462,646,0,6,0,1,653
S01012463,479,0,1,0,0,480
S01012464,489,0,2,0,0,491
S01012465,563,0,3,0,0,566
S01012466,667,3,0,2,1,673
S01012467,551,1,9,1,0,562
S01012468,616,2,0,0,0,618
S01012469,669,3,3,0,1,676
S01012470,823,1,2,1,0,827
S01012471,722,4,2,4,0,732
S01012472,610,2,2,0,0,614
S01012473,449,1,20,0,0,470
S01012474,620,0,5,0,4,629
S01012475,555,0,2,1,0,558
S01012476,767,0,3,0,0,770
S01012477,569,0,1,1,0,571
S01012478,688,1,1,0,0,690
S01012479,550,0,4,0,0,554
S01012480,468,1,8,3,0,480
S01012481,684,1,24,3,2,714
S01012482,737,1,1,2,0,741
S01012483,777,1,31,1,1,811
S01012484,664,2,7,0,1,674
S01012485,729,1,10,1,2,743
S01012486,581,5,1,0,0,587
S01012487,520,0,9,0,0,529
S01012488,803,2,1,1,0,807
S01012489,818,1,24,0,2,845
S01012490,841,1,12,5,1,860
S01012491,354,0,5,0,0,359
S01012492,686,2,11,0,0,699
S01012493,599,0,7,0,0,606
S01012494,797,0,5,0,0,802
S01012495,861,0,1,0,0,862
S01012496,639,0,0,0,0,639
S01012497,426,0,0,0,0,426
S01012498,636,0,1,0,0,637
S01012499,585,1,3,0,0,589
S01012500,375,0,1,0,1,377
S01012501,449,0,0,0,0,449
S01012502,598,0,3,1,0,602
S01012503,521,0,2,0,0,523
S01012504,483,3,3,0,0,489
S01012505,861,1,5,2,0,869
S01012506,430,0,3,0,1,434
S01012507,811,1,3,0,0,815
S01012508,651,0,2,0,0,653
S01012509,454,0,3,2,0,459
S01012510,708,2,0,0,0,710
S01012511,548,2,0,1,1,552
S01012512,507,0,3,1,4,515
S01012513,441,0,3,2,0,446
S01012514,733,2,3,0,0,738
S01012515,523,1,3,2,0,529
S01012516,526,0,10,0,0,536
S01012517,665,1,27,0,1,694
S01012518,483,1,2,2,0,488
S01012519,442,0,18,0,0,460
S01012520,705,1,4,0,5,715
S01012521,434,0,3,0,0,437
S01012522,729,0,8,0,0,737
S01012523,743,2,4,1,0,750
S01012524,778,0,6,1,0,785
S01012525,625,0,2,0,5,632
S01012526,660,1,4,0,0,665
S01012527,536,1,0,1,1,539
S01012528,653,2,2,0,3,660
S01012529,612,0,7,0,2,621
S01012530,750,1,5,2,1,759
S01012531,612,0,6,3,0,621
S01012532,660,0,0,0,0,660
S01012533,452,1,11,3,0,467
S01012534,529,1,5,2,0,537
S01012535,684,1,0,0,0,685
S01012536,621,0,0,1,1,623
S01012537,667,3,4,0,0,674
S01012538,908,0,0,1,0,909
S01012539,577,1,3,3,0,584
S01012540,566,0,2,0,0,568
S01012541,857,2,0,0,0,859
S01012542,795,1,0,1,0,797
S01012543,544,0,4,1,0,549
S01012544,667,1,1,0,1,670
S01012545,374,0,3,0,0,377
S01012546,646,1,0,1,0,648
S01012547,616,2,9,0,0,627
S01012548,705,2,4,0,1,712
S01012549,437,0,0,1,0,438
S01012550,666,0,2,0,2,670
S01012551,668,1,8,0,0,677
S01012552,757,1,2,1,0,761
S01012553,644,0,6,1,1,652
S01012554,380,0,4,3,0,387
S01012555,434,1,1,1,0,437
S01012556,486,0,0,0,0,486
S01012557,529,3,1,0,0,533
S01012558,484,3,1,0,1,489
S01012559,651,1,8,0,1,661
S01012560,446,0,0,0,0,446
S01012561,621,1,4,0,0,626
S01012562,636,0,4,0,1,641
S01012563,550,3,7,0,0,560
S01012564,698,0,4,1,0,703
S01012565,653,2,7,0,1,663
S01012566,625,0,15,2,0,642
S01012567,893,1,1,0,2,897
S01012568,515,2,1,0,1,519
S01012569,698,0,11,0,0,709
S01012570,389,1,0,0,2,392
S01012571,667,2,1,2,0,672
S01012572,428,0,5,0,2,435
S01012573,667,1,4,2,3,677
S01012574,708,3,3,0,1,715
S01012575,542,0,0,0,0,542
S01012576,642,2,2,0,0,646
S01012577,610,0,8,0,0,618
S01012578,839,0,12,0,0,851
S01012579,541,1,3,2,0,547
S01012580,614,2,3,1,0,620
S01012581,571,1,5,0,0,577
S01012582,726,0,3,3,0,732
S01012583,580,1,3,0,0,584
S01012584,617,0,3,1,0,621
S01012585,669,1,6,0,0,676
S01012586,782,1,2,3,2,790
S01012587,704,4,0,0,0,708
S01012588,517,0,3,0,0,520
S01012589,563,1,0,1,0,565
S01012590,651,1,0,1,0,653
S01012591,646,3,2,2,0,653
S01012592,450,2,2,0,1,455
S01012593,670,0,3,3,0,676
S01012594,393,0,2,0,0,395
S01012595,528,0,4,0,0,532
S01012596,612,0,0,1,1,614
S01012597,343,0,8,0,0,351
S01012598,579,2,4,0,0,585
S01012599,552,1,9,0,3,565
S01012600,580,0,14,0,1,595
S01012601,714,0,9,0,1,724
S01012602,531,0,5,1,0,537
S01012603,586,0,2,0,0,588
S01012604,550,1,10,0,0,561
S01012605,434,0,2,0,0,436
S01012606,544,0,2,3,1,550
S01012607,621,0,3,0,0,624
S01012608,672,0,0,0,2,674
S01012609,677,0,0,2,1,680
S01012610,736,0,11,0,1,748
S01012611,691,0,5,0,1,697
S01012612,587,3,16,0,0,606
S01012613,548,0,0,1,0,549
S01012614,863,1,17,2,1,884
S01012615,564,1,6,1,0,572
S01012616,786,2,1,0,0,789
S01012617,350,0,0,0,4,354
S01012618,441,1,1,0,0,443
S01012619,481,2,7,0,0,490
S01012620,639,1,4,2,0,646
S01012621,505,1,1,1,4,512
S01012622,598,0,0,1,1,600
S01012623,549,0,4,1,1,555
S01012624,583,2,1,2,0,588
S01012625,453,0,0,0,2,455
S01012626,408,0,2,1,1,412
S01012627,430,0,1,0,0,431
S01012628,788,2,2,2,1,795
S01012629,398,0,1,2,0,401
S01012630,765,2,2,0,0,769
S01012631,718,1,6,1,1,727
S01012632,585,0,4,1,0,590
S01012633,566,0,1,0,1,568
S01012634,566,2,4,2,0,574
S01012635,874,0,3,0,1,878
S01012636,500,2,0,0,0,502
S01012637,659,1,2,2,0,664
S01012638,721,1,1,0,0,723
S01012639,683,0,0,0,0,683
S01012640,766,1,5,2,1,775
S01012641,930,2,9,3,0,944
S01012642,636,1,14,0,2,653
S01012643,372,2,0,1,0,375
S01012644,521,0,9,6,0,536
S01012645,669,1,13,1,0,684
S01012646,752,1,7,3,1,764
S01012647,516,1,5,7,0,529
S01012648,438,0,0,0,0,438
S01012649,543,2,3,1,1,550
S01012650,489,0,7,0,1,497
S01012651,519,1,1,2,0,523
S01012652,877,0,3,3,0,883
S01012653,700,0,2,0,2,704
S01012654,607,0,6,0,1,614
S01012655,958,0,4,2,0,964
S01012656,672,1,0,0,0,673
S01012657,453,0,2,0,0,455
S01012658,807,2,6,0,3,818
S01012659,756,0,12,1,2,771
S01012660,585,1,5,0,0,591
S01012661,640,0,2,3,0,645
S01012662,630,3,0,0,0,633
S01012663,589,1,2,3,2,597
S01012664,808,1,3,1,2,815
S01012665,562,0,2,1,0,565
S01012666,551,1,0,1,0,553
S01012667,480,0,0,2,0,482
S01012668,589,0,8,0,0,597
S01012669,610,0,7,1,0,618
S01012670,610,0,3,0,0,613
S01012671,762,0,0,0,0,762
S01012672,582,0,4,0,2,588
S01012673,475,2,1,0,0,478
S01012674,439,0,2,0,0,441
S01012675,632,2,3,1,3,641
S01012676,628,0,2,3,1,634
S01012677,473,1,1,0,1,476
S01012678,573,0,2,0,0,575
S01012679,653,0,13,0,2,668
S01012680,435,1,0,0,1,437
S01012681,565,0,1,1,1,568
S01012682,661,0,2,2,0,665
S01012683,603,1,0,0,0,604
S01012684,437,0,4,0,0,441
S01012685,620,1,1,0,1,623
S01012686,792,0,1,1,0,794
S01012687,456,0,0,0,0,456
S01012688,677,1,13,1,0,692
S01012689,390,0,0,1,1,392
S01012690,423,0,0,0,1,424
S01012691,583,0,6,0,6,595
S01012692,618,1,5,0,1,625
S01012693,695,1,5,0,0,701
S01012694,360,0,2,1,0,363
S01012695,635,0,16,0,0,651
S01012696,573,2,101,36,22,734
S01012697,404,0,1,0,0,405
S01012698,650,0,3,0,0,653
S01012699,841,3,2,0,1,847
S01012700,656,3,8,3,1,671
S01012701,460,0,7,0,0,467
S01012702,469,2,10,0,2,483
S01012703,447,0,16,0,1,464
S01012704,595,0,1,0,1,597
S01012705,549,1,31,0,3,584
S01012706,553,0,4,0,0,557
S01012707,705,0,21,0,2,728
S01012708,590,0,5,0,0,595
S01012709,421,1,8,0,0,430
S01012710,598,1,6,0,0,605
S01012711,710,1,4,1,0,716
S01012712,666,0,28,0,1,695
S01012713,600,0,12,2,0,614
S01012714,514,0,2,0,0,516
S01012715,591,1,28,4,0,624
S01012716,723,0,15,0,1,739
S01012717,857,1,5,0,6,869
S01012718,842,1,19,2,4,868
S01012719,657,4,28,3,3,695
S01012720,429,0,27,1,7,464
S01012721,529,1,1,3,4,538
S01012722,609,0,17,5,0,631
S01012723,565,1,5,1,0,572
S01012724,614,1,12,4,0,631
S01012725,733,0,27,6,1,767
S01012726,504,1,11,3,0,519
S01012727,559,0,4,3,0,566
S01012728,567,0,1,2,2,572
S01012729,659,0,8,4,0,671
S01012730,451,0,0,0,0,451
S01012731,623,0,1,2,0,626
S01012732,547,0,1,2,0,550
S01012733,749,0,14,0,1,764
S01012734,407,3,14,0,1,425
S01012735,395,1,1,3,1,401
S01012736,724,1,9,4,1,739
S01012737,618,1,12,2,1,634
S01012738,494,1,11,0,0,506
S01012739,555,0,58,0,1,614
S01012740,590,0,32,2,0,624
S01012741,478,0,8,3,0,489
S01012742,581,0,10,1,1,593
S01012743,506,0,0,0,0,506
S01012744,567,0,5,1,2,575
S01012745,588,0,14,0,0,602
S01012746,621,0,8,0,1,630
S01012747,683,0,1,0,0,684
S01012748,627,1,12,8,0,648
S01012749,684,0,0,0,1,685
S01012750,611,0,1,2,1,615
S01012751,702,2,0,2,0,706
S01012752,660,1,6,3,0,670
S01012753,379,0,6,1,0,386
S01012754,471,3,2,0,0,476
S01012755,435,2,4,1,0,442
S01012756,456,0,0,4,0,460
S01012757,396,1,3,0,0,400
S01012758,487,1,5,6,0,499
S01012759,583,0,0,2,0,585
S01012760,776,0,6,2,0,784
S01012761,637,2,11,3,1,654
S01012762,603,0,5,0,1,609
S01012763,343,2,4,0,0,349
S01012764,619,0,1,3,0,623
S01012765,579,2,5,0,0,586
S01012766,681,1,5,5,1,693
S01012767,481,0,1,1,0,483
S01012768,616,0,0,0,0,616
S01012769,354,0,3,1,0,358
S01012770,688,1,7,2,0,698
S01012771,594,0,6,2,0,602
S01012772,541,1,1,0,1,544
S01012773,719,0,9,2,1,731
S01012774,734,1,7,2,1,745
S01012775,368,1,0,0,0,369
S01012776,631,2,2,1,1,637
S01012777,697,1,6,3,3,710
S01012778,534,1,8,0,0,543
S01012779,332,0,8,0,0,340
S01012780,549,2,14,2,0,567
S01012781,545,1,6,0,2,554
S01012782,501,0,3,0,5,509
S01012783,549,2,3,3,1,558
S01012784,615,4,8,1,1,629
S01012785,604,1,11,0,1,617
S01012786,586,1,2,0,0,589
S01012787,445,0,1,1,0,447
S01012788,485,1,9,0,0,495
S01012789,585,0,31,2,1,619
S01012790,488,4,11,3,1,507
S01012791,605,0,2,0,0,607
S01012792,863,2,4,3,0,872
S01012793,667,1,17,5,0,690
S01012794,510,0,35,0,6,551
S01012795,862,0,5,1,0,868
S01012796,599,0,7,3,2,611
S01012797,522,0,19,7,0,548
S01012798,566,2,24,0,1,593
S01012799,644,2,18,2,0,666
S01012800,717,2,12,3,0,734
S01012801,382,0,8,0,0,390
S01012802,445,0,38,3,0,486
S01012803,563,1,9,0,0,573
S01012804,617,1,6,0,0,624
S01012805,736,1,5,0,0,742
S01012806,575,1,7,0,0,583
S01012807,449,1,18,6,0,474
S01012808,867,1,5,0,0,873
S01012809,511,0,16,4,0,531
S01012810,780,1,3,1,1,786
S01012811,655,0,5,2,1,663
S01012812,549,1,6,0,1,557
S01012813,760,4,2,2,0,768
S01012814,625,3,7,4,1,640
S01012815,584,1,36,4,0,625
S01012816,403,0,23,8,0,434
S01012817,357,0,21,5,0,383
S01012818,585,0,39,3,0,627
S01012819,600,0,2,4,0,606
S01012820,708,0,63,5,2,778
S01012821,451,1,91,10,0,553
S01012822,356,0,4,4,1,365
S01012823,601,0,29,5,0,635
S01012824,505,2,11,2,1,521
S01012825,413,0,3,4,0,420
S01012826,425,2,4,8,0,439
S01012827,421,0,55,1,1,478
S01012828,444,0,16,0,2,462
S01012829,636,0,9,7,1,653
S01012830,553,0,10,2,0,565
S01012831,550,1,6,2,1,560
S01012832,433,0,2,1,0,436
S01012833,567,1,2,1,1,572
S01012834,556,1,2,2,0,561
S01012835,755,0,14,2,0,771
S01012836,483,2,42,0,0,527
S01012837,572,0,4,2,1,579
S01012838,685,0,16,4,3,708
S01012839,575,2,0,1,0,578
S01012840,553,0,31,0,0,584
S01012841,480,1,11,3,2,497
S01012842,394,0,13,0,0,407
S01012843,755,0,17,2,0,774
S01012844,549,1,11,0,0,561
S01012845,536,3,14,1,0,554
S01012846,789,4,12,2,0,807
S01012847,455,0,0,0,1,456
S01012848,554,0,21,5,2,582
S01012849,549,0,12,3,0,564
S01012850,617,0,4,2,0,623
S01012851,680,0,15,3,0,698
S01012852,576,1,12,3,0,592
S01012853,667,3,17,0,1,688
S01012854,686,0,8,1,0,695
S01012855,517,0,22,0,0,539
S01012856,595,2,5,3,3,608
S01012857,753,1,11,0,0,765
S01012858,608,0,10,2,1,621
S01012859,795,0,44,3,3,845
S01012860,944,1,2,1,0,948
S01012861,557,2,30,3,0,592
S01012862,478,0,39,2,0,519
S01012863,540,1,10,5,0,556
S01012864,630,0,17,13,0,660
S01012865,659,1,10,0,0,670
S01012866,607,0,30,1,0,638
S01012867,641,0,3,1,0,645
S01012868,497,0,2,1,1,501
S01012869,413,1,3,6,1,424
S01012870,796,0,8,2,0,806
S01012871,653,2,38,5,1,699
S01012872,528,0,36,10,3,577
S01012873,620,2,27,4,2,655
S01012874,628,0,9,1,0,638
S01012875,477,2,5,1,1,486
S01012876,650,1,12,0,2,665
S01012877,626,0,4,0,1,631
S01012878,763,4,4,2,1,774
S01012879,607,0,2,0,0,609
S01012880,740,2,15,1,1,759
S01012881,756,2,14,1,1,774
S01012882,484,0,9,1,0,494
S01012883,525,1,2,0,1,529
S01012884,450,0,0,0,1,451
S01012885,388,0,3,0,0,391
S01012886,629,3,14,3,2,651
S01012887,627,0,3,1,0,631
S01012888,688,0,1,3,2,694
S01012889,640,0,20,0,1,661
S01012890,537,1,8,2,1,549
S01012891,452,1,3,0,0,456
S01012892,908,0,11,6,5,930
S01012893,587,3,0,6,2,598
S01012894,586,0,14,6,0,606
S01012895,384,2,18,6,1,411
S01012896,755,2,3,1,0,761
S01012897,447,0,23,3,0,473
S01012898,383,0,18,0,0,401
S01012899,475,0,1,1,0,477
S01012900,605,2,5,5,1,618
S01012901,561,0,6,0,2,569
S01012902,623,2,3,1,0,629
S01012903,667,4,10,2,0,683
S01012904,623,0,8,0,2,633
S01012905,488,0,2,0,0,490
S01012906,778,1,4,0,0,783
S01012907,729,0,3,3,1,736
S01012908,599,1,3,0,0,603
S01012909,510,1,1,0,0,512
S01012910,770,1,2,0,1,774
S01012911,620,0,3,3,5,631
S01012912,575,0,3,2,0,580
S01012913,732,0,0,0,0,732
S01012914,699,1,8,1,2,711
S01012915,799,2,7,1,1,810
S01012916,558,0,12,1,1,572
S01012917,579,0,8,0,0,587
S01012918,417,0,0,0,0,417
S01012919,397,0,0,0,0,397
S01012920,501,1,3,1,0,506
S01012921,585,0,5,3,1,594
S01012922,782,1,0,0,1,784
S01012923,570,0,7,1,0,578
S01012924,416,1,5,0,0,422
S01012925,404,1,7,0,1,413
S01012926,581,0,6,1,5,593
S01012927,622,1,3,2,0,628
S01012928,660,0,10,0,5,675
S01012929,637,0,2,1,1,641
S01012930,752,1,22,2,2,779
S01012931,700,3,20,0,7,730
S01012932,416,0,6,0,1,423
S01012933,667,0,8,0,0,675
S01012934,599,2,4,0,0,605
S01012935,704,1,7,4,1,717
S01012936,592,1,24,0,2,619
S01012937,555,3,22,1,0,581
S01012938,570,1,29,0,0,600
S01012939,462,0,38,0,0,500
S01012940,548,4,24,3,0,579
S01012941,579,2,18,1,0,600
S01012942,621,1,0,1,1,624
S01012943,555,1,19,0,0,575
S01012944,416,1,1,0,0,418
S01012945,523,2,31,11,1,568
S01012946,663,1,25,1,1,691
S01012947,349,0,22,1,0,372
S01012948,566,3,2,0,1,572
S01012949,589,0,3,2,1,595
S01012950,653,1,21,2,1,678
S01012951,613,4,25,1,6,649
S01012952,497,3,19,4,2,525
S01012953,552,1,12,3,0,568
S01012954,388,0,2,1,1,392
S01012955,724,1,24,10,4,763
S01012956,831,2,13,3,2,851
S01012957,525,0,15,0,0,540
S01012958,433,0,1,0,1,435
S01012959,463,1,1,0,1,466
S01012960,497,1,4,0,0,502
S01012961,413,0,1,0,2,416
S01012962,539,3,11,2,0,555
S01012963,596,1,19,0,0,616
S01012964,425,1,22,1,0,449
S01012965,557,0,5,1,0,563
S01012966,581,1,11,0,0,593
S01012967,392,2,2,0,1,397
S01012968,507,1,3,5,1,517
S01012969,558,1,10,1,0,570
S01012970,487,0,1,1,0,489
S01012971,628,0,7,2,1,638
S01012972,607,0,2,0,3,612
S01012973,642,0,4,1,0,647
S01012974,878,4,0,1,1,884
S01012975,486,2,2,0,1,491
S01012976,418,1,2,0,6,427
S01012977,557,0,0,1,1,559
S01012978,636,4,7,0,0,647
S01012979,504,0,9,3,0,516
S01012980,517,1,8,0,1,527
S01012981,596,3,14,9,0,622
S01012982,655,3,4,0,0,662
S01012983,622,1,6,4,0,633
S01012984,509,2,11,8,0,530
S01012985,651,0,6,2,0,659
S01012986,613,1,8,3,1,626
S01012987,615,0,17,0,0,632
S01012988,730,2,9,1,2,744
S01012989,795,0,12,0,2,809
S01012990,507,0,9,0,0,516
S01012991,662,1,6,0,0,669
S01012992,647,1,11,0,0,659
S01012993,576,1,7,1,0,585
S01012994,735,0,25,0,0,760
S01012995,656,0,5,1,0,662
S01012996,548,0,2,0,0,550
S01012997,390,0,2,0,0,392
S01012998,829,1,5,2,0,837
S01012999,378,2,16,1,0,397
S01013000,537,2,7,3,0,549
S01013001,319,1,1,0,0,321
S01013002,402,0,3,0,0,405
S01013003,522,0,0,0,0,522
S01013004,532,1,0,0,0,533
S01013005,573,0,2,0,0,575
S01013006,492,1,7,2,1,503
S01013007,790,1,5,2,0,798
S01013008,605,1,8,1,1,616
S01013009,523,1,0,2,0,526
S01013010,478,0,3,0,0,481
S01013011,509,1,1,1,0,512
S01013012,529,3,5,2,1,540
S01013013,561,0,1,4,0,566
S01013014,599,3,4,0,1,607
S01013015,604,1,2,0,1,608
S01013016,493,2,2,0,0,497
S01013017,655,0,3,1,0,659
S01013018,762,4,2,1,1,770
S01013019,682,2,1,2,0,687
S01013020,405,0,0,0,0,405
S01013021,368,0,6,0,2,376
S01013022,322,0,2,0,0,324
S01013023,696,0,5,7,1,709
S01013024,421,0,0,0,1,422
S01013025,473,1,0,3,1,478
S01013026,793,0,14,3,2,812
S01013027,790,0,4,0,0,794
S01013028,388,0,3,2,0,393
S01013029,487,0,3,0,0,490
S01013030,480,0,0,1,0,481
S01013031,501,0,4,0,0,505
S01013032,557,0,8,4,2,571
S01013033,497,0,15,0,0,512
S01013034,573,1,2,0,0,576
S01013035,548,0,0,0,0,548
S01013036,604,0,1,0,0,605
S01013037,646,1,7,0,0,654
S01013038,803,0,5,3,0,811
S01013039,415,1,10,1,0,427
S01013040,541,1,2,0,0,544
S01013041,476,1,8,0,0,485
S01013042,638,0,12,0,0,650
S01013043,542,0,15,0,1,558
S01013044,635,1,9,1,3,649
S01013045,522,0,15,3,1,541
S01013046,416,1,4,0,0,421
S01013047,674,0,27,2,0,703
S01013048,667,0,11,4,2,684
S01013049,665,1,16,3,0,685
S01013050,632,1,14,2,0,649
S01013051,751,2,7,3,0,763
S01013052,631,2,4,0,0,637
S01013053,513,0,11,2,0,526
S01013054,575,0,1,1,0,577
S01013055,564,0,13,1,3,581
S01013056,750,4,19,0,1,774
S01013057,626,1,13,1,0,641
S01013058,397,2,20,1,0,420
S01013059,655,2,9,2,1,669
S01013060,435,1,11,1,1,449
S01013061,669,1,13,0,0,683
S01013062,720,1,25,0,0,746
S01013063,655,2,20,0,1,678
S01013064,704,1,6,3,0,714
S01013065,701,0,27,2,1,731
S01013066,593,2,13,4,2,614
S01013067,651,6,113,2,2,774
S01013068,609,2,43,1,4,659
S01013069,590,3,72,3,2,670
S01013070,466,4,78,8,5,561
S01013071,778,12,120,11,3,924
S01013072,431,0,0,2,0,433
S01013073,607,2,24,2,4,639
S01013074,512,1,10,0,3,526
S01013075,722,2,20,1,5,750
S01013076,534,6,102,10,0,652
S01013077,537,2,5,0,0,544
S01013078,427,1,5,3,0,436
S01013079,1032,2,27,9,16,1086
S01013080,690,4,38,1,5,738
S01013081,538,0,8,1,1,548
S01013082,719,3,9,2,3,736
S01013083,2042,20,104,32,9,2207
S01013084,607,2,14,1,0,624
S01013085,450,3,133,9,1,596
S01013086,691,6,43,2,18,760
S01013087,608,1,69,7,4,689
S01013088,756,2,13,1,1,773
S01013089,599,5,25,0,4,633
S01013090,624,3,57,2,2,688
S01013091,404,0,55,1,2,462
S01013092,699,3,36,1,2,741
S01013093,404,0,4,2,0,410
S01013094,476,1,0,0,0,477
S01013095,621,1,4,0,6,632
S01013096,436,1,6,3,2,448
S01013097,490,1,1,0,2,494
S01013098,416,2,2,0,1,421
S01013099,773,2,11,0,5,791
S01013100,487,0,5,0,3,495
S01013101,825,1,8,1,0,835
S01013102,495,0,4,0,2,501
S01013103,615,1,1,1,1,619
S01013104,778,3,9,1,4,795
S01013105,727,2,3,0,0,732
S01013106,657,0,1,0,1,659
S01013107,554,0,2,0,0,556
S01013108,475,0,2,1,0,478
S01013109,878,1,8,1,0,888
S01013110,483,1,3,1,0,488
S01013111,369,2,4,0,1,376
S01013112,484,0,0,5,0,489
S01013113,674,0,1,2,3,680
S01013114,666,0,8,2,0,676
S01013115,566,2,1,5,0,574
S01013116,681,0,1,0,0,682
S01013117,506,0,3,0,1,510
S01013118,449,2,2,1,0,454
S01013119,660,0,2,3,3,668
S01013120,822,1,6,2,1,832
S01013121,329,0,3,0,0,332
S01013122,470,1,4,5,1,481
S01013123,599,2,6,5,2,614
S01013124,590,0,7,0,0,597
S01013125,684,0,4,0,0,688
S01013126,571,0,7,2,0,580
S01013127,613,3,8,0,1,625
S01013128,544,2,6,2,5,559
S01013129,951,2,13,2,4,972
S01013130,516,1,16,8,0,541
S01013131,505,0,1,1,0,507
S01013132,472,1,6,2,0,481
S01013133,770,0,3,0,1,774
S01013134,659,0,8,1,1,669
S01013135,590,0,12,1,1,604
S01013136,775,0,12,0,0,787
S01013137,622,0,3,2,0,627
S01013138,505,0,6,5,1,517
S01013139,695,6,7,2,0,710
S01013140,664,0,6,1,1,672
S01013141,535,2,1,1,0,539
S01013142,739,1,7,3,0,750
S01013143,716,0,11,1,0,728
S01013144,776,0,4,0,2,782
S01013145,596,0,11,0,1,608
S01013146,369,0,0,0,0,369
S01013147,575,1,15,3,1,595
S01013148,639,1,9,0,0,649
S01013149,681,1,6,0,4,692
S01013150,719,1,8,0,1,729
S01013151,469,2,5,0,0,476
S01013152,735,0,0,1,0,736
S01013153,669,0,2,5,1,677
S01013154,769,3,0,10,1,783
S01013155,623,0,9,31,3,666
S01013156,636,1,3,7,0,647
S01013157,689,0,16,31,4,740
S01013158,492,0,3,0,0,495
S01013159,584,0,19,0,1,604
S01013160,580,0,1,0,0,581
S01013161,827,1,6,1,1,836
S01013162,698,1,2,3,0,704
S01013163,573,0,0,0,4,577
S01013164,852,0,3,2,1,858
S01013165,764,0,7,0,1,772
S01013166,524,0,6,1,0,531
S01013167,518,3,7,1,0,529
S01013168,740,1,11,8,0,760
S01013169,718,0,5,0,0,723
S01013170,434,0,3,0,0,437
S01013171,513,0,10,0,0,523
S01013172,604,0,7,0,2,613
S01013173,653,1,4,0,0,658
S01013174,624,0,1,0,0,625
S01013175,647,1,7,3,1,659
S01013176,695,1,2,3,1,702
S01013177,526,1,4,0,1,532
S01013178,621,0,1,0,1,623
S01013179,694,1,10,1,0,706
S01013180,352,0,8,0,0,360
S01013181,609,0,2,0,0,611
S01013182,630,0,3,0,0,633
S01013183,690,0,14,2,0,706
S01013184,437,0,2,0,0,439
S01013185,613,0,1,4,0,618
S01013186,517,0,5,0,0,522
S01013187,655,2,0,0,2,659
S01013188,724,3,4,0,2,733
S01013189,523,0,1,0,0,524
S01013190,646,0,5,0,1,652
S01013191,825,0,9,0,0,834
S01013192,806,1,12,0,0,819
S01013193,552,0,3,2,0,557
S01013194,492,1,2,0,0,495
S01013195,865,0,20,1,5,891
S01013196,559,1,3,0,0,563
S01013197,498,2,0,1,1,502
S01013198,697,1,2,1,0,701
S01013199,791,1,18,5,1,816
S01013200,579,1,17,0,0,597
S01013201,597,3,0,0,0,600
S01013202,461,0,5,0,0,466
S01013203,572,0,3,1,0,576
S01013204,619,2,12,0,0,633
S01013205,461,1,0,1,0,463
S01013206,511,2,2,3,1,519
S01013207,654,1,5,1,3,664
S01013208,739,0,0,2,0,741
S01013209,705,0,1,2,0,708
S01013210,504,0,8,0,0,512
S01013211,723,1,7,2,0,733
S01013212,460,0,6,7,0,473
S01013213,456,0,3,0,0,459
S01013214,347,0,1,0,0,348
S01013215,641,0,4,4,1,650
S01013216,449,1,1,0,0,451
S01013217,539,0,3,0,0,542
S01013218,449,0,0,3,3,455
S01013219,422,0,1,0,1,424
S01013220,523,1,0,0,0,524
S01013221,720,0,1,0,0,721
S01013222,464,0,8,1,4,477
S01013223,920,3,15,0,0,938
S01013224,673,1,0,0,0,674
S01013225,611,0,7,1,1,620
S01013226,399,1,2,0,0,402
S01013227,562,0,2,0,0,564
S01013228,602,0,3,1,0,606
S01013229,617,1,0,2,0,620
S01013230,558,0,4,0,1,563
S01013231,612,0,10,0,0,622
S01013232,596,2,4,0,1,603
S01013233,495,1,12,0,2,510
S01013234,304,0,7,0,0,311
S01013235,675,1,5,0,0,681
S01013236,752,1,9,0,1,763
S01013237,642,1,3,0,2,648
S01013238,621,1,5,0,0,627
S01013239,706,1,0,0,2,709
S01013240,422,3,1,7,0,433
S01013241,719,3,5,0,0,727
S01013242,508,1,0,0,0,509
S01013243,594,0,5,1,0,600
S01013244,608,1,5,0,3,617
S01013245,790,0,7,0,0,797
S01013246,366,0,0,0,0,366
S01013247,627,2,0,0,0,629
S01013248,510,0,1,0,0,511
S01013249,375,0,0,0,0,375
S01013250,691,2,11,1,0,705
S01013251,544,0,12,2,0,558
S01013252,540,0,6,0,0,546
S01013253,581,0,4,0,0,585
S01013254,489,5,4,0,1,499
S01013255,1171,0,24,5,0,1200
S01013256,600,1,2,0,1,604
S01013257,691,1,4,0,0,696
S01013258,629,1,3,4,1,638
S01013259,676,0,1,0,1,678
S01013260,671,1,2,3,0,677
S01013261,622,0,0,0,0,622
S01013262,526,0,2,1,0,529
S01013263,402,0,5,0,0,407
S01013264,373,0,5,2,1,381
S01013265,435,2,46,1,1,485
S01013266,412,0,11,2,0,425
S01013267,459,0,0,3,0,462
S01013268,639,4,12,2,0,657
S01013269,689,0,57,2,0,748
S01013270,585,3,19,2,2,611
S01013271,488,1,12,0,0,501
S01013272,533,1,30,0,1,565
S01013273,603,3,25,8,2,641
S01013274,671,0,12,3,0,686
S01013275,551,0,17,1,0,569
S01013276,496,0,2,2,1,501
S01013277,696,2,17,4,0,719
S01013278,686,2,10,4,2,704
S01013279,535,0,14,1,0,550
S01013280,441,1,12,1,1,456
S01013281,715,3,18,5,0,741
S01013282,616,0,11,2,0,629
S01013283,457,1,72,5,0,535
S01013284,535,1,2,0,0,538
S01013285,536,0,5,0,1,542
S01013286,549,0,7,0,0,556
S01013287,630,1,2,1,0,634
S01013288,539,2,2,0,1,544
S01013289,583,0,10,1,0,594
S01013290,682,1,5,1,3,692
S01013291,514,0,9,0,4,527
S01013292,617,1,2,0,0,620
S01013293,565,0,15,1,1,582
S01013294,580,3,10,6,0,599
S01013295,619,1,4,3,0,627
S01013296,594,1,1,0,1,597
S01013297,573,2,0,0,0,575
S01013298,579,0,2,0,0,581
S01013299,809,0,9,3,1,822
S01013300,477,2,6,0,0,485
S01013301,403,1,5,0,0,409
S01013302,506,0,9,0,0,515
S01013303,750,1,4,5,1,761
S01013304,733,1,9,3,1,747
S01013305,778,1,4,4,3,790
S01013306,747,0,5,4,0,756
S01013307,783,4,18,8,2,815
S01013308,694,1,11,2,1,709
S01013309,470,3,14,6,0,493
S01013310,495,2,9,0,0,506
S01013311,607,2,5,5,0,619
S01013312,816,1,16,0,0,833
S01013313,525,1,7,3,2,538
S01013314,520,0,14,3,0,537
S01013315,352,0,26,4,0,382
S01013316,533,2,10,1,2,548
S01013317,454,2,1,2,0,459
S01013318,463,0,14,3,0,480
S01013319,411,0,19,0,0,430
S01013320,681,3,38,10,1,733
S01013321,358,0,8,0,2,368
S01013322,615,1,24,0,2,642
S01013323,735,1,22,9,3,770
S01013324,469,3,25,2,1,500
S01013325,646,1,11,4,0,662
S01013326,416,1,10,2,0,429
S01013327,529,1,8,4,0,542
S01013328,462,1,15,1,1,480
S01013329,424,0,7,4,0,435
S01013330,798,1,17,2,1,819
S01013331,451,1,27,1,1,481
S01013332,521,0,11,2,2,536
S01013333,619,1,19,2,2,643
S01013334,563,1,4,0,2,570
S01013335,560,1,9,1,0,571
S01013336,649,2,2,7,0,660
S01013337,736,2,36,4,6,784
S01013338,327,1,59,1,0,388
S01013339,451,3,13,5,1,473
S01013340,668,1,22,4,0,695
S01013341,667,2,54,3,0,726
S01013342,505,0,9,2,0,516
S01013343,513,4,6,2,1,526
S01013344,646,0,8,0,0,654
S01013345,568,0,5,1,1,575
S01013346,584,4,25,3,5,621
S01013347,562,2,8,3,0,575
S01013348,326,1,14,2,0,343
S01013349,549,1,50,10,5,615
S01013350,540,2,4,4,1,551
S01013351,625,3,3,0,0,631
S01013352,698,3,12,1,1,715
S01013353,504,0,6,0,0,510
S01013354,582,0,3,3,1,589
S01013355,520,1,1,0,0,522
S01013356,567,2,12,0,2,583
S01013357,654,4,0,0,0,658
S01013358,673,0,4,0,0,677
S01013359,502,0,0,1,0,503
S01013360,571,1,1,0,0,573
S01013361,477,0,4,1,0,482
S01013362,386,0,1,0,2,389
S01013363,603,0,6,1,0,610
S01013364,711,0,7,0,1,719
S01013365,652,0,16,0,0,668
S01013366,694,0,4,0,1,699
S01013367,449,0,20,0,1,470
S01013368,634,1,4,0,0,639
S01013369,708,1,2,0,0,711
S01013370,499,0,0,0,0,499
S01013371,555,0,3,0,0,558
S01013372,831,0,6,5,1,843
S01013373,753,0,3,1,0,757
S01013374,740,0,4,3,0,747
S01013375,465,0,0,2,0,467
S01013376,473,0,7,0,0,480
S01013377,647,0,3,4,0,654
S01013378,775,1,11,0,1,788
S01013379,697,0,7,0,1,705
S01013380,126,0,0,0,0,126
S01013381,397,0,4,0,2,403
S01013382,428,1,13,3,1,446
S01013383,575,1,3,1,1,581
S01013384,611,2,6,0,0,619
S01013385,401,1,5,0,0,407
S01013386,688,0,0,0,1,689
S01013387,468,2,1,0,0,471
S01013388,634,1,4,0,0,639
S01013389,619,1,2,0,1,623
S01013390,382,0,0,0,0,382
S01013391,355,0,0,0,1,356
S01013392,541,0,3,5,0,549
S01013393,561,2,0,0,0,563
S01013394,527,1,2,2,2,534
S01013395,516,0,2,0,0,518
S01013396,494,1,6,0,0,501
S01013397,696,0,9,0,0,705
S01013398,431,0,12,3,0,446
S01013399,817,1,19,2,0,839
S01013400,527,0,3,5,2,537
S01013401,596,1,17,1,1,616
S01013402,737,1,19,11,1,769
S01013403,591,0,30,1,0,622
S01013404,402,0,13,6,1,422
S01013405,565,1,3,2,0,571
S01013406,502,1,2,0,0,505
S01013407,421,1,5,7,2,436
S01013408,518,0,0,0,1,519
S01013409,816,2,11,2,3,834
S01013410,479,0,5,2,0,486
S01013411,597,0,5,1,1,604
S01013412,652,4,5,0,0,661
S01013413,628,2,6,0,0,636
S01013414,751,0,10,5,0,766
S01013415,562,0,2,1,1,566
S01013416,482,1,6,1,1,491
S01013417,717,3,9,1,0,730
S01013418,506,0,4,0,0,510
S01013419,386,0,1,0,0,387
S01013420,467,1,0,0,0,468
S01013421,556,0,8,1,0,565
S01013422,588,0,1,2,0,591
S01013423,660,0,0,4,4,668
S01013424,377,0,7,0,2,386
S01013425,349,2,6,1,0,358
S01013426,667,0,1,1,2,671
S01013427,346,1,0,1,0,348
S01013428,734,0,5,0,0,739
S01013429,544,3,2,0,0,549
S01013430,548,0,2,2,0,552
S01013431,559,2,0,2,0,563
S01013432,584,0,6,1,0,591
S01013433,593,1,6,0,1,601
S01013434,411,3,4,3,0,421
S01013435,486,0,1,1,0,488
S01013436,651,4,3,2,2,662
S01013437,550,1,8,1,1,561
S01013438,463,0,6,0,0,469
S01013439,733,1,3,1,0,738
S01013440,820,1,3,1,2,827
S01013441,628,2,7,2,0,639
S01013442,623,0,6,2,2,633
S01013443,499,3,6,0,1,509
S01013444,806,2,6,0,0,814
S01013445,580,0,0,0,0,580
S01013446,566,3,9,0,0,578
S01013447,416,1,3,1,0,421
S01013448,679,2,1,1,5,688
S01013449,517,2,5,0,0,524
S01013450,462,1,6,1,0,470
S01013451,658,1,9,0,0,668
S01013452,595,2,8,1,0,606
S01013453,594,2,3,0,0,599
S01013454,595,0,3,2,0,600
S01013455,457,3,3,4,0,467
S01013456,645,0,1,1,2,649
S01013457,724,0,3,1,0,728
S01013458,582,1,3,2,0,588
S01013459,706,1,11,5,0,723
S01013460,644,1,1,7,0,653
S01013461,800,3,16,8,2,829
S01013462,657,2,17,3,2,681
S01013463,388,0,9,5,2,404
S01013464,606,0,11,1,2,620
S01013465,580,1,2,2,2,587
S01013466,398,2,1,0,0,401
S01013467,704,1,7,2,7,721
S01013468,574,1,9,1,1,586
S01013469,638,0,4,2,1,645
S01013470,572,1,2,1,1,577
S01013471,731,1,5,4,2,743
S01013472,437,1,30,1,0,469
S01013473,431,0,32,4,2,469
S01013474,436,1,20,2,6,465
S01013475,497,2,11,1,0,511
S01013476,529,0,6,1,2,538
S01013477,505,1,6,0,0,512
S01013478,654,1,6,4,6,671
S01013479,666,2,9,6,0,683
S01013480,563,1,1,1,0,566
S01013481,388,0,5,0,0,393
