areacode,owned_mortage,owned_outright,private_rented,social_rented,total
E01000001,312,530,449,59,1350
E01000002,352,485,387,69,1293
E01000003,218,241,285,402,1146
E01000005,33,36,199,553,821
E01000006,536,307,433,29,1305
E01000007,245,43,445,325,1058
E01000008,161,58,191,632,1042
E01000009,407,271,585,199,1462
E01000010,436,122,1124,507,2189
E01000011,447,240,494,82,1263
E01000012,315,84,645,282,1326
E01000013,388,222,185,450,1245
E01000014,411,214,179,415,1219
E01000015,587,144,354,485,1570
E01000016,501,168,162,385,1216
E01000017,492,142,152,405,1191
E01000018,505,152,132,379,1168
E01000019,393,208,189,240,1030
E01000020,560,178,195,363,1296
E01000021,441,131,331,293,1196
E01000022,387,163,160,254,964
E01000023,297,103,248,233,881
E01000024,394,149,155,261,959
E01000025,454,190,165,409,1218
E01000027,407,188,98,527,1220
E01000028,303,98,166,536,1103
E01000029,483,584,136,111,1314
E01000030,311,164,143,718,1336
E01000031,633,362,206,63,1264
E01000032,499,331,259,188,1277
E01000033,323,153,74,448,998
E01000034,391,146,109,388,1034
E01000035,474,329,192,175,1170
E01000036,552,287,174,40,1053
E01000037,737,434,75,37,1283
E01000038,483,430,105,139,1157
E01000039,618,363,170,116,1267
E01000040,329,139,170,555,1193
E01000041,482,186,156,392,1216
E01000042,328,86,255,599,1268
E01000043,416,145,139,304,1004
E01000044,522,271,399,143,1335
E01000045,381,139,239,431,1190
E01000046,500,204,138,436,1278
E01000048,75,16,157,881,1129
E01000049,196,97,156,722,1171
E01000050,340,190,315,370,1215
E01000051,192,29,150,899,1270
E01000052,567,244,352,323,1486
E01000053,346,115,296,361,1118
E01000054,445,214,184,422,1265
E01000055,488,156,147,370,1161
E01000056,372,120,166,436,1094
E01000057,408,125,139,387,1059
E01000058,556,150,262,394,1362
E01000059,449,160,138,383,1130
E01000060,460,215,125,510,1310
E01000061,135,21,56,920,1132
E01000062,541,331,192,400,1464
E01000063,492,220,117,372,1201
E01000064,489,284,225,382,1380
E01000065,444,187,211,504,1346
E01000066,708,280,186,266,1440
E01000067,729,373,231,184,1517
E01000068,569,360,289,25,1243
E01000069,800,378,153,17,1348
E01000070,759,486,251,62,1558
E01000071,834,356,374,148,1712
E01000072,399,139,329,574,1441
E01000073,481,167,191,343,1182
E01000074,384,144,168,433,1129
E01000075,525,234,164,377,1300
E01000076,464,158,219,536,1377
E01000077,401,132,187,376,1096
E01000078,449,151,189,432,1221
E01000079,405,193,168,369,1135
E01000080,467,167,161,364,1159
E01000081,548,196,172,354,1270
E01000082,489,139,159,439,1226
E01000083,445,198,177,423,1243
E01000084,316,123,158,393,990
E01000085,332,165,228,506,1231
E01000086,411,142,123,376,1052
E01000087,369,128,189,315,1001
E01000088,560,276,312,115,1263
E01000089,618,268,248,80,1214
E01000090,466,296,297,69,1128
E01000091,305,124,186,553,1168
E01000092,733,242,407,543,1925
E01000093,296,71,183,565,1115
E01000094,367,91,253,215,926
E01000095,477,106,224,303,1110
E01000096,252,87,154,743,1236
E01000097,404,177,198,493,1272
E01000098,426,171,244,435,1276
E01000099,504,217,170,392,1283
E01000100,468,186,162,380,1196
E01000101,433,185,150,380,1148
E01000102,455,168,136,398,1157
E01000103,453,145,224,419,1241
E01000104,288,164,148,680,1280
E01000105,372,166,204,835,1577
E01000106,316,183,335,639,1473
E01000107,548,371,171,157,1247
E01000108,503,322,281,123,1229
E01000109,608,294,208,158,1268
E01000110,597,355,128,29,1109
E01000111,554,261,244,335,1394
E01000112,648,310,413,96,1467
E01000113,572,305,335,63,1275
E01000114,687,391,321,150,1549
E01000115,564,517,89,8,1178
E01000116,652,454,178,51,1335
E01000117,650,602,231,19,1502
E01000118,736,546,187,43,1512
E01000119,596,531,174,53,1354
E01000120,550,510,129,2,1191
E01000121,309,176,74,458,1017
E01000122,619,381,148,17,1165
E01000123,699,347,247,56,1349
E01000124,395,232,355,297,1279
E01000125,610,186,653,568,2017
E01000126,390,116,367,671,1544
E01000127,385,122,204,432,1143
E01000128,435,265,302,375,1377
E01000129,329,120,446,419,1314
E01000130,468,133,207,408,1216
E01000131,466,352,473,131,1422
E01000132,332,141,204,395,1072
E01000133,359,167,176,513,1215
E01000134,393,174,351,335,1253
E01000135,377,446,380,19,1222
E01000136,271,562,335,6,1174
E01000137,252,177,334,470,1233
E01000138,312,342,428,69,1151
E01000139,300,402,425,52,1179
E01000140,262,296,685,131,1374
E01000141,323,175,934,254,1686
E01000142,482,328,915,103,1828
E01000143,188,151,281,399,1019
E01000144,211,277,773,23,1284
E01000145,342,299,427,6,1074
E01000146,211,305,857,86,1459
E01000147,523,508,394,24,1449
E01000148,372,253,412,455,1492
E01000150,590,485,406,178,1659
E01000151,184,51,123,801,1159
E01000152,176,49,132,778,1135
E01000153,174,90,122,771,1157
E01000154,217,82,258,473,1030
E01000155,302,132,893,160,1487
E01000156,521,332,569,89,1511
E01000157,458,271,347,159,1235
E01000158,451,285,238,169,1143
E01000159,590,443,202,157,1392
E01000160,709,315,596,52,1672
E01000161,487,288,582,124,1481
E01000162,512,366,231,85,1194
E01000163,353,118,385,385,1241
E01000164,368,168,347,406,1289
E01000165,564,360,488,67,1479
E01000166,501,403,205,147,1256
E01000167,458,204,61,329,1052
E01000168,567,559,127,18,1271
E01000169,530,340,287,50,1207
E01000170,498,327,218,235,1278
E01000171,486,225,626,92,1429
E01000172,553,485,193,54,1285
E01000173,660,454,153,77,1344
E01000174,517,279,439,133,1368
E01000175,584,462,181,29,1256
E01000176,300,165,173,648,1286
E01000177,460,360,483,54,1357
E01000178,455,441,352,162,1410
E01000179,553,261,490,40,1344
E01000180,297,284,378,367,1326
E01000181,427,388,545,41,1401
E01000182,374,408,615,34,1431
E01000183,375,342,323,71,1111
E01000184,244,138,166,513,1061
E01000185,194,66,306,590,1156
E01000186,606,421,103,42,1172
E01000187,475,330,204,222,1231
E01000188,606,470,146,16,1238
E01000189,169,67,214,846,1296
E01000190,536,444,139,85,1204
E01000191,501,501,181,13,1196
E01000192,441,441,538,49,1469
E01000193,538,395,388,42,1363
E01000194,386,337,563,31,1317
E01000195,487,143,339,372,1341
E01000196,238,363,954,40,1595
E01000197,445,339,676,35,1495
E01000198,678,383,361,6,1428
E01000199,439,578,267,9,1293
E01000200,417,590,489,58,1554
E01000201,459,545,211,15,1230
E01000202,514,430,393,45,1382
E01000203,345,327,350,254,1276
E01000204,493,447,390,105,1435
E01000205,526,430,189,15,1160
E01000206,295,568,274,28,1165
E01000207,337,505,339,65,1246
E01000208,402,530,324,24,1280
E01000209,381,594,196,107,1278
E01000210,458,362,336,15,1171
E01000211,310,310,1016,70,1706
E01000212,255,500,367,16,1138
E01000213,358,492,123,77,1050
E01000214,382,387,613,8,1390
E01000215,324,427,598,85,1434
E01000216,403,385,570,68,1426
E01000217,397,424,394,9,1224
E01000218,254,348,657,22,1281
E01000219,308,271,715,30,1324
E01000220,233,250,718,95,1296
E01000221,142,97,174,528,941
E01000222,329,338,377,162,1206
E01000223,293,147,226,326,992
E01000224,389,379,432,17,1217
E01000225,419,325,271,118,1133
E01000226,471,176,197,474,1318
E01000227,619,474,254,40,1387
E01000228,545,310,119,115,1089
E01000229,527,240,233,273,1273
E01000230,593,540,231,33,1397
E01000231,672,372,290,59,1393
E01000232,609,459,249,123,1440
E01000233,672,407,258,57,1394
E01000234,531,397,374,40,1342
E01000235,424,225,242,381,1272
E01000236,318,334,599,91,1342
E01000237,359,385,903,24,1671
E01000238,477,288,565,75,1405
E01000239,457,239,783,146,1625
E01000240,544,324,435,52,1355
E01000241,472,414,475,74,1435
E01000242,420,355,296,173,1244
E01000243,372,343,810,68,1593
E01000244,345,308,510,121,1284
E01000245,234,202,556,577,1569
E01000246,478,535,186,40,1239
E01000247,597,392,304,69,1362
E01000248,584,383,245,66,1278
E01000249,592,506,104,13,1215
E01000250,689,478,466,155,1788
E01000251,512,342,500,186,1540
E01000252,504,324,303,199,1330
E01000253,518,652,122,13,1305
E01000254,568,443,159,19,1189
E01000255,418,305,203,262,1188
E01000256,704,405,250,54,1413
E01000257,217,213,405,547,1382
E01000258,511,477,302,35,1325
E01000259,829,546,514,124,2013
E01000260,640,354,439,95,1528
E01000261,448,487,171,95,1201
E01000262,577,426,311,340,1654
E01000263,613,480,70,13,1176
E01000264,426,337,458,71,1292
E01000265,578,328,457,127,1490
E01000266,622,508,79,13,1222
E01000267,579,464,183,19,1245
E01000268,410,337,550,35,1332
E01000269,546,435,129,44,1154
E01000270,505,448,216,45,1214
E01000271,451,536,200,20,1207
E01000272,442,483,109,18,1052
E01000273,362,382,320,189,1253
E01000274,579,338,244,281,1442
E01000275,459,383,345,98,1285
E01000276,524,454,194,0,1172
E01000277,248,263,466,315,1292
E01000278,416,484,209,18,1127
E01000279,460,572,126,18,1176
E01000280,431,579,106,18,1134
E01000281,165,159,437,153,914
E01000282,520,510,299,33,1362
E01000283,463,506,120,23,1112
E01000284,398,336,435,203,1372
E01000285,520,355,112,197,1184
E01000286,460,265,161,343,1229
E01000287,502,229,94,417,1242
E01000288,560,363,146,142,1211
E01000289,306,154,122,740,1322
E01000290,486,510,93,199,1288
E01000291,286,203,97,576,1162
E01000292,438,479,217,80,1214
E01000293,592,525,229,15,1361
E01000294,488,333,223,193,1237
E01000295,409,428,540,41,1418
E01000296,344,314,716,65,1439
E01000297,381,345,374,89,1189
E01000298,384,329,703,78,1494
E01000299,404,257,767,59,1487
E01000300,531,353,347,108,1339
E01000301,413,407,323,7,1150
E01000302,285,270,708,186,1449
E01000303,428,428,289,32,1177
E01000304,449,275,497,61,1282
E01000305,250,351,483,262,1346
E01000306,401,461,478,65,1405
E01000307,431,330,345,217,1323
E01000308,179,156,166,688,1189
E01000309,444,386,575,56,1461
E01000310,369,431,777,108,1685
E01000311,392,407,305,11,1115
E01000312,427,180,421,272,1300
E01000313,387,275,703,138,1503
E01000314,356,420,731,32,1539
E01000315,374,220,112,597,1303
E01000316,617,368,630,221,1836
E01000317,426,344,425,105,1300
E01000318,610,515,243,92,1460
E01000319,492,340,256,101,1189
E01000320,446,470,238,59,1213
E01000321,452,250,565,75,1342
E01000322,430,314,543,115,1402
E01000323,423,357,767,58,1605
E01000324,609,415,273,90,1387
E01000325,655,568,57,13,1293
E01000326,648,271,90,13,1022
E01000327,623,530,63,49,1265
E01000328,611,461,53,77,1202
E01000329,450,349,87,168,1054
E01000330,551,424,184,154,1313
E01000331,510,326,82,348,1266
E01000332,526,488,142,101,1257
E01000333,520,312,237,249,1318
E01000334,640,459,138,61,1298
E01000335,504,229,277,279,1289
E01000336,465,169,319,458,1411
E01000337,642,295,214,135,1286
E01000338,655,321,336,48,1360
E01000339,556,387,66,225,1234
E01000340,614,491,106,16,1227
E01000341,606,515,61,22,1204
E01000342,745,428,112,7,1292
E01000343,681,401,114,8,1204
E01000344,658,465,142,19,1284
E01000345,640,372,61,6,1079
E01000346,758,453,60,12,1283
E01000347,634,378,130,50,1192
E01000348,715,435,28,8,1186
E01000349,698,541,73,26,1338
E01000350,615,467,104,19,1205
E01000351,691,520,89,8,1308
E01000352,654,385,158,70,1267
E01000353,668,715,26,14,1423
E01000354,537,363,76,242,1218
E01000355,595,575,49,14,1233
E01000356,557,622,120,11,1310
E01000357,632,431,48,19,1130
E01000358,619,589,110,26,1344
E01000359,542,431,60,8,1041
E01000360,574,316,348,18,1256
E01000361,652,388,129,68,1237
E01000362,557,533,83,54,1227
E01000363,591,499,108,8,1206
E01000364,593,521,124,65,1303
E01000365,590,474,200,53,1317
E01000366,664,419,165,36,1284
E01000367,499,303,86,316,1204
E01000368,463,175,78,451,1167
E01000369,716,439,84,79,1318
E01000370,622,505,91,82,1300
E01000371,733,422,86,26,1267
E01000372,533,261,77,388,1259
E01000373,155,49,79,779,1062
E01000374,454,151,50,423,1078
E01000375,556,260,95,237,1148
E01000376,636,327,107,107,1177
E01000377,589,440,96,65,1190
E01000378,806,371,298,216,1691
E01000379,642,335,91,217,1285
E01000380,457,154,119,471,1201
E01000381,534,290,95,300,1219
E01000382,598,530,61,50,1239
E01000383,545,496,71,139,1251
E01000384,646,417,228,136,1427
E01000385,461,232,155,527,1375
E01000386,303,171,156,492,1122
E01000387,572,523,75,86,1256
E01000388,622,576,63,18,1279
E01000389,622,511,131,117,1381
E01000390,548,411,55,55,1069
E01000391,741,427,99,98,1365
E01000392,472,230,287,273,1262
E01000393,729,405,147,24,1305
E01000394,515,485,145,42,1187
E01000395,647,479,54,1,1181
E01000396,655,433,48,0,1136
E01000398,544,377,109,233,1263
E01000399,611,496,127,59,1293
E01000400,630,415,124,77,1246
E01000401,531,298,173,248,1250
E01000402,467,253,193,280,1193
E01000403,579,311,179,580,1649
E01000404,471,92,629,413,1605
E01000405,507,192,195,118,1012
E01000406,643,282,244,61,1230
E01000407,458,548,107,111,1224
E01000408,637,257,277,70,1241
E01000409,767,501,67,13,1348
E01000410,717,436,105,6,1264
E01000411,659,391,76,11,1137
E01000412,786,405,130,3,1324
E01000413,612,325,99,11,1047
E01000414,604,451,292,33,1380
E01000415,670,509,45,12,1236
E01000416,427,240,229,219,1115
E01000417,533,437,169,219,1358
E01000418,627,331,259,272,1489
E01000419,595,542,58,15,1210
E01000420,635,516,94,43,1288
E01000421,570,621,35,5,1231
E01000422,169,86,118,866,1239
E01000423,698,535,62,14,1309
E01000424,684,542,136,49,1411
E01000425,697,560,29,13,1299
E01000426,656,378,238,83,1355
E01000427,603,618,163,230,1614
E01000428,291,316,295,512,1414
E01000429,371,72,369,380,1192
E01000430,689,180,173,257,1299
E01000431,365,138,141,565,1209
E01000432,527,273,136,309,1245
E01000433,471,202,155,485,1313
E01000434,285,103,81,646,1115
E01000435,437,255,107,286,1085
E01000436,701,555,91,24,1371
E01000437,581,352,54,65,1052
E01000438,709,367,157,25,1258
E01000439,508,249,164,126,1047
E01000440,587,511,47,23,1168
E01000441,509,260,130,329,1228
E01000442,624,510,73,82,1289
E01000443,510,305,68,138,1021
E01000444,585,642,106,9,1342
E01000445,584,665,122,5,1376
E01000446,766,375,102,12,1255
E01000447,558,365,230,94,1247
E01000448,521,533,24,10,1088
E01000449,523,595,90,31,1239
E01000450,693,383,80,216,1372
E01000451,851,409,65,15,1340
E01000452,691,335,39,16,1081
E01000453,675,389,74,10,1148
E01000454,681,357,77,165,1280
E01000455,720,508,106,16,1350
E01000456,612,427,41,18,1098
E01000457,466,431,520,55,1472
E01000458,481,567,127,61,1236
E01000459,444,517,239,195,1395
E01000460,574,457,92,11,1134
E01000461,738,531,88,12,1369
E01000462,453,391,373,96,1313
E01000463,583,351,65,4,1003
E01000464,334,140,149,470,1093
E01000465,267,101,168,673,1209
E01000466,395,126,185,482,1188
E01000467,515,115,285,261,1176
E01000468,936,145,544,202,1827
E01000469,604,191,296,164,1255
E01000470,134,94,138,681,1047
E01000471,596,276,335,102,1309
E01000472,304,154,610,50,1118
E01000473,443,371,649,106,1569
E01000474,636,331,362,246,1575
E01000475,531,335,538,205,1609
E01000476,508,430,321,94,1353
E01000477,495,251,586,140,1472
E01000478,476,385,375,105,1341
E01000479,594,442,259,25,1320
E01000480,582,430,396,26,1434
E01000481,250,192,490,301,1233
E01000482,342,177,681,887,2087
E01000483,256,119,422,496,1293
E01000484,222,105,153,454,934
E01000485,347,205,307,270,1129
E01000486,475,394,444,39,1352
E01000487,412,352,647,124,1535
E01000488,312,253,435,222,1222
E01000489,358,345,360,239,1302
E01000490,269,162,755,203,1389
E01000491,431,357,497,291,1576
E01000492,388,358,248,98,1092
E01000493,447,500,314,81,1342
E01000494,315,287,629,227,1458
E01000495,264,155,556,422,1397
E01000497,479,325,390,210,1404
E01000498,357,432,243,160,1192
E01000499,305,343,431,195,1274
E01000501,330,194,277,574,1375
E01000502,366,232,269,153,1020
E01000503,371,422,478,310,1581
E01000504,328,273,588,233,1422
E01000505,256,409,395,268,1328
E01000506,243,153,635,271,1302
E01000507,332,428,417,172,1349
E01000508,233,190,477,574,1474
E01000509,316,395,375,83,1169
E01000510,317,290,589,102,1298
E01000511,349,252,529,89,1219
E01000512,388,371,525,142,1426
E01000513,474,366,371,53,1264
E01000514,459,309,346,63,1177
E01000515,331,166,435,406,1338
E01000516,481,389,447,49,1366
E01000517,400,512,379,32,1323
E01000518,466,325,292,217,1300
E01000519,454,279,544,209,1486
E01000520,414,348,382,132,1276
E01000521,204,180,693,560,1637
E01000522,300,184,325,594,1403
E01000523,380,208,809,562,1959
E01000524,240,107,745,741,1833
E01000525,236,133,508,614,1491
E01000526,231,109,247,1043,1630
E01000527,292,232,601,450,1575
E01000528,127,47,134,803,1111
E01000530,464,484,419,160,1527
E01000531,334,274,720,368,1696
E01000532,338,257,355,438,1388
E01000533,288,180,653,630,1751
E01000534,505,314,385,196,1400
E01000535,474,257,721,285,1737
E01000536,477,515,292,28,1312
E01000538,586,480,175,6,1247
E01000539,527,495,233,50,1305
E01000540,523,523,188,11,1245
E01000541,400,289,388,68,1145
E01000543,369,461,388,98,1316
E01000544,178,59,301,839,1377
E01000545,252,165,865,316,1598
E01000546,268,242,663,221,1394
E01000547,318,260,567,344,1489
E01000548,311,144,873,472,1800
E01000549,460,274,649,230,1613
E01000550,211,96,385,887,1579
E01000551,134,63,151,1243,1591
E01000552,69,29,118,1125,1341
E01000553,292,369,851,199,1711
E01000554,371,270,618,204,1463
E01000555,332,369,440,80,1221
E01000556,104,207,979,276,1566
E01000557,267,210,948,154,1579
E01000558,301,238,510,216,1265
E01000559,264,144,581,271,1260
E01000560,283,243,695,187,1408
E01000561,249,204,606,439,1498
E01000562,530,499,149,91,1269
E01000563,588,495,143,30,1256
E01000564,409,231,531,60,1231
E01000565,423,293,266,195,1177
E01000566,528,459,242,28,1257
E01000567,416,313,254,114,1097
E01000568,238,253,455,452,1398
E01000569,607,469,194,21,1291
E01000570,433,290,328,196,1247
E01000571,499,404,417,26,1346
E01000572,432,392,309,45,1178
E01000573,438,404,371,44,1257
E01000574,378,331,319,47,1075
E01000575,447,319,662,73,1501
E01000576,440,415,441,74,1370
E01000577,327,92,723,553,1695
E01000578,413,378,530,165,1486
E01000579,373,292,463,276,1404
E01000580,451,416,451,247,1565
E01000581,298,305,413,207,1223
E01000582,416,384,493,168,1461
E01000583,410,280,864,364,1918
E01000584,444,404,395,143,1386
E01000585,397,360,466,238,1461
E01000586,374,177,1133,377,2061
E01000587,501,481,306,33,1321
E01000588,510,377,305,464,1656
E01000589,516,554,338,117,1525
E01000590,531,522,328,72,1453
E01000591,476,476,588,156,1696
E01000592,458,406,310,160,1334
E01000593,610,364,369,324,1667
E01000594,441,400,435,76,1352
E01000595,192,162,264,554,1172
E01000596,163,100,253,700,1216
E01000599,121,11,101,750,983
E01000600,185,65,346,882,1478
E01000601,137,73,193,599,1002
E01000602,230,197,123,573,1123
E01000603,267,122,360,330,1079
E01000604,224,55,103,904,1286
E01000605,150,102,86,866,1204
E01000606,471,328,433,105,1337
E01000607,655,391,660,48,1754
E01000608,496,269,734,268,1767
E01000609,553,348,542,170,1613
E01000610,418,314,565,179,1476
E01000611,295,229,408,228,1160
E01000612,455,274,412,199,1340
E01000613,333,164,622,196,1315
E01000615,324,266,596,98,1284
E01000616,337,332,686,106,1461
E01000617,428,408,499,114,1449
E01000618,461,438,286,104,1289
E01000619,434,550,272,77,1333
E01000620,393,506,411,50,1360
E01000621,441,420,529,49,1439
E01000622,332,202,575,151,1260
E01000623,478,486,394,56,1414
E01000624,547,441,322,41,1351
E01000625,365,332,369,119,1185
E01000626,169,53,257,633,1112
E01000627,296,247,485,415,1443
E01000628,416,308,489,232,1445
E01000629,612,462,436,53,1563
E01000630,429,280,596,507,1812
E01000631,510,495,518,39,1562
E01000632,502,593,598,35,1728
E01000633,365,406,776,96,1643
E01000634,559,262,766,227,1814
E01000635,530,294,833,286,1943
E01000636,464,484,491,67,1506
E01000637,254,225,643,258,1380
E01000638,181,189,854,298,1522
E01000639,242,204,897,165,1508
E01000640,220,207,1016,236,1679
E01000641,233,190,756,337,1516
E01000642,274,147,1035,325,1781
E01000643,310,126,328,861,1625
E01000644,303,302,652,315,1572
E01000645,549,518,58,7,1132
E01000646,516,375,332,70,1293
E01000647,690,327,156,56,1229
E01000648,725,387,164,30,1306
E01000649,676,617,162,74,1529
E01000650,647,573,112,164,1496
E01000651,552,406,129,103,1190
E01000652,647,567,78,34,1326
E01000653,431,590,98,99,1218
E01000654,615,329,51,10,1005
E01000655,611,317,64,32,1024
E01000656,673,416,48,13,1150
E01000657,671,374,107,131,1283
E01000658,479,604,56,19,1158
E01000659,742,358,36,18,1154
E01000661,300,152,101,636,1189
E01000662,669,348,84,283,1384
E01000663,572,321,63,302,1258
E01000664,545,368,68,272,1253
E01000665,709,476,180,82,1447
E01000666,622,762,148,10,1542
E01000667,611,633,48,12,1304
E01000668,636,298,265,84,1283
E01000669,700,342,205,60,1307
E01000670,555,523,413,97,1588
E01000671,623,393,289,121,1426
E01000672,552,406,199,33,1190
E01000673,600,389,153,84,1226
E01000674,527,288,293,197,1305
E01000675,507,378,379,48,1312
E01000676,361,232,546,294,1433
E01000677,655,272,394,53,1374
E01000678,630,408,222,77,1337
E01000679,727,359,158,24,1268
E01000680,565,617,123,31,1336
E01000681,752,544,48,6,1350
E01000682,575,590,70,4,1239
E01000683,647,385,129,109,1270
E01000684,863,581,114,20,1578
E01000685,614,370,91,164,1239
E01000686,556,528,69,102,1255
E01000687,590,582,116,26,1314
E01000688,549,471,56,26,1102
E01000689,439,272,167,218,1096
E01000690,638,363,69,49,1119
E01000691,525,306,119,192,1142
E01000692,593,411,211,39,1254
E01000693,370,466,152,60,1048
E01000694,539,675,59,14,1287
E01000695,563,488,111,41,1203
E01000696,473,591,128,7,1199
E01000697,619,443,278,24,1364
E01000698,444,516,30,11,1001
E01000699,466,173,288,209,1136
E01000700,657,201,154,189,1201
E01000701,584,241,158,95,1078
E01000702,534,277,196,83,1090
E01000703,572,285,301,99,1257
E01000704,635,288,151,56,1130
E01000705,482,208,175,166,1031
E01000706,527,253,131,145,1056
E01000707,665,291,88,17,1061
E01000708,623,367,172,65,1227
E01000709,358,328,288,186,1160
E01000710,511,395,395,93,1394
E01000711,428,352,575,181,1536
E01000712,516,456,437,39,1448
E01000713,579,449,385,53,1466
E01000714,506,371,684,78,1639
E01000715,555,500,338,57,1450
E01000716,482,504,213,53,1252
E01000717,516,424,403,85,1428
E01000718,527,259,328,491,1605
E01000719,633,278,192,336,1439
E01000720,442,196,142,400,1180
E01000721,293,95,61,507,956
E01000722,596,336,197,162,1291
E01000723,453,550,61,22,1086
E01000724,377,157,68,643,1245
E01000725,457,262,193,357,1269
E01000726,467,441,136,34,1078
E01000727,548,470,147,115,1280
E01000728,468,400,137,182,1187
E01000729,356,197,74,709,1336
E01000730,345,139,75,654,1213
E01000731,455,274,53,253,1035
E01000732,582,415,55,135,1187
E01000733,592,370,74,234,1270
E01000734,513,347,79,100,1039
E01000735,433,230,77,382,1122
E01000736,578,277,50,295,1200
E01000737,414,258,67,297,1036
E01000738,573,370,98,164,1205
E01000739,329,187,68,530,1114
E01000740,370,92,609,301,1372
E01000741,348,116,346,512,1322
E01000742,494,138,578,413,1623
E01000743,302,85,336,616,1339
E01000744,225,103,132,681,1141
E01000745,456,157,463,330,1406
E01000746,516,224,489,300,1529
E01000747,656,536,219,80,1491
E01000748,577,667,95,26,1365
E01000749,576,589,71,76,1312
E01000750,299,231,51,633,1214
E01000751,727,572,142,86,1527
E01000752,460,689,102,91,1342
E01000753,605,756,107,10,1478
E01000754,599,583,145,20,1347
E01000755,591,533,79,14,1217
E01000756,567,586,80,25,1258
E01000757,560,647,39,9,1255
E01000758,580,534,62,46,1222
E01000759,668,487,55,11,1221
E01000760,572,429,123,18,1142
E01000761,696,464,50,6,1216
E01000762,596,541,197,31,1365
E01000763,636,465,38,8,1147
E01000764,619,456,53,151,1279
E01000765,637,497,182,37,1353
E01000766,712,611,28,6,1357
E01000767,674,541,54,5,1274
E01000768,503,525,131,74,1233
E01000769,526,321,43,141,1031
E01000770,408,575,239,9,1231
E01000771,647,510,103,26,1286
E01000772,484,590,159,46,1279
E01000773,595,407,83,116,1201
E01000774,617,393,108,46,1164
E01000775,923,559,188,62,1732
E01000777,660,439,102,18,1219
E01000778,688,352,70,118,1228
E01000779,427,367,148,78,1020
E01000780,439,316,127,287,1169
E01000781,353,126,94,499,1072
E01000782,313,141,131,509,1094
E01000783,417,150,136,407,1110
E01000784,646,314,114,88,1162
E01000785,414,227,67,366,1074
E01000786,431,724,41,47,1243
E01000787,500,422,78,190,1190
E01000788,547,427,89,179,1242
E01000789,229,80,75,790,1174
E01000790,620,461,381,149,1611
E01000791,541,539,64,69,1213
E01000792,344,417,59,106,926
E01000793,622,641,55,23,1341
E01000794,529,696,51,20,1296
E01000795,484,343,51,220,1098
E01000796,168,51,98,877,1194
E01000797,586,378,169,140,1273
E01000798,208,96,223,626,1153
E01000799,539,253,321,207,1320
E01000800,357,171,354,381,1263
E01000801,466,275,181,214,1136
E01000802,561,246,287,293,1387
E01000803,487,247,281,260,1275
E01000804,566,427,117,43,1153
E01000805,479,257,253,236,1225
E01000806,268,83,427,527,1305
E01000807,506,503,177,25,1211
E01000808,616,524,67,61,1268
E01000809,606,554,62,12,1234
E01000810,565,606,59,4,1234
E01000811,536,384,157,9,1086
E01000812,552,489,133,99,1273
E01000813,591,643,73,6,1313
E01000814,644,598,48,0,1290
E01000815,584,610,33,5,1232
E01000816,612,398,100,90,1200
E01000818,604,474,58,51,1187
E01000819,483,254,157,420,1314
E01000820,405,308,204,176,1093
E01000822,508,318,274,178,1278
E01000823,620,303,339,90,1352
E01000824,440,194,208,109,951
E01000825,474,306,369,135,1284
E01000826,670,571,42,0,1283
E01000827,513,596,249,52,1410
E01000828,534,448,205,137,1324
E01000829,579,411,300,85,1375
E01000830,563,625,34,5,1227
E01000831,519,564,192,92,1367
E01000832,571,530,87,7,1195
E01000833,607,449,37,7,1100
E01000834,680,302,46,8,1036
E01000835,546,412,249,39,1246
E01000836,648,397,40,8,1093
E01000837,542,454,140,76,1212
E01000838,551,525,65,12,1153
E01000839,590,539,69,6,1204
E01000840,544,594,26,186,1350
E01000841,610,558,88,12,1268
E01000842,229,369,469,114,1181
E01000843,210,331,562,267,1370
E01000844,310,334,750,89,1483
E01000845,258,309,490,179,1236
E01000846,143,179,189,613,1124
E01000847,205,211,340,500,1256
E01000848,287,416,551,102,1356
E01000849,265,346,655,106,1372
E01000850,115,164,717,204,1200
E01000851,173,211,913,214,1511
E01000852,58,173,462,240,933
E01000853,126,120,283,819,1348
E01000854,146,144,694,442,1426
E01000855,226,337,855,245,1663
E01000856,135,132,393,634,1294
E01000857,220,309,371,297,1197
E01000858,148,113,382,860,1503
E01000859,317,395,492,143,1347
E01000860,123,242,302,477,1144
E01000861,193,157,596,438,1384
E01000862,350,507,514,94,1465
E01000863,144,184,692,218,1238
E01000864,254,218,510,349,1331
E01000865,201,181,258,200,840
E01000866,303,277,435,702,1717
E01000867,185,81,496,539,1301
E01000868,110,72,149,718,1049
E01000869,322,276,788,407,1793
E01000870,297,187,323,617,1424
E01000871,383,420,342,196,1341
E01000872,283,169,994,216,1662
E01000873,340,368,492,186,1386
E01000874,388,357,559,28,1332
E01000875,265,178,789,218,1450
E01000876,241,118,467,601,1427
E01000877,326,239,642,121,1328
E01000878,233,349,356,116,1054
E01000879,218,332,413,104,1067
E01000880,292,343,477,56,1168
E01000881,134,252,637,151,1174
E01000882,271,371,589,37,1268
E01000883,170,244,649,74,1137
E01000884,313,438,333,41,1125
E01000885,185,502,342,94,1123
E01000886,361,330,305,177,1173
E01000887,304,263,468,221,1256
E01000888,287,300,353,339,1279
E01000889,155,79,173,897,1304
E01000890,102,34,149,1021,1306
E01000891,109,64,253,767,1193
E01000892,293,335,437,416,1481
E01000893,294,526,427,54,1301
E01000894,233,459,394,37,1123
E01000895,183,315,578,302,1378
E01000896,293,564,488,46,1391
E01000897,287,489,476,31,1283
E01000898,132,229,482,588,1431
E01000899,304,621,331,23,1279
E01000900,261,195,395,623,1474
E01000901,185,61,209,863,1318
E01000902,113,94,214,681,1102
E01000903,211,273,343,399,1226
E01000904,233,172,460,874,1739
E01000905,118,24,231,1116,1489
E01000906,267,370,550,193,1380
E01000907,228,164,168,575,1135
E01000908,256,200,199,634,1289
E01000909,330,540,291,209,1370
E01000910,273,509,267,172,1221
E01000911,298,292,212,429,1231
E01000912,226,188,264,651,1329
E01000913,403,680,300,27,1410
E01000914,209,243,833,332,1617
E01000915,108,95,298,733,1234
E01000916,232,184,516,551,1483
E01000917,103,44,266,1044,1457
E01000918,211,199,642,629,1681
E01000919,257,135,578,524,1494
E01000920,208,204,716,549,1677
E01000921,308,204,822,355,1689
E01000922,194,159,467,492,1312
E01000923,302,278,249,377,1206
E01000924,298,287,515,336,1436
E01000925,162,82,223,695,1162
E01000926,186,135,807,409,1537
E01000927,350,366,480,294,1490
E01000928,307,281,284,444,1316
E01000929,148,123,277,712,1260
E01000930,174,104,639,669,1586
E01000931,228,79,588,686,1581
E01000932,301,267,687,402,1657
E01000933,303,236,708,245,1492
E01000934,191,97,368,577,1233
E01000935,89,63,205,690,1047
E01000936,106,113,257,572,1048
E01000937,63,102,396,253,814
E01000938,73,69,669,553,1364
E01000939,61,38,267,555,921
E01000940,47,36,244,606,933
E01000941,57,43,150,723,973
E01000942,117,181,550,232,1080
E01000943,97,115,456,226,894
E01000944,113,100,714,700,1627
E01000945,125,94,546,460,1225
E01000946,137,280,468,376,1261
E01000947,210,179,928,419,1736
E01000948,237,315,489,419,1460
E01000949,61,60,175,971,1267
E01000950,88,62,247,703,1100
E01000951,123,87,319,689,1218
E01000952,119,81,393,809,1402
E01000953,163,83,287,816,1349
E01000954,48,76,165,905,1194
E01000955,52,14,174,923,1163
E01000956,86,44,361,696,1187
E01000957,254,119,539,523,1435
E01000958,262,77,601,767,1707
E01000959,139,98,346,793,1376
E01000960,236,271,713,254,1474
E01000961,178,217,373,460,1228
E01000962,318,267,712,79,1376
E01000963,208,346,881,132,1567
E01000964,260,185,453,411,1309
E01000965,284,250,535,246,1315
E01000966,324,346,577,45,1292
E01000967,233,405,377,134,1149
E01000968,263,251,599,222,1335
E01000969,377,320,1016,78,1791
E01000970,330,207,734,91,1362
E01000971,321,331,448,137,1237
E01000972,126,144,674,732,1676
E01000973,233,143,792,484,1652
E01000974,235,141,569,541,1486
E01000975,434,270,558,76,1338
E01000976,429,244,661,178,1512
E01000977,382,202,554,288,1426
E01000978,433,182,757,139,1511
E01000979,446,266,627,84,1423
E01000980,532,219,189,150,1090
E01000981,683,259,215,101,1258
E01000982,531,248,359,122,1260
E01000983,665,349,288,79,1381
E01000984,447,178,427,370,1422
E01000985,576,462,84,61,1183
E01000986,603,497,215,77,1392
E01000987,661,443,76,12,1192
E01000989,784,369,107,63,1323
E01000990,269,134,72,581,1056
E01000991,710,570,82,32,1394
E01000992,527,213,145,545,1430
E01000993,619,370,212,88,1289
E01000994,568,336,271,48,1223
E01000995,439,308,443,57,1247
E01000996,520,274,204,13,1011
E01000997,451,273,258,59,1041
E01000998,401,218,453,155,1227
E01000999,437,350,241,54,1082
E01001000,390,209,318,62,979
E01001001,353,152,246,147,898
E01001002,467,194,298,76,1035
E01001003,394,213,319,194,1120
E01001004,581,168,440,326,1515
E01001005,505,194,440,71,1210
E01001006,401,131,255,287,1074
E01001007,666,296,341,165,1468
E01001008,388,187,239,366,1180
E01001009,509,199,424,196,1328
E01001010,345,183,140,429,1097
E01001011,428,143,550,318,1439
E01001012,319,194,725,226,1464
E01001013,252,102,494,685,1533
E01001014,713,181,550,574,2018
E01001015,432,267,83,319,1101
E01001016,655,517,96,93,1361
E01001017,692,535,65,24,1316
E01001018,644,513,78,33,1268
E01001019,581,556,62,57,1256
E01001020,707,457,82,65,1311
E01001021,345,179,73,441,1038
E01001022,580,555,47,29,1211
E01001023,447,241,273,82,1043
E01001024,625,371,90,38,1124
E01001025,572,380,47,27,1026
E01001026,760,375,67,143,1345
E01001027,665,383,100,49,1197
E01001028,700,490,79,26,1295
E01001029,533,425,209,42,1209
E01001030,599,410,79,12,1100
E01001031,652,440,79,4,1175
E01001032,480,568,79,4,1131
E01001033,577,329,301,76,1283
E01001034,594,263,323,43,1223
E01001035,402,218,655,123,1398
E01001036,444,520,216,38,1218
E01001037,423,145,306,208,1082
E01001038,536,175,627,183,1521
E01001039,543,487,135,36,1201
E01001040,599,259,406,90,1354
E01001041,450,177,464,154,1245
E01001042,389,136,599,324,1448
E01001043,497,160,1054,363,2074
E01001044,455,518,506,71,1550
E01001045,350,161,721,215,1447
E01001046,334,365,715,13,1427
E01001047,472,148,666,138,1424
E01001048,310,127,871,212,1520
E01001049,438,567,149,20,1174
E01001050,219,215,464,416,1314
E01001051,227,115,48,705,1095
E01001052,227,117,54,563,961
E01001053,405,241,38,417,1101
E01001054,383,231,88,570,1272
E01001055,327,220,76,601,1224
E01001056,199,82,53,812,1146
E01001057,108,39,45,917,1109
E01001058,559,355,80,42,1036
E01001059,544,327,236,48,1155
E01001060,678,304,162,97,1241
E01001061,552,230,206,216,1204
E01001062,613,534,112,37,1296
E01001063,644,468,133,28,1273
E01001064,630,563,102,30,1325
E01001065,540,389,208,27,1164
E01001066,275,128,83,480,966
E01001067,701,512,79,5,1297
E01001068,676,407,143,270,1496
E01001069,575,310,84,55,1024
E01001070,619,389,83,237,1328
E01001071,767,402,99,187,1455
E01001072,549,534,61,7,1151
E01001073,525,330,226,92,1173
E01001074,680,267,341,235,1523
E01001075,607,269,200,80,1156
E01001076,446,213,164,340,1163
E01001077,583,350,73,107,1113
E01001078,310,204,59,457,1030
E01001079,407,221,102,509,1239
E01001080,186,89,66,825,1166
E01001081,408,188,70,392,1058
E01001082,464,214,55,453,1186
E01001083,604,504,151,31,1290
E01001084,619,556,234,44,1453
E01001085,434,331,388,123,1276
E01001086,687,416,266,54,1423
E01001087,569,340,639,231,1779
E01001088,559,277,232,209,1277
E01001089,456,235,450,263,1404
E01001090,559,263,548,371,1741
E01001091,572,383,289,33,1277
E01001092,542,440,207,54,1243
E01001093,683,368,210,82,1343
E01001094,564,549,102,16,1231
E01001095,592,185,309,62,1148
E01001096,611,491,107,30,1239
E01001097,580,319,673,176,1748
E01001098,640,433,69,10,1152
E01001099,544,243,150,202,1139
E01001100,537,375,210,50,1172
E01001101,627,462,46,10,1145
E01001102,515,546,100,65,1226
E01001103,629,574,71,73,1347
E01001104,758,459,71,44,1332
E01001105,651,348,62,259,1320
E01001106,581,356,109,122,1168
E01001107,568,553,176,26,1323
E01001108,676,613,54,35,1378
E01001109,437,164,432,404,1437
E01001110,325,117,589,318,1349
E01001111,543,250,264,163,1220
E01001112,351,152,323,453,1279
E01001113,470,197,478,212,1357
E01001114,288,110,251,359,1008
E01001115,413,116,278,450,1257
E01001116,455,147,289,130,1021
E01001117,690,215,755,362,2022
E01001118,392,186,384,481,1443
E01001119,624,478,55,61,1218
E01001120,631,325,66,4,1026
E01001121,528,516,36,39,1119
E01001122,620,433,106,12,1171
E01001123,626,576,48,18,1268
E01001124,579,672,50,16,1317
E01001125,688,463,195,19,1365
E01001126,606,456,78,34,1174
E01001127,706,492,46,81,1325
E01001128,290,165,76,594,1125
E01001129,685,458,40,9,1192
E01001130,150,59,82,812,1103
E01001131,673,310,109,162,1254
E01001132,548,603,82,61,1294
E01001133,518,661,85,74,1338
E01001134,684,427,157,81,1349
E01001135,669,558,107,33,1367
E01001136,416,169,686,187,1458
E01001137,464,361,393,210,1428
E01001138,464,274,319,204,1261
E01001139,629,276,307,66,1278
E01001140,598,223,322,115,1258
E01001141,314,100,266,276,956
E01001142,569,327,211,74,1181
E01001143,563,195,340,386,1484
E01001144,429,144,428,298,1299
E01001145,233,97,382,553,1265
E01001146,613,262,246,126,1247
E01001147,416,165,285,285,1151
E01001148,564,261,256,141,1222
E01001149,581,241,252,78,1152
E01001150,689,270,226,52,1237
E01001151,374,166,259,379,1178
E01001152,369,198,463,188,1218
E01001153,585,275,252,129,1241
E01001154,501,236,410,263,1410
E01001155,317,141,320,498,1276
E01001156,438,219,228,380,1265
E01001157,673,353,191,130,1347
E01001158,501,199,302,189,1191
E01001159,563,446,334,106,1449
E01001160,769,505,230,34,1538
E01001161,437,171,156,631,1395
E01001162,453,184,252,405,1294
E01001163,765,341,309,116,1531
E01001164,441,187,647,285,1560
E01001165,621,258,334,91,1304
E01001166,438,153,479,332,1402
E01001167,791,358,326,225,1700
E01001168,648,314,345,94,1401
E01001169,382,216,102,540,1240
E01001170,420,222,670,265,1577
E01001171,359,192,265,338,1154
E01001172,371,105,90,668,1234
E01001173,669,363,469,466,1967
E01001174,499,382,257,88,1226
E01001175,481,255,306,70,1112
E01001176,541,308,359,169,1377
E01001177,474,155,227,336,1192
E01001178,183,100,422,262,967
E01001179,516,272,302,61,1151
E01001180,550,215,401,82,1248
E01001181,406,127,381,429,1343
E01001182,415,341,313,23,1092
E01001183,418,314,409,88,1229
E01001184,490,332,194,50,1066
E01001185,597,252,323,120,1292
E01001186,521,210,402,237,1370
E01001187,647,237,332,267,1483
E01001188,514,264,306,266,1350
E01001189,525,193,110,107,935
E01001190,581,215,134,237,1167
E01001191,431,183,585,180,1379
E01001192,447,167,362,240,1216
E01001193,476,102,67,605,1250
E01001194,677,198,222,99,1196
E01001195,410,406,607,46,1469
E01001196,238,246,425,459,1368
E01001197,295,261,553,192,1301
E01001198,359,264,441,112,1176
E01001199,339,175,516,315,1345
E01001200,409,311,415,102,1237
E01001201,408,231,438,174,1251
E01001202,315,166,666,480,1627
E01001203,333,102,629,406,1470
E01001204,488,398,254,143,1283
E01001205,264,176,319,439,1198
E01001206,174,109,201,680,1164
E01001207,501,252,466,100,1319
E01001208,489,397,99,42,1027
E01001209,586,432,281,14,1313
E01001210,247,167,241,639,1294
E01001211,458,349,414,104,1325
E01001212,415,452,381,35,1283
E01001213,553,421,306,182,1462
E01001214,466,556,362,59,1443
E01001215,416,437,387,164,1404
E01001216,423,398,316,89,1226
E01001217,581,363,236,37,1217
E01001218,342,274,383,457,1456
E01001219,395,143,231,679,1448
E01001220,121,104,146,690,1061
E01001221,292,161,1056,183,1692
E01001222,505,217,1059,221,2002
E01001223,279,341,517,68,1205
E01001224,452,491,289,41,1273
E01001225,327,343,614,218,1502
E01001226,249,294,617,107,1267
E01001227,392,395,353,67,1207
E01001228,333,378,664,105,1480
E01001229,350,240,233,392,1215
E01001230,342,276,470,82,1170
E01001231,486,480,542,69,1577
E01001232,426,266,324,245,1261
E01001233,335,227,401,247,1210
E01001234,269,201,625,111,1206
E01001235,297,189,751,57,1294
E01001236,250,265,654,173,1342
E01001237,330,300,564,65,1259
E01001238,536,170,1284,435,2425
E01001239,242,146,436,392,1216
E01001240,296,274,509,234,1313
E01001241,257,291,525,162,1235
E01001242,255,281,343,232,1111
E01001243,327,178,430,360,1295
E01001244,402,241,799,608,2050
E01001245,597,280,546,161,1584
E01001246,299,184,331,241,1055
E01001247,329,413,930,115,1787
E01001248,494,303,261,200,1258
E01001249,307,101,703,701,1812
E01001250,411,220,603,422,1656
E01001251,568,310,400,56,1334
E01001252,411,258,686,184,1539
E01001253,489,265,429,131,1314
E01001254,606,271,286,177,1340
E01001255,596,329,272,70,1267
E01001257,308,104,177,662,1251
E01001258,574,354,310,113,1351
E01001259,487,278,349,49,1163
E01001260,603,410,451,67,1531
E01001261,510,277,717,231,1735
E01001262,432,208,187,337,1164
E01001263,449,190,257,385,1281
E01001264,459,324,213,257,1253
E01001265,464,258,454,138,1314
E01001266,607,439,419,40,1505
E01001267,504,227,387,386,1504
E01001268,561,468,292,35,1356
E01001269,584,383,518,57,1542
E01001270,662,346,301,60,1369
E01001271,625,302,388,101,1416
E01001272,436,327,468,60,1291
E01001273,357,490,467,15,1329
E01001274,286,301,556,66,1209
E01001275,252,352,758,218,1580
E01001276,430,311,666,28,1435
E01001277,358,368,759,52,1537
E01001278,379,375,777,66,1597
E01001279,449,553,178,16,1196
E01001280,425,338,640,33,1436
E01001281,465,415,287,21,1188
E01001282,387,139,196,486,1208
E01001283,368,213,209,472,1262
E01001284,527,460,220,48,1255
E01001285,477,238,244,277,1236
E01001286,473,241,263,279,1256
E01001287,252,176,159,469,1056
E01001288,458,275,307,107,1147
E01001289,479,241,220,98,1038
E01001290,429,342,551,177,1499
E01001291,611,315,299,57,1282
E01001292,591,443,306,38,1378
E01001293,543,320,327,73,1263
E01001294,701,471,283,71,1526
E01001295,673,471,267,40,1451
E01001296,509,340,207,122,1178
E01001297,495,483,367,92,1437
E01001298,496,482,354,121,1453
E01001299,517,597,327,23,1464
E01001300,552,333,385,28,1298
E01001301,367,200,584,159,1310
E01001302,488,367,381,55,1291
E01001303,420,372,475,44,1311
E01001304,478,218,476,166,1338
E01001305,605,482,254,34,1375
E01001306,493,460,338,31,1322
E01001307,610,433,446,14,1503
E01001308,606,607,471,15,1699
E01001309,690,365,331,53,1439
E01001310,639,306,355,101,1401
E01001311,554,188,355,406,1503
E01001312,484,409,494,83,1470
E01001313,551,388,403,42,1384
E01001314,527,347,371,19,1264
E01001315,568,197,219,141,1125
E01001316,310,187,257,420,1174
E01001317,570,224,307,304,1405
E01001318,448,204,227,455,1334
E01001319,532,306,237,91,1166
E01001320,289,102,112,557,1060
E01001321,572,412,313,287,1584
E01001322,521,336,430,68,1355
E01001323,460,319,544,88,1411
E01001324,413,182,415,171,1181
E01001325,609,276,113,324,1322
E01001326,435,188,257,397,1277
E01001327,535,247,274,338,1394
E01001328,367,229,237,432,1265
E01001329,497,282,256,278,1313
E01001330,331,99,210,563,1203
E01001331,276,91,260,528,1155
E01001332,335,92,220,488,1135
E01001333,299,337,465,303,1404
E01001334,276,208,178,548,1210
E01001335,687,469,166,97,1419
E01001336,458,313,238,269,1278
E01001337,256,236,144,465,1101
E01001338,386,496,420,214,1516
E01001339,418,208,133,587,1346
E01001340,231,46,265,489,1031
E01001341,478,357,485,37,1357
E01001342,602,317,528,23,1470
E01001343,483,395,319,22,1219
E01001344,610,385,545,185,1725
E01001345,547,287,325,147,1306
E01001346,651,418,378,36,1483
E01001347,492,360,375,38,1265
E01001348,422,331,491,45,1289
E01001349,344,247,215,332,1138
E01001350,329,312,444,135,1220
E01001351,352,192,677,320,1541
E01001352,314,246,547,120,1227
E01001353,252,168,586,350,1356
E01001354,392,345,644,84,1465
E01001355,410,195,525,285,1415
E01001356,145,97,242,940,1424
E01001357,226,61,156,382,825
E01001358,123,48,162,783,1116
E01001359,605,421,514,154,1694
E01001360,498,565,445,53,1561
E01001361,303,256,460,282,1301
E01001362,518,463,432,131,1544
E01001363,419,388,344,124,1275
E01001364,378,300,200,463,1341
E01001365,597,574,478,73,1722
E01001366,476,364,488,143,1471
E01001367,327,277,615,171,1390
E01001368,492,352,300,184,1328
E01001369,451,346,526,153,1476
E01001370,558,389,496,134,1577
E01001371,438,395,495,218,1546
E01001372,478,258,476,163,1375
E01001373,466,249,345,92,1152
E01001374,529,307,480,164,1480
E01001375,502,434,392,15,1343
E01001376,352,209,490,283,1334
E01001377,438,501,353,108,1400
E01001379,589,371,350,42,1352
E01001380,474,346,540,114,1474
E01001381,389,267,645,111,1412
E01001382,487,478,208,29,1202
E01001383,580,352,455,87,1474
E01001384,501,287,536,57,1381
E01001385,495,374,466,31,1366
E01001386,514,395,446,82,1437
E01001387,370,240,525,104,1239
E01001388,351,159,347,458,1315
E01001389,433,247,591,141,1412
E01001390,533,409,695,33,1670
E01001391,330,245,646,86,1307
E01001392,546,517,403,56,1522
E01001393,522,412,750,103,1787
E01001394,389,369,449,156,1363
E01001395,350,210,208,431,1199
E01001396,343,461,356,39,1199
E01001397,587,353,478,128,1546
E01001398,603,406,79,17,1105
E01001399,662,429,69,18,1178
E01001400,502,646,105,17,1270
E01001401,552,361,78,47,1038
E01001402,685,526,277,20,1508
E01001403,548,529,174,47,1298
E01001404,502,414,162,91,1169
E01001405,467,547,351,79,1444
E01001406,524,264,314,158,1260
E01001407,630,326,170,136,1262
E01001408,700,323,187,99,1309
E01001409,563,235,381,246,1425
E01001410,350,142,237,512,1241
E01001411,667,383,214,138,1402
E01001412,533,440,224,264,1461
E01001413,578,532,96,75,1281
E01001414,319,169,143,573,1204
E01001415,394,448,366,130,1338
E01001416,715,609,74,26,1424
E01001417,623,581,98,29,1331
E01001418,463,479,261,165,1368
E01001419,539,503,534,96,1672
E01001420,381,296,296,266,1239
E01001421,330,277,411,317,1335
E01001422,614,605,85,4,1308
E01001423,500,229,302,293,1324
E01001424,133,52,237,449,871
E01001425,287,151,400,461,1299
E01001426,447,178,309,410,1344
E01001427,236,151,237,655,1279
E01001428,441,173,227,403,1244
E01001429,282,41,260,1199,1782
E01001430,277,56,253,660,1246
E01001431,274,123,383,341,1121
E01001432,468,257,469,213,1407
E01001433,425,139,195,528,1287
E01001434,572,299,194,113,1178
E01001435,562,313,167,70,1112
E01001436,602,433,250,117,1402
E01001437,486,265,390,602,1743
E01001438,468,282,239,253,1242
E01001439,384,194,483,372,1433
E01001440,510,297,210,246,1263
E01001441,413,224,171,332,1140
E01001442,252,174,261,432,1119
E01001444,643,373,218,87,1321
E01001445,735,237,484,222,1678
E01001446,624,324,275,151,1374
E01001447,411,234,316,513,1474
E01001448,544,246,303,261,1354
E01001449,493,242,196,230,1161
E01001450,444,394,603,121,1562
E01001451,519,581,189,40,1329
E01001452,560,423,87,23,1093
E01001453,568,621,138,49,1376
E01001454,551,547,197,10,1305
E01001455,645,470,116,22,1253
E01001456,533,471,76,2,1082
E01001457,473,510,361,24,1368
E01001458,305,110,319,532,1266
E01001459,534,418,255,73,1280
E01001460,308,208,530,154,1200
E01001461,286,151,432,394,1263
E01001462,332,213,287,189,1021
E01001463,494,344,224,156,1218
E01001464,387,153,134,330,1004
E01001465,541,366,205,74,1186
E01001466,455,261,436,119,1271
E01001467,553,289,389,136,1367
E01001468,365,313,188,127,993
E01001469,526,374,159,231,1290
E01001470,526,609,120,54,1309
E01001471,573,495,395,31,1494
E01001472,560,441,325,86,1412
E01001473,499,384,107,226,1216
E01001474,617,578,319,23,1537
E01001475,645,619,96,20,1380
E01001476,528,321,299,123,1271
E01001477,448,259,235,388,1330
E01001478,529,329,153,172,1183
E01001479,443,279,396,147,1265
E01001480,480,285,322,100,1187
E01001481,542,369,234,112,1257
E01001482,424,324,309,317,1374
E01001483,230,123,390,165,908
E01001484,458,357,199,29,1043
E01001485,361,283,360,315,1319
E01001486,417,193,306,604,1520
E01001487,479,308,382,230,1399
E01001488,524,281,413,146,1364
E01001489,508,318,340,164,1330
E01001491,409,308,440,292,1449
E01001492,534,391,313,211,1449
E01001493,461,306,278,376,1421
E01001494,568,473,159,20,1220
E01001495,510,357,547,28,1442
E01001496,620,501,225,28,1374
E01001497,511,358,223,56,1148
E01001498,514,322,711,48,1595
E01001499,569,509,211,59,1348
E01001500,409,391,349,57,1206
E01001501,461,278,564,181,1484
E01001502,460,312,285,244,1301
E01001503,555,353,307,171,1386
E01001504,493,320,220,120,1153
E01001505,516,236,302,246,1300
E01001506,390,192,307,261,1150
E01001507,385,223,480,328,1416
E01001508,506,243,458,235,1442
E01001509,461,226,415,196,1298
E01001510,83,34,129,735,981
E01001511,660,358,239,43,1300
E01001512,631,300,355,91,1377
E01001513,509,188,216,392,1305
E01001514,584,267,264,255,1370
E01001515,362,132,324,572,1390
E01001516,511,290,224,335,1360
E01001517,327,88,240,677,1332
E01001518,636,347,379,49,1411
E01001519,423,372,1199,92,2086
E01001520,469,422,295,175,1361
E01001521,523,411,437,63,1434
E01001522,572,234,368,135,1309
E01001523,592,543,246,38,1419
E01001524,388,409,202,210,1209
E01001525,467,429,464,64,1424
E01001526,546,562,191,22,1321
E01001527,460,399,355,102,1316
E01001528,252,169,212,496,1129
E01001529,224,152,553,285,1214
E01001530,323,327,309,99,1058
E01001531,537,447,194,1,1179
E01001532,666,513,247,19,1445
E01001533,575,563,98,14,1250
E01001534,442,480,362,45,1329
E01001535,465,518,194,47,1224
E01001536,517,455,335,100,1407
E01001537,620,309,340,51,1320
E01001538,669,533,62,43,1307
E01001539,598,497,166,54,1315
E01001540,609,371,423,40,1443
E01001541,640,307,180,43,1170
E01001542,494,286,220,217,1217
E01001543,682,495,101,29,1307
E01001544,598,577,104,23,1302
E01001545,357,111,184,658,1310
E01001546,563,363,221,201,1348
E01001547,557,390,257,156,1360
E01001548,526,274,247,291,1338
E01001549,417,154,452,351,1374
E01001550,489,227,141,343,1200
E01001551,387,295,143,478,1303
E01001552,631,448,189,122,1390
E01001553,355,137,214,440,1146
E01001554,221,86,237,779,1323
E01001555,489,258,454,142,1343
E01001556,532,445,211,71,1259
E01001557,425,221,275,225,1146
E01001558,309,128,320,355,1112
E01001559,480,257,488,244,1469
E01001560,408,327,260,247,1242
E01001562,138,37,397,660,1232
E01001563,516,315,431,37,1299
E01001564,576,408,245,55,1284
E01001565,552,377,285,138,1352
E01001566,581,402,307,18,1308
E01001567,560,549,137,30,1276
E01001568,606,572,84,34,1296
E01001569,477,355,518,88,1438
E01001570,584,363,329,150,1426
E01001571,598,268,243,147,1256
E01001572,554,265,313,149,1281
E01001573,551,309,191,105,1156
E01001574,274,120,178,676,1248
E01001575,294,172,145,577,1188
E01001576,276,121,141,656,1194
E01001577,365,192,190,573,1320
E01001578,516,196,434,421,1567
E01001579,390,172,146,507,1215
E01001580,413,287,607,120,1427
E01001581,421,218,348,451,1438
E01001582,360,307,217,260,1144
E01001583,433,301,434,208,1376
E01001584,340,392,353,135,1220
E01001585,475,299,230,199,1203
E01001586,264,258,249,401,1172
E01001587,539,392,394,263,1588
E01001588,366,168,209,540,1283
E01001589,381,141,270,506,1298
E01001590,461,295,380,309,1445
E01001591,280,114,257,880,1531
E01001592,590,250,320,228,1388
E01001593,545,356,258,183,1342
E01001594,256,76,222,854,1408
E01001595,354,207,161,689,1411
E01001596,655,497,99,33,1284
E01001597,504,392,188,179,1263
E01001598,636,456,140,113,1345
E01001599,610,387,134,230,1361
E01001600,598,322,249,119,1288
E01001601,608,373,129,89,1199
E01001602,480,248,94,633,1455
E01001603,358,146,75,731,1310
E01001604,555,369,128,118,1170
E01001605,696,515,55,22,1288
E01001606,749,409,103,32,1293
E01001607,508,336,90,259,1193
E01001608,554,439,72,114,1179
E01001609,463,392,216,259,1330
E01001610,659,391,137,179,1366
E01001611,530,337,115,381,1363
E01001613,441,345,254,297,1337
E01001614,592,532,66,36,1226
E01001615,370,319,388,215,1292
E01001617,591,478,198,88,1355
E01001618,512,329,108,303,1252
E01001619,692,336,318,172,1518
E01001620,426,150,105,537,1218
E01001621,420,175,135,476,1206
E01001623,475,130,207,516,1328
E01001624,429,268,73,484,1254
E01001625,383,157,85,634,1259
E01001629,276,87,430,844,1637
E01001631,159,92,323,930,1504
E01001632,414,310,882,207,1813
E01001633,243,113,251,600,1207
E01001634,174,35,126,865,1200
E01001635,469,229,408,210,1316
E01001636,359,223,598,216,1396
E01001637,351,241,428,354,1374
E01001638,225,63,358,787,1433
E01001640,167,50,473,938,1628
E01001641,365,209,425,376,1375
E01001642,461,403,351,212,1427
E01001644,552,216,748,362,1878
E01001645,530,282,143,408,1363
E01001646,656,121,736,668,2181
E01001647,486,354,139,227,1206
E01001648,641,289,221,264,1415
E01001649,458,197,135,406,1196
E01001650,498,224,172,473,1367
E01001651,377,205,186,581,1349
E01001652,514,286,270,215,1285
E01001653,321,64,81,690,1156
E01001654,302,195,104,537,1138
E01001655,237,101,103,679,1120
E01001656,296,276,141,329,1042
E01001657,403,413,228,158,1202
E01001658,455,334,256,210,1255
E01001659,479,376,169,176,1200
E01001660,349,240,119,505,1213
E01001661,447,232,95,423,1197
E01001662,447,209,479,240,1375
E01001664,347,241,569,441,1598
E01001665,528,212,558,252,1550
E01001666,342,151,414,307,1214
E01001667,189,82,282,722,1275
E01001668,349,163,394,891,1797
E01001669,508,254,217,435,1414
E01001671,489,246,243,233,1211
E01001672,458,149,690,251,1548
E01001673,309,170,609,431,1519
E01001674,550,275,433,231,1489
E01001675,408,210,640,314,1572
E01001676,318,150,366,452,1286
E01001677,549,232,501,202,1484
E01001678,661,357,173,142,1333
E01001679,540,250,148,107,1045
E01001680,554,519,171,36,1280
E01001681,421,231,143,167,962
E01001682,464,329,106,162,1061
E01001683,444,228,254,259,1185
E01001684,453,203,127,356,1139
E01001685,523,242,251,217,1233
E01001686,460,202,336,385,1383
E01001687,280,127,207,305,919
E01001688,642,92,566,391,1691
E01001690,282,92,187,877,1438
E01001692,177,54,121,645,997
E01001693,127,47,113,808,1095
E01001694,410,146,331,354,1241
E01001695,177,117,321,670,1285
E01001696,50,28,277,630,985
E01001697,320,185,643,396,1544
E01001698,237,65,271,698,1271
E01001699,122,14,458,477,1071
E01001700,377,168,517,411,1473
E01001701,185,57,489,319,1050
E01001702,196,57,137,705,1095
E01001703,149,38,185,949,1321
E01001704,495,208,250,311,1264
E01001705,212,61,305,832,1410
E01001706,150,67,135,656,1008
E01001708,420,239,234,347,1240
E01001709,142,46,200,528,916
E01001710,91,23,190,889,1193
E01001711,246,74,520,294,1134
E01001712,164,60,327,985,1536
E01001713,72,37,96,926,1131
E01001714,177,57,294,659,1187
E01001715,237,91,701,172,1201
E01001716,208,71,429,361,1069
E01001717,184,129,285,353,951
E01001718,377,188,967,95,1627
E01001719,126,43,247,540,956
E01001720,349,185,840,162,1536
E01001722,231,103,482,711,1527
E01001723,287,302,669,269,1527
E01001724,449,187,889,327,1852
E01001725,195,183,492,341,1211
E01001726,137,73,273,473,956
E01001727,264,223,510,275,1272
E01001728,130,119,495,494,1238
E01001729,267,27,284,934,1512
E01001730,147,43,237,986,1413
E01001731,267,87,602,872,1828
E01001732,175,33,199,859,1266
E01001733,405,231,540,282,1458
E01001734,225,139,723,448,1535
E01001735,336,141,290,533,1300
E01001736,378,158,449,363,1348
E01001737,485,179,485,360,1509
E01001738,326,215,521,389,1451
E01001739,470,297,556,374,1697
E01001740,167,62,231,743,1203
E01001741,389,212,375,208,1184
E01001742,404,103,353,617,1477
E01001744,321,158,431,655,1565
E01001745,233,65,546,923,1767
E01001746,75,24,139,910,1148
E01001747,460,140,877,398,1875
E01001748,331,151,889,623,1994
E01001749,400,194,509,345,1448
E01001750,330,130,500,605,1565
E01001751,398,288,559,127,1372
E01001752,557,95,688,647,1987
E01001753,98,51,193,884,1226
E01001754,302,76,727,865,1970
E01001755,164,52,307,836,1359
E01001756,376,212,980,365,1933
E01001757,163,65,204,865,1297
E01001758,245,67,462,840,1614
E01001759,266,109,431,694,1500
E01001760,213,87,604,581,1485
E01001761,222,51,411,847,1531
E01001762,284,113,690,462,1549
E01001763,262,121,364,617,1364
E01001764,302,85,414,571,1372
E01001765,118,30,132,1002,1282
E01001767,259,182,460,379,1280
E01001768,358,232,608,329,1527
E01001769,244,159,462,461,1326
E01001770,253,95,355,685,1388
E01001772,81,28,106,605,820
E01001773,230,69,467,915,1681
E01001774,283,59,669,662,1673
E01001775,179,53,304,867,1403
E01001776,107,86,244,777,1214
E01001777,222,76,840,793,1931
E01001779,386,91,508,968,1953
E01001780,187,71,435,841,1534
E01001781,93,37,370,865,1365
E01001782,434,180,699,659,1972
E01001783,142,53,271,1057,1523
E01001784,209,57,417,856,1539
E01001785,291,198,344,370,1203
E01001786,164,56,186,900,1306
E01001787,168,71,150,761,1150
E01001788,120,33,205,792,1150
E01001789,366,212,389,412,1379
E01001790,70,39,157,673,939
E01001791,282,128,196,524,1130
E01001792,327,339,358,371,1395
E01001793,351,252,474,311,1388
E01001794,383,375,504,219,1481
E01001795,286,192,505,229,1212
E01001796,283,165,598,333,1379
E01001798,191,143,377,618,1329
E01001799,208,182,464,155,1009
E01001800,86,57,331,614,1088
E01001801,223,104,279,500,1106
E01001802,147,102,258,391,898
E01001803,378,242,506,275,1401
E01001804,188,173,404,233,998
E01001805,223,113,474,209,1019
E01001806,285,122,336,526,1269
E01001807,207,131,475,515,1328
E01001808,150,191,676,144,1161
E01001809,171,213,553,341,1278
E01001811,98,39,230,809,1176
E01001812,199,112,408,469,1188
E01001813,72,54,269,583,978
E01001814,281,149,507,226,1163
E01001815,213,89,257,852,1411
E01001816,357,172,282,493,1304
E01001819,312,202,316,506,1336
E01001820,161,95,213,719,1188
E01001821,151,63,216,738,1168
E01001822,170,80,384,648,1282
E01001823,237,154,338,391,1120
E01001824,155,97,279,468,999
E01001825,208,188,422,115,933
E01001826,169,128,464,371,1132
E01001827,157,132,322,688,1299
E01001828,218,120,305,845,1488
E01001829,500,308,464,156,1428
E01001830,189,95,533,832,1649
E01001831,267,185,682,327,1461
E01001832,318,207,531,320,1376
E01001833,366,195,563,617,1741
E01001834,311,204,756,449,1720
E01001835,370,211,303,177,1061
E01001836,273,93,376,724,1466
E01001837,351,165,383,340,1239
E01001838,115,54,141,945,1255
E01001839,292,81,886,525,1784
E01001840,208,62,189,832,1291
E01001841,272,147,219,517,1155
E01001842,185,59,210,757,1211
E01001843,233,99,156,492,980
E01001844,317,184,427,596,1524
E01001845,70,36,160,950,1216
E01001846,169,63,164,574,970
E01001847,189,81,230,371,871
E01001848,263,104,338,548,1253
E01001849,431,81,722,583,1817
E01001850,113,45,191,900,1249
E01001851,327,322,474,168,1291
E01001852,380,197,822,242,1641
E01001853,336,214,537,191,1278
E01001854,330,199,674,309,1512
E01001855,354,226,633,250,1463
E01001856,166,193,503,474,1336
E01001857,122,103,396,628,1249
E01001858,275,131,502,449,1357
E01001859,517,181,607,693,1998
E01001860,206,116,587,538,1447
E01001861,245,144,392,438,1219
E01001862,249,134,474,616,1473
E01001863,398,199,390,256,1243
E01001864,242,205,574,314,1335
E01001865,350,266,563,198,1377
E01001866,274,262,689,168,1393
E01001867,226,210,610,120,1166
E01001868,80,44,308,665,1097
E01001869,202,291,421,129,1043
E01001870,326,215,1021,199,1761
E01001871,223,280,801,144,1448
E01001872,270,263,679,212,1424
E01001873,194,177,423,416,1210
E01001874,259,118,625,778,1780
E01001875,234,166,303,714,1417
E01001876,186,77,184,978,1425
E01001877,264,179,343,299,1085
E01001878,166,135,217,738,1256
E01001879,201,214,497,367,1279
E01001880,175,155,481,488,1299
E01001881,267,268,633,214,1382
E01001882,356,250,780,164,1550
E01001883,224,124,584,397,1329
E01001884,237,141,604,627,1609
E01001885,58,48,150,754,1010
E01001886,252,146,446,463,1307
E01001887,218,122,500,489,1329
E01001888,408,340,496,158,1402
E01001889,326,204,522,180,1232
E01001890,200,136,647,608,1591
E01001891,368,294,1062,126,1850
E01001892,201,100,326,504,1131
E01001893,119,72,283,529,1003
E01001894,116,160,404,385,1065
E01001895,275,204,505,325,1309
E01001896,225,141,582,361,1309
E01001897,272,284,359,224,1139
E01001898,226,197,695,226,1344
E01001899,115,68,277,708,1168
E01001900,137,133,529,633,1432
E01001901,345,322,458,188,1313
E01001902,284,196,760,286,1526
E01001903,208,189,479,498,1374
E01001904,406,274,560,114,1354
E01001905,353,297,645,148,1443
E01001906,354,223,550,153,1280
E01001907,283,259,402,102,1046
E01001908,260,154,904,177,1495
E01001909,294,153,630,490,1567
E01001910,243,147,753,244,1387
E01001911,218,69,329,759,1375
E01001912,121,72,362,705,1260
E01001913,314,219,868,41,1442
E01001914,249,136,930,252,1567
E01001915,287,367,377,124,1155
E01001916,243,543,396,28,1210
E01001917,317,227,431,282,1257
E01001918,392,287,403,155,1237
E01001919,428,377,325,122,1252
E01001920,171,165,416,586,1338
E01001921,292,254,456,273,1275
E01001922,315,396,403,181,1295
E01001923,290,244,429,290,1253
E01001924,380,326,466,76,1248
E01001925,368,393,343,133,1237
E01001926,348,360,410,81,1199
E01001927,374,435,327,54,1190
E01001928,326,270,414,339,1349
E01001929,293,281,346,109,1029
E01001930,304,230,436,476,1446
E01001931,243,169,503,278,1193
E01001932,222,181,646,347,1396
E01001933,249,347,306,223,1125
E01001934,228,176,360,550,1314
E01001935,441,277,568,484,1770
E01001937,366,317,649,193,1525
E01001938,282,108,272,533,1195
E01001939,324,269,393,666,1652
E01001940,195,128,550,468,1341
E01001941,192,138,894,284,1508
E01001942,240,206,786,387,1619
E01001943,237,170,819,460,1686
E01001944,94,62,239,950,1345
E01001945,288,260,523,387,1458
E01001946,214,176,536,441,1367
E01001947,108,47,193,755,1103
E01001948,472,295,638,223,1628
E01001949,319,256,609,100,1284
E01001950,313,304,571,83,1271
E01001951,265,257,560,292,1374
E01001952,282,194,813,186,1475
E01001953,160,104,573,323,1160
E01001954,294,204,309,423,1230
E01001955,207,103,276,783,1369
E01001956,287,239,321,426,1273
E01001957,118,48,243,811,1220
E01001958,94,29,172,914,1209
E01001959,289,199,252,601,1341
E01001960,329,234,759,268,1590
E01001961,106,51,200,747,1104
E01001962,527,327,254,193,1301
E01001963,599,407,286,84,1376
E01001964,455,272,434,140,1301
E01001965,605,306,231,114,1256
E01001966,453,466,219,50,1188
E01001967,497,457,260,50,1264
E01001968,492,343,580,90,1505
E01001969,339,180,707,349,1575
E01001970,342,115,482,598,1537
E01001971,369,89,332,753,1543
E01001972,345,206,372,438,1361
E01001973,518,399,514,366,1797
E01001974,471,345,898,157,1871
E01001975,371,212,711,147,1441
E01001976,317,191,427,290,1225
E01001977,264,147,438,334,1183
E01001978,285,132,506,526,1449
E01001979,293,128,663,564,1648
E01001980,383,247,660,233,1523
E01001981,320,190,616,270,1396
E01001982,348,241,550,275,1414
E01001983,445,262,382,216,1305
E01001984,375,269,570,158,1372
E01001985,514,318,457,70,1359
E01001986,461,294,428,162,1345
E01001987,471,487,514,45,1517
E01001988,439,238,629,170,1476
E01001989,509,343,379,182,1413
E01001990,466,206,1105,115,1892
E01001991,356,169,666,77,1268
E01001992,419,538,343,44,1344
E01001993,483,503,185,62,1233
E01001994,459,427,518,92,1496
E01001995,698,236,242,586,1762
E01001996,518,280,411,81,1290
E01001997,366,208,712,46,1332
E01001998,443,296,939,126,1804
E01001999,411,303,903,107,1724
E01002000,408,272,609,123,1412
E01002001,349,271,700,145,1465
E01002002,323,190,815,210,1538
E01002003,192,122,1001,413,1728
E01002004,433,363,625,186,1607
E01002005,389,159,840,84,1472
E01002006,396,232,680,97,1405
E01002007,299,464,604,59,1426
E01002008,306,472,334,115,1227
E01002009,347,392,531,46,1316
E01002010,348,337,312,322,1319
E01002011,409,289,559,193,1450
E01002013,523,260,241,100,1124
E01002014,392,167,613,266,1438
E01002015,320,212,204,500,1236
E01002016,454,213,513,421,1601
E01002017,424,193,499,262,1378
E01002018,387,174,174,371,1106
E01002019,501,362,192,29,1084
E01002020,342,240,481,230,1293
E01002021,483,444,193,89,1209
E01002022,350,268,941,44,1603
E01002023,453,384,258,88,1183
E01002024,383,273,225,170,1051
E01002025,423,496,369,53,1341
E01002026,144,55,277,783,1259
E01002027,262,190,494,322,1268
E01002028,337,232,528,366,1463
E01002029,332,73,370,505,1280
E01002030,288,272,591,208,1359
E01002031,260,257,886,219,1622
E01002032,268,125,393,630,1416
E01002033,267,173,419,597,1456
E01002034,175,61,423,688,1347
E01002036,245,204,324,421,1194
E01002037,142,104,454,584,1284
E01002038,170,75,450,520,1215
E01002039,69,41,169,846,1125
E01002040,352,212,507,416,1487
E01002041,304,153,438,509,1404
E01002042,306,259,526,112,1203
E01002043,351,240,777,212,1580
E01002044,313,285,769,128,1495
E01002045,287,139,743,555,1724
E01002046,299,195,362,463,1319
E01002047,246,268,795,139,1448
E01002048,402,268,596,314,1580
E01002049,325,208,423,516,1472
E01002050,256,272,491,117,1136
E01002051,192,114,629,393,1328
E01002052,344,222,417,189,1172
E01002053,271,134,391,563,1359
E01002054,160,86,321,719,1286
E01002055,267,216,431,124,1038
E01002056,285,146,640,525,1596
E01002057,255,197,500,327,1279
E01002058,290,182,721,250,1443
E01002059,428,226,276,397,1327
E01002060,542,291,433,180,1446
E01002061,478,253,540,159,1430
E01002062,495,232,642,220,1589
E01002063,351,191,447,323,1312
E01002064,282,146,379,429,1236
E01002065,340,122,697,312,1471
E01002066,208,57,373,732,1370
E01002067,237,149,395,570,1351
E01002068,303,146,769,325,1543
E01002069,266,147,741,480,1634
E01002070,430,284,611,267,1592
E01002071,210,84,366,545,1205
E01002072,260,131,432,526,1349
E01002073,283,120,479,481,1363
E01002074,347,101,426,639,1513
E01002075,252,133,548,400,1333
E01002076,332,202,556,348,1438
E01002077,143,75,593,725,1536
E01002078,358,126,433,786,1703
E01002079,329,224,483,186,1222
E01002080,297,239,600,181,1317
E01002081,200,76,483,644,1403
E01002082,104,28,131,839,1102
E01002083,283,370,530,71,1254
E01002084,382,285,513,157,1337
E01002085,326,223,789,404,1742
E01002086,270,221,356,419,1266
E01002087,222,243,575,285,1325
E01002088,390,339,594,204,1527
E01002089,60,18,106,904,1088
E01002090,329,202,218,469,1218
E01002091,307,146,220,670,1343
E01002092,261,75,502,404,1242
E01002093,284,96,213,722,1315
E01002094,256,128,201,537,1122
E01002095,210,61,237,657,1165
E01002096,334,107,135,622,1198
E01002097,295,118,219,515,1147
E01002098,337,200,452,154,1143
E01002099,250,79,419,833,1581
E01002100,371,264,506,341,1482
E01002101,557,281,636,109,1583
E01002102,314,233,781,235,1563
E01002103,375,235,671,216,1497
E01002104,351,259,311,226,1147
E01002105,271,148,1014,284,1717
E01002106,852,476,214,53,1595
E01002107,716,438,193,11,1358
E01002108,758,473,165,13,1409
E01002109,695,529,190,53,1467
E01002110,635,493,251,10,1389
E01002111,744,479,323,120,1666
E01002112,600,630,263,60,1553
E01002113,526,390,163,174,1253
E01002114,434,555,400,301,1690
E01002115,486,412,226,95,1219
E01002116,540,570,283,34,1427
E01002117,631,517,308,138,1594
E01002118,379,384,578,38,1379
E01002119,500,302,373,175,1350
E01002120,292,173,212,359,1036
E01002121,584,447,320,43,1394
E01002122,565,436,356,23,1380
E01002123,445,409,526,48,1428
E01002124,583,377,302,72,1334
E01002125,446,384,462,75,1367
E01002126,503,377,1230,212,2322
E01002127,501,404,466,33,1404
E01002128,430,293,859,56,1638
E01002129,433,313,709,229,1684
E01002130,382,234,1044,169,1829
E01002131,419,234,329,329,1311
E01002132,543,383,655,27,1608
E01002133,323,214,390,713,1640
E01002134,397,321,415,27,1160
E01002135,488,284,464,162,1398
E01002136,527,401,377,53,1358
E01002137,266,174,378,6,824
E01002138,516,258,348,57,1179
E01002139,268,94,135,580,1077
E01002140,599,379,232,141,1351
E01002141,666,513,184,90,1453
E01002142,665,509,258,22,1454
E01002143,549,262,222,152,1185
E01002144,607,457,140,96,1300
E01002145,491,448,173,116,1228
E01002146,589,481,97,7,1174
E01002147,447,551,127,10,1135
E01002148,558,391,143,85,1177
E01002149,556,501,46,5,1108
E01002150,474,460,500,75,1509
E01002151,303,149,133,510,1095
E01002152,556,538,224,32,1350
E01002153,625,625,162,10,1422
E01002154,666,495,313,150,1624
E01002155,651,518,141,30,1340
E01002156,611,526,96,22,1255
E01002157,547,456,354,48,1405
E01002158,632,454,98,3,1187
E01002159,642,497,312,80,1531
E01002160,539,301,666,45,1551
E01002161,624,408,419,144,1595
E01002162,573,382,348,155,1458
E01002163,641,473,168,39,1321
E01002164,524,405,413,55,1397
E01002165,440,428,491,44,1403
E01002166,500,501,299,47,1347
E01002167,422,380,347,172,1321
E01002168,408,190,171,399,1168
E01002169,395,427,319,209,1350
E01002170,460,332,162,121,1075
E01002171,569,432,366,14,1381
E01002172,617,323,172,119,1231
E01002173,630,544,246,20,1440
E01002174,582,469,239,21,1311
E01002175,494,490,182,23,1189
E01002176,554,511,372,18,1455
E01002177,560,347,224,21,1152
E01002178,655,494,137,42,1328
E01002179,576,354,590,250,1770
E01002180,457,252,555,352,1616
E01002181,607,356,493,29,1485
E01002182,534,460,630,28,1652
E01002183,664,457,471,68,1660
E01002184,555,322,417,170,1464
E01002185,337,166,132,543,1178
E01002186,428,372,344,212,1356
E01002187,588,505,216,196,1505
E01002188,525,671,120,7,1323
E01002189,445,506,353,67,1371
E01002190,629,658,83,38,1408
E01002191,809,454,199,45,1507
E01002192,441,581,173,56,1251
E01002193,558,409,223,190,1380
E01002194,588,625,112,62,1387
E01002195,636,463,136,49,1284
E01002196,764,542,75,15,1396
E01002197,518,359,161,32,1070
E01002198,531,448,423,22,1424
E01002199,569,398,219,24,1210
E01002200,512,450,336,66,1364
E01002201,594,558,251,18,1421
E01002202,363,225,833,122,1543
E01002203,561,389,335,46,1331
E01002204,417,292,605,55,1369
E01002206,496,317,276,18,1107
E01002207,627,404,251,44,1326
E01002208,498,483,102,10,1093
E01002209,501,449,366,10,1326
E01002210,592,414,247,27,1280
E01002211,319,200,204,432,1155
E01002212,465,253,465,162,1345
E01002213,733,398,855,229,2215
E01002214,559,294,344,180,1377
E01002215,357,148,213,478,1196
E01002216,568,380,244,75,1267
E01002217,179,58,118,743,1098
E01002218,510,389,358,31,1288
E01002219,509,279,533,78,1399
E01002220,612,344,191,98,1245
E01002221,439,344,385,91,1259
E01002222,627,320,253,39,1239
E01002223,709,382,271,56,1418
E01002224,491,185,170,297,1143
E01002225,434,667,139,21,1261
E01002226,566,630,517,164,1877
E01002227,389,222,171,598,1380
E01002228,527,471,371,234,1603
E01002229,429,484,297,237,1447
E01002230,706,568,176,34,1484
E01002231,620,326,340,163,1449
E01002232,555,409,395,166,1525
E01002233,504,320,547,208,1579
E01002234,544,303,370,109,1326
E01002235,428,262,285,435,1410
E01002236,551,282,422,142,1397
E01002237,440,197,517,176,1330
E01002238,577,358,386,85,1406
E01002239,559,501,279,16,1355
E01002240,545,291,310,239,1385
E01002241,566,318,189,177,1250
E01002242,650,573,256,31,1510
E01002243,442,191,345,460,1438
E01002244,654,312,237,141,1344
E01002245,586,295,206,132,1219
E01002246,620,482,154,46,1302
E01002247,754,299,284,62,1399
E01002248,399,331,182,187,1099
E01002249,614,345,256,292,1507
E01002250,730,291,172,56,1249
E01002251,484,219,85,275,1063
E01002252,570,604,51,36,1261
E01002253,610,666,24,5,1305
E01002254,574,683,65,9,1331
E01002255,620,508,82,22,1232
E01002256,593,528,83,32,1236
E01002257,631,638,89,8,1366
E01002258,461,497,169,262,1389
E01002259,589,545,57,36,1227
E01002260,583,470,139,74,1266
E01002261,596,492,190,35,1313
E01002262,647,382,94,196,1319
E01002263,715,507,73,43,1338
E01002264,367,230,88,500,1185
E01002265,617,482,103,34,1236
E01002266,521,564,66,79,1230
E01002267,513,405,99,328,1345
E01002268,515,448,50,85,1098
E01002269,786,554,85,19,1444
E01002270,662,566,78,119,1425
E01002271,613,580,57,4,1254
E01002272,524,487,73,17,1101
E01002273,514,550,46,5,1115
E01002274,636,572,125,14,1347
E01002275,542,567,51,9,1169
E01002276,636,353,83,368,1440
E01002277,439,232,75,467,1213
E01002278,423,233,62,469,1187
E01002279,502,253,100,350,1205
E01002280,299,138,101,575,1113
E01002281,323,156,131,623,1233
E01002282,306,119,108,648,1181
E01002283,508,212,96,339,1155
E01002284,643,247,105,421,1416
E01002285,460,529,69,22,1080
E01002286,670,615,38,11,1334
E01002287,632,553,91,27,1303
E01002288,655,541,57,24,1277
E01002289,642,478,70,104,1294
E01002290,620,601,51,24,1296
E01002291,567,557,261,14,1399
E01002292,542,419,80,204,1245
E01002293,628,297,288,82,1295
E01002294,560,497,100,103,1260
E01002295,605,410,153,103,1271
E01002296,632,614,91,71,1408
E01002297,334,153,100,590,1177
E01002298,567,510,100,96,1273
E01002299,636,273,97,329,1335
E01002300,549,568,168,72,1357
E01002301,596,578,70,71,1315
E01002302,648,429,84,79,1240
E01002303,624,353,145,448,1570
E01002304,453,426,105,95,1079
E01002305,586,433,77,118,1214
E01002306,408,166,61,520,1155
E01002307,564,325,85,300,1274
E01002308,569,359,126,235,1289
E01002309,449,402,113,274,1238
E01002310,478,195,120,459,1252
E01002311,577,284,106,315,1282
E01002312,377,417,61,269,1124
E01002313,429,291,123,340,1183
E01002314,412,141,92,590,1235
E01002315,549,236,105,294,1184
E01002316,338,121,98,641,1198
E01002317,677,506,38,31,1252
E01002318,634,595,67,42,1338
E01002319,621,382,129,177,1309
E01002320,686,430,69,22,1207
E01002321,638,552,129,30,1349
E01002322,900,529,123,49,1601
E01002323,747,506,78,15,1346
E01002324,533,391,92,220,1236
E01002325,486,384,105,383,1358
E01002326,550,385,165,104,1204
E01002327,615,432,75,69,1191
E01002328,699,507,111,28,1345
E01002329,684,427,121,52,1284
E01002330,626,435,153,163,1377
E01002331,594,468,103,73,1238
E01002332,628,484,110,105,1327
E01002333,536,503,45,11,1095
E01002334,676,650,54,39,1419
E01002335,491,401,80,218,1190
E01002336,618,504,72,39,1233
E01002337,496,424,83,75,1078
E01002338,569,393,111,20,1093
E01002339,661,585,47,16,1309
E01002340,560,418,87,22,1087
E01002341,566,576,28,11,1181
E01002342,630,318,193,116,1257
E01002343,676,621,79,15,1391
E01002344,530,555,138,34,1257
E01002345,480,247,292,238,1257
E01002346,537,254,152,239,1182
E01002347,536,447,128,26,1137
E01002348,539,691,65,14,1309
E01002349,584,530,81,101,1296
E01002350,429,272,358,155,1214
E01002351,659,345,215,51,1270
E01002352,650,292,287,73,1302
E01002353,674,496,279,201,1650
E01002354,504,502,105,14,1125
E01002355,605,473,74,21,1173
E01002356,401,213,526,579,1719
E01002358,684,255,385,128,1452
E01002359,568,461,47,8,1084
E01002360,408,515,151,183,1257
E01002361,476,350,346,262,1434
E01002362,588,457,167,31,1243
E01002363,500,389,83,316,1288
E01002364,549,496,78,27,1150
E01002365,520,409,130,39,1098
E01002366,630,431,61,57,1179
E01002367,551,470,204,50,1275
E01002368,340,214,123,522,1199
E01002369,676,535,146,151,1508
E01002370,704,287,161,405,1557
E01002371,613,542,105,69,1329
E01002372,639,504,87,60,1290
E01002373,614,484,98,81,1277
E01002374,618,377,94,136,1225
E01002375,517,344,95,306,1262
E01002376,603,474,68,11,1156
E01002377,652,423,148,102,1325
E01002378,804,411,82,29,1326
E01002379,518,419,267,31,1235
E01002380,619,388,409,297,1713
E01002381,537,488,97,141,1263
E01002382,688,465,250,64,1467
E01002383,689,482,104,36,1311
E01002384,580,555,107,34,1276
E01002385,645,515,80,33,1273
E01002386,619,493,367,47,1526
E01002387,643,627,39,4,1313
E01002388,647,639,48,5,1339
E01002389,542,698,42,16,1298
E01002390,596,533,29,12,1170
E01002391,523,634,68,37,1262
E01002392,327,144,114,566,1151
E01002393,620,287,272,290,1469
E01002394,466,345,300,98,1209
E01002395,485,287,262,62,1096
E01002396,436,270,321,309,1336
E01002397,479,289,417,101,1286
E01002398,566,355,381,60,1362
E01002399,587,354,252,39,1232
E01002400,556,222,290,274,1342
E01002401,524,213,339,214,1290
E01002402,413,208,194,313,1128
E01002403,540,190,241,315,1286
E01002404,517,187,208,411,1323
E01002405,547,278,278,284,1387
E01002406,598,328,402,259,1587
E01002407,619,313,435,327,1694
E01002408,366,211,289,371,1237
E01002409,436,270,295,380,1381
E01002410,622,417,284,68,1391
E01002411,417,289,355,333,1394
E01002412,684,459,535,205,1883
E01002413,392,228,239,343,1202
E01002414,308,249,367,102,1026
E01002415,826,432,80,19,1357
E01002416,779,411,101,79,1370
E01002417,560,551,170,20,1301
E01002418,686,420,77,186,1369
E01002419,602,449,156,23,1230
E01002420,560,353,137,215,1265
E01002421,597,498,141,76,1312
E01002422,559,295,220,27,1101
E01002423,627,454,153,70,1304
E01002424,642,307,215,40,1204
E01002425,552,237,386,235,1410
E01002426,675,319,259,43,1296
E01002427,655,333,137,33,1158
E01002428,586,376,131,56,1149
E01002429,458,182,137,276,1053
E01002430,551,583,43,37,1214
E01002431,499,541,76,11,1127
E01002432,501,527,280,20,1328
E01002433,596,458,128,294,1476
E01002434,527,462,67,42,1098
E01002435,585,516,58,20,1179
E01002436,635,436,108,119,1298
E01002437,448,674,85,53,1260
E01002438,480,297,98,106,981
E01002439,429,306,176,260,1171
E01002440,480,329,54,300,1163
E01002441,488,271,170,295,1224
E01002442,453,320,103,342,1218
E01002443,449,262,508,50,1269
E01002444,441,338,463,76,1318
E01002445,330,165,199,425,1119
E01002446,358,340,386,146,1230
E01002447,402,143,663,167,1375
E01002448,500,314,580,173,1567
E01002449,513,186,645,100,1444
E01002450,640,308,112,19,1079
E01002451,575,382,137,70,1164
E01002452,634,334,165,78,1211
E01002453,669,373,212,70,1324
E01002454,585,300,133,283,1301
E01002455,558,328,284,197,1367
E01002456,519,276,264,170,1229
E01002457,373,198,257,370,1198
E01002458,547,530,97,15,1189
E01002459,582,643,77,4,1306
E01002460,459,437,165,63,1124
E01002461,569,478,128,31,1206
E01002462,518,422,157,19,1116
E01002463,569,528,89,50,1236
E01002464,642,404,78,101,1225
E01002465,576,303,265,57,1201
E01002466,736,464,85,23,1308
E01002467,559,545,119,15,1238
E01002468,726,446,141,31,1344
E01002469,704,475,121,31,1331
E01002470,489,409,351,122,1371
E01002471,705,425,118,36,1284
E01002472,324,418,428,101,1271
E01002473,463,577,96,193,1329
E01002474,450,429,204,145,1228
E01002475,339,338,252,286,1215
E01002476,498,579,183,35,1295
E01002477,324,364,242,92,1022
E01002478,420,397,334,90,1241
E01002479,543,295,93,371,1302
E01002480,605,593,205,41,1444
E01002481,526,273,167,321,1287
E01002482,591,604,115,20,1330
E01002483,514,448,398,45,1405
E01002484,446,278,152,293,1169
E01002485,430,382,385,198,1395
E01002486,670,270,256,371,1567
E01002487,571,311,260,231,1373
E01002488,609,325,261,105,1300
E01002489,554,303,427,93,1377
E01002490,725,342,383,112,1562
E01002491,412,248,236,296,1192
E01002492,567,285,255,113,1220
E01002493,370,187,223,491,1271
E01002494,693,296,212,140,1341
E01002495,621,313,353,138,1425
E01002496,681,277,310,134,1402
E01002497,481,375,427,150,1433
E01002498,538,428,104,65,1135
E01002499,590,397,246,128,1361
E01002501,496,304,279,225,1304
E01002502,477,191,181,384,1233
E01002503,446,196,350,311,1303
E01002504,682,274,362,213,1531
E01002505,409,96,254,518,1277
E01002506,385,140,458,375,1358
E01002507,578,297,324,71,1270
E01002508,465,156,321,529,1471
E01002509,628,415,117,11,1171
E01002511,498,278,166,261,1203
E01002512,621,612,174,31,1438
E01002513,487,483,99,89,1158
E01002514,494,450,469,162,1575
E01002515,421,244,393,248,1306
E01002516,539,454,151,21,1165
E01002518,480,329,282,42,1133
E01002519,435,236,320,279,1270
E01002520,411,218,348,263,1240
E01002521,335,134,486,493,1448
E01002523,477,271,469,131,1348
E01002525,542,427,242,92,1303
E01002526,515,187,188,506,1396
E01002527,347,316,321,191,1175
E01002528,528,217,155,400,1300
E01002529,506,296,517,284,1603
E01002530,307,169,164,521,1161
E01002531,554,418,185,172,1329
E01002532,550,223,363,565,1701
E01002533,525,275,77,244,1121
E01002534,544,377,109,143,1173
E01002535,443,499,492,80,1514
E01002536,356,266,422,29,1073
E01002537,439,349,331,28,1147
E01002538,611,440,123,157,1331
E01002539,542,532,72,109,1255
E01002540,556,185,232,274,1247
E01002541,821,320,275,100,1516
E01002542,459,168,374,375,1376
E01002543,499,212,193,336,1240
E01002544,595,321,327,45,1288
E01002545,151,130,143,609,1033
E01002546,554,294,311,32,1191
E01002547,464,254,314,143,1175
E01002548,404,214,155,475,1248
E01002549,599,367,226,210,1402
E01002550,508,157,478,289,1432
E01002551,546,267,286,406,1505
E01002552,480,170,203,344,1197
E01002553,364,161,255,504,1284
E01002554,778,155,688,354,1975
E01002555,715,395,328,86,1524
E01002556,599,283,230,185,1297
E01002557,548,264,292,354,1458
E01002558,564,228,228,468,1488
E01002559,605,204,424,495,1728
E01002560,604,279,157,350,1390
E01002561,326,29,73,546,974
E01002562,308,217,191,414,1130
E01002563,456,448,404,83,1391
E01002564,449,171,289,559,1468
E01002565,660,287,416,383,1746
E01002566,249,109,343,967,1668
E01002567,557,295,422,188,1462
E01002568,542,139,309,1140,2130
E01002569,476,360,436,162,1434
E01002570,365,259,559,225,1408
E01002571,408,335,298,45,1086
E01002572,315,140,222,600,1277
E01002573,366,476,357,106,1305
E01002574,388,357,434,95,1274
E01002575,431,436,445,84,1396
E01002576,379,288,271,417,1355
E01002577,489,390,328,111,1318
E01002578,444,390,216,155,1205
E01002579,516,492,304,154,1466
E01002580,241,161,469,281,1152
E01002581,540,279,595,148,1562
E01002582,520,353,288,159,1320
E01002583,492,383,387,76,1338
E01002584,457,307,482,82,1328
E01002585,403,258,383,279,1323
E01002586,487,412,450,30,1379
E01002587,421,330,520,276,1547
E01002588,113,41,141,977,1272
E01002589,379,238,451,439,1507
E01002590,585,325,284,275,1469
E01002591,596,295,151,345,1387
E01002592,533,266,392,386,1577
E01002593,665,447,345,174,1631
E01002594,694,395,298,135,1522
E01002595,653,233,217,413,1516
E01002596,556,84,490,230,1360
E01002598,580,177,252,382,1391
E01002599,518,185,105,386,1194
E01002600,437,184,152,381,1154
E01002601,659,179,311,100,1249
E01002602,700,282,106,74,1162
E01002603,572,144,253,431,1400
E01002604,250,52,102,795,1199
E01002605,461,266,245,442,1414
E01002606,293,118,103,733,1247
E01002607,591,307,295,269,1462
E01002608,445,230,185,433,1293
E01002609,762,359,151,129,1401
E01002610,401,247,101,448,1197
E01002611,632,353,170,246,1401
E01002612,480,285,222,337,1324
E01002613,696,287,189,220,1392
E01002614,562,294,443,116,1415
E01002615,324,114,108,598,1144
E01002616,465,363,121,150,1099
E01002617,677,403,144,74,1298
E01002618,669,439,255,31,1394
E01002619,601,453,397,140,1591
E01002620,348,252,444,319,1363
E01002621,555,287,325,267,1434
E01002622,546,329,352,168,1395
E01002623,394,260,337,278,1269
E01002624,418,233,333,215,1199
E01002625,678,361,251,68,1358
E01002626,599,383,265,94,1341
E01002627,324,159,287,513,1283
E01002628,570,448,470,90,1578
E01002629,584,341,444,275,1644
E01002630,384,347,547,82,1360
E01002631,546,276,320,102,1244
E01002632,639,389,263,155,1446
E01002633,279,138,196,624,1237
E01002634,290,103,170,649,1212
E01002635,505,423,400,83,1411
E01002636,669,428,389,129,1615
E01002637,339,267,316,367,1289
E01002638,400,239,227,500,1366
E01002639,364,467,572,15,1418
E01002640,365,392,726,32,1515
E01002641,288,397,619,271,1575
E01002642,312,223,896,188,1619
E01002643,634,419,406,389,1848
E01002645,502,261,633,290,1686
E01002646,382,206,494,416,1498
E01002647,609,209,393,400,1611
E01002648,592,377,970,185,2124
E01002649,438,212,622,175,1447
E01002650,670,281,488,298,1737
E01002651,476,372,453,126,1427
E01002652,539,419,385,94,1437
E01002653,653,441,359,27,1480
E01002654,701,392,288,55,1436
E01002655,644,434,408,41,1527
E01002656,465,371,151,96,1083
E01002657,711,406,307,51,1475
E01002658,484,355,205,38,1082
E01002659,498,274,241,109,1122
E01002660,414,321,562,158,1455
E01002661,411,527,585,47,1570
E01002662,417,504,739,49,1709
E01002663,488,278,466,438,1670
E01002664,420,172,589,177,1358
E01002665,350,253,351,328,1282
E01002666,455,287,295,83,1120
E01002667,401,219,277,345,1242
E01002668,552,203,526,286,1567
E01002669,434,127,215,585,1361
E01002670,624,305,333,144,1406
E01002671,558,327,131,307,1323
E01002672,282,71,330,585,1268
E01002673,113,35,97,896,1141
E01002674,422,435,515,21,1393
E01002675,849,498,392,192,1931
E01002676,613,465,372,6,1456
E01002677,422,263,411,173,1269
E01002678,605,426,472,22,1525
E01002679,521,424,457,70,1472
E01002680,533,413,546,98,1590
E01002681,399,213,444,533,1589
E01002682,796,292,308,435,1831
E01002683,873,351,558,226,2008
E01002684,566,286,634,440,1926
E01002686,353,147,173,740,1413
E01002687,409,314,629,127,1479
E01002689,352,325,271,350,1298
E01002690,385,394,263,139,1181
E01002691,368,372,577,22,1339
E01002692,313,262,677,263,1515
E01002693,296,380,558,191,1425
E01002694,127,43,228,782,1180
E01002695,212,92,613,484,1401
E01002696,362,271,575,388,1596
E01002697,95,84,321,799,1299
E01002698,419,274,598,494,1785
E01002699,288,211,393,443,1335
E01002700,321,428,332,159,1240
E01002701,140,97,274,731,1242
E01002702,95,70,462,854,1481
E01002703,163,102,383,714,1362
E01002704,248,121,410,794,1573
E01002706,178,93,465,845,1581
E01002707,192,121,610,620,1543
E01002708,263,124,612,584,1583
E01002709,156,87,522,727,1492
E01002710,212,108,271,736,1327
E01002711,279,125,832,486,1722
E01002712,188,79,437,311,1015
E01002713,168,108,230,796,1302
E01002714,345,271,597,244,1457
E01002715,127,59,332,655,1173
E01002716,264,85,497,1010,1856
E01002717,217,208,320,343,1088
E01002718,304,289,590,300,1483
E01002719,303,304,341,328,1276
E01002720,244,90,307,1112,1753
E01002721,330,116,335,641,1422
E01002722,143,97,239,622,1101
E01002723,168,136,328,652,1284
E01002724,390,279,616,330,1615
E01002725,134,54,170,662,1020
E01002726,221,139,472,571,1403
E01002727,260,172,459,541,1432
E01002728,126,70,263,412,871
E01002729,245,221,361,458,1285
E01002730,266,180,795,334,1575
E01002731,453,224,1055,431,2163
E01002732,190,55,337,898,1480
E01002733,323,208,502,189,1222
E01002734,54,25,474,661,1214
E01002735,163,116,641,476,1396
E01002736,98,67,159,731,1055
E01002737,155,121,333,823,1432
E01002738,317,279,405,431,1432
E01002739,400,330,457,352,1539
E01002740,377,400,532,207,1516
E01002741,177,98,292,627,1194
E01002742,375,280,465,203,1323
E01002743,301,197,380,406,1284
E01002744,324,180,360,382,1246
E01002745,327,231,336,364,1258
E01002747,305,267,587,234,1393
E01002748,218,106,327,534,1185
E01002749,230,139,230,410,1009
E01002751,159,117,326,844,1446
E01002752,290,151,256,523,1220
E01002753,211,95,358,534,1198
E01002754,346,253,396,232,1227
E01002755,173,68,125,706,1072
E01002756,303,144,324,346,1117
E01002757,308,163,227,409,1107
E01002758,151,48,257,744,1200
E01002759,404,296,346,292,1338
E01002760,237,88,225,641,1191
E01002762,374,225,735,393,1727
E01002763,157,105,446,384,1092
E01002764,255,183,431,586,1455
E01002765,300,122,411,946,1779
E01002766,130,54,384,904,1472
E01002767,356,167,463,742,1728
E01002768,281,105,321,661,1368
E01002769,384,271,529,487,1671
E01002770,293,179,499,303,1274
E01002771,206,158,334,510,1208
E01002772,342,190,561,466,1559
E01002773,155,77,199,716,1147
E01002774,295,118,589,789,1791
E01002775,297,121,497,351,1266
E01002776,264,143,380,554,1341
E01002777,335,124,466,524,1449
E01002778,158,47,299,803,1307
E01002779,367,158,489,393,1407
E01002780,329,121,350,566,1366
E01002781,185,83,231,595,1094
E01002782,147,56,216,698,1117
E01002783,204,81,341,573,1199
E01002784,253,105,338,694,1390
E01002785,411,360,479,327,1577
E01002786,210,87,524,640,1461
E01002787,166,58,349,531,1104
E01002788,466,237,567,329,1599
E01002789,501,404,441,244,1590
E01002790,67,56,246,840,1209
E01002791,270,243,493,346,1352
E01002792,292,269,611,429,1601
E01002793,215,116,485,812,1628
E01002794,206,262,659,426,1553
E01002795,270,184,620,620,1694
E01002796,176,135,268,350,929
E01002797,274,77,473,786,1610
E01002798,512,281,489,411,1693
E01002799,218,95,357,806,1476
E01002800,56,41,77,618,792
E01002801,281,307,455,333,1376
E01002802,298,231,456,289,1274
E01002803,324,303,522,500,1649
E01002804,215,57,353,686,1311
E01002805,201,126,746,310,1383
E01002806,388,220,320,413,1341
E01002807,209,119,454,640,1422
E01002808,411,160,585,445,1601
E01002809,283,155,432,472,1342
E01002810,296,119,295,601,1311
E01002811,235,126,216,617,1194
E01002812,171,379,829,95,1474
E01002813,262,552,599,52,1465
E01002814,233,286,621,481,1621
E01002815,213,330,612,79,1234
E01002816,133,342,665,11,1151
E01002817,210,609,486,23,1328
E01002818,179,344,1167,94,1784
E01002819,159,381,820,23,1383
E01002820,140,245,641,45,1071
E01002821,179,342,574,123,1218
E01002822,136,372,420,64,992
E01002823,84,200,253,605,1142
E01002824,216,427,514,90,1247
E01002825,210,556,599,108,1473
E01002826,181,366,695,43,1285
E01002827,290,585,630,20,1525
E01002828,163,395,415,174,1147
E01002829,147,152,330,648,1277
E01002830,219,159,322,834,1534
E01002831,178,205,442,834,1659
E01002832,135,178,434,694,1441
E01002833,237,286,526,206,1255
E01002834,206,268,591,108,1173
E01002835,209,368,723,20,1320
E01002836,216,296,630,82,1224
E01002837,155,360,566,63,1144
E01002838,122,287,445,56,910
E01002839,178,242,760,236,1416
E01002840,112,264,176,606,1158
E01002841,285,212,350,333,1180
E01002842,58,77,79,753,967
E01002843,90,76,158,692,1016
E01002844,142,459,471,124,1196
E01002845,190,318,325,331,1164
E01002846,183,126,622,257,1188
E01002847,288,301,665,126,1380
E01002848,157,235,617,372,1381
E01002849,294,257,596,160,1307
E01002850,186,201,647,159,1193
E01002851,121,138,553,603,1415
E01002852,147,69,296,982,1494
E01002853,24,15,133,717,889
E01002854,97,41,84,648,870
E01002855,146,83,204,994,1427
E01002856,137,147,536,706,1526
E01002857,50,37,54,912,1053
E01002858,94,214,420,393,1121
E01002859,194,318,819,69,1400
E01002860,164,518,603,9,1294
E01002861,131,466,430,211,1238
E01002862,60,126,533,649,1368
E01002863,129,345,766,24,1264
E01002864,225,528,364,45,1162
E01002865,204,380,473,20,1077
E01002866,337,292,557,265,1451
E01002867,313,286,804,248,1651
E01002868,211,595,512,36,1354
E01002869,224,327,492,229,1272
E01002870,73,34,143,901,1151
E01002871,234,576,481,75,1366
E01002872,78,154,142,812,1186
E01002873,215,333,284,267,1099
E01002874,195,268,381,318,1162
E01002875,194,501,345,136,1176
E01002876,289,384,345,374,1392
E01002877,142,157,131,855,1285
E01002878,271,230,341,547,1389
E01002879,111,72,296,746,1225
E01002880,101,45,99,958,1203
E01002881,105,106,124,752,1087
E01002882,167,354,336,258,1115
E01002883,231,550,609,41,1431
E01002884,164,192,535,174,1065
E01002885,215,286,789,101,1391
E01002886,275,430,469,125,1299
E01002887,166,332,723,28,1249
E01002888,278,396,1094,65,1833
E01002889,143,270,515,27,955
E01002890,208,642,493,41,1384
E01002891,178,298,650,79,1205
E01002892,250,354,908,35,1547
E01002893,309,292,684,278,1563
E01002894,255,255,616,98,1224
E01002895,228,433,398,41,1100
E01002896,341,452,621,75,1489
E01002897,213,272,549,128,1162
E01002898,298,437,459,97,1291
E01002899,110,273,435,376,1194
E01002900,234,514,456,12,1216
E01002901,147,267,285,136,835
E01002902,178,380,775,192,1525
E01002903,203,593,450,10,1256
E01002904,34,2,58,832,926
E01002905,127,109,150,839,1225
E01002906,275,114,254,676,1319
E01002907,22,10,65,894,991
E01002908,287,230,311,300,1128
E01002909,325,280,453,810,1868
E01002910,151,412,345,237,1145
E01002911,291,446,566,54,1357
E01002912,205,352,502,337,1396
E01002913,288,386,670,254,1598
E01002914,162,494,538,23,1217
E01002915,568,421,92,14,1095
E01002916,571,447,156,16,1190
E01002917,558,476,87,2,1123
E01002918,740,291,226,49,1306
E01002919,520,285,408,138,1351
E01002920,655,462,102,33,1252
E01002921,338,165,723,145,1371
E01002922,511,431,304,116,1362
E01002923,253,90,378,616,1337
E01002924,569,532,75,11,1187
E01002925,519,175,528,90,1312
E01002926,525,372,259,23,1179
E01002927,568,400,207,87,1262
E01002928,433,384,395,34,1246
E01002929,530,532,211,32,1305
E01002930,431,312,517,104,1364
E01002931,700,431,246,38,1415
E01002932,374,136,267,512,1289
E01002933,539,234,277,440,1490
E01002934,519,335,418,92,1364
E01002935,524,229,692,64,1509
E01002937,680,329,221,54,1284
E01002938,607,410,335,105,1457
E01002939,569,283,208,166,1226
E01002940,562,329,103,217,1211
E01002941,602,435,122,96,1255
E01002942,552,418,68,70,1108
E01002943,461,278,83,280,1102
E01002944,567,266,80,114,1027
E01002945,743,328,118,59,1248
E01002946,685,409,104,31,1229
E01002947,698,446,113,36,1293
E01002948,728,370,210,289,1597
E01002949,763,440,104,135,1442
E01002950,545,249,127,338,1259
E01002951,409,374,394,52,1229
E01002952,373,531,199,12,1115
E01002953,399,373,230,28,1030
E01002954,208,195,432,109,944
E01002955,471,296,332,50,1149
E01002956,388,334,156,69,947
E01002957,206,154,459,494,1313
E01002958,678,362,213,52,1305
E01002959,491,507,111,3,1112
E01002960,558,383,267,55,1263
E01002961,605,521,213,34,1373
E01002962,481,272,185,245,1183
E01002963,451,272,583,103,1409
E01002964,467,171,661,464,1763
E01002965,448,397,1017,218,2080
E01002966,547,344,521,91,1503
E01002967,513,366,719,40,1638
E01002968,592,326,1070,102,2090
E01002969,113,70,195,990,1368
E01002970,412,164,373,320,1269
E01002971,538,243,451,178,1410
E01002972,471,211,711,184,1577
E01002973,345,130,292,298,1065
E01002974,473,343,385,317,1518
E01002975,501,366,175,49,1091
E01002976,655,454,138,40,1287
E01002977,450,340,140,357,1287
E01002978,667,585,181,48,1481
E01002979,582,444,155,69,1250
E01002980,580,406,134,12,1132
E01002981,620,423,163,18,1224
E01002982,468,426,136,78,1108
E01002983,657,541,108,39,1345
E01002984,361,355,221,183,1120
E01002985,537,319,357,71,1284
E01002986,423,356,153,101,1033
E01002987,333,180,717,135,1365
E01002988,339,177,426,87,1029
E01002989,662,281,581,48,1572
E01002990,442,224,779,81,1526
E01002991,530,320,482,37,1369
E01002992,386,195,285,48,914
E01002993,299,276,727,67,1369
E01002994,497,367,262,31,1157
E01002995,425,395,315,16,1151
E01002996,545,262,329,22,1158
E01002997,565,331,240,34,1170
E01002998,504,217,223,223,1167
E01002999,295,165,625,155,1240
E01003000,567,295,169,212,1243
E01003001,782,439,209,17,1447
E01003002,552,272,353,286,1463
E01003003,501,332,356,29,1218
E01003004,579,392,207,56,1234
E01003005,649,363,116,43,1171
E01003006,499,378,212,88,1177
E01003007,585,385,122,45,1137
E01003008,591,359,84,11,1045
E01003009,658,402,223,176,1459
E01003010,513,429,157,67,1166
E01003011,517,494,309,77,1397
E01003013,160,174,958,143,1435
E01003014,190,182,342,532,1246
E01003015,133,103,294,771,1301
E01003016,107,102,412,327,948
E01003017,129,116,357,853,1455
E01003018,434,190,947,252,1823
E01003019,497,188,816,348,1849
E01003020,347,191,545,410,1493
E01003021,203,92,335,608,1238
E01003022,391,178,500,413,1482
E01003023,586,146,916,390,2038
E01003024,219,55,417,685,1376
E01003025,431,183,478,549,1641
E01003026,352,244,561,133,1290
E01003027,452,299,287,40,1078
E01003028,285,259,403,235,1182
E01003029,315,198,724,330,1567
E01003030,428,246,770,101,1545
E01003031,272,96,597,455,1420
E01003032,247,159,514,578,1498
E01003033,376,268,343,226,1213
E01003034,350,142,553,369,1414
E01003035,236,128,779,282,1425
E01003036,313,167,497,372,1349
E01003037,166,63,340,585,1154
E01003038,408,236,522,145,1311
E01003039,443,292,876,153,1764
E01003040,238,241,393,217,1089
E01003041,218,53,427,556,1254
E01003042,134,72,424,289,919
E01003043,349,170,539,364,1422
E01003044,54,16,126,785,981
E01003045,138,31,228,1075,1472
E01003046,171,49,193,849,1262
E01003047,155,47,514,637,1353
E01003048,145,31,180,923,1279
E01003049,208,55,363,637,1263
E01003050,264,141,656,367,1428
E01003051,148,52,545,544,1289
E01003052,159,44,230,937,1370
E01003053,347,233,764,235,1579
E01003054,314,128,1062,193,1697
E01003055,313,91,501,450,1355
E01003056,296,135,876,424,1731
E01003057,200,74,433,696,1403
E01003058,358,159,925,311,1753
E01003059,241,44,279,688,1252
E01003060,174,50,253,749,1226
E01003061,154,62,420,413,1049
E01003062,397,92,504,391,1384
E01003063,290,79,198,540,1107
E01003064,524,158,447,97,1226
E01003065,288,92,144,583,1107
E01003066,317,113,396,501,1327
E01003067,423,172,361,216,1172
E01003068,385,134,250,387,1156
E01003069,339,148,190,323,1000
E01003070,238,50,208,653,1149
E01003071,555,251,750,397,1953
E01003072,449,344,446,221,1460
E01003073,277,115,274,660,1326
E01003074,553,279,599,492,1923
E01003075,156,34,220,789,1199
E01003076,260,98,906,322,1586
E01003077,368,142,666,334,1510
E01003078,494,363,291,157,1305
E01003079,349,130,376,446,1301
E01003080,501,201,454,119,1275
E01003081,342,146,573,326,1387
E01003082,328,131,237,427,1123
E01003083,460,269,261,174,1164
E01003084,518,194,391,153,1256
E01003085,564,336,240,216,1356
E01003086,317,100,160,579,1156
E01003087,178,62,213,586,1039
E01003088,270,100,584,558,1512
E01003089,207,76,401,773,1457
E01003090,456,112,994,509,2071
E01003091,248,98,445,522,1313
E01003092,187,81,346,762,1376
E01003093,238,60,330,1066,1694
E01003094,212,182,518,446,1358
E01003095,402,237,576,321,1536
E01003096,385,175,1096,270,1926
E01003097,207,75,375,743,1400
E01003098,229,215,377,440,1261
E01003099,198,97,554,458,1307
E01003100,321,145,1167,151,1784
E01003101,190,67,503,515,1275
E01003102,291,126,625,454,1496
E01003104,301,146,701,269,1417
E01003105,289,85,247,747,1368
E01003106,369,199,397,628,1593
E01003107,459,215,605,390,1669
E01003108,183,100,259,683,1225
E01003109,336,125,557,840,1858
E01003110,428,239,459,446,1572
E01003111,137,70,164,836,1207
E01003112,207,118,293,655,1273
E01003113,456,201,707,202,1566
E01003114,462,191,723,119,1495
E01003115,360,163,528,225,1276
E01003116,431,352,316,192,1291
E01003117,371,235,797,222,1625
E01003118,452,258,585,112,1407
E01003119,425,200,788,108,1521
E01003120,332,85,1029,179,1625
E01003121,119,39,234,846,1238
E01003122,359,142,553,497,1551
E01003123,348,237,435,263,1283
E01003124,152,98,491,463,1204
E01003125,177,63,221,829,1290
E01003126,221,57,406,536,1220
E01003127,303,198,531,441,1473
E01003128,207,38,335,618,1198
E01003129,266,186,747,390,1589
E01003130,476,269,599,105,1449
E01003131,370,216,454,149,1189
E01003132,254,101,236,487,1078
E01003133,376,171,586,260,1393
E01003134,450,218,354,228,1250
E01003135,386,117,441,451,1395
E01003136,318,134,540,303,1295
E01003137,209,69,417,444,1139
E01003138,473,210,521,106,1310
E01003139,435,285,431,62,1213
E01003140,442,300,326,78,1146
E01003141,460,265,362,258,1345
E01003142,353,314,306,86,1059
E01003143,329,195,224,354,1102
E01003144,540,392,207,53,1192
E01003145,360,155,747,151,1413
E01003146,363,218,358,231,1170
E01003147,507,255,591,226,1579
E01003148,547,166,479,201,1393
E01003149,528,314,443,75,1360
E01003150,276,134,521,389,1320
E01003151,242,75,431,653,1401
E01003152,493,322,656,113,1584
E01003153,404,152,1188,110,1854
E01003154,372,167,400,516,1455
E01003155,500,281,544,128,1453
E01003156,373,190,367,348,1278
E01003157,447,270,333,167,1217
E01003158,548,162,481,184,1375
E01003159,135,107,320,604,1166
E01003160,85,30,195,784,1094
E01003161,249,140,371,231,991
E01003162,205,94,317,944,1560
E01003163,402,296,328,218,1244
E01003164,369,144,739,439,1691
E01003165,385,270,293,316,1264
E01003166,504,195,870,242,1811
E01003167,560,337,332,107,1336
E01003168,98,41,187,902,1228
E01003169,610,239,588,512,1949
E01003170,574,416,313,166,1469
E01003171,412,175,543,331,1461
E01003172,325,92,388,691,1496
E01003173,477,289,500,103,1369
E01003174,209,61,382,835,1487
E01003175,270,70,201,649,1190
E01003176,230,86,371,702,1389
E01003177,276,128,547,420,1371
E01003178,386,186,587,236,1395
E01003179,139,47,178,867,1231
E01003180,281,101,338,508,1228
E01003181,204,41,411,557,1213
E01003182,325,88,448,594,1455
E01003183,201,58,284,701,1244
E01003184,105,10,159,735,1009
E01003185,252,71,561,511,1395
E01003186,345,184,666,449,1644
E01003187,199,58,183,808,1248
E01003188,179,38,186,655,1058
E01003189,330,110,136,610,1186
E01003190,302,130,221,682,1335
E01003191,337,142,169,453,1101
E01003192,304,105,167,661,1237
E01003193,483,290,144,323,1240
E01003194,405,190,279,438,1312
E01003195,570,255,244,117,1186
E01003196,394,124,172,530,1220
E01003197,419,97,143,573,1232
E01003198,385,238,224,283,1130
E01003199,465,241,474,227,1407
E01003200,306,328,520,173,1327
E01003201,301,144,291,536,1272
E01003202,380,428,471,60,1339
E01003203,332,137,570,453,1492
E01003204,270,160,271,387,1088
E01003205,108,56,95,729,988
E01003206,374,299,357,232,1262
E01003207,111,39,342,627,1119
E01003209,314,98,568,553,1533
E01003210,343,135,655,345,1478
E01003211,386,123,509,295,1313
E01003212,510,264,627,310,1711
E01003213,433,173,640,294,1540
E01003214,345,126,479,451,1401
E01003215,160,183,703,287,1333
E01003216,698,203,357,173,1431
E01003217,672,301,215,72,1260
E01003218,596,295,155,109,1155
E01003219,640,338,228,111,1317
E01003220,493,225,307,175,1200
E01003221,595,306,345,238,1484
E01003222,545,288,284,152,1269
E01003223,683,416,231,41,1371
E01003224,644,238,264,148,1294
E01003225,642,317,193,71,1223
E01003226,551,280,518,83,1432
E01003227,615,285,304,154,1358
E01003228,534,199,362,118,1213
E01003229,368,143,375,360,1246
E01003230,485,211,401,426,1523
E01003231,370,213,485,215,1283
E01003232,554,353,279,162,1348
E01003233,573,263,374,150,1360
E01003235,436,224,107,247,1014
E01003236,348,132,185,484,1149
E01003237,359,150,170,416,1095
E01003238,376,136,137,370,1019
E01003239,374,122,112,440,1048
E01003240,506,183,191,466,1346
E01003241,414,241,159,439,1253
E01003243,324,138,220,373,1055
E01003244,76,23,186,814,1099
E01003245,173,17,126,749,1065
E01003246,196,44,263,632,1135
E01003247,292,118,774,315,1499
E01003248,216,50,365,591,1222
E01003249,326,49,490,716,1581
E01003250,249,70,418,690,1427
E01003251,132,24,313,981,1450
E01003252,117,53,84,829,1083
E01003253,184,81,344,558,1167
E01003254,463,342,205,148,1158
E01003255,507,186,678,232,1603
E01003256,394,270,407,602,1673
E01003257,430,225,210,389,1254
E01003258,218,79,170,579,1046
E01003259,471,215,433,198,1317
E01003260,474,313,312,219,1318
E01003261,487,254,188,241,1170
E01003262,375,175,286,226,1062
E01003263,401,210,270,370,1251
E01003264,437,295,242,324,1298
E01003265,339,92,436,297,1164
E01003266,347,211,148,640,1346
E01003267,459,204,102,418,1183
E01003268,580,238,316,231,1365
E01003269,470,264,193,315,1242
E01003270,698,354,233,51,1336
E01003271,660,532,137,44,1373
E01003272,433,232,715,260,1640
E01003273,473,253,264,709,1699
E01003274,455,233,486,196,1370
E01003275,434,165,248,407,1254
E01003276,588,302,283,263,1436
E01003277,452,181,440,336,1409
E01003278,421,237,651,292,1601
E01003279,508,318,317,188,1331
E01003280,430,267,200,335,1232
E01003281,528,350,188,145,1211
E01003282,596,264,847,339,2046
E01003283,685,412,418,142,1657
E01003284,564,290,322,242,1418
E01003285,437,371,445,90,1343
E01003286,277,166,237,614,1294
E01003287,642,422,298,177,1539
E01003288,309,148,417,562,1436
E01003290,297,112,637,377,1423
E01003291,207,51,236,633,1127
E01003292,522,193,474,114,1303
E01003293,371,162,460,216,1209
E01003295,522,174,379,220,1295
E01003296,453,172,735,346,1706
E01003297,278,53,683,168,1182
E01003298,181,53,203,544,981
E01003299,290,73,440,469,1272
E01003300,180,71,185,610,1046
E01003301,458,85,668,349,1560
E01003302,321,78,270,524,1193
E01003303,214,98,385,397,1094
E01003304,261,72,716,526,1575
E01003305,194,117,236,456,1003
E01003307,477,236,272,228,1213
E01003308,541,219,345,302,1407
E01003309,311,164,196,457,1128
E01003310,379,95,369,424,1267
E01003311,504,422,203,126,1255
E01003312,541,278,404,197,1420
E01003313,306,98,228,494,1126
E01003314,562,205,330,182,1279
E01003315,332,109,387,226,1054
E01003316,516,271,246,150,1183
E01003317,527,303,452,156,1438
E01003318,279,108,597,229,1213
E01003319,399,254,428,315,1396
E01003320,318,173,281,381,1153
E01003321,483,186,500,308,1477
E01003322,380,235,370,158,1143
E01003323,442,191,314,239,1186
E01003324,249,126,291,494,1160
E01003325,410,155,381,329,1275
E01003326,377,198,256,287,1118
E01003327,464,264,386,372,1486
E01003328,451,217,353,379,1400
E01003329,497,192,236,315,1240
E01003330,201,147,143,640,1131
E01003331,355,256,185,291,1087
E01003332,393,121,271,401,1186
E01003333,406,182,309,327,1224
E01003334,345,126,405,439,1315
E01003335,269,150,114,545,1078
E01003336,182,57,186,586,1011
E01003337,187,35,122,763,1107
E01003338,175,47,343,830,1395
E01003339,304,139,489,493,1425
E01003340,371,192,904,211,1678
E01003341,341,277,369,229,1216
E01003342,445,143,538,206,1332
E01003343,293,217,329,267,1106
E01003344,361,172,517,405,1455
E01003345,399,152,579,327,1457
E01003346,471,196,140,346,1153
E01003347,193,65,182,713,1153
E01003348,424,313,167,241,1145
E01003349,275,120,138,464,997
E01003350,352,148,112,405,1017
E01003351,389,128,172,380,1069
E01003352,379,336,180,494,1389
E01003353,645,359,255,101,1360
E01003354,639,236,312,89,1276
E01003355,386,212,717,31,1346
E01003356,486,364,486,80,1416
E01003357,317,139,403,568,1427
E01003358,387,299,809,48,1543
E01003359,421,229,539,286,1475
E01003360,534,277,570,39,1420
E01003361,510,375,364,87,1336
E01003362,477,473,123,37,1110
E01003363,643,522,126,9,1300
E01003364,676,570,108,34,1388
E01003365,545,480,140,13,1178
E01003366,455,253,359,210,1277
E01003367,657,255,855,137,1904
E01003368,496,319,392,123,1330
E01003369,468,214,671,103,1456
E01003370,483,183,898,148,1712
E01003371,434,339,495,75,1343
E01003372,330,125,353,410,1218
E01003373,270,102,159,520,1051
E01003374,321,190,227,245,983
E01003375,523,317,291,165,1296
E01003376,327,169,252,502,1250
E01003377,238,74,230,595,1137
E01003378,624,228,306,351,1509
E01003379,367,125,356,547,1395
E01003380,557,362,400,43,1362
E01003381,393,320,541,37,1291
E01003382,484,320,428,47,1279
E01003383,410,221,639,38,1308
E01003384,373,330,499,62,1264
E01003385,485,349,358,50,1242
E01003386,594,262,601,157,1614
E01003387,447,207,213,365,1232
E01003388,432,249,253,241,1175
E01003389,542,277,444,105,1368
E01003390,245,64,264,619,1192
E01003391,275,159,135,413,982
E01003392,465,222,305,72,1064
E01003393,352,118,724,72,1266
E01003394,546,390,614,40,1590
E01003395,542,394,251,17,1204
E01003396,424,338,526,28,1316
E01003397,430,330,465,41,1266
E01003398,505,384,398,79,1366
E01003399,332,305,456,92,1185
E01003400,352,256,611,60,1279
E01003401,272,245,510,100,1127
E01003402,275,425,556,43,1299
E01003403,287,439,498,60,1284
E01003404,362,292,629,179,1462
E01003405,491,212,312,334,1349
E01003406,415,122,263,418,1218
E01003407,512,139,719,102,1472
E01003408,556,240,596,180,1572
E01003409,505,213,291,305,1314
E01003410,410,157,415,280,1262
E01003411,558,215,376,197,1346
E01003412,557,170,221,308,1256
E01003413,711,301,351,107,1470
E01003414,629,353,254,20,1256
E01003415,657,375,207,27,1266
E01003416,625,344,210,44,1223
E01003417,678,472,108,25,1283
E01003418,637,457,83,12,1189
E01003419,777,387,143,46,1353
E01003420,584,347,121,22,1074
E01003421,581,388,240,106,1315
E01003422,558,373,131,34,1096
E01003423,512,277,409,24,1222
E01003424,479,597,135,7,1218
E01003425,483,509,130,13,1135
E01003426,555,514,322,12,1403
E01003427,450,312,620,60,1442
E01003428,382,363,340,113,1198
E01003429,570,309,173,75,1127
E01003430,418,93,175,358,1044
E01003431,376,178,132,422,1108
E01003432,368,116,78,534,1096
E01003433,543,285,236,132,1196
E01003434,632,315,185,46,1178
E01003435,501,349,164,36,1050
E01003436,498,215,172,318,1203
E01003437,575,498,301,158,1532
E01003438,479,217,179,432,1307
E01003439,333,139,417,239,1128
E01003440,463,264,200,292,1219
E01003441,501,212,312,344,1369
E01003442,438,408,354,67,1267
E01003443,476,459,234,28,1197
E01003444,432,406,329,67,1234
E01003445,572,453,208,120,1353
E01003446,384,303,675,84,1446
E01003447,415,113,361,324,1213
E01003448,501,209,240,356,1306
E01003449,541,268,335,230,1374
E01003450,468,212,160,365,1205
E01003451,652,424,112,185,1373
E01003452,441,153,172,808,1574
E01003453,413,255,336,291,1295
E01003454,385,269,377,81,1112
E01003455,502,145,548,147,1342
E01003456,337,262,600,55,1254
E01003457,494,349,337,66,1246
E01003458,533,250,506,35,1324
E01003459,474,196,617,421,1708
E01003460,311,476,304,116,1207
E01003461,281,435,574,12,1302
E01003462,375,495,225,82,1177
E01003463,374,444,166,6,990
E01003464,284,534,212,32,1062
E01003465,281,544,160,11,996
E01003466,574,497,213,10,1294
E01003467,608,430,201,52,1291
E01003468,690,461,171,17,1339
E01003469,604,251,309,94,1258
E01003470,636,371,306,50,1363
E01003471,438,342,310,129,1219
E01003472,498,340,169,8,1015
E01003473,391,342,353,7,1093
E01003474,402,431,228,17,1078
E01003475,673,335,772,289,2069
E01003476,322,229,301,211,1063
E01003477,451,280,414,53,1198
E01003478,574,294,367,19,1254
E01003479,327,114,473,226,1140
E01003480,337,93,430,533,1393
E01003481,250,79,284,375,988
E01003482,548,87,821,614,2070
E01003483,237,74,213,616,1140
E01003484,447,94,561,131,1233
E01003485,411,143,479,158,1191
E01003486,71,8,127,730,936
E01003487,126,31,160,637,954
E01003488,195,121,296,784,1396
E01003489,186,110,435,566,1297
E01003490,380,180,546,256,1362
E01003491,289,242,781,326,1638
E01003492,504,276,586,119,1485
E01003493,442,308,768,259,1777
E01003494,605,266,503,106,1480
E01003495,742,260,475,82,1559
E01003496,167,40,445,516,1168
E01003497,247,125,521,457,1350
E01003498,230,91,460,561,1342
E01003499,264,135,509,768,1676
E01003500,349,93,416,684,1542
E01003501,372,173,490,530,1565
E01003502,284,97,498,577,1456
E01003503,235,53,246,741,1275
E01003506,191,75,287,564,1117
E01003507,427,228,570,422,1647
E01003508,201,120,439,419,1179
E01003509,175,65,1029,233,1502
E01003511,109,36,148,639,932
E01003512,350,137,401,515,1403
E01003513,437,120,496,140,1193
E01003514,227,67,273,562,1129
E01003515,278,82,330,661,1351
E01003516,209,79,324,761,1373
E01003517,333,61,272,598,1264
E01003518,489,168,411,168,1236
E01003519,317,160,464,295,1236
E01003520,303,256,876,191,1626
E01003521,358,263,1142,82,1845
E01003522,390,207,695,133,1425
E01003523,390,246,572,348,1556
E01003524,346,300,734,202,1582
E01003525,381,258,770,126,1535
E01003526,488,313,502,155,1458
E01003527,559,245,400,107,1311
E01003528,215,136,204,437,992
E01003529,513,529,781,103,1926
E01003530,407,379,559,102,1447
E01003531,327,381,629,246,1583
E01003532,408,514,579,113,1614
E01003533,425,336,484,185,1430
E01003534,549,352,766,130,1797
E01003535,319,66,209,642,1236
E01003536,469,177,438,234,1318
E01003537,589,239,517,194,1539
E01003538,439,147,503,383,1472
E01003539,593,204,513,283,1593
E01003540,330,140,321,524,1315
E01003541,518,199,398,195,1310
E01003542,323,167,334,540,1364
E01003543,486,313,705,437,1941
E01003544,368,215,671,261,1515
E01003545,232,134,457,489,1312
E01003546,353,126,450,487,1416
E01003547,553,309,428,241,1531
E01003548,396,186,991,365,1938
E01003549,327,200,726,488,1741
E01003550,355,177,488,367,1387
E01003551,254,166,685,259,1364
E01003552,348,216,541,207,1312
E01003553,209,88,657,549,1503
E01003554,270,257,799,263,1589
E01003555,469,349,528,135,1481
E01003556,265,141,545,423,1374
E01003557,315,175,727,325,1542
E01003558,258,224,600,138,1220
E01003559,438,183,1106,424,2151
E01003560,420,331,545,79,1375
E01003561,445,288,658,83,1474
E01003562,430,463,791,110,1794
E01003563,444,284,704,106,1538
E01003564,457,341,920,176,1894
E01003565,293,275,735,133,1436
E01003566,234,224,679,248,1385
E01003567,319,261,656,183,1419
E01003568,477,530,656,176,1839
E01003569,336,313,826,88,1563
E01003570,449,275,700,181,1605
E01003571,431,402,821,114,1768
E01003572,343,373,515,106,1337
E01003573,436,406,696,117,1655
E01003574,483,423,924,268,2098
E01003575,375,213,417,199,1204
E01003576,225,89,541,530,1385
E01003577,208,48,258,797,1311
E01003578,248,137,840,194,1419
E01003579,424,214,549,189,1376
E01003580,381,163,410,325,1279
E01003581,410,240,602,142,1394
E01003582,295,136,440,297,1168
E01003583,424,259,600,118,1401
E01003584,603,301,486,198,1588
E01003585,408,294,458,79,1239
E01003586,405,243,644,122,1414
E01003587,409,188,815,455,1867
E01003588,364,294,574,122,1354
E01003589,369,268,687,76,1400
E01003590,210,102,302,495,1109
E01003591,310,190,737,394,1631
E01003592,393,233,495,289,1410
E01003593,216,88,332,545,1181
E01003594,382,107,442,393,1324
E01003595,190,108,419,492,1209
E01003596,296,247,536,288,1367
E01003597,352,257,484,181,1274
E01003598,223,86,334,736,1379
E01003599,244,166,428,397,1235
E01003600,229,120,350,696,1395
E01003601,438,183,406,523,1550
E01003602,469,226,589,279,1563
E01003603,556,214,475,154,1399
E01003604,459,177,555,500,1691
E01003605,414,267,559,360,1600
E01003606,515,222,641,231,1609
E01003607,281,126,423,419,1249
E01003608,610,249,547,154,1560
E01003609,343,112,886,722,2063
E01003611,173,58,303,722,1256
E01003615,245,193,675,381,1494
E01003616,225,97,661,420,1403
E01003617,376,89,1085,800,2350
E01003618,287,189,1056,316,1848
E01003619,378,72,822,603,1875
E01003621,438,168,476,129,1211
E01003622,328,116,443,286,1173
E01003623,369,107,452,309,1237
E01003624,339,158,321,343,1161
E01003625,419,167,527,161,1274
E01003626,404,235,566,39,1244
E01003627,344,316,514,102,1276
E01003628,443,302,459,64,1268
E01003629,332,226,642,52,1252
E01003630,207,114,536,697,1554
E01003631,295,109,600,465,1469
E01003632,523,260,724,281,1788
E01003633,170,41,271,900,1382
E01003634,285,80,386,657,1408
E01003635,350,373,677,221,1621
E01003636,233,90,513,650,1486
E01003637,265,238,647,330,1480
E01003638,645,304,121,237,1307
E01003639,561,304,273,232,1370
E01003640,685,375,244,57,1361
E01003641,634,342,245,70,1291
E01003642,521,338,194,202,1255
E01003643,651,472,209,47,1379
E01003644,539,438,188,47,1212
E01003645,677,287,769,131,1864
E01003646,583,395,359,47,1384
E01003647,562,438,401,21,1422
E01003648,575,541,92,6,1214
E01003649,668,409,155,61,1293
E01003650,495,355,203,141,1194
E01003651,662,400,125,8,1195
E01003652,652,358,148,32,1190
E01003653,422,328,368,19,1137
E01003654,596,330,157,142,1225
E01003655,542,388,254,59,1243
E01003656,455,298,161,303,1217
E01003657,715,566,287,113,1681
E01003658,456,212,208,397,1273
E01003659,735,371,155,22,1283
E01003660,755,456,163,20,1394
E01003661,762,443,167,117,1489
E01003662,538,305,469,110,1422
E01003663,588,537,145,87,1357
E01003664,684,367,142,113,1306
E01003665,709,341,130,34,1214
E01003666,673,220,483,212,1588
E01003668,454,444,432,40,1370
E01003669,578,411,202,33,1224
E01003670,461,374,187,152,1174
E01003671,721,435,52,9,1217
E01003672,391,191,345,229,1156
E01003673,663,301,447,45,1456
E01003674,623,271,773,110,1777
E01003675,534,454,227,34,1249
E01003676,687,403,169,48,1307
E01003677,595,477,154,13,1239
E01003678,679,387,131,39,1236
E01003679,739,487,84,4,1314
E01003680,722,393,114,6,1235
E01003681,637,390,284,148,1459
E01003682,673,463,153,13,1302
E01003683,549,318,515,98,1480
E01003684,493,304,341,106,1244
E01003685,457,338,513,52,1360
E01003686,531,357,436,93,1417
E01003688,426,398,442,93,1359
E01003689,358,285,425,116,1184
E01003690,431,353,455,75,1314
E01003691,542,246,262,32,1082
E01003692,565,320,306,23,1214
E01003693,602,448,165,24,1239
E01003694,498,441,182,52,1173
E01003695,401,323,439,47,1210
E01003696,783,409,269,47,1508
E01003697,663,352,220,25,1260
E01003698,570,383,117,35,1105
E01003699,542,411,158,34,1145
E01003700,833,472,292,178,1775
E01003701,531,415,370,68,1384
E01003702,543,376,337,61,1317
E01003703,911,506,355,178,1950
E01003704,605,295,210,206,1316
E01003705,791,478,309,116,1694
E01003706,472,413,243,77,1205
E01003707,548,343,106,69,1066
E01003708,392,235,190,305,1122
E01003709,619,498,145,30,1292
E01003710,619,498,104,21,1242
E01003711,603,433,251,138,1425
E01003712,336,156,136,412,1040
E01003713,582,349,335,62,1328
E01003714,636,385,475,71,1567
E01003715,558,395,502,52,1507
E01003716,591,319,281,109,1300
E01003718,555,258,483,72,1368
E01003719,540,409,514,66,1529
E01003720,429,362,208,439,1438
E01003721,511,375,175,174,1235
E01003722,562,314,163,338,1377
E01003723,526,294,103,405,1328
E01003724,511,305,111,124,1051
E01003725,444,205,243,236,1128
E01003726,426,190,139,389,1144
E01003727,497,229,140,351,1217
E01003728,465,269,779,281,1794
E01003729,379,232,515,162,1288
E01003730,419,311,385,61,1176
E01003731,374,220,355,124,1073
E01003732,192,72,364,370,998
E01003733,605,267,357,76,1305
E01003734,486,244,416,88,1234
E01003735,292,117,387,745,1541
E01003736,423,218,319,166,1126
E01003737,647,499,151,96,1393
E01003738,847,466,267,39,1619
E01003739,828,372,256,134,1590
E01003740,802,452,231,84,1569
E01003741,628,445,209,116,1398
E01003742,680,263,481,65,1489
E01003743,548,275,404,44,1271
E01003744,499,502,117,27,1145
E01003745,581,503,51,1,1136
E01003746,503,557,162,15,1237
E01003747,491,491,39,34,1055
E01003748,503,520,151,13,1187
E01003749,468,528,328,14,1338
E01003750,501,457,268,172,1398
E01003751,651,389,335,94,1469
E01003752,945,489,434,130,1998
E01003753,567,368,518,33,1486
E01003754,596,386,216,64,1262
E01003755,748,355,303,53,1459
E01003756,724,454,341,69,1588
E01003757,569,311,437,107,1424
E01003758,541,224,562,457,1784
E01003759,588,463,114,14,1179
E01003760,637,350,276,123,1386
E01003761,156,77,166,785,1184
E01003762,643,303,229,99,1274
E01003763,815,417,169,37,1438
E01003764,590,340,474,166,1570
E01003765,607,275,318,52,1252
E01003766,605,420,374,54,1453
E01003767,471,285,593,53,1402
E01003768,403,289,558,96,1346
E01003769,415,232,583,48,1278
E01003770,826,316,433,273,1848
E01003771,571,320,420,83,1394
E01003772,528,426,334,25,1313
E01003773,643,279,284,52,1258
E01003774,589,396,386,113,1484
E01003775,512,516,364,33,1425
E01003776,301,225,418,465,1409
E01003777,567,412,485,59,1523
E01003778,504,429,574,68,1575
E01003779,469,377,276,107,1229
E01003780,580,554,68,14,1216
E01003781,377,350,476,75,1278
E01003782,358,354,520,58,1290
E01003783,347,277,849,202,1675
E01003784,575,290,392,79,1336
E01003785,362,262,706,87,1417
E01003786,524,315,226,26,1091
E01003787,431,407,288,30,1156
E01003788,343,296,653,72,1364
E01003789,457,402,171,192,1222
E01003790,462,351,142,159,1114
E01003791,520,559,115,29,1223
E01003792,561,375,127,38,1101
E01003793,442,258,248,324,1272
E01003794,484,411,139,98,1132
E01003795,407,420,88,22,937
E01003796,510,404,226,134,1274
E01003797,380,515,109,70,1074
E01003798,328,432,277,188,1225
E01003799,429,405,371,60,1265
E01003800,299,378,246,298,1221
E01003801,311,348,387,26,1072
E01003802,288,359,401,51,1099
E01003803,209,177,205,600,1191
E01003804,512,385,401,72,1370
E01003805,497,574,132,29,1232
E01003806,426,513,134,36,1109
E01003807,468,316,548,152,1484
E01003808,590,376,314,134,1414
E01003809,562,540,174,48,1324
E01003810,626,356,143,87,1212
E01003811,611,347,188,30,1176
E01003812,663,314,334,133,1444
E01003813,589,538,141,32,1300
E01003814,535,409,266,104,1314
E01003815,562,273,416,161,1412
E01003816,424,472,180,192,1268
E01003817,457,520,312,139,1428
E01003818,482,449,195,120,1246
E01003819,408,220,186,516,1330
E01003820,563,392,223,341,1519
E01003821,240,282,624,108,1254
E01003822,549,493,64,19,1125
E01003823,478,552,361,38,1429
E01003824,587,480,158,49,1274
E01003825,693,467,138,81,1379
E01003826,350,244,196,553,1343
E01003827,587,292,343,165,1387
E01003828,518,534,124,73,1249
E01003829,467,299,123,440,1329
E01003830,516,483,263,161,1423
E01003831,584,417,185,76,1262
E01003832,337,165,95,564,1161
E01003833,431,286,184,214,1115
E01003834,377,341,438,132,1288
E01003835,560,396,109,34,1099
E01003836,392,333,147,273,1145
E01003837,473,599,254,104,1430
E01003838,556,341,350,138,1385
E01003839,575,315,345,258,1493
E01003840,565,314,259,110,1248
E01003841,425,224,277,555,1481
E01003842,501,318,132,378,1329
E01003843,598,491,183,330,1602
E01003844,480,540,100,82,1202
E01003845,639,562,105,36,1342
E01003846,553,533,210,26,1322
E01003847,318,402,607,62,1389
E01003848,537,276,459,193,1465
E01003849,435,450,246,58,1189
E01003851,457,489,303,13,1262
E01003852,326,333,333,129,1121
E01003853,340,444,176,193,1153
E01003854,337,342,318,146,1143
E01003855,349,226,352,471,1398
E01003856,471,214,459,144,1288
E01003857,509,344,380,126,1359
E01003858,579,340,272,51,1242
E01003859,539,397,213,73,1222
E01003860,404,345,531,164,1444
E01003861,535,251,547,143,1476
E01003862,307,318,272,226,1123
E01003863,342,232,207,371,1152
E01003864,354,430,343,91,1218
E01003865,391,262,183,181,1017
E01003866,586,357,240,12,1195
E01003867,510,309,276,95,1190
E01003868,501,284,362,22,1169
E01003869,513,382,418,22,1335
E01003870,733,337,303,48,1421
E01003871,547,346,244,87,1224
E01003872,398,348,392,34,1172
E01003873,384,369,501,113,1367
E01003874,346,322,543,73,1284
E01003875,405,464,281,108,1258
E01003876,328,378,666,60,1432
E01003877,336,422,383,72,1213
E01003878,179,141,171,595,1086
E01003879,299,350,412,24,1085
E01003880,491,432,156,58,1137
E01003881,342,331,182,36,891
E01003882,640,382,368,25,1415
E01003883,746,301,358,69,1474
E01003884,488,421,247,123,1279
E01003885,552,304,280,49,1185
E01003886,548,361,329,65,1303
E01003887,587,424,339,42,1392
E01003888,457,310,412,364,1543
E01003889,513,530,317,31,1391
E01003890,521,389,257,33,1200
E01003891,584,508,323,28,1443
E01003892,476,478,582,24,1560
E01003893,395,348,516,51,1310
E01003894,482,311,478,55,1326
E01003895,550,347,342,118,1357
E01003896,439,305,629,42,1415
E01003897,533,286,477,116,1412
E01003898,568,240,336,42,1186
E01003899,532,300,252,24,1108
E01003900,415,261,159,387,1222
E01003901,672,385,115,62,1234
E01003902,536,334,102,28,1000
E01003903,558,345,163,168,1234
E01003904,551,242,235,173,1201
E01003905,490,331,250,39,1110
E01003906,565,343,235,98,1241
E01003907,458,271,189,402,1320
E01003908,686,520,217,30,1453
E01003909,472,479,251,80,1282
E01003910,607,561,140,21,1329
E01003911,229,55,331,873,1488
E01003912,82,17,104,909,1112
E01003913,332,239,607,355,1533
E01003914,446,213,484,379,1522
E01003915,354,125,298,795,1572
E01003916,454,153,586,510,1703
E01003917,371,130,338,626,1465
E01003918,125,35,215,854,1229
E01003919,218,105,414,637,1374
E01003920,208,43,192,922,1365
E01003921,69,20,334,703,1126
E01003922,211,100,399,792,1502
E01003923,324,96,479,537,1436
E01003924,102,35,356,987,1480
E01003925,84,31,167,703,985
E01003926,148,40,257,668,1113
E01003927,356,84,743,592,1775
E01003929,346,148,846,588,1928
E01003930,118,65,300,331,814
E01003932,179,81,384,585,1229
E01003933,218,116,361,493,1188
E01003934,234,148,377,511,1270
E01003935,121,38,197,458,814
E01003936,172,79,539,309,1099
E01003937,398,108,644,251,1401
E01003938,293,77,397,718,1485
E01003939,250,107,785,483,1625
E01003940,140,37,280,687,1144
E01003941,408,112,700,480,1700
E01003942,163,38,266,640,1107
E01003943,123,36,286,613,1058
E01003945,539,366,255,208,1368
E01003946,427,410,268,260,1365
E01003947,175,84,176,665,1100
E01003948,484,264,368,139,1255
E01003949,590,261,482,203,1536
E01003950,336,154,314,685,1489
E01003951,358,378,221,155,1112
E01003952,494,230,453,181,1358
E01003953,544,212,641,392,1789
E01003954,536,264,315,178,1293
E01003955,545,222,453,327,1547
E01003956,586,234,372,175,1367
E01003957,564,251,346,246,1407
E01003958,505,271,340,241,1357
E01003960,324,94,696,444,1558
E01003961,187,60,402,989,1638
E01003963,127,37,339,758,1261
E01003964,197,89,465,797,1548
E01003966,149,63,568,792,1572
E01003967,104,26,162,990,1282
E01003968,79,47,110,833,1069
E01003969,289,138,687,438,1552
E01003970,83,60,135,856,1134
E01003971,116,34,110,980,1240
E01003972,151,42,329,769,1291
E01003973,96,22,331,850,1299
E01003974,92,44,101,729,966
E01003975,197,35,219,779,1230
E01003976,295,76,583,680,1634
E01003977,244,76,325,760,1405
E01003978,363,70,594,528,1555
E01003979,240,73,548,564,1425
E01003980,126,51,666,832,1675
E01003981,128,55,507,581,1271
E01003983,108,40,236,1087,1471
E01003984,370,148,568,594,1680
E01003986,76,39,162,683,960
E01003987,178,57,250,930,1415
E01003988,228,110,417,943,1698
E01003989,176,30,247,943,1396
E01003990,214,94,265,1016,1589
E01003991,156,82,193,592,1023
E01003992,137,69,231,695,1132
E01003993,179,45,155,890,1269
E01003994,199,57,383,613,1252
E01003995,169,91,227,660,1147
E01003997,231,81,304,384,1000
E01003998,232,120,358,466,1176
E01003999,250,69,338,508,1165
E01004000,399,178,430,534,1541
E01004001,247,77,172,832,1328
E01004002,543,264,277,215,1299
E01004003,243,102,247,772,1364
E01004004,514,204,668,664,2050
E01004005,256,46,374,883,1559
E01004006,436,181,605,418,1640
E01004007,137,12,120,664,933
E01004008,273,61,269,1042,1645
E01004010,243,49,363,518,1173
E01004011,256,23,188,1037,1504
E01004012,423,44,500,913,1880
E01004013,224,34,254,733,1245
E01004014,207,35,255,835,1332
E01004015,413,222,354,258,1247
E01004016,732,325,386,361,1804
E01004017,465,310,298,154,1227
E01004018,700,310,412,100,1522
E01004019,531,153,368,719,1771
E01004020,275,80,233,702,1290
E01004021,539,173,882,232,1826
E01004022,579,171,429,930,2109
E01004023,210,117,287,666,1280
E01004024,156,46,425,857,1484
E01004027,278,99,711,711,1799
E01004028,251,48,287,740,1326
E01004029,404,143,851,213,1611
E01004030,205,104,366,623,1298
E01004031,427,134,509,610,1680
E01004032,503,185,766,65,1519
E01004033,198,39,313,696,1246
E01004034,180,47,300,679,1206
E01004035,126,71,256,798,1251
E01004036,142,63,454,845,1504
E01004037,360,51,505,651,1567
E01004038,490,40,618,621,1769
E01004039,326,96,481,385,1288
E01004040,131,28,133,1040,1332
E01004041,115,64,332,786,1297
E01004042,144,89,329,879,1441
E01004043,295,198,278,396,1167
E01004044,172,68,184,646,1070
E01004045,129,37,129,805,1100
E01004046,409,241,329,345,1324
E01004047,196,55,231,706,1188
E01004048,406,154,266,447,1273
E01004049,172,83,200,528,983
E01004050,425,196,440,195,1256
E01004051,443,245,284,144,1116
E01004052,472,207,516,295,1490
E01004053,568,230,686,155,1639
E01004054,524,163,684,105,1476
E01004055,132,68,97,746,1043
E01004056,379,97,762,574,1812
E01004057,288,213,405,359,1265
E01004058,515,215,839,12,1581
E01004059,321,150,879,56,1406
E01004060,239,78,553,612,1482
E01004061,439,251,479,319,1488
E01004062,400,109,523,483,1515
E01004063,473,241,480,449,1643
E01004064,291,94,390,736,1511
E01004065,430,189,387,232,1238
E01004066,398,169,400,695,1662
E01004067,266,116,405,909,1696
E01004068,427,84,240,783,1534
E01004069,429,430,136,59,1054
E01004070,559,353,338,311,1561
E01004071,418,146,303,394,1261
E01004072,557,398,244,124,1323
E01004073,532,354,422,173,1481
E01004074,553,481,245,108,1387
E01004075,501,528,217,98,1344
E01004076,560,245,149,203,1157
E01004077,606,393,140,108,1247
E01004078,667,204,174,218,1263
E01004079,638,426,48,9,1121
E01004080,583,452,54,3,1092
E01004081,645,278,142,92,1157
E01004082,664,391,66,10,1131
E01004083,174,97,74,725,1070
E01004084,616,534,58,5,1213
E01004085,664,539,81,23,1307
E01004086,616,363,148,150,1277
E01004087,612,522,56,16,1206
E01004088,108,17,49,1123,1297
E01004089,282,84,65,488,919
E01004090,232,83,123,443,881
E01004091,543,505,19,8,1075
E01004092,544,516,146,16,1222
E01004093,569,438,177,22,1206
E01004094,643,368,291,32,1334
E01004095,554,489,177,8,1228
E01004096,397,201,496,99,1193
E01004097,704,389,213,32,1338
E01004098,448,358,137,32,975
E01004099,479,236,245,217,1177
E01004100,506,437,115,43,1101
E01004101,563,425,100,22,1110
E01004102,532,355,145,60,1092
E01004103,656,285,303,54,1298
E01004104,583,553,60,13,1209
E01004105,724,479,122,96,1421
E01004106,614,600,41,3,1258
E01004107,593,282,116,183,1174
E01004108,679,400,98,76,1253
E01004109,594,311,82,291,1278
E01004110,552,405,437,82,1476
E01004111,651,337,116,51,1155
E01004112,578,564,166,4,1312
E01004114,596,678,66,13,1353
E01004115,783,461,125,5,1374
E01004116,581,567,67,56,1271
E01004117,689,400,53,12,1154
E01004118,595,465,245,41,1346
E01004119,690,394,69,4,1157
E01004120,712,485,60,11,1268
E01004121,532,428,277,34,1271
E01004122,531,451,81,61,1124
E01004123,596,155,392,484,1627
E01004124,632,196,143,404,1375
E01004125,420,144,118,517,1199
E01004126,402,122,94,476,1094
E01004127,576,223,104,329,1232
E01004128,396,151,94,433,1074
E01004129,439,163,128,634,1364
E01004130,653,460,118,61,1292
E01004131,666,383,175,51,1275
E01004132,661,393,84,10,1148
E01004133,676,401,65,9,1151
E01004134,543,414,176,46,1179
E01004135,592,454,133,14,1193
E01004136,684,446,88,51,1269
E01004137,470,285,449,43,1247
E01004138,609,224,256,145,1234
E01004139,548,246,256,53,1103
E01004140,377,122,279,475,1253
E01004141,494,241,224,292,1251
E01004142,496,120,436,607,1659
E01004143,597,241,187,116,1141
E01004144,649,492,179,28,1348
E01004145,881,483,194,122,1680
E01004146,659,283,227,112,1281
E01004147,614,456,85,94,1249
E01004148,513,220,160,298,1191
E01004149,560,499,256,109,1424
E01004150,266,252,524,311,1353
E01004151,453,268,534,79,1334
E01004152,341,283,499,187,1310
E01004153,372,360,565,130,1427
E01004154,488,521,122,30,1161
E01004155,533,304,441,26,1304
E01004156,364,298,689,55,1406
E01004157,555,407,49,9,1020
E01004158,436,380,362,27,1205
E01004159,635,381,168,56,1240
E01004160,604,298,316,36,1254
E01004161,663,293,153,27,1136
E01004162,448,260,478,61,1247
E01004163,734,377,79,54,1244
E01004164,627,366,139,102,1234
E01004165,635,272,235,203,1345
E01004166,583,325,178,121,1207
E01004167,386,177,128,331,1022
E01004168,724,404,104,36,1268
E01004169,386,116,111,246,859
E01004170,653,396,306,62,1417
E01004171,620,382,109,57,1168
E01004172,415,227,280,289,1211
E01004173,535,317,59,203,1114
E01004174,544,297,255,65,1161
E01004175,679,324,147,133,1283
E01004176,576,225,184,138,1123
E01004177,369,355,349,337,1410
E01004178,675,301,488,150,1614
E01004179,676,389,148,31,1244
E01004180,667,639,82,17,1405
E01004181,510,409,257,150,1326
E01004182,434,159,158,409,1160
E01004183,472,133,138,551,1294
E01004184,448,111,102,481,1142
E01004185,296,71,143,543,1053
E01004186,675,166,354,164,1359
E01004187,609,246,105,270,1230
E01004188,540,242,280,221,1283
E01004189,586,182,110,567,1445
E01004190,563,471,96,5,1135
E01004191,630,469,223,18,1340
E01004192,787,278,251,197,1513
E01004193,965,287,283,158,1693
E01004194,567,321,124,81,1093
E01004195,507,311,373,71,1262
E01004196,588,441,115,21,1165
E01004197,272,98,674,818,1862
E01004198,131,72,305,727,1235
E01004199,113,47,220,792,1172
E01004200,174,53,721,279,1227
E01004201,184,77,360,603,1224
E01004202,274,119,574,460,1427
E01004203,235,141,655,435,1466
E01004204,190,99,253,701,1243
E01004205,162,61,445,912,1580
E01004206,161,77,357,588,1183
E01004207,161,66,293,558,1078
E01004208,331,146,882,253,1612
E01004209,104,48,212,621,985
E01004211,265,95,623,356,1339
E01004212,200,110,510,489,1309
E01004214,113,37,187,871,1208
E01004215,379,209,933,685,2206
E01004216,325,108,648,282,1363
E01004217,320,181,429,499,1429
E01004218,413,211,608,229,1461
E01004219,279,77,504,895,1755
E01004221,361,90,670,440,1561
E01004222,255,156,402,1118,1931
E01004223,171,91,319,1094,1675
E01004224,236,71,608,718,1633
E01004225,635,158,980,193,1966
E01004226,218,96,393,613,1320
E01004228,395,170,501,491,1557
E01004229,287,112,371,421,1191
E01004230,288,170,603,632,1693
E01004231,183,69,432,630,1314
E01004232,292,243,647,231,1413
E01004233,207,127,308,745,1387
E01004234,477,254,692,418,1841
E01004235,108,21,219,630,978
E01004236,189,40,280,693,1202
E01004237,156,58,244,441,899
E01004238,281,101,767,919,2068
E01004239,175,69,217,749,1210
E01004240,175,81,267,746,1269
E01004241,117,48,278,732,1175
E01004242,237,61,633,857,1788
E01004243,162,80,297,733,1272
E01004244,147,109,289,750,1295
E01004245,129,34,145,701,1009
E01004246,471,229,431,409,1540
E01004247,192,81,462,722,1457
E01004248,53,30,163,650,896
E01004249,182,70,314,913,1479
E01004250,203,67,308,1110,1688
E01004251,301,122,384,775,1582
E01004252,363,118,691,917,2089
E01004253,230,147,358,904,1639
E01004254,489,217,1027,159,1892
E01004255,263,54,369,564,1250
E01004256,222,90,346,641,1299
E01004257,169,71,413,662,1315
E01004258,314,213,456,301,1284
E01004259,309,122,604,407,1442
E01004260,232,134,376,620,1362
E01004261,118,74,596,530,1318
E01004262,144,95,406,487,1132
E01004263,126,57,239,658,1080
E01004264,186,106,321,511,1124
E01004266,215,132,362,548,1257
E01004267,212,63,573,594,1442
E01004268,104,52,385,775,1316
E01004269,167,115,556,677,1515
E01004270,375,116,987,414,1892
E01004271,107,48,275,668,1098
E01004272,187,37,297,922,1443
E01004273,152,64,213,932,1361
E01004274,207,92,490,737,1526
E01004275,400,151,616,354,1521
E01004276,532,215,1083,21,1851
E01004277,305,203,934,38,1480
E01004280,250,137,515,571,1473
E01004281,342,129,921,139,1531
E01004283,241,90,465,867,1663
E01004284,395,29,233,1109,1766
E01004285,223,75,323,984,1605
E01004286,319,113,269,1039,1740
E01004287,313,126,447,776,1662
E01004288,144,41,180,758,1123
E01004289,234,159,483,601,1477
E01004290,181,125,526,261,1093
E01004291,497,260,709,202,1668
E01004292,453,220,772,122,1567
E01004293,427,377,844,277,1925
E01004294,363,204,577,355,1499
E01004295,144,79,250,597,1070
E01004296,234,100,410,549,1293
E01004297,493,269,691,173,1626
E01004298,154,68,333,727,1282
E01004300,120,85,191,633,1029
E01004301,217,84,282,392,975
E01004302,339,77,344,646,1406
E01004303,374,142,578,750,1844
E01004304,278,66,382,747,1473
E01004305,244,69,406,741,1460
E01004306,239,174,669,456,1538
E01004307,300,171,989,259,1719
E01004308,312,125,379,378,1194
E01004309,333,133,657,844,1967
E01004310,228,106,646,644,1624
E01004311,178,98,342,597,1215
E01004312,128,58,410,692,1288
E01004313,246,130,580,622,1578
E01004314,269,195,331,144,939
E01004315,269,122,474,573,1438
E01004316,150,64,301,418,933
E01004317,396,153,1199,617,2365
E01004318,126,51,301,636,1114
E01004319,197,166,552,555,1470
E01004321,185,85,380,801,1451
E01004322,131,56,303,437,927
E01004323,216,100,437,437,1190
E01004324,277,99,283,517,1176
E01004325,215,131,1436,400,2182
E01004326,188,73,513,400,1174
E01004327,246,95,300,341,982
E01004328,495,172,645,170,1482
E01004329,459,183,661,212,1515
E01004330,453,271,626,127,1477
E01004331,385,204,609,229,1427
E01004332,294,201,685,243,1423
E01004333,282,156,386,496,1320
E01004334,178,66,179,705,1128
E01004335,114,46,222,886,1268
E01004336,229,385,668,190,1472
E01004337,284,168,448,621,1521
E01004338,325,296,755,121,1497
E01004339,344,199,627,226,1396
E01004340,224,101,461,656,1442
E01004341,247,101,430,583,1361
E01004342,513,258,581,318,1670
E01004343,733,380,232,74,1419
E01004344,521,204,308,306,1339
E01004345,657,260,383,134,1434
E01004346,588,250,215,177,1230
E01004347,680,250,440,182,1552
E01004348,778,297,752,216,2043
E01004349,413,279,84,353,1129
E01004350,472,388,201,404,1465
E01004351,568,541,85,93,1287
E01004352,622,612,271,51,1556
E01004353,594,635,168,115,1512
E01004354,589,447,317,56,1409
E01004355,554,283,159,281,1277
E01004356,548,366,117,269,1300
E01004357,496,436,115,193,1240
E01004358,603,396,184,200,1383
E01004359,625,447,104,174,1350
E01004360,521,470,62,36,1089
E01004361,574,397,88,23,1082
E01004362,395,234,493,199,1321
E01004363,555,336,338,40,1269
E01004364,358,265,377,316,1316
E01004365,370,293,983,206,1852
E01004366,477,463,480,90,1510
E01004367,418,329,418,109,1274
E01004368,439,319,675,122,1555
E01004369,331,135,797,95,1358
E01004370,431,255,645,86,1417
E01004371,369,282,650,110,1411
E01004372,424,182,776,56,1438
E01004373,372,246,689,128,1435
E01004374,452,309,670,114,1545
E01004375,370,211,786,130,1497
E01004376,371,361,847,122,1701
E01004377,666,408,224,85,1383
E01004378,551,323,278,256,1408
E01004379,641,343,119,32,1135
E01004380,494,308,121,280,1203
E01004381,734,353,205,120,1412
E01004382,237,94,89,524,944
E01004383,646,382,100,127,1255
E01004384,474,225,149,472,1320
E01004385,356,244,130,372,1102
E01004386,681,581,84,28,1374
E01004387,644,442,93,23,1202
E01004388,438,333,257,152,1180
E01004389,453,302,131,383,1269
E01004390,408,258,97,468,1231
E01004391,436,252,552,247,1487
E01004392,591,285,808,163,1847
E01004393,960,119,495,477,2051
E01004394,316,261,420,429,1426
E01004395,486,261,376,110,1233
E01004396,501,325,514,77,1417
E01004397,557,337,811,201,1906
E01004398,396,162,215,725,1498
E01004399,334,79,146,699,1258
E01004400,501,222,379,220,1322
E01004401,554,241,546,301,1642
E01004402,504,205,272,376,1357
E01004403,496,167,249,426,1338
E01004404,406,110,582,451,1549
E01004405,386,258,360,235,1239
E01004406,331,185,789,153,1458
E01004407,112,49,190,528,879
E01004408,457,263,410,229,1359
E01004409,411,224,502,222,1359
E01004410,319,141,363,629,1452
E01004411,388,243,655,157,1443
E01004412,455,232,469,229,1385
E01004413,419,273,86,435,1213
E01004414,574,469,180,61,1284
E01004415,593,300,93,241,1227
E01004416,630,400,122,195,1347
E01004417,598,375,203,139,1315
E01004418,580,385,195,130,1290
E01004419,594,390,238,60,1282
E01004420,483,290,599,344,1716
E01004421,512,427,427,185,1551
E01004422,488,329,355,90,1262
E01004423,286,267,574,350,1477
E01004424,344,142,539,319,1344
E01004425,573,97,617,265,1552
E01004426,526,347,369,100,1342
E01004427,443,143,907,67,1560
E01004428,148,83,168,862,1261
E01004429,329,216,464,395,1404
E01004430,411,307,972,179,1869
E01004432,421,257,525,103,1306
E01004434,451,285,467,355,1558
E01004435,345,224,658,256,1483
E01004436,363,279,485,193,1320
E01004437,318,246,637,299,1500
E01004438,456,302,822,154,1734
E01004439,315,274,514,215,1318
E01004440,490,262,810,191,1753
E01004441,510,317,413,119,1359
E01004442,506,297,558,120,1481
E01004443,409,363,509,167,1448
E01004444,427,159,751,558,1895
E01004445,392,298,489,221,1400
E01004446,520,264,501,188,1473
E01004447,570,324,516,93,1503
E01004448,406,202,533,255,1396
E01004449,321,90,207,712,1330
E01004450,683,517,88,27,1315
E01004451,707,453,117,132,1409
E01004452,535,366,245,163,1309
E01004453,612,379,261,49,1301
E01004454,578,412,187,156,1333
E01004455,441,271,237,210,1159
E01004456,287,82,75,728,1172
E01004457,522,219,497,253,1491
E01004458,461,336,515,161,1473
E01004459,155,63,107,779,1104
E01004460,474,241,458,282,1455
E01004461,546,326,722,94,1688
E01004462,463,275,539,142,1419
E01004463,594,144,573,275,1586
E01004464,248,79,241,589,1157
E01004465,523,264,249,119,1155
E01004466,589,299,284,130,1302
E01004467,279,152,636,552,1619
E01004468,567,347,322,90,1326
E01004469,293,148,217,544,1202
E01004470,343,195,358,270,1166
E01004471,363,179,349,385,1276
E01004472,494,381,506,105,1486
E01004473,483,258,572,156,1469
E01004474,419,156,930,178,1683
E01004475,380,189,478,165,1212
E01004476,296,208,791,184,1479
E01004477,412,496,305,51,1264
E01004478,435,403,225,72,1135
E01004479,372,359,359,107,1197
E01004480,455,277,672,70,1474
E01004481,382,221,786,93,1482
E01004482,317,312,551,154,1334
E01004483,570,192,929,107,1798
E01004484,385,184,600,159,1328
E01004485,380,262,590,196,1428
E01004486,354,183,595,185,1317
E01004487,363,188,433,288,1272
E01004488,399,282,314,221,1216
E01004489,398,176,341,215,1130
E01004490,544,233,417,56,1250
E01004491,317,149,320,718,1504
E01004492,513,203,534,217,1467
E01004493,561,199,563,164,1487
E01004494,406,144,535,319,1404
E01004495,262,97,369,492,1220
E01004496,575,140,884,190,1789
E01004497,437,252,250,214,1153
E01004498,598,192,625,74,1489
E01004499,371,231,631,132,1365
E01004500,279,275,741,168,1463
E01004501,295,251,474,321,1341
E01004502,577,305,405,51,1338
E01004503,345,226,603,224,1398
E01004504,392,268,485,51,1196
E01004505,392,357,650,64,1463
E01004506,337,359,872,142,1710
E01004507,299,281,953,142,1675
E01004508,477,293,734,307,1811
E01004509,479,266,1075,204,2024
E01004510,572,207,741,193,1713
E01004511,476,266,701,43,1486
E01004512,402,257,357,159,1175
E01004513,545,193,537,281,1556
E01004514,528,284,516,140,1468
E01004515,415,164,565,308,1452
E01004516,525,381,196,84,1186
E01004517,492,194,694,166,1546
E01004518,627,320,307,91,1345
E01004519,469,280,425,184,1358
E01004520,393,243,276,120,1032
E01004521,596,275,417,216,1504
E01004522,435,244,446,112,1237
E01004523,394,337,315,255,1301
E01004524,312,125,410,442,1289
E01004525,283,231,986,44,1544
E01004526,321,166,674,173,1334
E01004527,337,316,585,79,1317
E01004528,310,161,438,277,1186
E01004529,570,213,774,178,1735
E01004530,484,296,666,149,1595
E01004531,347,278,415,309,1349
E01004532,357,271,366,232,1226
E01004533,295,163,333,315,1106
E01004534,501,290,655,191,1637
E01004535,146,54,211,852,1263
E01004536,302,119,759,551,1731
E01004537,197,131,370,824,1522
E01004538,387,163,454,624,1628
E01004539,227,123,320,868,1538
E01004540,429,239,471,594,1733
E01004541,224,131,286,732,1373
E01004542,516,290,374,102,1282
E01004543,490,313,515,84,1402
E01004544,432,298,327,152,1209
E01004545,335,251,840,52,1478
E01004546,409,272,491,107,1279
E01004547,311,229,268,291,1099
E01004548,437,332,923,146,1838
E01004549,415,274,433,194,1316
E01004550,280,233,334,205,1052
E01004551,245,108,603,627,1583
E01004552,448,200,1065,113,1826
E01004553,380,255,597,191,1423
E01004554,489,323,429,49,1290
E01004555,531,396,245,47,1219
E01004556,484,304,328,58,1174
E01004557,389,296,418,115,1218
E01004558,508,263,409,126,1306
E01004559,420,275,246,78,1019
E01004560,464,303,725,223,1715
E01004562,267,148,433,636,1484
E01004563,294,82,607,618,1601
E01004564,357,195,588,462,1602
E01004565,323,157,593,409,1482
E01004566,313,323,619,124,1379
E01004567,329,143,438,885,1795
E01004568,74,47,206,464,791
E01004569,371,185,610,412,1578
E01004570,132,77,607,682,1498
E01004571,214,142,527,510,1393
E01004572,286,273,474,307,1340
E01004573,423,225,411,217,1276
E01004574,106,67,393,735,1301
E01004575,175,197,374,544,1290
E01004576,220,212,351,417,1200
E01004577,366,293,682,316,1657
E01004579,350,253,346,399,1348
E01004580,418,186,877,270,1751
E01004581,367,271,692,296,1626
E01004582,475,487,711,142,1815
E01004583,357,389,547,192,1485
E01004584,110,80,264,814,1268
E01004585,442,270,688,256,1656
E01004586,456,231,812,143,1642
E01004587,482,300,568,135,1485
E01004588,497,236,853,114,1700
E01004589,487,248,655,58,1448
E01004590,305,184,370,608,1467
E01004591,349,180,601,425,1555
E01004592,289,124,284,703,1400
E01004593,499,277,691,101,1568
E01004594,478,392,388,19,1277
E01004595,534,242,618,100,1494
E01004596,547,318,391,28,1284
E01004597,558,273,385,232,1448
E01004598,637,235,577,101,1550
E01004599,525,367,224,28,1144
E01004600,260,73,482,798,1613
E01004601,619,265,654,332,1870
E01004602,442,254,653,68,1417
E01004604,531,428,268,30,1257
E01004605,405,424,368,231,1428
E01004606,426,288,674,34,1422
E01004607,476,441,440,41,1398
E01004608,324,326,598,235,1483
E01004609,481,297,1066,81,1925
E01004610,423,442,592,165,1622
E01004611,354,359,486,111,1310
E01004612,312,323,669,102,1406
E01004613,252,188,586,294,1320
E01004614,425,177,889,263,1754
E01004615,220,147,454,545,1366
E01004616,278,192,1222,143,1835
E01004617,251,167,730,242,1390
E01004618,453,333,448,48,1282
E01004619,366,332,239,126,1063
E01004620,485,216,403,219,1323
E01004621,454,326,424,126,1330
E01004622,300,136,285,202,923
E01004623,580,271,396,129,1376
E01004624,507,230,375,214,1326
E01004625,484,418,115,22,1039
E01004626,544,334,426,28,1332
E01004627,489,272,329,178,1268
E01004628,517,225,644,358,1744
E01004629,423,367,347,127,1264
E01004630,228,120,415,569,1332
E01004631,267,182,439,280,1168
E01004632,401,307,390,117,1215
E01004633,182,66,498,506,1252
E01004634,325,195,547,193,1260
E01004635,357,279,557,138,1331
E01004636,342,209,449,187,1187
E01004637,305,205,448,260,1218
E01004638,385,530,167,39,1121
E01004639,337,373,647,112,1469
E01004640,444,421,591,42,1498
E01004641,491,402,377,339,1609
E01004642,442,285,357,314,1398
E01004643,331,235,564,467,1597
E01004644,558,386,314,338,1596
E01004645,322,184,421,622,1549
E01004646,262,317,490,159,1228
E01004647,187,374,447,225,1233
E01004648,361,556,969,93,1979
E01004649,179,424,624,80,1307
E01004650,346,461,809,45,1661
E01004651,243,348,1020,148,1759
E01004652,211,233,1066,143,1653
E01004653,282,434,552,275,1543
E01004654,367,433,883,289,1972
E01004656,337,300,778,446,1861
E01004657,161,220,901,45,1327
E01004658,119,200,856,39,1214
E01004659,234,330,956,102,1622
E01004660,265,410,785,94,1554
E01004661,216,234,1030,141,1621
E01004662,173,250,1162,115,1700
E01004663,288,354,557,229,1428
E01004665,100,140,194,672,1106
E01004666,85,126,301,421,933
E01004667,137,185,351,492,1165
E01004668,221,309,289,331,1150
E01004669,175,194,306,678,1353
E01004670,123,146,181,1488,1938
E01004674,225,173,313,940,1651
E01004675,218,104,618,925,1865
E01004676,239,148,631,360,1378
E01004677,277,168,562,550,1557
E01004678,308,146,543,602,1599
E01004679,189,79,555,820,1643
E01004680,195,413,600,29,1237
E01004681,320,364,1088,150,1922
E01004682,151,212,724,140,1227
E01004683,272,439,686,41,1438
E01004684,158,207,693,84,1142
E01004686,182,231,827,51,1291
E01004687,213,507,683,14,1417
E01004688,92,296,383,17,788
E01004689,144,293,374,51,862
E01004690,177,357,579,54,1167
E01004691,138,415,713,89,1355
E01004692,156,414,621,23,1214
E01004693,205,359,578,71,1213
E01004694,175,259,1008,83,1525
E01004695,132,197,812,21,1162
E01004696,205,201,329,560,1295
E01004697,226,237,760,130,1353
E01004698,175,208,823,64,1270
E01004699,242,296,1376,115,2029
E01004700,250,191,943,101,1485
E01004701,309,297,726,46,1378
E01004702,169,224,532,1061,1986
E01004703,335,656,737,150,1878
E01004705,293,273,589,68,1223
E01004706,324,223,740,101,1388
E01004707,412,345,813,28,1598
E01004708,278,140,623,337,1378
E01004709,272,233,536,349,1390
E01004710,188,137,345,529,1199
E01004711,157,143,427,627,1354
E01004712,191,291,806,124,1412
E01004713,176,343,1035,57,1611
E01004714,242,327,1158,202,1929
E01004715,188,201,622,382,1393
E01004716,180,392,603,105,1280
E01004717,126,247,970,59,1402
E01004718,260,161,429,745,1595
E01004719,253,166,230,796,1445
E01004720,286,223,198,825,1532
E01004721,208,132,308,949,1597
E01004722,169,87,279,1249,1784
E01004723,193,111,622,865,1791
E01004724,204,316,752,214,1486
E01004725,95,161,501,553,1310
E01004726,256,482,700,59,1497
E01004727,303,514,952,8,1777
E01004728,201,309,572,261,1343
E01004729,159,183,434,594,1370
E01004730,239,462,674,20,1395
E01004731,218,366,815,104,1503
E01004732,30,47,164,874,1115
E01004733,214,392,740,232,1578
E01004734,112,143,1024,533,1812
E01004735,117,186,623,580,1506
E01004736,159,317,689,20,1185
E01004737,81,204,253,577,1115
E01004738,169,292,591,111,1163
E01004739,18,25,1148,106,1297
E01004740,184,158,244,707,1293
E01004741,157,176,310,455,1098
E01004742,254,223,608,175,1260
E01004743,140,208,333,454,1135
E01004744,95,142,427,449,1113
E01004745,331,327,615,570,1843
E01004746,144,138,246,669,1197
E01004747,308,333,672,568,1881
E01004748,202,393,439,62,1096
E01004749,369,439,906,304,2018
E01004750,195,258,514,562,1529
E01004751,354,362,680,172,1568
E01004752,182,207,474,583,1446
E01004753,218,270,617,556,1661
E01004754,108,120,230,695,1153
E01004755,213,129,533,851,1726
E01004756,252,139,676,436,1503
E01004757,148,106,319,633,1206
E01004760,274,175,368,527,1344
E01004761,171,388,1062,143,1764
E01004762,184,354,881,431,1850
E01004763,145,162,1147,213,1667
E01004765,246,284,806,451,1787
E01004766,501,412,266,155,1334
E01004767,541,484,299,78,1402
E01004768,722,483,61,12,1278
E01004769,701,482,92,3,1278
E01004770,525,583,85,13,1206
E01004771,648,564,91,1,1304
E01004772,441,193,79,579,1292
E01004773,661,452,422,31,1566
E01004774,582,303,175,272,1332
E01004775,549,526,99,23,1197
E01004776,689,326,243,202,1460
E01004777,505,272,222,217,1216
E01004778,414,481,74,21,990
E01004779,648,252,110,183,1193
E01004780,855,553,180,30,1618
E01004781,766,374,274,63,1477
E01004782,387,255,63,217,922
E01004783,625,521,89,22,1257
E01004784,513,498,30,8,1049
E01004785,471,511,66,127,1175
E01004786,541,533,66,74,1214
E01004787,277,107,106,726,1216
E01004788,507,613,49,4,1173
E01004789,528,589,64,8,1189
E01004790,464,533,88,111,1196
E01004791,458,473,80,38,1049
E01004792,527,656,73,1,1257
E01004793,268,191,88,637,1184
E01004794,237,219,105,696,1257
E01004795,411,303,108,339,1161
E01004796,612,442,125,50,1229
E01004797,292,194,86,415,987
E01004798,516,321,106,336,1279
E01004799,466,587,79,10,1142
E01004800,593,416,69,13,1091
E01004801,224,114,107,753,1198
E01004802,277,141,136,778,1332
E01004803,571,569,205,2,1347
E01004804,529,590,72,34,1225
E01004805,592,629,100,31,1352
E01004806,476,666,90,26,1258
E01004807,700,338,96,3,1137
E01004808,635,604,108,7,1354
E01004809,610,408,247,210,1475
E01004810,761,400,83,34,1278
E01004811,292,272,224,340,1128
E01004812,383,316,415,219,1333
E01004813,329,303,213,207,1052
E01004814,464,295,187,142,1088
E01004815,459,363,138,206,1166
E01004816,498,327,129,204,1158
E01004817,373,247,344,311,1275
E01004818,243,270,438,308,1259
E01004819,373,459,186,73,1091
E01004820,281,260,175,461,1177
E01004822,220,368,209,429,1226
E01004823,230,143,179,821,1373
E01004824,286,607,144,176,1213
E01004825,239,354,155,447,1195
E01004826,320,240,266,322,1148
E01004827,262,254,214,451,1181
E01004828,365,348,268,266,1247
E01004829,214,365,262,182,1023
E01004830,423,317,251,257,1248
E01004831,587,489,186,35,1297
E01004832,549,377,216,48,1190
E01004833,528,548,142,36,1254
E01004834,504,352,218,47,1121
E01004835,503,629,68,31,1231
E01004836,486,581,128,9,1204
E01004837,593,666,53,15,1327
E01004838,379,333,244,248,1204
E01004839,291,176,210,862,1539
E01004840,507,519,173,138,1337
E01004841,223,110,89,788,1210
E01004842,535,668,110,71,1384
E01004843,560,533,103,17,1213
E01004844,566,701,42,14,1323
E01004845,616,460,227,81,1384
E01004846,289,236,217,201,943
E01004847,299,271,238,485,1293
E01004848,130,141,219,607,1097
E01004849,183,600,227,238,1248
E01004850,194,324,228,583,1329
E01004851,144,367,205,510,1226
E01004852,221,561,199,176,1157
E01004853,159,374,199,350,1082
E01004854,196,545,247,102,1090
E01004855,478,361,200,129,1168
E01004856,329,252,212,308,1101
E01004857,368,266,237,282,1153
E01004858,504,231,240,315,1290
E01004859,250,213,141,494,1098
E01004860,484,413,175,159,1231
E01004861,321,127,145,597,1190
E01004862,262,116,115,520,1013
E01004863,351,200,136,504,1191
E01004864,628,410,163,79,1280
E01004865,363,290,210,229,1092
E01004866,274,221,174,633,1302
E01004867,482,414,195,69,1160
E01004868,427,386,359,148,1320
E01004869,287,325,469,251,1332
E01004870,335,542,541,64,1482
E01004871,350,390,318,106,1164
E01004872,519,246,158,282,1205
E01004873,544,219,128,388,1279
E01004874,574,300,92,362,1328
E01004875,546,500,101,136,1283
E01004876,563,231,142,513,1449
E01004877,185,176,164,747,1272
E01004878,454,438,142,108,1142
E01004879,333,155,121,394,1003
E01004880,523,434,88,25,1070
E01004881,345,321,229,258,1153
E01004882,509,354,109,138,1110
E01004883,594,396,167,25,1182
E01004884,501,687,77,20,1285
E01004885,537,504,43,19,1103
E01004886,383,253,107,358,1101
E01004887,403,354,69,340,1166
E01004888,458,341,54,217,1070
E01004889,449,314,95,276,1134
E01004890,503,418,231,34,1186
E01004891,622,543,127,75,1367
E01004892,535,659,89,30,1313
E01004893,610,584,61,6,1261
E01004894,659,460,267,116,1502
E01004895,405,331,91,255,1082
E01004896,403,667,55,9,1134
E01004897,439,368,95,7,909
E01004899,544,404,129,148,1225
E01004900,736,287,143,45,1211
E01004901,867,515,98,40,1520
E01004902,568,349,235,224,1376
E01004903,690,327,70,47,1134
E01004904,685,294,152,134,1265
E01004905,576,319,125,256,1276
E01004906,509,284,182,377,1352
E01004907,423,235,92,258,1008
E01004908,424,506,63,100,1093
E01004909,437,292,78,309,1116
E01004910,758,420,420,124,1722
E01004911,471,334,147,335,1287
E01004912,531,597,98,34,1260
E01004913,807,286,206,165,1464
E01004914,372,558,54,33,1017
E01004915,499,569,44,11,1123
E01004916,448,368,97,258,1171
E01004917,755,413,180,258,1606
E01004918,540,448,73,11,1072
E01004919,591,500,128,24,1243
E01004920,416,423,105,286,1230
E01004921,563,494,163,93,1313
E01004922,487,263,307,302,1359
E01004923,570,366,313,20,1269
E01004924,657,516,63,18,1254
E01004925,645,465,110,36,1256
E01004926,242,145,57,516,960
E01004927,384,172,444,636,1636
E01004928,415,276,324,121,1136
E01004929,600,302,252,407,1561
E01004930,594,505,86,93,1278
E01004931,458,253,182,402,1295
E01004932,556,324,328,57,1265
E01004933,654,283,122,13,1072
E01004934,623,255,66,191,1135
E01004935,812,373,136,53,1374
E01004936,851,432,332,86,1701
E01004937,712,397,74,37,1220
E01004938,304,179,76,580,1139
E01004939,538,347,132,223,1240
E01004940,649,432,77,41,1199
E01004941,634,269,114,370,1387
E01004942,249,141,117,584,1091
E01004943,548,275,240,174,1237
E01004944,703,430,108,45,1286
E01004945,520,640,77,59,1296
E01004946,302,179,82,728,1291
E01004947,531,245,246,110,1132
E01004948,483,341,275,285,1384
E01004949,592,557,43,2,1194
E01004950,604,552,30,63,1249
E01004951,588,662,50,4,1304
E01004952,435,750,46,12,1243
E01004953,658,445,48,74,1225
E01004954,363,514,145,173,1195
E01004955,497,222,135,168,1022
E01004956,482,315,176,231,1204
E01004957,370,183,120,692,1365
E01004958,382,236,275,232,1125
E01004959,492,265,252,278,1287
E01004960,148,65,82,742,1037
E01004961,524,301,124,266,1215
E01004962,714,335,234,19,1302
E01004963,552,501,77,122,1252
E01004964,608,348,405,80,1441
E01004965,442,490,53,31,1016
E01004966,475,335,144,389,1343
E01004967,540,457,39,11,1047
E01004968,679,486,83,11,1259
E01004969,516,437,200,41,1194
E01004970,637,527,77,41,1282
E01004971,609,556,78,3,1246
E01004972,447,178,117,371,1113
E01004973,617,427,182,46,1272
E01004974,529,484,139,24,1176
E01004975,515,272,320,159,1266
E01004976,474,321,128,317,1240
E01004977,547,451,224,139,1361
E01004978,602,430,185,80,1297
E01004979,369,199,290,286,1144
E01004980,395,253,297,91,1036
E01004981,473,467,122,112,1174
E01004982,541,583,64,29,1217
E01004983,483,267,281,36,1067
E01004984,479,493,116,15,1103
E01004985,529,590,58,23,1200
E01004986,520,338,309,192,1359
E01004987,303,200,71,437,1011
E01004988,548,347,148,128,1171
E01004989,518,471,155,6,1150
E01004990,514,311,184,179,1188
E01004991,498,321,179,113,1111
E01004992,505,332,256,58,1151
E01004993,513,202,77,281,1073
E01004994,376,186,229,217,1008
E01004995,644,570,73,14,1301
E01004996,313,203,275,367,1158
E01004997,626,299,172,63,1160
E01004998,489,558,129,20,1196
E01004999,649,373,72,58,1152
E01005000,745,349,93,9,1196
E01005001,661,290,60,51,1062
E01005002,634,458,80,122,1294
E01005003,536,279,174,162,1151
E01005004,256,157,101,728,1242
E01005005,500,519,95,29,1143
E01005006,533,440,91,197,1261
E01005007,509,541,162,22,1234
E01005008,453,186,297,501,1437
E01005009,384,189,331,284,1188
E01005010,651,407,121,88,1267
E01005011,609,416,76,12,1113
E01005012,540,312,156,323,1331
E01005013,700,243,345,450,1738
E01005014,448,431,313,72,1264
E01005015,507,281,129,308,1225
E01005016,610,435,199,22,1266
E01005017,728,419,122,71,1340
E01005018,564,289,206,157,1216
E01005019,528,528,111,41,1208
E01005020,790,291,44,5,1130
E01005021,413,355,56,5,829
E01005022,720,392,151,15,1278
E01005023,439,454,54,112,1059
E01005024,282,229,309,163,983
E01005025,564,425,204,69,1262
E01005026,454,389,290,47,1180
E01005027,557,357,325,143,1382
E01005028,419,225,170,589,1403
E01005029,593,450,227,85,1355
E01005030,313,189,307,451,1260
E01005031,483,313,112,242,1150
E01005032,236,192,137,289,854
E01005033,496,425,245,25,1191
E01005034,547,413,180,24,1164
E01005035,528,368,154,86,1136
E01005036,394,266,493,438,1591
E01005037,623,414,137,8,1182
E01005038,594,369,102,9,1074
E01005039,429,283,171,306,1189
E01005040,692,437,204,78,1411
E01005041,622,450,104,7,1183
E01005042,561,432,181,89,1263
E01005043,567,334,223,7,1131
E01005044,368,246,327,40,981
E01005045,564,337,207,168,1276
E01005046,437,696,85,0,1218
E01005047,541,527,78,4,1150
E01005048,653,716,38,10,1417
E01005049,683,573,116,14,1386
E01005050,894,400,213,53,1560
E01005051,669,328,140,70,1207
E01005052,668,490,37,7,1202
E01005053,611,395,121,68,1195
E01005054,604,448,144,60,1256
E01005055,546,564,98,10,1218
E01005056,437,577,82,8,1104
E01005057,600,360,135,98,1193
E01005058,561,481,50,1,1093
E01005059,636,318,179,233,1366
E01005060,597,487,188,83,1355
E01005061,81,30,112,983,1206
E01005062,239,119,608,563,1529
E01005063,155,83,163,674,1075
E01005065,161,124,353,958,1596
E01005066,85,52,161,501,799
E01005067,92,92,148,670,1002
E01005068,368,161,77,613,1219
E01005069,669,295,138,110,1212
E01005070,282,124,219,635,1260
E01005071,467,144,193,422,1226
E01005072,490,124,240,463,1317
E01005073,618,344,102,158,1222
E01005074,394,187,119,474,1174
E01005075,443,153,126,355,1077
E01005076,223,73,928,93,1317
E01005077,270,91,122,638,1121
E01005078,350,200,620,122,1292
E01005079,489,268,185,266,1208
E01005081,335,106,126,771,1338
E01005082,407,186,161,474,1228
E01005083,338,122,1033,45,1538
E01005084,634,284,325,385,1628
E01005085,243,89,201,586,1119
E01005086,293,111,140,780,1324
E01005087,243,89,265,897,1494
E01005088,165,80,89,874,1208
E01005089,245,107,199,759,1310
E01005090,207,46,142,836,1231
E01005091,264,80,331,903,1578
E01005092,210,208,354,437,1209
E01005093,230,196,271,526,1223
E01005094,198,161,283,464,1106
E01005097,189,116,102,802,1209
E01005098,242,175,141,669,1227
E01005099,204,127,84,859,1274
E01005100,431,364,104,336,1235
E01005101,450,185,152,530,1317
E01005102,514,367,164,84,1129
E01005103,339,264,171,569,1343
E01005104,286,151,328,568,1333
E01005105,404,129,401,560,1494
E01005106,222,230,370,583,1405
E01005107,248,74,189,756,1267
E01005108,267,207,346,1025,1845
E01005111,410,225,86,395,1116
E01005112,459,260,112,429,1260
E01005113,360,134,107,667,1268
E01005114,569,599,232,107,1507
E01005115,591,304,110,461,1466
E01005116,777,178,271,420,1646
E01005117,416,96,172,851,1535
E01005118,426,314,186,230,1156
E01005119,369,199,132,463,1163
E01005120,629,263,219,257,1368
E01005121,352,131,154,524,1161
E01005122,461,208,114,482,1265
E01005123,277,163,107,697,1244
E01005124,330,126,196,681,1333
E01005125,396,214,232,403,1245
E01005126,635,524,404,100,1663
E01005128,175,85,975,38,1273
E01005129,75,70,223,747,1115
E01005130,102,74,143,855,1174
E01005132,202,109,137,651,1099
E01005133,167,61,255,558,1041
E01005135,320,179,127,586,1212
E01005136,509,350,134,227,1220
E01005138,180,117,77,909,1283
E01005139,610,344,125,266,1345
E01005140,900,441,478,328,2147
E01005141,310,147,75,827,1359
E01005142,130,113,161,943,1347
E01005143,319,437,571,463,1790
E01005145,408,495,780,182,1865
E01005146,550,433,585,141,1709
E01005147,236,80,362,1048,1726
E01005149,351,424,381,70,1226
E01005150,253,129,1115,159,1656
E01005151,392,274,356,200,1222
E01005152,588,326,239,28,1181
E01005153,471,269,464,206,1410
E01005154,355,207,713,66,1341
E01005155,550,297,331,26,1204
E01005156,528,321,362,30,1241
E01005157,664,395,156,17,1232
E01005158,442,191,336,302,1271
E01005159,490,294,482,56,1322
E01005160,522,422,322,109,1375
E01005161,572,378,216,18,1184
E01005162,450,398,318,160,1326
E01005163,538,427,263,58,1286
E01005164,258,163,424,355,1200
E01005165,303,210,661,441,1615
E01005166,405,269,531,170,1375
E01005167,391,204,389,337,1321
E01005168,514,388,135,41,1078
E01005169,450,385,150,28,1013
E01005170,502,458,219,15,1194
E01005171,578,414,392,55,1439
E01005172,388,349,537,99,1373
E01005173,454,376,392,59,1281
E01005174,541,433,272,15,1261
E01005175,523,345,248,200,1316
E01005176,430,243,830,121,1624
E01005177,428,320,303,93,1144
E01005178,416,215,422,510,1563
E01005179,528,307,782,171,1788
E01005180,342,192,235,661,1430
E01005181,541,380,481,152,1554
E01005182,307,104,123,516,1050
E01005183,366,151,159,677,1353
E01005184,269,214,1246,149,1878
E01005185,64,48,1444,88,1644
E01005186,484,244,427,548,1703
E01005187,357,241,561,229,1388
E01005188,502,440,295,90,1327
E01005189,217,130,233,730,1310
E01005190,443,344,416,323,1526
E01005191,299,225,419,346,1289
E01005192,525,294,312,133,1264
E01005193,553,268,445,144,1410
E01005194,471,297,813,279,1860
E01005195,207,64,208,928,1407
E01005196,344,74,327,851,1596
E01005197,301,189,304,404,1198
E01005198,210,109,141,671,1131
E01005199,528,310,663,149,1650
E01005200,491,247,348,290,1376
E01005201,231,151,667,355,1404
E01005202,173,167,288,662,1290
E01005203,137,77,232,1000,1446
E01005205,281,139,327,794,1541
E01005206,468,285,404,135,1292
E01005207,403,334,702,84,1523
E01005208,307,74,1053,524,1958
E01005209,105,62,607,720,1494
E01005210,46,56,435,550,1087
E01005212,132,75,409,467,1083
E01005213,240,73,612,914,1839
E01005214,470,86,1068,306,1930
E01005215,555,395,412,137,1499
E01005216,527,379,230,60,1196
E01005217,590,530,318,33,1471
E01005218,364,328,536,207,1435
E01005219,472,246,712,226,1656
E01005220,527,263,484,115,1389
E01005221,589,278,675,105,1647
E01005222,553,216,481,330,1580
E01005223,372,273,184,169,998
E01005224,448,186,555,133,1322
E01005225,407,410,284,378,1479
E01005226,415,305,440,52,1212
E01005227,326,225,420,280,1251
E01005228,129,80,156,868,1233
E01005229,635,476,125,33,1269
E01005230,255,181,946,351,1733
E01005231,84,136,1273,127,1620
E01005232,410,225,385,361,1381
E01005233,408,206,563,438,1615
E01005234,380,218,511,356,1465
E01005235,265,145,270,629,1309
E01005236,181,206,966,312,1665
E01005237,488,343,461,132,1424
E01005238,459,337,469,184,1449
E01005239,211,48,162,736,1157
E01005240,272,201,639,704,1816
E01005241,441,254,878,321,1894
E01005242,177,123,866,715,1881
E01005243,203,66,418,1080,1767
E01005244,172,234,1372,437,2215
E01005245,137,87,268,1127,1619
E01005246,114,134,312,788,1348
E01005247,614,384,115,93,1206
E01005248,562,526,53,54,1195
E01005249,637,299,165,314,1415
E01005250,449,276,162,477,1364
E01005251,375,228,120,469,1192
E01005252,473,298,106,564,1441
E01005253,337,272,98,495,1202
E01005254,715,399,125,90,1329
E01005255,185,122,130,824,1261
E01005256,322,154,334,682,1492
E01005257,245,168,186,744,1343
E01005258,466,303,282,277,1328
E01005259,286,135,323,504,1248
E01005260,537,411,173,59,1180
E01005261,238,127,99,700,1164
E01005262,554,190,249,458,1451
E01005263,494,207,195,469,1365
E01005264,435,153,118,439,1145
E01005265,412,140,153,564,1269
E01005266,458,230,216,588,1492
E01005267,565,410,124,189,1288
E01005268,733,480,460,114,1787
E01005269,541,446,130,116,1233
E01005270,347,124,277,624,1372
E01005271,138,131,1604,117,1990
E01005272,325,138,155,708,1326
E01005273,131,101,1008,204,1444
E01005274,305,206,590,405,1506
E01005275,292,162,1058,60,1572
E01005276,264,198,838,68,1368
E01005277,426,343,673,35,1477
E01005278,316,314,805,136,1571
E01005279,429,266,360,515,1570
E01005280,450,246,228,447,1371
E01005281,118,100,593,163,974
E01005282,408,364,512,136,1420
E01005283,58,45,1226,73,1402
E01005284,179,152,1153,186,1670
E01005285,138,57,436,380,1011
E01005286,315,220,1144,108,1787
E01005287,388,222,401,515,1526
E01005288,162,130,907,256,1455
E01005289,244,85,91,692,1112
E01005290,325,135,95,639,1194
E01005291,269,98,90,709,1166
E01005292,296,138,109,629,1172
E01005293,523,261,108,91,983
E01005294,557,424,112,179,1272
E01005295,956,181,520,277,1934
E01005296,543,416,332,64,1355
E01005297,510,368,681,266,1825
E01005298,501,309,426,124,1360
E01005299,568,411,249,42,1270
E01005300,486,459,259,20,1224
E01005301,465,440,348,27,1280
E01005302,341,182,764,235,1522
E01005304,269,204,1073,96,1642
E01005305,391,370,730,20,1511
E01005306,474,382,364,80,1300
E01005307,385,317,983,85,1770
E01005308,376,202,370,410,1358
E01005309,135,143,1839,104,2221
E01005310,102,80,1179,316,1677
E01005311,301,301,877,93,1572
E01005312,98,108,1372,176,1754
E01005313,328,164,144,528,1164
E01005314,401,207,123,498,1229
E01005315,265,156,157,619,1197
E01005316,450,166,359,340,1315
E01005317,404,245,180,508,1337
E01005318,509,199,215,479,1402
E01005319,479,229,302,631,1641
E01005320,451,323,344,187,1305
E01005321,334,353,255,205,1147
E01005322,188,107,178,464,937
E01005323,402,210,187,291,1090
E01005324,260,139,75,599,1073
E01005325,115,45,74,474,708
E01005326,532,868,232,245,1877
E01005327,711,420,136,150,1417
E01005328,294,201,116,511,1122
E01005329,696,468,81,10,1255
E01005330,667,537,74,24,1302
E01005331,528,409,173,97,1207
E01005332,754,446,313,274,1787
E01005333,560,489,35,8,1092
E01005334,726,351,73,9,1159
E01005335,539,475,83,9,1106
E01005336,642,598,61,5,1306
E01005337,629,292,266,128,1315
E01005338,450,238,170,452,1310
E01005339,491,644,64,18,1217
E01005340,426,208,91,370,1095
E01005341,576,287,133,151,1147
E01005342,331,235,129,388,1083
E01005343,422,263,84,283,1052
E01005344,411,256,234,236,1137
E01005345,627,503,86,35,1251
E01005346,581,462,88,81,1212
E01005347,522,339,126,63,1050
E01005348,348,188,114,502,1152
E01005349,577,387,261,245,1470
E01005350,190,98,133,1132,1553
E01005351,499,305,214,213,1231
E01005352,361,206,147,250,964
E01005353,276,223,132,726,1357
E01005354,518,218,173,298,1207
E01005355,603,336,189,77,1205
E01005356,681,295,70,26,1072
E01005357,526,607,46,44,1223
E01005358,623,308,140,250,1321
E01005359,505,736,99,51,1391
E01005360,332,537,67,242,1178
E01005361,615,674,98,48,1435
E01005362,507,493,122,82,1204
E01005363,499,335,237,168,1239
E01005364,679,599,90,24,1392
E01005365,626,468,96,25,1215
E01005366,475,258,63,416,1212
E01005367,601,518,60,13,1192
E01005368,562,218,257,177,1214
E01005369,402,207,246,266,1121
E01005370,335,146,171,529,1181
E01005371,422,219,237,140,1018
E01005372,403,267,105,168,943
E01005373,457,452,60,27,996
E01005374,452,395,98,206,1151
E01005375,534,618,70,28,1250
E01005376,301,193,159,310,963
E01005377,171,71,95,638,975
E01005378,518,404,222,67,1211
E01005379,110,82,56,610,858
E01005380,374,108,57,510,1049
E01005381,280,188,138,530,1136
E01005382,349,238,172,373,1132
E01005383,561,314,159,356,1390
E01005386,303,141,80,525,1049
E01005387,601,412,128,47,1188
E01005388,500,363,108,122,1093
E01005389,414,207,206,416,1243
E01005390,589,463,94,46,1192
E01005391,563,464,64,204,1295
E01005392,375,236,141,509,1261
E01005393,479,461,43,63,1046
E01005394,566,564,80,87,1297
E01005395,606,478,74,25,1183
E01005396,517,481,56,159,1213
E01005397,578,373,126,119,1196
E01005398,586,460,154,27,1227
E01005399,652,572,120,22,1366
E01005400,363,365,80,453,1261
E01005401,634,591,78,38,1341
E01005402,615,355,140,75,1185
E01005403,781,310,111,88,1290
E01005406,537,548,79,19,1183
E01005407,674,590,154,5,1423
E01005408,643,536,162,115,1456
E01005409,570,544,212,5,1331
E01005410,622,541,66,30,1259
E01005411,481,559,136,132,1308
E01005412,597,612,183,32,1424
E01005413,653,543,104,24,1324
E01005414,457,446,126,37,1066
E01005415,355,357,55,180,947
E01005416,498,449,166,9,1122
E01005417,537,564,123,21,1245
E01005418,680,466,62,17,1225
E01005419,619,433,173,8,1233
E01005420,559,398,133,254,1344
E01005421,513,228,264,234,1239
E01005422,265,74,64,591,994
E01005427,285,516,199,279,1279
E01005428,412,406,294,61,1173
E01005429,279,475,186,246,1186
E01005430,619,469,306,209,1603
E01005431,577,341,244,114,1276
E01005432,220,105,124,658,1107
E01005433,151,117,198,622,1088
E01005434,232,201,321,304,1058
E01005435,537,411,272,54,1274
E01005436,606,429,132,37,1204
E01005437,558,454,266,32,1310
E01005438,802,410,403,141,1756
E01005439,521,524,137,71,1253
E01005440,512,272,92,264,1140
E01005441,463,280,92,491,1326
E01005442,564,505,91,23,1183
E01005443,545,537,43,13,1138
E01005444,575,327,225,85,1212
E01005445,478,252,300,170,1200
E01005446,506,362,115,145,1128
E01005447,418,254,201,302,1175
E01005448,222,166,166,591,1145
E01005449,350,185,104,352,991
E01005450,408,326,313,139,1186
E01005451,537,308,143,12,1000
E01005452,664,368,74,17,1123
E01005453,604,380,63,18,1065
E01005454,677,337,48,85,1147
E01005455,755,296,139,41,1231
E01005456,408,199,205,443,1255
E01005459,175,228,113,397,913
E01005460,447,555,288,310,1600
E01005461,563,674,182,176,1595
E01005462,576,468,182,104,1330
E01005463,102,290,155,242,789
E01005464,303,197,114,619,1233
E01005465,603,325,266,183,1377
E01005466,299,132,119,1180,1730
E01005467,302,161,146,703,1312
E01005468,638,471,115,32,1256
E01005469,650,512,206,48,1416
E01005470,382,404,249,158,1193
E01005471,409,429,221,107,1166
E01005472,410,204,180,353,1147
E01005473,413,356,177,166,1112
E01005474,393,418,95,65,971
E01005475,380,351,175,321,1227
E01005476,628,395,207,59,1289
E01005477,448,280,389,234,1351
E01005478,494,491,136,171,1292
E01005479,627,436,165,166,1394
E01005480,500,467,119,252,1338
E01005481,623,338,137,134,1232
E01005482,149,138,233,1110,1630
E01005483,262,243,212,695,1412
E01005484,261,279,267,786,1593
E01005485,355,720,319,184,1578
E01005486,431,217,348,92,1088
E01005487,450,416,266,107,1239
E01005488,748,306,108,4,1166
E01005489,421,422,75,45,963
E01005490,301,139,98,285,823
E01005491,545,360,120,180,1205
E01005492,609,586,67,13,1275
E01005493,719,508,106,15,1348
E01005494,694,353,176,147,1370
E01005495,575,452,161,125,1313
E01005496,283,140,75,528,1026
E01005497,377,257,108,460,1202
E01005498,530,255,263,85,1133
E01005499,556,443,178,66,1243
E01005500,611,380,146,119,1256
E01005501,312,161,266,573,1312
E01005502,515,340,193,194,1242
E01005503,607,426,52,6,1091
E01005504,436,316,196,242,1190
E01005505,581,349,187,256,1373
E01005506,492,306,122,299,1219
E01005507,538,378,290,63,1269
E01005508,828,581,78,29,1516
E01005509,338,244,235,673,1490
E01005510,514,342,34,25,915
E01005511,512,354,72,71,1009
E01005512,518,354,148,228,1248
E01005513,291,150,103,486,1030
E01005514,445,235,120,397,1197
E01005515,264,178,109,707,1258
E01005516,576,404,113,7,1100
E01005517,496,612,110,31,1249
E01005518,462,352,149,180,1143
E01005519,636,401,82,83,1202
E01005520,577,519,193,130,1419
E01005521,537,385,170,57,1149
E01005522,426,297,271,96,1090
E01005523,746,452,228,100,1526
E01005524,619,355,119,126,1219
E01005525,375,220,114,593,1302
E01005526,526,255,143,327,1251
E01005527,286,152,105,586,1129
E01005528,420,334,115,333,1202
E01005529,339,170,125,665,1299
E01005530,514,645,52,12,1223
E01005531,400,310,144,82,936
E01005532,386,212,105,415,1118
E01005533,609,382,229,172,1392
E01005534,612,245,160,178,1195
E01005535,595,313,209,180,1297
E01005536,555,298,205,180,1238
E01005537,657,403,64,19,1143
E01005538,544,155,117,291,1107
E01005539,412,277,195,205,1089
E01005540,589,316,131,64,1100
E01005541,677,301,198,102,1278
E01005542,419,193,100,338,1050
E01005543,512,372,82,82,1048
E01005544,598,574,60,11,1243
E01005545,449,487,50,21,1007
E01005546,413,342,73,230,1058
E01005547,548,311,137,149,1145
E01005548,402,196,144,309,1051
E01005549,644,571,36,13,1264
E01005550,494,630,47,31,1202
E01005551,430,164,104,609,1307
E01005552,336,159,149,836,1480
E01005553,459,295,201,519,1474
E01005554,590,282,93,124,1089
E01005555,537,401,103,50,1091
E01005556,623,373,226,28,1250
E01005557,480,456,52,15,1003
E01005558,597,301,179,256,1333
E01005559,356,186,132,514,1188
E01005560,548,527,200,23,1298
E01005561,481,378,167,71,1097
E01005562,546,291,171,226,1234
E01005563,497,336,245,222,1300
E01005564,461,372,297,232,1362
E01005565,497,156,72,423,1148
E01005566,706,196,267,350,1519
E01005567,564,248,169,180,1161
E01005568,191,142,176,627,1136
E01005569,358,355,113,391,1217
E01005570,429,475,131,24,1059
E01005571,663,494,115,15,1287
E01005572,689,517,100,12,1318
E01005573,623,467,56,43,1189
E01005574,562,629,158,37,1386
E01005575,547,639,166,17,1369
E01005576,518,643,73,8,1242
E01005577,552,550,104,35,1241
E01005578,361,234,129,277,1001
E01005579,259,86,83,646,1074
E01005580,545,304,252,68,1169
E01005581,376,240,167,326,1109
E01005583,389,402,179,266,1236
E01005585,431,257,177,150,1015
E01005586,273,151,85,609,1118
E01005587,745,289,83,10,1127
E01005588,311,401,133,324,1169
E01005589,528,390,252,61,1231
E01005590,420,360,197,193,1170
E01005591,505,382,174,87,1148
E01005592,333,232,126,473,1164
E01005593,447,182,106,380,1115
E01005594,556,376,104,152,1188
E01005595,303,153,138,568,1162
E01005596,836,462,166,28,1492
E01005597,618,391,198,56,1263
E01005598,595,574,129,14,1312
E01005599,351,223,194,551,1319
E01005600,504,215,219,191,1129
E01005601,327,174,184,452,1137
E01005602,264,99,137,627,1127
E01005603,466,222,310,200,1198
E01005604,555,323,115,241,1234
E01005605,459,293,239,140,1131
E01005609,242,40,297,833,1412
E01005610,95,56,75,565,791
E01005611,283,172,443,684,1582
E01005612,91,60,212,1130,1493
E01005613,173,155,452,841,1621
E01005614,232,171,366,268,1037
E01005615,243,246,574,292,1355
E01005616,420,280,66,412,1178
E01005617,561,390,120,147,1218
E01005618,446,189,142,359,1136
E01005619,489,215,109,232,1045
E01005620,993,440,324,195,1952
E01005621,506,292,254,273,1325
E01005622,552,239,241,130,1162
E01005623,551,365,124,21,1061
E01005624,383,164,104,589,1240
E01005625,530,384,146,44,1104
E01005626,525,422,87,9,1043
E01005627,509,356,67,31,963
E01005628,463,407,406,71,1347
E01005629,436,363,133,178,1110
E01005630,485,332,200,153,1170
E01005631,157,120,282,803,1362
E01005632,620,310,513,188,1631
E01005633,453,257,74,351,1135
E01005634,614,442,120,26,1202
E01005635,472,372,312,119,1275
E01005636,542,425,228,106,1301
E01005637,418,316,170,189,1093
E01005638,401,195,316,313,1225
E01005639,199,96,67,684,1046
E01005640,420,158,75,388,1041
E01005641,461,240,120,328,1149
E01005642,579,279,93,20,971
E01005643,456,528,108,103,1195
E01005644,770,306,126,24,1226
E01005645,580,539,55,54,1228
E01005646,316,255,325,129,1025
E01005647,342,350,336,104,1132
E01005648,565,384,440,98,1487
E01005649,336,407,398,74,1215
E01005650,312,168,271,276,1027
E01005651,352,242,297,246,1137
E01005652,404,233,102,326,1065
E01005653,200,183,272,500,1155
E01005654,390,203,476,154,1223
E01005655,47,34,370,635,1086
E01005656,370,266,320,215,1171
E01005657,432,262,241,265,1200
E01005658,123,73,53,822,1071
E01005659,405,281,127,315,1128
E01005660,305,101,105,590,1101
E01005661,505,214,159,426,1304
E01005662,214,124,109,625,1072
E01005663,384,215,169,307,1075
E01005664,209,115,106,652,1082
E01005665,178,58,86,747,1069
E01005667,285,69,181,907,1442
E01005670,433,232,268,431,1364
E01005671,399,230,220,370,1219
E01005672,561,258,213,89,1121
E01005673,519,272,170,195,1156
E01005674,484,256,145,249,1134
E01005675,641,295,298,87,1321
E01005676,488,506,103,17,1114
E01005677,544,388,190,141,1263
E01005678,423,181,76,506,1186
E01005679,273,181,88,608,1150
E01005680,170,121,310,503,1104
E01005681,61,35,140,637,873
E01005682,29,16,66,1232,1343
E01005683,83,88,171,895,1237
E01005686,491,332,182,155,1160
E01005687,663,313,256,162,1394
E01005688,466,442,104,232,1244
E01005689,249,124,70,572,1015
E01005690,609,391,122,158,1280
E01005691,414,579,166,117,1276
E01005692,270,174,210,435,1089
E01005693,545,480,110,26,1161
E01005694,730,375,163,72,1340
E01005695,587,582,80,10,1259
E01005696,596,361,116,163,1236
E01005697,644,486,108,32,1270
E01005698,283,189,170,665,1307
E01005699,605,529,75,19,1228
E01005700,547,371,154,144,1216
E01005701,629,490,113,47,1279
E01005702,705,389,279,337,1710
E01005703,339,192,122,536,1189
E01005704,513,313,130,148,1104
E01005705,661,347,207,278,1493
E01005706,339,239,127,409,1114
E01005707,369,215,188,535,1307
E01005708,442,237,242,303,1224
E01005709,255,147,98,560,1060
E01005710,504,463,65,198,1230
E01005711,612,431,146,61,1250
E01005712,540,333,249,194,1316
E01005713,539,577,79,18,1213
E01005714,476,261,54,361,1152
E01005715,656,536,121,56,1369
E01005716,817,479,115,9,1420
E01005717,759,314,80,7,1160
E01005718,599,432,231,186,1448
E01005719,336,248,481,454,1519
E01005720,387,294,861,367,1909
E01005721,419,354,266,232,1271
E01005722,374,224,288,452,1338
E01005723,298,161,160,524,1143
E01005724,520,494,100,116,1230
E01005725,233,130,115,530,1008
E01005726,472,286,188,228,1174
E01005727,457,176,286,199,1118
E01005728,514,470,89,35,1108
E01005729,122,93,135,701,1051
E01005730,638,345,179,131,1293
E01005731,307,174,96,570,1147
E01005732,285,194,75,405,959
E01005733,343,197,72,425,1037
E01005734,512,330,128,139,1109
E01005735,539,519,70,8,1136
E01005736,527,520,136,12,1195
E01005737,555,569,85,15,1224
E01005738,599,632,191,14,1436
E01005739,692,392,105,7,1196
E01005740,554,562,144,41,1301
E01005741,619,585,110,49,1363
E01005742,636,465,133,46,1280
E01005743,496,511,109,19,1135
E01005744,515,322,141,132,1110
E01005745,584,376,109,96,1165
E01005746,350,250,88,534,1222
E01005747,596,496,89,10,1191
E01005748,577,675,40,20,1312
E01005749,763,425,156,23,1367
E01005750,712,421,173,22,1328
E01005751,573,313,152,13,1051
E01005752,454,249,87,346,1136
E01005753,330,171,89,596,1186
E01005754,272,128,81,937,1418
E01005755,403,203,81,492,1179
E01005756,167,123,51,796,1137
E01005757,557,283,259,134,1233
E01005758,230,86,229,1032,1577
E01005759,749,303,201,69,1322
E01005760,580,274,443,133,1430
E01005761,463,196,119,282,1060
E01005762,246,129,64,725,1164
E01005763,478,205,93,432,1208
E01005764,599,218,255,217,1289
E01005765,625,362,96,22,1105
E01005766,342,279,360,234,1215
E01005767,491,672,74,18,1255
E01005768,588,614,83,8,1293
E01005769,564,309,228,43,1144
E01005770,573,399,132,57,1161
E01005771,567,353,98,48,1066
E01005772,545,471,101,58,1175
E01005773,502,510,120,76,1208
E01005774,363,176,95,508,1142
E01005775,652,457,80,22,1211
E01005776,561,573,114,20,1268
E01005777,518,453,101,165,1237
E01005778,626,386,148,70,1230
E01005779,619,354,130,35,1138
E01005780,692,250,134,47,1123
E01005781,362,233,175,483,1253
E01005782,468,492,74,16,1050
E01005783,545,543,94,87,1269
E01005784,517,532,68,5,1122
E01005785,628,463,111,43,1245
E01005786,678,509,80,8,1275
E01005787,517,514,24,14,1069
E01005788,592,481,91,37,1201
E01005789,586,493,138,29,1246
E01005790,484,264,63,156,967
E01005791,625,429,94,106,1254
E01005792,551,590,64,4,1209
E01005793,477,512,161,43,1193
E01005794,492,507,39,2,1040
E01005795,528,458,58,9,1053
E01005796,483,446,75,7,1011
E01005797,467,222,276,154,1119
E01005798,460,399,248,165,1272
E01005799,444,93,119,581,1237
E01005800,672,490,118,40,1320
E01005801,544,337,235,36,1152
E01005802,692,396,97,27,1212
E01005803,690,458,59,5,1212
E01005804,363,185,126,179,853
E01005805,661,490,43,31,1225
E01005806,496,458,36,3,993
E01005807,596,642,51,13,1302
E01005808,539,466,75,2,1082
E01005809,515,402,87,1,1005
E01005810,504,545,145,33,1227
E01005811,616,438,120,8,1182
E01005812,512,471,38,4,1025
E01005813,629,478,100,2,1209
E01005814,501,567,49,6,1123
E01005815,587,526,42,3,1158
E01005816,632,254,298,51,1235
E01005817,534,259,223,81,1097
E01005818,463,242,113,210,1028
E01005819,689,473,99,34,1295
E01005820,530,354,187,71,1142
E01005821,570,342,169,131,1212
E01005822,337,158,270,520,1285
E01005823,673,239,145,229,1286
E01005824,684,335,81,101,1201
E01005825,671,345,141,109,1266
E01005826,338,186,69,461,1054
E01005827,507,547,76,66,1196
E01005828,206,96,73,583,958
E01005829,364,229,45,313,951
E01005830,601,376,150,114,1241
E01005831,626,366,206,38,1236
E01005832,573,453,77,110,1213
E01005833,362,248,56,187,853
E01005834,576,247,103,271,1197
E01005835,588,482,68,17,1155
E01005836,630,651,172,68,1521
E01005837,725,427,102,31,1285
E01005838,591,378,383,39,1391
E01005839,515,544,29,10,1098
E01005840,535,414,209,103,1261
E01005841,575,526,83,34,1218
E01005842,633,603,83,7,1326
E01005843,688,494,73,20,1275
E01005844,509,551,112,12,1184
E01005845,639,534,124,23,1320
E01005846,642,486,97,78,1303
E01005847,650,457,147,23,1277
E01005848,698,647,124,6,1475
E01005849,647,596,56,3,1302
E01005850,636,461,125,210,1432
E01005851,593,583,88,1,1265
E01005852,571,414,272,42,1299
E01005853,489,303,90,329,1211
E01005854,652,538,148,8,1346
E01005855,597,479,136,0,1212
E01005856,616,494,147,37,1294
E01005857,628,433,147,13,1221
E01005858,583,502,245,1,1331
E01005859,458,337,279,42,1116
E01005860,558,503,72,30,1163
E01005861,554,452,139,142,1287
E01005862,621,515,58,54,1248
E01005863,608,540,222,57,1427
E01005864,478,332,287,36,1133
E01005865,500,555,162,16,1233
E01005866,542,336,448,93,1419
E01005867,466,507,158,37,1168
E01005868,584,485,101,3,1173
E01005869,624,457,76,73,1230
E01005870,543,280,181,66,1070
E01005871,525,304,208,32,1069
E01005872,640,330,221,143,1334
E01005873,637,413,69,56,1175
E01005874,352,213,253,588,1406
E01005875,721,418,109,26,1274
E01005876,637,420,110,48,1215
E01005877,441,318,164,177,1100
E01005878,422,289,104,318,1133
E01005879,451,363,115,143,1072
E01005880,510,547,127,47,1231
E01005881,485,520,45,6,1056
E01005882,448,544,47,7,1046
E01005883,490,678,97,13,1278
E01005884,535,634,38,26,1233
E01005885,372,470,187,53,1082
E01005886,554,284,192,133,1163
E01005887,510,170,127,282,1089
E01005888,622,310,94,141,1167
E01005889,539,332,133,203,1207
E01005890,534,260,113,190,1097
E01005891,540,492,69,17,1118
E01005892,484,292,157,121,1054
E01005893,516,265,424,190,1395
E01005894,607,357,109,41,1114
E01005895,420,241,85,167,913
E01005896,603,345,313,75,1336
E01005897,516,300,92,236,1144
E01005898,540,511,89,190,1330
E01005899,513,602,121,75,1311
E01005900,473,435,152,248,1308
E01005901,495,592,54,62,1203
E01005902,473,248,75,477,1273
E01005903,479,694,44,8,1225
E01005904,551,517,90,25,1183
E01005905,398,160,76,409,1043
E01005906,500,701,48,2,1251
E01005907,389,633,68,11,1101
E01005908,519,634,58,0,1211
E01005909,515,646,70,61,1292
E01005910,477,374,109,290,1250
E01005911,489,509,38,35,1071
E01005912,489,550,111,5,1155
E01005913,547,559,56,49,1211
E01005914,528,399,125,127,1179
E01005915,519,280,179,242,1220
E01005916,530,384,233,111,1258
E01005917,479,240,313,296,1328
E01005918,123,62,99,925,1209
E01005919,409,183,93,494,1179
E01005920,684,505,75,29,1293
E01005921,481,264,251,157,1153
E01005922,594,420,125,35,1174
E01005923,591,622,39,6,1258
E01005924,487,477,77,0,1041
E01005925,459,537,77,63,1136
E01005926,471,468,63,6,1008
E01005927,593,419,35,12,1059
E01005928,605,314,100,211,1230
E01005929,425,605,83,18,1131
E01005930,560,631,61,11,1263
E01005931,502,584,73,35,1194
E01005932,530,555,34,13,1132
E01005933,343,107,75,545,1070
E01005934,508,394,81,198,1181
E01005935,293,163,169,495,1120
E01005936,583,474,87,104,1248
E01005937,391,370,151,287,1199
E01005938,501,443,101,265,1310
E01005939,490,553,58,12,1113
E01005940,495,547,102,96,1240
E01005941,363,351,344,219,1277
E01005942,612,456,178,92,1338
E01005943,630,420,353,68,1471
E01005944,570,391,140,37,1138
E01005945,421,196,194,569,1380
E01005946,588,311,261,116,1276
E01005947,415,250,331,255,1251
E01005948,236,156,524,544,1460
E01005949,477,363,259,178,1277
E01005950,351,333,388,238,1310
E01005951,476,270,281,209,1236
E01005952,122,90,265,1288,1765
E01005953,406,292,330,461,1489
E01005954,462,308,125,381,1276
E01005955,769,488,95,14,1366
E01005956,577,439,66,96,1178
E01005957,523,443,141,48,1155
E01005958,411,216,97,425,1149
E01005959,471,341,104,384,1300
E01005960,437,231,238,352,1258
E01005961,547,419,145,25,1136
E01005962,581,454,91,60,1186
E01005963,494,344,92,53,983
E01005964,590,424,163,73,1250
E01005965,351,198,124,454,1127
E01005966,522,227,130,175,1054
E01005967,345,185,92,518,1140
E01005968,621,469,115,8,1213
E01005969,514,506,118,20,1158
E01005970,594,561,97,20,1272
E01005971,518,356,189,83,1146
E01005972,578,264,247,232,1321
E01005973,557,476,100,59,1192
E01005974,520,323,327,107,1277
E01005975,494,343,200,222,1259
E01005976,474,226,96,386,1182
E01005977,544,495,120,88,1247
E01005978,382,230,100,395,1107
E01005979,525,448,121,287,1381
E01005980,415,221,113,363,1112
E01005981,367,275,113,512,1267
E01005982,368,340,55,324,1087
E01005983,612,579,112,48,1351
E01005984,239,185,123,674,1221
E01005985,543,626,88,36,1293
E01005986,506,245,93,148,992
E01005987,612,608,94,9,1323
E01005988,715,456,113,5,1289
E01005989,500,459,69,16,1044
E01005990,525,496,82,36,1139
E01005991,625,384,102,73,1184
E01005992,410,274,176,165,1025
E01005993,528,478,81,89,1176
E01005994,564,281,172,131,1148
E01005995,743,354,41,29,1167
E01005996,747,390,194,174,1505
E01005997,567,356,176,116,1215
E01005998,687,408,236,28,1359
E01005999,483,313,347,332,1475
E01006000,356,287,204,484,1331
E01006001,603,406,170,73,1252
E01006002,540,321,126,114,1101
E01006003,554,432,165,32,1183
E01006004,624,500,127,13,1264
E01006005,326,218,171,328,1043
E01006006,619,461,139,9,1228
E01006007,581,295,255,77,1208
E01006008,624,247,153,111,1135
E01006009,533,374,132,73,1112
E01006010,340,195,181,375,1091
E01006011,446,180,111,525,1262
E01006012,635,424,220,167,1446
E01006013,453,394,111,101,1059
E01006014,429,211,55,271,966
E01006015,703,297,67,63,1130
E01006016,328,203,247,673,1451
E01006017,634,452,40,3,1129
E01006018,544,550,54,13,1161
E01006019,367,240,84,562,1253
E01006020,533,317,70,254,1174
E01006021,502,454,119,44,1119
E01006022,556,365,326,144,1391
E01006023,427,234,147,482,1290
E01006024,888,493,68,10,1459
E01006025,292,190,42,547,1071
E01006026,623,297,209,160,1289
E01006027,309,160,70,531,1070
E01006028,445,229,214,524,1412
E01006029,604,260,259,218,1341
E01006030,544,295,133,403,1375
E01006031,347,183,133,501,1164
E01006032,423,172,96,323,1014
E01006033,450,231,161,261,1103
E01006034,734,254,198,450,1636
E01006035,716,320,201,374,1611
E01006036,580,248,244,393,1465
E01006037,683,492,52,7,1234
E01006038,633,470,91,92,1286
E01006039,394,284,156,164,998
E01006040,471,204,287,213,1175
E01006041,589,299,255,63,1206
E01006042,628,489,182,64,1363
E01006043,546,380,119,114,1159
E01006044,502,466,58,106,1132
E01006045,475,539,60,8,1082
E01006046,545,513,119,11,1188
E01006047,476,342,120,141,1079
E01006048,478,538,195,66,1277
E01006049,549,450,168,120,1287
E01006050,328,172,57,758,1315
E01006051,615,473,122,142,1352
E01006052,386,212,84,516,1198
E01006053,749,561,195,19,1524
E01006054,458,331,126,371,1286
E01006055,594,351,160,45,1150
E01006056,208,108,85,479,880
E01006057,647,364,167,27,1205
E01006058,699,414,397,67,1577
E01006059,610,342,157,36,1145
E01006060,368,172,206,375,1121
E01006061,789,293,110,611,1803
E01006062,940,576,134,26,1676
E01006063,689,394,77,37,1197
E01006064,327,242,110,562,1241
E01006065,318,173,49,430,970
E01006066,475,270,202,128,1075
E01006067,930,402,101,38,1471
E01006068,427,245,400,236,1308
E01006069,412,193,103,532,1240
E01006070,588,391,173,22,1174
E01006071,560,713,69,32,1374
E01006072,715,638,49,10,1412
E01006073,475,159,218,413,1265
E01006074,520,241,93,328,1182
E01006075,572,537,385,51,1545
E01006076,429,604,231,55,1319
E01006077,456,299,414,169,1338
E01006078,618,304,524,116,1562
E01006079,676,492,384,60,1612
E01006080,623,474,294,65,1456
E01006081,486,542,60,0,1088
E01006082,454,636,201,5,1296
E01006083,514,450,82,10,1056
E01006084,656,476,166,10,1308
E01006085,549,457,133,23,1162
E01006086,487,424,150,227,1288
E01006087,429,480,178,146,1233
E01006088,563,384,225,41,1213
E01006089,569,323,245,83,1220
E01006090,722,496,267,156,1641
E01006091,1079,271,271,179,1800
E01006092,302,101,81,504,988
E01006093,677,436,113,15,1241
E01006094,562,566,64,11,1203
E01006095,767,437,105,20,1329
E01006096,620,423,116,13,1172
E01006097,434,558,413,47,1452
E01006098,415,525,71,2,1013
E01006099,538,349,158,36,1081
E01006100,627,341,158,83,1209
E01006101,637,491,60,0,1188
E01006102,489,359,86,146,1080
E01006103,734,449,77,3,1263
E01006104,601,452,161,155,1369
E01006105,341,170,86,710,1307
E01006106,512,305,90,251,1158
E01006107,501,255,170,361,1287
E01006108,232,76,45,793,1146
E01006109,80,73,124,839,1116
E01006110,430,399,260,245,1334
E01006111,193,177,249,562,1181
E01006112,265,308,202,494,1269
E01006113,455,519,162,32,1168
E01006114,497,334,132,306,1269
E01006115,443,379,229,221,1272
E01006116,562,360,119,15,1056
E01006117,710,538,36,62,1346
E01006118,508,276,92,272,1148
E01006119,691,527,59,54,1331
E01006120,577,504,74,3,1158
E01006121,599,478,89,63,1229
E01006122,584,629,72,30,1315
E01006123,631,512,127,61,1331
E01006124,580,591,44,9,1224
E01006125,575,468,54,136,1233
E01006126,493,295,76,455,1319
E01006127,735,392,84,71,1282
E01006128,729,488,119,54,1390
E01006129,423,362,65,250,1100
E01006130,762,479,99,113,1453
E01006131,662,436,99,58,1255
E01006132,656,378,97,136,1267
E01006133,569,614,59,16,1258
E01006134,546,579,74,2,1201
E01006135,491,613,86,52,1242
E01006136,570,547,120,3,1240
E01006137,514,545,62,7,1128
E01006138,558,542,137,205,1442
E01006139,654,430,220,5,1309
E01006140,657,388,141,73,1259
E01006141,527,328,133,218,1206
E01006142,514,453,155,233,1355
E01006143,595,473,206,84,1358
E01006144,282,161,223,490,1156
E01006145,408,282,181,457,1328
E01006146,741,476,172,57,1446
E01006147,586,458,57,7,1108
E01006148,553,524,200,38,1315
E01006149,523,347,182,130,1182
E01006150,511,431,245,68,1255
E01006151,559,545,74,17,1195
E01006152,622,652,53,7,1334
E01006153,590,603,69,37,1299
E01006154,633,303,211,40,1187
E01006155,606,411,209,69,1295
E01006156,555,328,81,282,1246
E01006157,578,402,139,115,1234
E01006158,443,300,137,431,1311
E01006159,490,262,112,444,1308
E01006160,418,238,585,282,1523
E01006161,602,436,480,51,1569
E01006162,595,445,272,7,1319
E01006163,673,316,456,17,1462
E01006164,568,564,136,111,1379
E01006165,670,367,401,134,1572
E01006166,523,335,119,302,1279
E01006167,251,144,54,834,1283
E01006168,312,89,92,875,1368
E01006169,605,526,121,85,1337
E01006170,602,387,113,160,1262
E01006171,509,264,122,492,1387
E01006172,554,579,64,102,1299
E01006173,633,519,57,28,1237
E01006174,590,540,260,50,1440
E01006175,416,211,73,579,1279
E01006176,651,473,188,142,1454
E01006177,465,137,88,515,1205
E01006178,737,471,207,76,1491
E01006179,538,325,173,413,1449
E01006180,601,353,407,116,1477
E01006181,577,354,185,187,1303
E01006182,652,474,86,33,1245
E01006183,703,445,132,49,1329
E01006184,552,352,110,323,1337
E01006185,254,226,578,568,1626
E01006186,533,304,382,240,1459
E01006187,913,356,472,281,2022
E01006188,364,332,325,144,1165
E01006189,702,444,285,284,1715
E01006190,610,649,82,6,1347
E01006191,624,596,94,18,1332
E01006192,584,536,83,29,1232
E01006193,546,524,114,19,1203
E01006194,778,342,504,167,1791
E01006195,722,596,80,9,1407
E01006196,886,460,65,13,1424
E01006197,619,400,128,38,1185
E01006198,538,310,193,169,1210
E01006199,510,318,185,272,1285
E01006200,445,341,99,265,1150
E01006201,640,273,168,112,1193
E01006202,437,378,202,108,1125
E01006203,647,395,48,10,1100
E01006204,577,533,106,109,1325
E01006205,514,480,72,37,1103
E01006206,635,330,110,349,1424
E01006207,343,157,105,693,1298
E01006208,531,317,74,320,1242
E01006209,558,599,61,37,1255
E01006210,639,473,77,115,1304
E01006211,540,288,86,295,1209
E01006212,510,460,83,91,1144
E01006213,376,203,260,404,1243
E01006214,438,279,194,156,1067
E01006215,367,289,172,455,1283
E01006216,890,453,209,144,1696
E01006217,825,354,220,387,1786
E01006218,644,332,381,224,1581
E01006219,474,456,109,18,1057
E01006220,499,338,134,449,1420
E01006221,612,529,177,18,1336
E01006222,665,488,82,21,1256
E01006223,608,423,212,32,1275
E01006224,847,209,66,4,1126
E01006225,501,583,99,74,1257
E01006226,668,572,135,58,1433
E01006227,604,436,102,102,1244
E01006228,593,379,256,105,1333
E01006229,432,669,166,17,1284
E01006230,571,476,60,81,1188
E01006231,567,553,63,54,1237
E01006232,734,556,179,29,1498
E01006233,645,495,40,6,1186
E01006234,371,462,76,135,1044
E01006235,359,238,109,493,1199
E01006236,524,616,107,28,1275
E01006237,676,411,59,62,1208
E01006238,380,285,166,418,1249
E01006239,442,224,130,827,1623
E01006240,227,162,82,686,1157
E01006241,498,279,157,520,1454
E01006242,569,543,151,111,1374
E01006243,833,565,236,35,1669
E01006244,419,409,305,197,1330
E01006245,944,497,325,183,1949
E01006246,428,455,126,306,1315
E01006247,527,446,61,79,1113
E01006248,226,142,74,818,1260
E01006249,422,257,76,468,1223
E01006250,656,511,118,7,1292
E01006251,636,439,115,27,1217
E01006252,544,539,99,41,1223
E01006253,385,428,119,334,1266
E01006254,296,150,85,655,1186
E01006255,569,554,116,32,1271
E01006256,553,376,167,66,1162
E01006257,467,388,196,5,1056
E01006258,595,488,191,62,1336
E01006259,531,389,85,85,1090
E01006260,420,254,79,449,1202
E01006261,493,430,109,212,1244
E01006262,419,234,90,461,1204
E01006263,539,721,47,18,1325
E01006264,566,534,38,13,1151
E01006265,523,438,162,68,1191
E01006266,502,630,62,24,1218
E01006267,375,211,79,675,1340
E01006268,645,409,206,153,1413
E01006269,577,415,152,183,1327
E01006270,354,299,89,498,1240
E01006271,677,528,191,63,1459
E01006272,621,323,230,88,1262
E01006273,424,365,130,307,1226
E01006274,383,255,129,405,1172
E01006275,291,209,89,589,1178
E01006276,1026,456,211,46,1739
E01006277,968,318,45,29,1360
E01006278,547,597,88,91,1323
E01006279,712,470,81,13,1276
E01006280,450,448,108,149,1155
E01006281,786,532,118,6,1442
E01006282,551,376,128,274,1329
E01006283,414,219,146,400,1179
E01006284,521,229,126,335,1211
E01006285,799,627,86,10,1522
E01006286,503,596,67,113,1279
E01006287,525,425,54,17,1021
E01006288,389,216,80,679,1364
E01006289,342,221,135,698,1396
E01006290,533,539,96,14,1182
E01006291,501,335,164,191,1191
E01006292,515,595,119,56,1285
E01006293,523,285,160,288,1256
E01006294,766,318,401,73,1558
E01006295,586,291,197,240,1314
E01006296,393,145,155,493,1186
E01006297,319,240,209,510,1278
E01006298,372,187,149,412,1120
E01006299,810,497,189,41,1537
E01006300,471,604,53,44,1172
E01006301,579,470,46,32,1127
E01006302,742,374,137,42,1295
E01006303,509,557,90,15,1171
E01006304,483,478,81,161,1203
E01006305,265,228,111,746,1350
E01006306,234,196,306,601,1337
E01006307,401,274,119,368,1162
E01006308,430,275,227,325,1257
E01006309,411,234,195,368,1208
E01006310,350,193,233,396,1172
E01006311,428,271,133,391,1223
E01006312,541,609,83,21,1254
E01006313,256,227,67,319,869
E01006314,605,673,131,20,1429
E01006315,468,477,69,10,1024
E01006316,567,540,124,34,1265
E01006317,505,485,101,167,1258
E01006318,507,654,58,16,1235
E01006319,673,217,117,36,1043
E01006320,545,553,59,5,1162
E01006321,787,491,86,23,1387
E01006322,443,299,240,242,1224
E01006323,438,290,296,149,1173
E01006324,416,293,146,220,1075
E01006325,616,393,147,112,1268
E01006326,480,331,264,87,1162
E01006327,276,167,107,578,1128
E01006328,425,287,371,87,1170
E01006329,323,242,140,194,899
E01006330,663,577,86,44,1370
E01006331,700,489,59,49,1297
E01006332,728,331,321,107,1487
E01006333,633,327,351,120,1431
E01006334,469,319,505,76,1369
E01006335,600,323,311,109,1343
E01006336,203,131,89,781,1204
E01006337,589,388,102,154,1233
E01006338,522,361,239,157,1279
E01006339,551,536,74,32,1193
E01006340,494,256,133,266,1149
E01006341,524,243,196,360,1323
E01006342,422,296,158,394,1270
E01006343,842,369,82,21,1314
E01006344,348,218,94,460,1120
E01006345,625,543,60,47,1275
E01006346,731,473,307,218,1729
E01006347,676,549,67,10,1302
E01006348,618,605,89,9,1321
E01006349,562,318,496,133,1509
E01006350,318,100,170,776,1364
E01006351,224,111,211,1007,1553
E01006352,514,355,333,141,1343
E01006353,553,540,133,81,1307
E01006354,435,312,149,319,1215
E01006355,582,465,202,31,1280
E01006356,393,232,72,449,1146
E01006357,258,101,90,785,1234
E01006358,512,403,220,289,1424
E01006359,436,319,159,264,1178
E01006360,260,126,72,814,1272
E01006361,319,145,119,611,1194
E01006362,680,668,111,22,1481
E01006363,500,774,57,12,1343
E01006364,655,362,134,315,1466
E01006365,955,527,160,41,1683
E01006366,509,559,105,273,1446
E01006367,663,593,47,39,1342
E01006368,540,590,120,91,1341
E01006369,456,308,374,304,1442
E01006370,421,371,495,87,1374
E01006371,618,449,185,14,1266
E01006372,567,677,121,4,1369
E01006373,566,555,135,17,1273
E01006374,571,583,113,17,1284
E01006375,583,420,271,22,1296
E01006376,426,262,85,493,1266
E01006377,690,537,65,41,1333
E01006378,524,550,64,22,1160
E01006379,580,523,144,37,1284
E01006380,440,234,114,541,1329
E01006381,943,357,130,44,1474
E01006382,642,459,47,15,1163
E01006383,754,342,77,154,1327
E01006384,662,401,86,18,1167
E01006385,666,532,43,20,1261
E01006386,150,95,145,999,1389
E01006387,420,363,147,88,1018
E01006388,604,345,84,337,1370
E01006389,613,241,99,132,1085
E01006390,433,561,123,191,1308
E01006391,558,627,80,75,1340
E01006392,279,141,161,532,1113
E01006393,707,443,75,3,1228
E01006394,637,656,34,4,1331
E01006395,1396,382,80,7,1865
E01006396,576,471,102,24,1173
E01006397,299,249,56,340,944
E01006398,379,194,113,212,898
E01006399,492,400,207,176,1275
E01006400,731,275,45,4,1055
E01006401,648,492,47,6,1193
E01006402,523,452,20,7,1002
E01006403,703,641,59,4,1407
E01006404,531,244,208,281,1264
E01006405,415,303,120,296,1134
E01006406,484,622,93,48,1247
E01006407,731,431,66,17,1245
E01006408,460,291,101,384,1236
E01006409,522,630,37,11,1200
E01006410,576,510,50,29,1165
E01006411,303,95,115,756,1269
E01006412,229,232,80,627,1168
E01006413,167,76,85,871,1199
E01006414,278,269,57,511,1115
E01006415,733,345,147,378,1603
E01006416,372,242,137,410,1161
E01006417,199,179,113,596,1087
E01006418,345,233,82,410,1070
E01006419,806,282,94,8,1190
E01006420,916,468,158,47,1589
E01006421,658,215,48,22,943
E01006422,502,522,50,17,1091
E01006423,681,388,64,17,1150
E01006424,1053,497,103,30,1683
E01006425,629,256,75,150,1110
E01006426,357,142,62,441,1002
E01006427,596,517,66,54,1233
E01006428,540,244,78,308,1170
E01006429,281,156,53,390,880
E01006430,264,151,78,509,1002
E01006431,622,363,151,232,1368
E01006432,440,309,86,377,1212
E01006433,477,384,64,227,1152
E01006434,448,209,148,368,1173
E01006435,417,334,68,432,1251
E01006436,379,198,124,484,1185
E01006437,396,220,90,416,1122
E01006438,393,454,95,81,1023
E01006439,525,314,215,267,1321
E01006440,308,180,142,495,1125
E01006441,930,326,136,455,1847
E01006442,223,103,77,603,1006
E01006443,312,214,95,478,1099
E01006444,262,153,101,484,1000
E01006445,325,168,69,463,1025
E01006446,392,260,116,313,1081
E01006447,327,118,220,410,1075
E01006448,382,188,164,544,1278
E01006449,516,306,147,233,1202
E01006450,330,213,154,401,1098
E01006451,480,325,127,247,1179
E01006452,636,282,214,75,1207
E01006453,240,125,52,501,918
E01006454,562,406,49,46,1063
E01006455,410,287,220,357,1274
E01006456,719,335,77,195,1326
E01006457,469,551,34,24,1078
E01006458,521,312,110,207,1150
E01006459,672,383,165,67,1287
E01006460,295,163,98,640,1196
E01006461,395,265,102,449,1211
E01006462,567,464,119,61,1211
E01006463,496,238,350,427,1511
E01006464,499,454,99,302,1354
E01006465,791,399,72,98,1360
E01006466,594,302,184,225,1305
E01006467,173,127,54,629,983
E01006470,294,166,72,575,1107
E01006471,598,561,75,14,1248
E01006472,640,558,86,40,1324
E01006473,538,412,65,39,1054
E01006474,619,519,83,17,1238
E01006475,572,482,99,19,1172
E01006476,708,462,40,6,1216
E01006477,506,298,109,187,1100
E01006478,395,267,150,283,1095
E01006479,527,302,89,211,1129
E01006480,353,198,99,455,1105
E01006481,338,298,99,366,1101
E01006482,459,326,147,252,1184
E01006483,409,285,81,303,1078
E01006484,428,225,105,347,1105
E01006485,637,433,104,54,1228
E01006486,499,410,78,4,991
E01006487,633,547,97,11,1288
E01006488,814,536,65,7,1422
E01006489,575,440,114,58,1187
E01006490,1448,283,244,38,2013
E01006491,1101,240,134,24,1499
E01006492,549,278,54,225,1106
E01006493,193,46,48,543,830
E01006494,250,136,68,579,1033
E01006495,608,110,112,497,1327
E01006496,514,305,77,239,1135
E01006497,425,324,76,97,922
E01006498,744,309,78,48,1179
E01006499,615,409,180,95,1299
E01006500,281,224,43,365,913
E01006501,642,211,120,80,1053
E01006502,703,690,104,5,1502
E01006503,445,536,54,45,1080
E01006504,387,157,75,429,1048
E01006505,398,264,97,568,1327
E01006506,618,245,164,17,1044
E01006507,383,224,130,387,1124
E01006508,563,227,110,184,1084
E01006509,486,214,144,431,1275
E01006510,502,378,92,35,1007
E01006512,140,108,694,283,1225
E01006513,153,88,1186,211,1638
E01006514,91,89,794,680,1654
E01006515,124,34,252,613,1023
E01006518,203,161,268,727,1359
E01006519,522,451,56,26,1055
E01006520,208,99,897,395,1599
E01006521,352,340,474,287,1453
E01006522,237,97,809,398,1541
E01006523,293,170,496,358,1317
E01006524,269,316,346,19,950
E01006525,472,440,122,15,1049
E01006526,495,370,144,105,1114
E01006527,437,321,145,263,1166
E01006528,461,257,406,88,1212
E01006529,520,321,200,39,1080
E01006530,546,584,67,22,1219
E01006531,501,622,69,97,1289
E01006532,599,597,52,29,1277
E01006533,457,462,85,148,1152
E01006534,579,328,77,287,1271
E01006535,584,349,104,275,1312
E01006536,607,359,152,427,1545
E01006537,719,475,519,134,1847
E01006538,538,393,98,72,1101
E01006539,533,555,103,12,1203
E01006540,200,141,441,412,1194
E01006541,510,371,206,263,1350
E01006542,353,240,252,204,1049
E01006543,551,360,90,52,1053
E01006544,249,180,236,639,1304
E01006545,495,317,332,30,1174
E01006546,313,292,373,38,1016
E01006547,276,269,480,172,1197
E01006548,314,299,473,147,1233
E01006549,144,142,838,309,1433
E01006550,206,125,1109,59,1499
E01006551,89,72,237,663,1061
E01006552,171,169,509,601,1450
E01006553,341,199,1084,81,1705
E01006554,291,189,876,152,1508
E01006556,114,155,578,747,1594
E01006557,212,204,1433,63,1912
E01006558,159,205,326,441,1131
E01006560,143,153,105,1175,1576
E01006562,209,223,241,512,1185
E01006563,115,94,257,938,1404
E01006564,397,497,165,418,1477
E01006565,516,377,109,273,1275
E01006566,620,350,96,93,1159
E01006567,398,309,181,518,1406
E01006568,640,267,119,154,1180
E01006569,405,317,92,350,1164
E01006570,590,401,163,51,1205
E01006571,430,249,94,405,1178
E01006572,230,139,71,469,909
E01006573,400,233,256,334,1223
E01006574,396,230,86,382,1094
E01006575,430,357,134,164,1085
E01006576,772,446,151,25,1394
E01006577,643,478,105,10,1236
E01006578,624,327,134,23,1108
E01006579,642,590,70,15,1317
E01006580,587,458,54,8,1107
E01006581,633,508,110,13,1264
E01006582,667,524,84,22,1297
E01006583,485,484,41,13,1023
E01006584,536,433,103,75,1147
E01006585,322,208,103,503,1136
E01006586,565,330,365,322,1582
E01006587,541,335,230,243,1349
E01006588,478,341,460,75,1354
E01006589,674,437,91,26,1228
E01006590,436,325,627,64,1452
E01006591,617,333,403,21,1374
E01006592,577,536,172,18,1303
E01006593,453,277,553,41,1324
E01006594,545,511,111,19,1186
E01006595,666,480,280,50,1476
E01006596,567,438,198,25,1228
E01006597,613,562,172,20,1367
E01006598,159,110,74,695,1038
E01006599,105,75,70,564,814
E01006600,383,299,99,392,1173
E01006603,374,337,70,372,1153
E01006604,432,286,94,318,1130
E01006605,413,249,131,477,1270
E01006606,493,312,198,264,1267
E01006607,415,279,87,444,1225
E01006608,373,242,192,189,996
E01006609,389,286,207,178,1060
E01006610,322,237,233,347,1139
E01006611,246,188,434,187,1055
E01006612,309,204,99,602,1214
E01006613,386,328,95,343,1152
E01006614,347,269,314,154,1084
E01006615,302,220,301,248,1071
E01006616,445,276,111,353,1185
E01006617,551,383,212,70,1216
E01006618,566,403,96,326,1391
E01006619,551,452,275,61,1339
E01006620,537,438,86,128,1189
E01006621,603,492,102,52,1249
E01006622,666,502,57,13,1238
E01006623,673,493,39,18,1223
E01006624,547,301,193,248,1289
E01006625,556,456,97,62,1171
E01006626,608,419,73,146,1246
E01006627,524,377,116,135,1152
E01006628,540,363,282,91,1276
E01006629,392,359,176,176,1103
E01006630,90,49,131,759,1029
E01006632,274,190,226,775,1465
E01006633,200,92,152,707,1151
E01006637,295,105,145,616,1161
E01006638,201,126,122,485,934
E01006639,573,258,147,199,1177
E01006640,694,498,139,165,1496
E01006641,809,126,157,75,1167
E01006642,237,159,104,514,1014
E01006643,377,208,173,599,1357
E01006644,575,281,297,490,1643
E01006645,230,194,110,627,1161
E01006646,245,108,454,808,1615
E01006647,101,89,60,821,1071
E01006648,290,132,627,846,1895
E01006651,895,241,73,39,1248
E01006652,535,406,236,34,1211
E01006653,500,264,116,331,1211
E01006654,604,237,194,143,1178
E01006655,525,349,191,320,1385
E01006656,550,366,258,47,1221
E01006657,371,252,233,122,978
E01006658,270,205,125,467,1067
E01006659,275,145,160,299,879
E01006660,433,252,109,342,1136
E01006661,353,224,152,621,1350
E01006662,347,192,154,604,1297
E01006663,386,103,124,283,896
E01006664,395,220,278,513,1406
E01006665,832,236,129,22,1219
E01006666,832,226,85,13,1156
E01006667,558,282,95,230,1165
E01006668,839,196,118,10,1163
E01006669,731,192,121,98,1142
E01006670,701,322,119,62,1204
E01006671,570,250,71,208,1099
E01006672,391,236,152,666,1445
E01006673,84,57,453,905,1499
E01006674,104,119,215,917,1355
E01006675,151,144,773,492,1560
E01006676,153,163,254,713,1283
E01006677,70,95,86,479,730
E01006678,262,180,282,1049,1773
E01006679,96,109,271,1054,1530
E01006680,656,562,56,36,1310
E01006681,494,421,174,253,1342
E01006682,518,484,60,6,1068
E01006683,609,559,57,26,1251
E01006684,770,590,396,15,1771
E01006685,503,487,193,23,1206
E01006686,578,511,91,12,1192
E01006687,709,448,193,263,1613
E01006688,480,418,297,87,1282
E01006689,705,466,146,48,1365
E01006690,224,166,474,398,1262
E01006691,179,211,466,292,1148
E01006692,408,316,574,450,1748
E01006693,227,224,176,707,1334
E01006694,218,208,778,277,1481
E01006695,256,177,641,469,1543
E01006696,330,227,401,414,1372
E01006697,294,280,641,240,1455
E01006698,509,338,301,176,1324
E01006699,161,162,177,762,1262
E01006700,299,246,294,310,1149
E01006701,418,324,163,269,1174
E01006702,268,263,255,479,1265
E01006703,242,180,172,691,1285
E01006705,411,261,382,103,1157
E01006706,201,176,53,656,1086
E01006707,215,215,35,573,1038
E01006708,567,223,105,491,1386
E01006709,424,217,63,507,1211
E01006710,514,388,156,127,1185
E01006711,395,270,338,184,1187
E01006712,423,272,250,64,1009
E01006713,483,367,233,29,1112
E01006716,355,234,291,248,1128
E01006717,560,414,165,34,1173
E01006718,546,391,199,158,1294
E01006719,501,375,241,92,1209
E01006720,253,147,857,406,1663
E01006721,220,136,564,456,1376
E01006722,294,186,1025,86,1591
E01006723,212,253,1015,208,1688
E01006724,270,245,1036,113,1664
E01006725,330,291,410,253,1284
E01006726,273,229,656,167,1325
E01006727,476,303,380,53,1212
E01006728,204,178,521,422,1325
E01006729,189,150,52,627,1018
E01006730,295,214,56,480,1045
E01006731,307,170,122,341,940
E01006732,40,85,44,1008,1177
E01006734,169,140,98,651,1058
E01006735,285,165,79,501,1030
E01006736,354,248,122,443,1167
E01006737,327,219,86,520,1152
E01006738,345,264,101,473,1183
E01006739,293,143,118,757,1311
E01006740,143,112,141,622,1018
E01006741,452,291,119,608,1470
E01006742,483,261,125,283,1152
E01006743,672,261,421,373,1727
E01006744,550,231,258,170,1209
E01006745,361,301,558,275,1495
E01006746,159,214,422,515,1310
E01006747,100,119,842,464,1525
E01006748,187,238,1054,289,1768
E01006751,200,157,549,779,1685
E01006752,252,180,266,141,839
E01006753,299,174,98,613,1184
E01006754,314,221,214,568,1317
E01006755,209,83,117,757,1166
E01006756,274,171,180,723,1348
E01006757,295,187,107,506,1095
E01006758,347,184,76,550,1157
E01006759,317,232,240,70,859
E01006760,248,189,656,270,1363
E01006761,428,277,309,299,1313
E01006762,393,281,172,499,1345
E01006763,523,274,307,55,1159
E01006764,391,287,400,136,1214
E01006765,497,285,234,176,1192
E01006766,248,173,339,208,968
E01006767,459,229,471,226,1385
E01006768,423,305,319,102,1149
E01006769,246,146,66,601,1059
E01006770,245,190,49,324,808
E01006771,225,183,116,648,1172
E01006772,410,282,57,159,908
E01006773,598,417,92,30,1137
E01006774,689,355,73,53,1170
E01006775,207,189,64,615,1075
E01006776,339,131,189,743,1402
E01006778,249,225,501,889,1864
E01006779,276,119,113,1049,1557
E01006780,564,369,220,43,1196
E01006781,724,357,100,41,1222
E01006782,536,349,309,67,1261
E01006783,553,355,259,46,1213
E01006784,528,307,214,36,1085
E01006785,575,371,418,74,1438
E01006786,723,457,182,96,1458
E01006787,418,208,440,174,1240
E01006788,667,387,260,90,1404
E01006790,224,160,282,610,1276
E01006791,332,173,314,592,1411
E01006792,483,555,58,53,1149
E01006793,347,420,255,231,1253
E01006794,514,520,245,67,1346
E01006795,568,436,156,23,1183
E01006796,624,590,67,18,1299
E01006797,467,288,113,379,1247
E01006798,530,527,117,41,1215
E01006799,353,343,302,637,1635
E01006800,484,653,97,12,1246
E01006801,522,589,73,7,1191
E01006802,565,551,90,208,1414
E01006803,548,583,75,16,1222
E01006804,521,593,79,132,1325
E01006805,488,384,79,265,1216
E01006806,525,674,52,24,1275
E01006807,446,651,29,16,1142
E01006808,595,468,48,6,1117
E01006809,570,600,74,16,1260
E01006810,511,524,23,20,1078
E01006811,424,495,62,169,1150
E01006812,304,224,87,463,1078
E01006813,423,398,146,279,1246
E01006814,671,554,36,32,1293
E01006815,349,394,81,226,1050
E01006816,290,166,161,656,1273
E01006817,232,142,110,574,1058
E01006818,521,460,42,68,1091
E01006819,537,329,110,228,1204
E01006820,333,225,169,387,1114
E01006821,278,243,118,466,1105
E01006822,547,490,44,39,1120
E01006823,377,685,41,8,1111
E01006824,490,460,37,5,992
E01006825,503,660,73,3,1239
E01006826,342,339,62,404,1147
E01006827,733,404,78,22,1237
E01006828,802,835,125,29,1791
E01006829,435,456,111,22,1024
E01006830,230,97,101,581,1009
E01006831,524,332,209,128,1193
E01006832,608,148,206,331,1293
E01006833,629,465,223,43,1360
E01006834,329,240,215,192,976
E01006835,496,428,130,108,1162
E01006836,392,394,106,274,1166
E01006837,486,463,106,155,1210
E01006838,490,340,202,183,1215
E01006839,486,401,62,202,1151
E01006840,575,500,89,115,1279
E01006841,822,395,54,65,1336
E01006842,397,154,141,489,1181
E01006843,311,389,94,212,1006
E01006844,415,328,217,319,1279
E01006845,486,324,281,133,1224
E01006846,522,554,56,51,1183
E01006847,296,152,69,768,1285
E01006848,500,506,107,87,1200
E01006849,305,227,61,537,1130
E01006850,370,293,104,471,1238
E01006851,454,427,53,154,1088
E01006852,584,475,34,23,1116
E01006853,584,419,62,81,1146
E01006854,487,382,119,202,1190
E01006855,397,469,74,250,1190
E01006856,578,317,178,34,1107
E01006857,567,492,78,52,1189
E01006858,376,268,98,384,1126
E01006859,693,476,138,53,1360
E01006860,430,321,123,275,1149
E01006861,261,84,74,721,1140
E01006862,383,214,78,385,1060
E01006863,436,250,260,393,1339
E01006864,811,398,249,82,1540
E01006865,393,279,117,611,1400
E01006866,401,187,91,501,1180
E01006867,949,410,110,113,1582
E01006868,344,255,118,449,1166
E01006869,467,313,144,268,1192
E01006870,387,362,282,92,1123
E01006871,297,169,187,505,1158
E01006872,238,202,364,374,1178
E01006873,141,109,91,521,862
E01006874,201,128,224,390,943
E01006875,308,261,207,229,1005
E01006876,485,469,233,53,1240
E01006877,344,299,218,297,1158
E01006878,526,360,147,114,1147
E01006879,485,269,101,323,1178
E01006880,311,203,210,470,1194
E01006881,341,224,264,376,1205
E01006882,398,565,32,21,1016
E01006883,380,610,99,38,1127
E01006884,433,571,60,106,1170
E01006885,456,541,77,27,1101
E01006886,467,604,55,10,1136
E01006887,389,414,107,172,1082
E01006888,423,536,38,15,1012
E01006889,616,492,68,23,1199
E01006890,541,441,124,81,1187
E01006891,538,426,61,90,1115
E01006892,464,430,58,40,992
E01006893,509,433,140,72,1154
E01006894,412,615,63,69,1159
E01006895,389,763,60,10,1222
E01006896,591,667,70,11,1339
E01006897,568,477,89,121,1255
E01006898,420,545,106,287,1358
E01006899,671,344,293,226,1534
E01006900,1217,443,290,134,2084
E01006901,535,412,106,22,1075
E01006903,347,256,162,476,1241
E01006904,549,365,133,305,1352
E01006905,299,277,47,463,1086
E01006906,569,369,192,68,1198
E01006907,566,387,122,168,1243
E01006908,332,217,91,408,1048
E01006909,138,101,67,590,896
E01006910,505,279,203,385,1372
E01006911,533,671,64,33,1301
E01006912,370,200,149,367,1086
E01006913,236,288,53,451,1028
E01006914,428,564,32,11,1035
E01006915,487,386,125,307,1305
E01006916,559,417,149,122,1247
E01006917,652,607,52,39,1350
E01006918,542,336,108,30,1016
E01006919,303,212,151,497,1163
E01006920,597,474,160,79,1310
E01006921,417,685,48,6,1156
E01006922,494,701,57,6,1258
E01006923,441,786,73,0,1300
E01006924,368,293,129,364,1154
E01006925,466,344,101,276,1187
E01006926,583,746,81,10,1420
E01006927,589,523,139,132,1383
E01006928,540,519,75,58,1192
E01006929,639,403,183,24,1249
E01006930,514,412,121,113,1160
E01006931,592,554,79,31,1256
E01006932,622,540,77,6,1245
E01006933,567,351,142,62,1122
E01006934,524,445,223,35,1227
E01006935,646,481,206,7,1340
E01006936,476,632,207,10,1325
E01006937,544,457,32,0,1033
E01006938,400,532,69,56,1057
E01006939,599,388,197,31,1215
E01006940,508,486,147,16,1157
E01006941,626,477,200,29,1332
E01006942,564,376,176,84,1200
E01006943,549,463,24,2,1038
E01006944,251,628,356,111,1346
E01006945,315,496,472,20,1303
E01006946,444,632,104,38,1218
E01006947,542,565,88,12,1207
E01006948,358,281,121,342,1102
E01006949,394,555,129,180,1258
E01006950,243,230,617,132,1222
E01006951,364,602,229,58,1253
E01006952,292,184,129,488,1093
E01006953,361,248,159,382,1150
E01006954,552,357,264,82,1255
E01006955,764,313,180,60,1317
E01006956,601,259,326,67,1253
E01006957,296,239,285,476,1296
E01006958,447,278,331,171,1227
E01006959,517,429,222,82,1250
E01006960,484,400,68,19,971
E01006961,488,239,262,183,1172
E01006962,506,296,121,245,1168
E01006963,291,220,264,332,1107
E01006964,394,236,259,279,1168
E01006965,420,229,82,407,1138
E01006966,552,251,201,208,1212
E01006967,340,216,202,465,1223
E01006968,193,298,843,149,1483
E01006969,407,280,438,23,1148
E01006970,337,344,607,31,1319
E01006971,361,644,334,20,1359
E01006972,351,701,185,182,1419
E01006973,402,591,188,19,1200
E01006974,500,665,149,6,1320
E01006976,628,312,97,128,1165
E01006977,401,225,145,620,1391
E01006978,611,412,101,36,1160
E01006979,282,207,98,512,1099
E01006980,303,172,85,565,1125
E01006981,381,185,133,460,1159
E01006982,452,372,188,96,1108
E01006983,664,354,190,105,1313
E01006984,299,124,88,417,928
E01006985,522,612,47,20,1201
E01006986,411,600,49,0,1060
E01006987,366,622,65,12,1065
E01006988,450,460,77,157,1144
E01006989,425,646,49,2,1122
E01006990,444,545,36,2,1027
E01006991,528,693,35,3,1259
E01006992,389,379,54,70,892
E01006993,546,657,35,8,1246
E01006994,499,298,380,20,1197
E01006995,526,378,90,39,1033
E01006996,500,311,377,26,1214
E01006997,624,341,208,23,1196
E01006998,564,324,359,46,1293
E01006999,557,519,168,72,1316
E01007000,395,262,101,248,1006
E01007001,488,366,261,99,1214
E01007002,523,485,110,11,1129
E01007003,227,142,265,282,916
E01007004,351,161,155,448,1115
E01007005,172,124,148,550,994
E01007006,296,158,191,436,1081
E01007007,187,68,56,693,1004
E01007008,228,144,175,478,1025
E01007009,176,100,290,438,1004
E01007010,162,123,126,434,845
E01007011,253,144,206,568,1171
E01007012,462,230,195,172,1059
E01007013,332,208,331,243,1114
E01007014,694,455,84,80,1313
E01007016,511,240,233,421,1405
E01007017,352,191,187,496,1226
E01007019,250,69,79,613,1011
E01007020,474,287,70,316,1147
E01007021,560,546,44,4,1154
E01007022,413,332,167,264,1176
E01007023,541,510,60,11,1122
E01007024,279,115,50,435,879
E01007025,577,520,23,11,1131
E01007026,350,238,77,290,955
E01007027,863,837,84,27,1811
E01007028,502,464,120,25,1111
E01007029,356,675,61,27,1119
E01007030,588,344,140,112,1184
E01007031,544,474,95,66,1179
E01007032,492,485,98,13,1088
E01007033,500,588,119,22,1229
E01007034,511,519,72,19,1121
E01007035,451,483,178,28,1140
E01007036,443,525,73,6,1047
E01007037,615,560,75,52,1302
E01007038,545,400,72,237,1254
E01007039,582,334,61,38,1015
E01007040,859,442,133,72,1506
E01007041,529,419,88,135,1171
E01007042,499,429,71,74,1073
E01007043,544,620,56,27,1247
E01007044,449,648,52,64,1213
E01007045,503,477,46,25,1051
E01007046,706,421,109,71,1307
E01007047,527,292,65,290,1174
E01007048,380,141,106,573,1200
E01007049,599,281,97,268,1245
E01007050,528,326,59,140,1053
E01007051,282,184,72,412,950
E01007052,424,218,71,339,1052
E01007053,568,379,103,98,1148
E01007054,411,367,105,288,1171
E01007055,326,210,151,421,1108
E01007056,633,359,251,28,1271
E01007057,578,405,234,22,1239
E01007058,553,335,266,10,1164
E01007059,636,364,159,24,1183
E01007060,490,267,162,172,1091
E01007061,614,313,179,34,1140
E01007062,584,403,151,20,1158
E01007063,599,382,181,57,1219
E01007064,520,352,94,15,981
E01007065,612,402,67,7,1088
E01007066,686,438,115,34,1273
E01007067,564,504,96,3,1167
E01007068,630,400,24,10,1064
E01007069,507,458,104,140,1209
E01007070,585,635,48,2,1270
E01007071,538,479,25,21,1063
E01007072,416,725,76,50,1267
E01007073,624,458,28,0,1110
E01007074,553,399,94,175,1221
E01007075,471,559,106,5,1141
E01007076,504,504,114,27,1149
E01007077,605,474,93,33,1205
E01007078,563,642,82,14,1301
E01007079,504,656,103,25,1288
E01007080,501,529,89,43,1162
E01007081,490,641,132,28,1291
E01007082,511,568,101,6,1186
E01007083,449,318,75,150,992
E01007084,758,310,58,13,1139
E01007085,347,180,102,431,1060
E01007086,275,181,73,382,911
E01007087,329,177,85,509,1100
E01007088,535,242,56,232,1065
E01007089,403,219,77,374,1073
E01007090,324,142,41,423,930
E01007091,453,338,74,228,1093
E01007092,338,233,63,253,887
E01007095,590,657,98,8,1353
E01007096,554,564,39,8,1165
E01007097,576,623,86,24,1309
E01007098,551,580,55,38,1224
E01007099,513,549,111,73,1246
E01007100,552,517,58,40,1167
E01007101,538,673,54,0,1265
E01007102,627,357,186,25,1195
E01007103,646,494,81,6,1227
E01007104,567,391,144,15,1117
E01007105,640,416,142,112,1310
E01007106,593,391,92,124,1200
E01007107,600,391,57,2,1050
E01007108,652,490,64,64,1270
E01007109,579,368,175,101,1223
E01007110,568,609,131,39,1347
E01007111,701,517,49,9,1276
E01007112,577,471,124,54,1226
E01007113,525,501,64,39,1129
E01007114,431,298,119,287,1135
E01007115,537,360,142,233,1272
E01007116,548,527,188,25,1288
E01007117,733,442,120,19,1314
E01007118,489,282,84,332,1187
E01007119,337,188,148,473,1146
E01007120,346,163,98,388,995
E01007121,200,123,129,670,1122
E01007122,119,104,144,690,1057
E01007123,255,96,239,615,1205
E01007124,218,73,63,743,1097
E01007125,552,307,297,174,1330
E01007126,220,134,416,786,1556
E01007127,226,146,277,495,1144
E01007128,186,152,277,732,1347
E01007129,296,178,399,305,1178
E01007130,474,252,464,122,1312
E01007131,363,217,400,210,1190
E01007133,70,59,128,677,934
E01007135,544,562,110,26,1242
E01007136,497,265,119,415,1296
E01007137,583,354,169,234,1340
E01007138,418,254,283,340,1295
E01007139,539,295,225,168,1227
E01007140,671,360,246,72,1349
E01007141,392,313,331,341,1377
E01007142,623,552,196,104,1475
E01007143,670,298,214,114,1296
E01007144,339,419,282,15,1055
E01007145,477,623,32,6,1138
E01007146,542,622,179,2,1345
E01007147,522,595,58,3,1178
E01007148,577,750,50,4,1381
E01007149,597,640,28,2,1267
E01007150,644,520,48,5,1217
E01007151,603,544,82,28,1257
E01007152,519,453,203,184,1359
E01007153,390,361,92,323,1166
E01007154,593,560,61,51,1265
E01007155,406,259,424,359,1448
E01007156,569,451,171,52,1243
E01007157,672,361,163,13,1209
E01007158,557,533,185,11,1286
E01007159,684,532,167,20,1403
E01007160,513,432,298,143,1386
E01007161,611,451,127,78,1267
E01007162,320,148,81,549,1098
E01007163,1023,551,164,100,1838
E01007164,703,404,174,98,1379
E01007165,532,535,69,3,1139
E01007166,558,613,64,14,1249
E01007167,552,347,90,192,1181
E01007168,541,369,108,333,1351
E01007169,680,427,150,176,1433
E01007170,548,572,101,46,1267
E01007171,683,475,80,20,1258
E01007172,556,535,59,52,1202
E01007173,626,445,121,50,1242
E01007174,612,387,143,111,1253
E01007175,403,262,321,443,1429
E01007176,497,360,244,158,1259
E01007177,491,348,129,277,1245
E01007178,538,364,190,185,1277
E01007179,319,168,348,177,1012
E01007180,593,357,226,105,1281
E01007181,562,311,266,17,1156
E01007182,417,630,183,74,1304
E01007183,528,457,63,10,1058
E01007184,563,505,98,29,1195
E01007185,561,419,208,61,1249
E01007186,581,632,70,6,1289
E01007187,514,721,39,2,1276
E01007188,561,607,52,2,1222
E01007189,483,805,76,5,1369
E01007190,438,729,61,0,1228
E01007191,489,594,27,3,1113
E01007192,397,463,59,185,1104
E01007193,520,547,291,8,1366
E01007194,541,385,220,37,1183
E01007195,651,616,62,8,1337
E01007196,461,585,209,22,1277
E01007197,626,525,131,27,1309
E01007198,481,451,375,79,1386
E01007199,652,584,36,4,1276
E01007200,711,530,80,25,1346
E01007201,603,440,138,9,1190
E01007202,395,391,229,96,1111
E01007203,996,419,208,45,1668
E01007204,208,117,110,716,1151
E01007205,461,266,121,358,1206
E01007206,777,315,187,176,1455
E01007207,265,183,120,535,1103
E01007208,562,495,170,174,1401
E01007209,321,297,68,406,1092
E01007210,516,398,161,467,1542
E01007211,447,432,95,19,993
E01007212,560,469,139,51,1219
E01007213,547,574,154,9,1284
E01007214,460,352,186,191,1189
E01007215,372,158,452,249,1231
E01007216,539,358,267,39,1203
E01007217,542,322,422,14,1300
E01007218,477,247,369,62,1155
E01007219,559,318,282,41,1200
E01007220,278,178,251,209,916
E01007221,554,473,167,38,1232
E01007222,678,496,131,16,1321
E01007223,649,213,126,63,1051
E01007224,644,492,79,8,1223
E01007225,667,729,103,23,1522
E01007226,578,651,148,11,1388
E01007227,420,235,138,377,1170
E01007228,362,374,92,343,1171
E01007229,604,363,296,35,1298
E01007230,430,417,148,32,1027
E01007231,548,412,320,18,1298
E01007232,507,345,250,23,1125
E01007233,552,335,408,108,1403
E01007234,592,373,287,33,1285
E01007235,582,435,184,10,1211
E01007236,566,278,180,61,1085
E01007237,351,421,413,110,1295
E01007238,348,221,480,270,1319
E01007239,499,271,369,192,1331
E01007240,446,273,445,122,1286
E01007241,477,535,153,50,1215
E01007242,549,659,203,31,1442
E01007243,556,530,179,123,1388
E01007244,706,300,512,56,1574
E01007245,586,589,105,13,1293
E01007246,682,517,76,8,1283
E01007247,740,523,124,8,1395
E01007248,620,484,100,20,1224
E01007249,368,209,149,311,1037
E01007250,570,498,57,47,1172
E01007251,399,396,135,80,1010
E01007252,701,475,91,7,1274
E01007253,493,358,77,358,1286
E01007254,587,594,75,12,1268
E01007255,585,504,68,85,1242
E01007256,558,732,79,7,1376
E01007257,291,140,181,415,1027
E01007258,523,589,86,16,1214
E01007259,527,458,28,8,1021
E01007260,585,602,41,50,1278
E01007261,458,676,39,15,1188
E01007262,530,660,60,6,1256
E01007263,432,331,122,295,1180
E01007264,575,571,74,4,1224
E01007265,605,351,67,54,1077
E01007266,594,567,62,33,1256
E01007267,545,504,98,77,1224
E01007268,497,480,89,8,1074
E01007269,363,188,287,546,1384
E01007270,400,242,378,320,1340
E01007271,570,282,334,102,1288
E01007272,410,249,286,150,1095
E01007273,199,164,300,354,1017
E01007274,155,84,179,585,1003
E01007275,490,290,369,48,1197
E01007276,570,379,214,28,1191
E01007277,312,286,321,211,1130
E01007278,346,210,347,203,1106
E01007279,742,474,69,53,1338
E01007280,681,602,126,22,1431
E01007281,453,529,86,40,1108
E01007282,462,405,269,12,1148
E01007283,430,550,47,3,1030
E01007284,626,697,64,7,1394
E01007285,533,587,108,23,1251
E01007286,504,470,98,117,1189
E01007287,634,774,127,91,1626
E01007288,486,552,98,204,1340
E01007289,131,110,125,753,1119
E01007290,264,199,374,475,1312
E01007291,401,192,352,422,1367
E01007292,311,157,286,337,1091
E01007293,160,60,186,690,1096
E01007294,393,240,349,107,1089
E01007295,254,133,245,269,901
E01007296,467,252,357,232,1308
E01007297,436,336,80,257,1109
E01007298,562,581,91,15,1249
E01007299,596,348,93,71,1108
E01007300,502,274,182,463,1421
E01007301,671,486,105,94,1356
E01007302,473,390,179,159,1201
E01007303,334,171,145,521,1171
E01007304,352,187,141,454,1134
E01007305,692,542,129,18,1381
E01007306,717,454,156,12,1339
E01007307,719,504,226,8,1457
E01007308,532,558,196,12,1298
E01007309,584,574,109,14,1281
E01007310,586,448,99,10,1143
E01007311,677,499,97,1,1274
E01007312,552,467,104,128,1251
E01007313,496,466,216,156,1334
E01007314,593,404,197,18,1212
E01007315,616,479,144,6,1245
E01007316,620,538,104,2,1264
E01007317,280,296,115,504,1195
E01007318,410,154,137,462,1163
E01007319,546,585,63,38,1232
E01007320,337,264,139,495,1235
E01007321,499,585,109,63,1256
E01007322,732,352,381,152,1617
E01007323,514,171,95,355,1135
E01007324,468,317,125,439,1349
E01007325,306,157,65,654,1182
E01007326,469,275,69,429,1242
E01007327,412,302,114,595,1423
E01007328,517,273,120,581,1491
E01007329,552,326,88,248,1214
E01007330,634,437,148,188,1407
E01007331,729,536,177,101,1543
E01007332,699,330,348,359,1736
E01007333,323,388,182,101,994
E01007334,517,519,88,19,1143
E01007335,541,506,77,81,1205
E01007336,402,324,489,92,1307
E01007337,587,333,432,100,1452
E01007338,221,266,248,623,1358
E01007339,326,276,454,154,1210
E01007340,476,362,447,44,1329
E01007341,229,156,97,477,959
E01007342,482,477,122,48,1129
E01007343,426,317,120,278,1141
E01007344,750,441,261,215,1667
E01007345,546,366,249,76,1237
E01007346,622,307,168,172,1269
E01007347,670,384,124,108,1286
E01007348,321,391,89,339,1140
E01007349,424,383,173,241,1221
E01007350,289,597,56,92,1034
E01007351,456,406,119,179,1160
E01007352,313,245,118,460,1136
E01007353,580,349,203,120,1252
E01007354,558,460,188,137,1343
E01007355,703,372,84,30,1189
E01007356,475,562,67,57,1161
E01007357,453,297,111,240,1101
E01007358,618,396,153,36,1203
E01007359,447,371,160,232,1210
E01007360,433,539,76,239,1287
E01007361,582,456,203,46,1287
E01007362,667,569,91,28,1355
E01007363,440,312,114,471,1337
E01007364,397,276,104,348,1125
E01007365,324,192,117,315,948
E01007366,795,559,227,54,1635
E01007367,349,312,247,19,927
E01007368,554,366,243,114,1277
E01007369,390,323,366,98,1177
E01007370,381,293,167,282,1123
E01007371,692,359,199,301,1551
E01007372,268,185,137,367,957
E01007373,336,302,215,386,1239
E01007374,484,572,105,87,1248
E01007375,523,489,127,205,1344
E01007376,417,276,222,198,1113
E01007377,262,269,140,175,846
E01007378,290,221,140,596,1247
E01007379,483,678,108,79,1348
E01007380,720,568,139,49,1476
E01007381,648,465,62,109,1284
E01007382,449,407,140,243,1239
E01007383,613,315,82,77,1087
E01007384,604,544,119,89,1356
E01007385,367,365,99,340,1171
E01007386,576,740,127,13,1456
E01007387,545,377,89,167,1178
E01007388,582,424,186,133,1325
E01007389,451,641,94,82,1268
E01007390,528,486,122,131,1267
E01007391,397,221,119,478,1215
E01007392,383,212,102,480,1177
E01007393,630,333,239,243,1445
E01007394,365,264,175,310,1114
E01007395,508,317,110,607,1542
E01007396,532,419,200,147,1298
E01007397,383,310,121,383,1197
E01007398,436,701,82,190,1409
E01007399,882,456,218,103,1659
E01007400,798,549,155,133,1635
E01007402,364,200,110,582,1256
E01007403,332,250,70,516,1168
E01007404,479,567,58,43,1147
E01007405,313,547,64,213,1137
E01007406,454,281,97,577,1409
E01007408,474,418,158,154,1204
E01007409,504,480,143,61,1188
E01007410,401,352,151,496,1400
E01007411,117,123,47,610,897
E01007413,279,195,115,422,1011
E01007414,427,245,232,333,1237
E01007415,487,389,160,181,1217
E01007416,263,172,49,465,949
E01007417,466,369,338,69,1242
E01007418,321,499,177,102,1099
E01007419,610,583,126,66,1385
E01007420,484,491,74,147,1196
E01007421,426,481,213,34,1154
E01007422,602,457,112,75,1246
E01007423,529,485,119,232,1365
E01007424,630,399,142,196,1367
E01007425,509,629,79,30,1247
E01007426,482,527,135,152,1296
E01007427,590,413,137,130,1270
E01007428,521,500,133,54,1208
E01007429,358,362,85,430,1235
E01007430,1091,462,156,37,1746
E01007431,498,455,41,135,1129
E01007432,499,459,75,118,1151
E01007433,533,420,113,239,1305
E01007434,698,380,246,194,1518
E01007435,419,224,111,526,1280
E01007436,392,441,66,150,1049
E01007437,540,311,108,239,1198
E01007438,589,433,59,158,1239
E01007439,490,432,51,61,1034
E01007440,504,294,205,198,1201
E01007441,533,326,327,77,1263
E01007442,388,711,75,37,1211
E01007443,461,267,692,224,1644
E01007444,467,503,134,205,1309
E01007445,484,289,311,131,1215
E01007446,369,495,157,108,1129
E01007447,448,284,103,390,1225
E01007448,457,359,386,104,1306
E01007449,579,517,339,41,1476
E01007450,365,328,94,484,1271
E01007451,519,297,168,355,1339
E01007452,634,353,144,96,1227
E01007453,247,203,73,672,1195
E01007455,429,571,44,133,1177
E01007456,706,487,162,80,1435
E01007457,517,276,135,365,1293
E01007458,501,374,160,150,1185
E01007459,454,681,96,132,1363
E01007460,463,465,73,197,1198
E01007461,464,318,115,432,1329
E01007462,358,254,115,494,1221
E01007463,275,240,116,742,1373
E01007464,444,262,112,347,1165
E01007465,493,340,102,237,1172
E01007466,390,236,259,344,1229
E01007467,513,274,146,275,1208
E01007468,446,637,71,8,1162
E01007469,546,303,87,108,1044
E01007470,498,255,114,207,1074
E01007471,707,320,98,118,1243
E01007472,379,243,147,444,1213
E01007473,470,300,215,150,1135
E01007474,256,160,119,533,1068
E01007475,688,433,122,12,1255
E01007476,474,393,122,203,1192
E01007477,541,493,106,45,1185
E01007478,546,419,155,147,1267
E01007479,490,413,172,210,1285
E01007480,516,263,148,203,1130
E01007482,311,259,163,381,1114
E01007483,607,402,121,42,1172
E01007484,492,410,128,133,1163
E01007485,699,361,87,10,1157
E01007486,347,681,123,37,1188
E01007487,512,358,117,332,1319
E01007488,577,647,159,58,1441
E01007489,607,498,213,38,1356
E01007490,513,454,140,154,1261
E01007491,478,329,342,118,1267
E01007492,407,216,118,462,1203
E01007493,715,504,130,61,1410
E01007494,625,276,283,61,1245
E01007495,467,253,415,297,1432
E01007496,364,120,151,527,1162
E01007497,423,274,103,243,1043
E01007498,499,297,277,169,1242
E01007499,286,147,131,563,1127
E01007500,328,158,127,415,1028
E01007501,499,614,90,46,1249
E01007502,1360,339,391,27,2117
E01007503,622,557,129,36,1344
E01007504,546,342,154,196,1238
E01007505,539,562,149,143,1393
E01007506,446,171,130,329,1076
E01007507,348,173,136,324,981
E01007508,376,221,322,320,1239
E01007509,442,274,310,346,1372
E01007510,499,309,286,171,1265
E01007511,314,262,140,484,1200
E01007512,657,428,127,128,1340
E01007513,445,365,118,240,1168
E01007514,508,321,352,9,1190
E01007515,465,334,133,320,1252
E01007516,541,387,88,92,1108
E01007517,440,307,370,108,1225
E01007518,642,358,82,127,1209
E01007519,496,274,140,123,1033
E01007520,427,693,66,14,1200
E01007521,465,522,97,102,1186
E01007522,386,247,155,464,1252
E01007523,525,519,214,14,1272
E01007524,502,655,151,56,1364
E01007525,506,276,135,321,1238
E01007526,538,621,132,50,1341
E01007527,791,517,571,29,1908
E01007528,406,254,124,323,1107
E01007529,284,153,530,167,1134
E01007530,201,217,424,81,923
E01007531,399,299,338,287,1323
E01007532,94,48,214,1117,1473
E01007533,417,310,237,217,1181
E01007534,360,201,813,206,1580
E01007535,425,314,411,57,1207
E01007536,688,509,358,63,1618
E01007537,647,408,154,182,1391
E01007538,566,292,117,223,1198
E01007539,452,245,155,214,1066
E01007540,596,438,112,152,1298
E01007541,443,410,118,276,1247
E01007542,398,284,174,529,1385
E01007543,337,218,99,600,1254
E01007544,209,102,90,882,1283
E01007545,607,245,213,99,1164
E01007546,420,373,247,102,1142
E01007547,450,342,268,124,1184
E01007548,287,206,71,243,807
E01007549,398,229,123,426,1176
E01007550,551,380,112,332,1375
E01007551,591,592,144,56,1383
E01007552,498,489,121,60,1168
E01007553,604,580,149,73,1406
E01007554,668,410,182,42,1302
E01007555,356,224,120,458,1158
E01007556,382,265,125,276,1048
E01007557,294,387,128,4,813
E01007558,556,449,102,98,1205
E01007559,294,436,56,28,814
E01007560,545,578,108,38,1269
E01007561,599,441,84,5,1129
E01007562,500,409,134,77,1120
E01007563,381,228,141,288,1038
E01007564,426,175,161,399,1161
E01007565,554,480,152,47,1233
E01007566,374,234,130,595,1333
E01007567,381,317,215,123,1036
E01007568,416,132,133,476,1157
E01007569,506,242,141,362,1251
E01007570,498,528,116,95,1237
E01007571,605,340,293,67,1305
E01007572,454,465,61,189,1169
E01007573,309,118,101,662,1190
E01007574,381,279,235,271,1166
E01007575,222,121,47,703,1093
E01007576,560,409,173,135,1277
E01007577,329,229,406,216,1180
E01007578,466,313,211,314,1304
E01007579,487,380,181,197,1245
E01007580,405,580,49,167,1201
E01007581,688,478,98,10,1274
E01007582,595,471,125,5,1196
E01007583,508,550,152,39,1249
E01007584,519,491,244,4,1258
E01007585,629,418,142,73,1262
E01007586,549,566,105,59,1279
E01007587,414,395,273,268,1350
E01007588,605,411,154,145,1315
E01007589,634,619,100,79,1432
E01007590,456,246,105,154,961
E01007591,517,432,125,123,1197
E01007592,424,190,223,332,1169
E01007593,473,266,109,162,1010
E01007594,1012,330,187,46,1575
E01007595,499,270,131,288,1188
E01007596,514,440,68,9,1031
E01007597,285,139,149,602,1175
E01007598,571,600,124,24,1319
E01007599,744,535,121,46,1446
E01007600,538,622,46,14,1220
E01007601,435,620,59,53,1167
E01007602,573,525,114,19,1231
E01007603,514,507,181,7,1209
E01007604,546,547,78,24,1195
E01007605,520,563,102,87,1272
E01007606,540,640,78,7,1265
E01007607,393,359,108,279,1139
E01007608,659,141,236,204,1240
E01007609,759,583,238,296,1876
E01007610,621,708,159,24,1512
E01007611,374,472,112,139,1097
E01007612,405,592,156,50,1203
E01007613,546,610,110,88,1354
E01007614,474,481,73,14,1042
E01007615,330,467,144,138,1079
E01007616,356,539,96,79,1070
E01007617,504,674,73,10,1261
E01007618,461,487,82,12,1042
E01007619,754,588,91,14,1447
E01007620,593,646,128,20,1387
E01007621,605,387,110,4,1106
E01007622,604,554,88,26,1272
E01007623,381,365,92,171,1009
E01007624,768,491,172,17,1448
E01007625,490,589,119,61,1259
E01007626,249,328,166,251,994
E01007627,450,245,153,452,1300
E01007628,306,182,138,449,1075
E01007629,306,220,178,518,1222
E01007630,368,613,104,89,1174
E01007631,435,555,35,2,1027
E01007632,586,348,145,167,1246
E01007633,437,265,126,175,1003
E01007634,452,254,183,340,1229
E01007635,361,449,80,274,1164
E01007636,425,248,211,322,1206
E01007637,418,520,171,95,1204
E01007638,380,326,208,375,1289
E01007639,575,401,341,236,1553
E01007640,551,658,152,34,1395
E01007641,593,341,143,101,1178
E01007642,488,264,177,309,1238
E01007643,326,225,220,466,1237
E01007644,561,372,256,16,1205
E01007645,376,325,782,93,1576
E01007646,401,355,390,12,1158
E01007647,504,392,293,65,1254
E01007648,320,280,818,136,1554
E01007649,570,366,287,24,1247
E01007650,509,470,206,256,1441
E01007651,440,283,235,379,1337
E01007652,442,215,228,558,1443
E01007653,570,392,282,37,1281
E01007654,435,332,395,58,1220
E01007655,253,251,814,196,1514
E01007656,462,299,130,329,1220
E01007657,560,497,92,35,1184
E01007658,577,444,91,32,1144
E01007659,446,412,65,13,936
E01007660,486,461,37,36,1020
E01007661,486,515,70,84,1155
E01007662,230,184,37,373,824
E01007663,477,667,92,17,1253
E01007664,574,820,107,103,1604
E01007665,740,475,88,133,1436
E01007666,542,487,96,66,1191
E01007667,482,303,86,219,1090
E01007668,263,164,155,649,1231
E01007669,497,623,57,104,1281
E01007670,614,539,74,14,1241
E01007671,946,522,175,23,1666
E01007672,589,501,60,24,1174
E01007673,386,306,101,350,1143
E01007674,920,529,87,29,1565
E01007675,626,472,177,131,1406
E01007676,481,317,139,404,1341
E01007677,215,153,158,472,998
E01007678,489,647,143,71,1350
E01007679,465,517,159,331,1472
E01007680,478,500,312,142,1432
E01007681,440,549,62,74,1125
E01007682,526,407,79,140,1152
E01007683,572,435,79,106,1192
E01007684,705,403,170,26,1304
E01007685,638,453,95,12,1198
E01007686,382,665,113,77,1237
E01007687,469,514,92,134,1209
E01007688,315,332,521,47,1215
E01007689,695,330,47,155,1227
E01007690,577,682,97,35,1391
E01007691,818,689,106,110,1723
E01007692,615,427,99,122,1263
E01007693,882,358,206,244,1690
E01007694,528,290,166,394,1378
E01007695,1147,419,160,165,1891
E01007696,387,340,372,143,1242
E01007697,384,256,65,518,1223
E01007698,557,477,146,50,1230
E01007699,663,281,163,324,1431
E01007700,798,259,192,113,1362
E01007701,423,271,242,377,1313
E01007702,567,241,308,103,1219
E01007703,468,442,47,62,1019
E01007704,467,461,89,190,1207
E01007705,591,542,84,11,1228
E01007706,617,425,101,41,1184
E01007707,568,593,56,90,1307
E01007708,443,215,124,552,1334
E01007709,588,565,52,15,1220
E01007710,565,675,76,18,1334
E01007711,667,639,99,18,1423
E01007712,654,675,183,43,1555
E01007713,583,664,63,13,1323
E01007714,304,272,559,498,1633
E01007715,217,259,440,272,1188
E01007716,240,371,372,471,1454
E01007717,553,335,256,330,1474
E01007718,379,224,188,355,1146
E01007719,254,178,87,452,971
E01007720,435,441,98,219,1193
E01007721,379,198,178,496,1251
E01007723,365,238,85,392,1080
E01007724,422,416,288,30,1156
E01007725,599,285,68,51,1003
E01007726,351,201,155,524,1231
E01007727,392,251,119,502,1264
E01007728,393,329,71,145,938
E01007729,351,188,87,754,1380
E01007730,329,259,112,496,1196
E01007731,446,286,162,148,1042
E01007732,345,262,69,566,1242
E01007733,385,238,55,432,1110
E01007734,464,173,133,617,1387
E01007735,258,111,100,559,1028
E01007736,242,168,236,532,1178
E01007737,240,95,107,646,1088
E01007738,331,140,123,497,1091
E01007739,318,186,96,615,1215
E01007740,407,260,73,439,1179
E01007741,585,641,85,16,1327
E01007742,466,402,69,221,1158
E01007743,583,426,41,49,1099
E01007744,515,383,163,204,1265
E01007745,433,292,79,420,1224
E01007746,575,416,60,191,1242
E01007747,410,227,94,324,1055
E01007748,434,561,90,172,1257
E01007749,725,521,150,47,1443
E01007750,540,559,94,82,1275
E01007751,756,309,241,214,1520
E01007752,578,527,113,13,1231
E01007753,490,469,115,191,1265
E01007754,717,252,75,55,1099
E01007755,668,377,76,24,1145
E01007756,687,423,70,42,1222
E01007757,565,573,132,92,1362
E01007758,413,280,209,161,1063
E01007759,435,350,120,310,1215
E01007760,388,300,417,255,1360
E01007761,559,355,122,269,1305
E01007762,448,440,100,164,1152
E01007763,352,343,287,224,1206
E01007764,217,188,227,625,1257
E01007765,515,392,259,66,1232
E01007766,413,206,61,427,1107
E01007767,445,332,279,153,1209
E01007768,277,354,308,482,1421
E01007769,209,243,559,218,1229
E01007770,506,329,128,367,1330
E01007771,537,481,120,42,1180
E01007772,430,240,152,241,1063
E01007773,432,307,195,202,1136
E01007774,488,321,121,229,1159
E01007775,219,145,106,518,988
E01007776,434,280,157,335,1206
E01007777,553,300,90,307,1250
E01007778,634,436,48,138,1256
E01007779,296,232,82,399,1009
E01007780,466,490,38,212,1206
E01007781,441,327,76,374,1218
E01007782,421,245,93,393,1152
E01007783,461,265,179,481,1386
E01007784,610,213,308,164,1295
E01007785,551,342,71,109,1073
E01007786,433,383,69,25,910
E01007787,1103,657,353,146,2259
E01007788,557,446,158,85,1246
E01007789,473,343,175,316,1307
E01007790,274,246,376,273,1169
E01007791,427,288,156,190,1061
E01007792,736,297,43,14,1090
E01007793,434,363,73,293,1163
E01007794,285,268,83,444,1080
E01007795,593,569,44,50,1256
E01007796,261,223,81,362,927
E01007797,424,424,65,212,1125
E01007798,416,584,37,42,1079
E01007799,406,368,76,315,1165
E01007800,428,361,255,157,1201
E01007801,606,476,114,45,1241
E01007802,519,487,74,70,1150
E01007803,441,366,102,173,1082
E01007804,403,222,62,493,1180
E01007805,368,168,63,544,1143
E01007806,394,115,56,410,975
E01007807,455,342,89,269,1155
E01007808,702,504,49,2,1257
E01007809,390,337,149,381,1257
E01007810,680,508,148,225,1561
E01007811,503,532,80,28,1143
E01007812,350,265,71,340,1026
E01007813,516,340,107,137,1100
E01007814,344,412,76,92,924
E01007815,520,321,356,143,1340
E01007816,536,379,72,298,1285
E01007817,422,363,84,307,1176
E01007818,542,645,90,58,1335
E01007819,430,574,68,148,1220
E01007820,495,296,255,111,1157
E01007821,498,331,68,342,1239
E01007822,274,255,147,559,1235
E01007823,484,557,110,255,1406
E01007824,609,480,39,1,1129
E01007825,537,574,36,12,1159
E01007826,649,510,34,3,1196
E01007827,616,543,113,20,1292
E01007828,559,380,175,234,1348
E01007829,586,361,303,51,1301
E01007830,518,466,90,164,1238
E01007831,566,342,281,17,1206
E01007832,623,402,178,46,1249
E01007833,565,577,55,233,1430
E01007834,589,455,100,209,1353
E01007835,494,473,68,131,1166
E01007836,546,572,97,114,1329
E01007838,641,361,77,158,1237
E01007839,741,452,75,29,1297
E01007841,735,427,73,34,1269
E01007842,600,370,80,236,1286
E01007843,452,255,71,520,1298
E01007846,617,443,129,49,1238
E01007847,338,330,104,307,1079
E01007848,316,181,100,616,1213
E01007849,588,249,286,452,1575
E01007850,523,579,110,81,1293
E01007851,370,276,108,319,1073
E01007852,547,385,181,103,1216
E01007853,618,466,98,124,1306
E01007854,419,238,164,377,1198
E01007855,555,346,432,129,1462
E01007856,410,141,83,387,1021
E01007857,401,192,71,504,1168
E01007858,407,365,292,41,1105
E01007859,148,210,861,102,1321
E01007860,202,214,831,121,1368
E01007861,487,619,132,14,1252
E01007862,209,321,1281,289,2100
E01007863,373,297,725,106,1501
E01007864,106,87,1614,39,1846
E01007865,585,446,243,64,1338
E01007866,259,215,991,80,1545
E01007867,172,92,1553,105,1922
E01007868,224,268,414,55,961
E01007869,315,428,211,220,1174
E01007870,425,384,280,313,1402
E01007871,357,303,140,646,1446
E01007872,410,494,277,85,1266
E01007873,220,364,222,477,1283
E01007874,213,196,169,689,1267
E01007875,196,213,309,521,1239
E01007877,247,327,249,83,906
E01007878,225,149,488,525,1387
E01007879,318,295,635,149,1397
E01007881,426,280,209,365,1280
E01007882,391,445,522,38,1396
E01007883,211,198,153,342,904
E01007885,192,78,165,778,1213
E01007886,247,127,105,707,1186
E01007887,542,327,71,188,1128
E01007888,631,431,50,34,1146
E01007889,1282,565,152,53,2052
E01007890,590,499,54,25,1168
E01007891,608,634,59,15,1316
E01007892,326,185,83,563,1157
E01007893,603,602,39,34,1278
E01007894,560,402,166,35,1163
E01007895,473,317,47,350,1187
E01007896,515,535,29,10,1089
E01007897,445,665,83,22,1215
E01007898,717,376,100,15,1208
E01007899,536,623,46,26,1231
E01007900,572,342,123,335,1372
E01007901,377,225,43,570,1215
E01007902,256,231,175,693,1355
E01007903,417,392,175,205,1189
E01007904,243,191,119,688,1241
E01007905,348,117,225,495,1185
E01007906,380,342,315,357,1394
E01007907,561,443,184,50,1238
E01007908,642,404,166,14,1226
E01007909,859,428,215,131,1633
E01007910,430,287,139,405,1261
E01007911,536,547,61,18,1162
E01007912,556,475,84,178,1293
E01007913,222,350,300,130,1002
E01007914,242,344,315,146,1047
E01007915,540,581,39,2,1162
E01007916,277,153,76,650,1156
E01007917,418,562,75,181,1236
E01007918,556,505,113,164,1338
E01007919,352,143,73,673,1241
E01007920,500,742,107,15,1364
E01007921,426,695,100,100,1321
E01007922,604,509,35,16,1164
E01007923,610,650,137,83,1480
E01007924,551,363,67,221,1202
E01007925,547,547,95,140,1329
E01007926,506,725,110,42,1383
E01007927,537,709,39,12,1297
E01007928,604,720,64,23,1411
E01007929,587,559,112,20,1278
E01007930,560,535,39,12,1146
E01007931,565,655,58,5,1283
E01007932,571,475,61,41,1148
E01007933,624,622,46,31,1323
E01007934,517,437,102,60,1116
E01007935,475,272,408,12,1167
E01007936,563,275,420,20,1278
E01007937,520,475,113,10,1118
E01007938,598,512,53,2,1165
E01007939,565,556,74,51,1246
E01007940,252,216,277,426,1171
E01007941,357,237,84,524,1202
E01007942,331,511,291,121,1254
E01007943,287,144,93,794,1318
E01007944,241,431,518,127,1317
E01007945,445,209,85,629,1368
E01007946,324,126,69,610,1129
E01007947,159,128,101,907,1295
E01007948,313,181,85,630,1209
E01007949,333,372,311,62,1078
E01007950,345,187,61,502,1095
E01007951,473,438,337,68,1316
E01007952,572,601,90,14,1277
E01007953,341,555,122,371,1389
E01007954,613,581,89,10,1293
E01007955,492,541,26,51,1110
E01007956,735,830,135,49,1749
E01007957,600,600,73,4,1277
E01007958,453,621,94,9,1177
E01007959,535,571,55,4,1165
E01007960,382,397,565,29,1373
E01007961,551,522,93,34,1200
E01007962,237,175,693,198,1303
E01007963,492,390,89,261,1232
E01007964,551,330,101,280,1262
E01007965,466,322,58,660,1506
E01007966,636,251,87,312,1286
E01007967,511,253,83,505,1352
E01007968,334,256,107,432,1129
E01007969,554,367,95,177,1193
E01007970,191,163,82,931,1367
E01007971,446,306,69,295,1116
E01007972,588,556,57,16,1217
E01007973,587,521,65,61,1234
E01007974,684,309,82,88,1163
E01007975,367,261,221,490,1339
E01007976,466,300,141,287,1194
E01007977,227,194,89,786,1296
E01007978,531,244,489,103,1367
E01007979,203,130,108,758,1199
E01007980,595,300,275,61,1231
E01007981,518,309,292,28,1147
E01007982,500,297,106,512,1415
E01007983,669,260,251,27,1207
E01007984,590,516,53,18,1177
E01007985,640,426,148,26,1240
E01007986,523,300,319,7,1149
E01007987,634,382,152,27,1195
E01007988,595,473,82,101,1251
E01007989,523,423,217,17,1180
E01007990,483,453,59,238,1233
E01007991,302,251,97,522,1172
E01007992,659,378,206,64,1307
E01007993,530,337,87,381,1335
E01007994,621,338,171,26,1156
E01007995,608,253,347,27,1235
E01007996,531,358,221,156,1266
E01007997,505,577,28,109,1219
E01007998,410,262,44,624,1340
E01007999,597,403,59,98,1157
E01008000,539,396,175,130,1240
E01008001,498,372,108,211,1189
E01008002,613,564,97,56,1330
E01008003,552,441,97,127,1217
E01008004,508,389,131,285,1313
E01008005,572,524,103,127,1326
E01008006,459,560,95,67,1181
E01008007,359,279,85,629,1352
E01008008,368,263,115,576,1322
E01008009,276,117,93,606,1092
E01008010,448,249,87,347,1131
E01008011,190,77,91,813,1171
E01008012,359,103,379,779,1620
E01008013,216,84,118,472,890
E01008014,435,338,161,290,1224
E01008015,399,191,110,584,1284
E01008016,481,367,119,197,1164
E01008017,289,118,103,752,1262
E01008018,303,129,54,514,1000
E01008019,684,342,85,339,1450
E01008020,610,439,92,65,1206
E01008021,727,416,38,16,1197
E01008022,320,115,80,695,1210
E01008023,1053,409,193,31,1686
E01008024,741,365,132,185,1423
E01008025,749,479,219,185,1632
E01008027,544,238,74,348,1204
E01008028,587,273,153,256,1269
E01008029,480,212,57,401,1150
E01008030,585,327,99,74,1085
E01008031,565,292,59,286,1202
E01008032,475,285,117,281,1158
E01008033,470,482,65,139,1156
E01008034,640,306,118,335,1399
E01008035,600,346,51,2,999
E01008036,720,326,101,26,1173
E01008037,363,390,55,430,1238
E01008038,571,717,65,23,1376
E01008039,532,471,93,71,1167
E01008040,724,357,69,231,1381
E01008041,776,294,69,37,1176
E01008042,492,371,365,43,1271
E01008043,619,589,151,18,1377
E01008044,590,537,85,22,1234
E01008045,512,323,183,66,1084
E01008046,554,280,445,42,1321
E01008047,321,208,851,27,1407
E01008048,270,227,810,50,1357
E01008049,411,411,350,170,1342
E01008050,364,193,693,19,1269
E01008051,487,406,440,66,1399
E01008052,536,404,528,41,1509
E01008053,347,222,44,418,1031
E01008054,306,139,67,473,985
E01008055,336,132,70,560,1098
E01008056,553,265,44,306,1168
E01008057,388,153,65,484,1090
E01008058,591,409,56,178,1234
E01008059,376,156,77,522,1131
E01008060,310,137,57,559,1063
E01008061,362,205,123,493,1183
E01008062,276,132,72,700,1180
E01008063,477,441,70,272,1260
E01008064,297,223,996,20,1536
E01008065,116,75,295,1028,1514
E01008066,171,89,1194,44,1498
E01008067,91,59,1338,110,1598
E01008068,131,87,683,787,1688
E01008069,249,155,1054,61,1519
E01008072,274,204,262,460,1200
E01008073,351,222,647,322,1542
E01008074,338,271,681,25,1315
E01008075,269,151,129,537,1086
E01008076,313,200,61,484,1058
E01008077,430,273,80,425,1208
E01008078,424,501,84,163,1172
E01008079,457,487,43,19,1006
E01008080,506,368,129,221,1224
E01008081,342,223,103,596,1264
E01008082,292,192,72,675,1231
E01008083,312,171,82,585,1150
E01008084,250,161,88,760,1259
E01008085,329,198,54,516,1097
E01008086,352,200,53,424,1029
E01008087,579,507,136,50,1272
E01008088,543,428,74,182,1227
E01008089,357,195,178,516,1246
E01008090,374,162,70,656,1262
E01008091,645,337,214,36,1232
E01008092,248,172,45,668,1133
E01008093,456,318,357,120,1251
E01008094,255,192,61,378,886
E01008095,152,110,377,378,1017
E01008096,308,204,349,850,1711
E01008097,277,180,90,662,1209
E01008098,300,129,90,653,1172
E01008099,582,288,316,92,1278
E01008100,244,110,40,582,976
E01008101,493,213,109,625,1440
E01008102,221,104,90,481,896
E01008103,244,115,94,584,1037
E01008104,168,159,665,186,1178
E01008105,309,207,1056,212,1784
E01008107,195,157,420,466,1238
E01008108,250,166,1090,196,1702
E01008109,294,208,862,328,1692
E01008111,214,163,1015,62,1454
E01008112,368,212,624,135,1339
E01008113,467,319,497,102,1385
E01008114,49,73,1124,687,1933
E01008115,95,104,1237,207,1643
E01008116,270,157,50,552,1029
E01008117,280,184,39,479,982
E01008118,356,229,51,486,1122
E01008119,286,149,35,435,905
E01008122,219,120,47,597,983
E01008123,270,177,53,467,967
E01008124,205,104,106,678,1093
E01008125,418,374,46,348,1186
E01008126,515,648,46,87,1296
E01008128,549,538,237,91,1415
E01008129,489,449,102,94,1134
E01008130,486,568,63,155,1272
E01008131,607,523,61,110,1301
E01008132,606,516,26,14,1162
E01008133,463,531,85,243,1322
E01008134,422,490,85,165,1162
E01008135,737,439,173,74,1423
E01008136,457,352,66,222,1097
E01008137,517,674,43,20,1254
E01008138,385,260,45,397,1087
E01008139,488,492,169,179,1328
E01008140,682,376,167,246,1471
E01008141,569,615,98,43,1325
E01008142,553,325,96,172,1146
E01008143,630,405,140,152,1327
E01008144,548,484,210,50,1292
E01008145,429,312,61,430,1232
E01008146,565,493,24,2,1084
E01008147,536,533,76,73,1218
E01008148,444,504,57,232,1237
E01008149,553,577,97,13,1240
E01008150,522,304,114,169,1109
E01008151,429,296,575,68,1368
E01008152,531,474,66,121,1192
E01008153,609,295,380,168,1452
E01008154,487,423,306,202,1418
E01008155,412,284,432,205,1333
E01008156,579,537,123,24,1263
E01008157,311,203,163,671,1348
E01008158,403,381,79,399,1262
E01008159,522,373,417,13,1325
E01008160,538,389,157,110,1194
E01008161,597,399,342,88,1426
E01008162,740,221,626,464,2051
E01008163,387,213,358,315,1273
E01008164,265,117,429,221,1032
E01008165,295,138,72,617,1122
E01008166,101,49,493,809,1452
E01008167,415,211,442,230,1298
E01008168,283,117,678,691,1769
E01008169,299,243,310,69,921
E01008170,384,174,490,622,1670
E01008171,244,129,483,51,907
E01008172,545,542,94,266,1447
E01008173,437,165,126,476,1204
E01008174,764,285,141,482,1672
E01008175,496,323,286,70,1175
E01008176,571,522,69,109,1271
E01008177,536,359,112,126,1133
E01008178,621,180,117,367,1285
E01008179,589,183,80,133,985
E01008180,276,118,71,700,1165
E01008181,527,436,71,197,1231
E01008182,570,160,96,462,1288
E01008183,469,309,124,268,1170
E01008184,516,550,66,80,1212
E01008185,365,203,53,477,1098
E01008186,562,562,389,106,1619
E01008187,391,446,126,442,1405
E01008188,564,394,65,163,1186
E01008189,329,163,41,612,1145
E01008190,515,478,40,77,1110
E01008191,346,188,75,622,1231
E01008192,404,256,84,467,1211
E01008193,478,427,27,56,988
E01008194,557,539,40,48,1184
E01008195,806,421,153,256,1636
E01008196,651,612,138,186,1587
E01008197,648,464,165,13,1290
E01008198,410,302,112,275,1099
E01008199,524,413,178,12,1127
E01008200,561,468,69,23,1121
E01008201,238,152,55,734,1179
E01008202,621,211,204,428,1464
E01008203,439,161,546,329,1475
E01008204,243,170,98,731,1242
E01008205,557,523,130,59,1269
E01008206,676,489,90,156,1411
E01008207,621,473,68,61,1223
E01008208,512,263,151,406,1332
E01008209,598,332,439,368,1737
E01008210,394,144,186,379,1103
E01008211,631,418,187,211,1447
E01008212,284,131,125,592,1132
E01008213,513,311,62,352,1238
E01008214,188,76,117,905,1286
E01008215,262,152,191,698,1303
E01008216,333,204,86,635,1258
E01008217,460,309,115,413,1297
E01008218,350,193,88,701,1332
E01008219,594,280,117,347,1338
E01008220,172,102,44,619,937
E01008221,449,225,72,595,1341
E01008222,484,238,62,409,1193
E01008223,363,146,95,774,1378
E01008224,632,504,65,332,1533
E01008225,538,504,68,345,1455
E01008226,454,359,120,328,1261
E01008227,198,61,75,872,1206
E01008228,320,182,85,387,974
E01008229,427,477,81,218,1203
E01008230,485,212,125,308,1130
E01008231,409,181,75,594,1259
E01008232,338,167,48,511,1064
E01008233,685,379,66,69,1199
E01008234,764,757,227,52,1800
E01008235,641,507,50,53,1251
E01008236,521,345,213,188,1267
E01008237,668,517,55,9,1249
E01008238,663,408,161,31,1263
E01008239,609,466,108,62,1245
E01008240,509,297,48,374,1228
E01008241,408,445,55,428,1336
E01008242,487,174,57,573,1291
E01008243,517,523,149,141,1330
E01008244,659,289,436,341,1725
E01008245,534,498,84,112,1228
E01008246,509,224,85,323,1141
E01008247,408,385,62,494,1349
E01008248,854,435,96,51,1436
E01008249,486,692,113,70,1361
E01008250,525,320,55,261,1161
E01008251,493,283,646,83,1505
E01008252,323,247,548,181,1299
E01008253,386,181,764,65,1396
E01008254,282,180,484,167,1113
E01008255,467,390,137,427,1421
E01008256,736,476,92,183,1487
E01008257,245,219,142,570,1176
E01008258,536,115,396,830,1877
E01008259,432,152,108,915,1607
E01008260,789,378,65,30,1262
E01008261,422,192,83,478,1175
E01008262,535,262,374,225,1396
E01008263,435,168,139,450,1192
E01008264,528,566,64,32,1190
E01008265,484,324,89,268,1165
E01008266,484,463,97,126,1170
E01008267,359,590,84,221,1254
E01008268,553,428,82,147,1210
E01008269,530,660,64,4,1258
E01008270,387,713,41,11,1152
E01008271,561,550,65,25,1201
E01008272,468,579,96,64,1207
E01008273,589,395,110,108,1202
E01008274,521,278,69,288,1156
E01008275,565,628,78,10,1281
E01008276,486,396,96,270,1248
E01008277,480,416,50,340,1286
E01008278,543,615,33,45,1236
E01008279,477,685,80,25,1267
E01008280,500,246,149,612,1507
E01008281,413,268,70,442,1193
E01008282,352,240,76,518,1186
E01008283,609,484,60,18,1171
E01008284,550,401,51,195,1197
E01008285,354,175,75,547,1151
E01008286,452,348,79,342,1221
E01008287,1057,267,91,193,1608
E01008288,450,272,154,225,1101
E01008289,293,135,85,640,1153
E01008290,272,218,214,280,984
E01008291,118,69,391,954,1532
E01008292,591,427,60,32,1110
E01008293,596,370,130,90,1186
E01008294,640,396,166,22,1224
E01008295,255,160,70,634,1119
E01008296,455,319,103,332,1209
E01008297,274,157,92,568,1091
E01008298,513,225,137,262,1137
E01008299,381,147,61,424,1013
E01008300,473,201,104,422,1200
E01008301,468,252,530,285,1535
E01008302,272,193,196,616,1277
E01008303,180,118,421,1005,1724
E01008304,109,72,223,1131,1535
E01008305,112,90,258,1058,1518
E01008306,484,489,96,310,1379
E01008307,298,155,86,283,822
E01008308,444,254,118,326,1142
E01008309,657,706,57,13,1433
E01008311,788,423,137,28,1376
E01008312,454,322,161,37,974
E01008313,473,330,94,76,973
E01008314,392,323,109,93,917
E01008315,488,423,176,177,1264
E01008316,677,512,139,20,1348
E01008317,608,459,122,8,1197
E01008318,373,166,132,508,1179
E01008319,857,504,77,18,1456
E01008320,538,433,120,126,1217
E01008321,584,487,255,57,1383
E01008322,655,473,67,27,1222
E01008323,477,321,344,103,1245
E01008324,339,212,97,360,1008
E01008325,302,238,80,513,1133
E01008326,693,358,86,59,1196
E01008327,240,88,75,582,985
E01008328,473,573,46,24,1116
E01008329,552,321,96,233,1202
E01008330,347,187,102,408,1044
E01008331,212,157,412,539,1320
E01008332,191,109,660,700,1660
E01008333,423,208,335,201,1167
E01008334,400,276,596,304,1576
E01008335,481,319,564,98,1462
E01008336,321,237,94,476,1128
E01008337,214,222,62,573,1071
E01008338,389,182,149,258,978
E01008339,343,167,127,531,1168
E01008340,242,96,109,644,1091
E01008341,427,235,106,340,1108
E01008342,508,521,133,76,1238
E01008343,587,385,115,138,1225
E01008344,542,314,194,232,1282
E01008345,314,231,89,672,1306
E01008346,306,198,366,243,1113
E01008347,525,361,124,125,1135
E01008348,235,139,88,403,865
E01008349,501,301,286,46,1134
E01008350,456,217,96,267,1036
E01008351,478,445,126,112,1161
E01008352,478,335,145,223,1181
E01008353,400,373,163,312,1248
E01008354,528,264,252,349,1393
E01008355,546,438,237,74,1295
E01008356,476,359,119,176,1130
E01008357,541,676,121,23,1361
E01008358,318,201,700,30,1249
E01008359,212,133,955,175,1475
E01008360,335,114,906,87,1442
E01008361,186,81,923,266,1456
E01008362,155,106,1131,305,1697
E01008363,489,535,395,18,1437
E01008364,331,163,958,78,1530
E01008365,655,416,232,27,1330
E01008366,242,218,1494,25,1979
E01008367,268,229,1393,63,1953
E01008368,188,192,1296,35,1711
E01008369,284,193,1300,77,1854
E01008370,276,289,847,130,1542
E01008371,443,514,201,9,1167
E01008372,176,168,1391,101,1836
E01008373,127,83,2070,27,2307
E01008374,587,388,117,189,1281
E01008375,432,207,97,469,1205
E01008376,534,347,47,40,968
E01008377,664,125,246,552,1587
E01008378,547,497,74,42,1160
E01008379,366,288,91,478,1223
E01008380,160,61,220,816,1257
E01008381,665,369,115,19,1168
E01008382,222,103,68,544,937
E01008383,360,170,116,484,1130
E01008384,495,376,81,195,1147
E01008385,447,240,262,189,1138
E01008386,480,371,56,203,1110
E01008387,524,421,166,34,1145
E01008388,233,110,143,890,1376
E01008389,281,109,63,867,1320
E01008390,217,75,115,888,1295
E01008391,266,101,70,662,1099
E01008392,406,263,288,322,1279
E01008394,66,29,1065,248,1408
E01008395,99,58,323,681,1161
E01008396,79,94,565,573,1311
E01008397,74,56,528,238,896
E01008398,88,55,293,906,1342
E01008399,160,112,186,969,1427
E01008400,246,149,107,598,1100
E01008401,370,269,64,461,1164
E01008402,506,358,124,238,1226
E01008403,524,561,99,50,1234
E01008404,558,237,207,357,1359
E01008405,432,227,92,386,1137
E01008406,122,74,349,694,1239
E01008407,82,82,1108,468,1740
E01008409,329,227,916,86,1558
E01008410,215,144,848,363,1570
E01008411,141,140,1282,160,1723
E01008412,357,174,889,99,1519
E01008413,137,92,865,276,1370
E01008415,306,153,141,324,924
E01008416,715,501,127,76,1419
E01008418,629,650,317,22,1618
E01008419,579,317,261,30,1187
E01008420,442,429,142,50,1063
E01008421,540,374,271,23,1208
E01008422,519,396,401,57,1373
E01008423,462,488,75,38,1063
E01008424,444,211,595,115,1365
E01008425,172,91,115,1114,1492
E01008426,206,104,62,817,1189
E01008427,86,90,73,706,955
E01008428,342,216,71,334,963
E01008429,272,158,85,562,1077
E01008430,469,272,153,209,1103
E01008431,539,389,155,62,1145
E01008432,434,330,138,245,1147
E01008433,546,504,54,111,1215
E01008434,621,501,64,78,1264
E01008435,386,233,77,459,1155
E01008436,313,170,87,667,1237
E01008437,75,26,108,678,887
E01008438,111,60,81,1086,1338
E01008439,127,79,158,902,1266
E01008441,441,295,113,530,1379
E01008442,539,579,47,9,1174
E01008443,583,517,64,23,1187
E01008444,590,590,72,49,1301
E01008445,732,532,135,158,1557
E01008446,520,669,56,7,1252
E01008447,514,528,70,50,1162
E01008448,665,576,48,7,1296
E01008449,164,145,925,207,1441
E01008450,296,170,71,548,1085
E01008451,543,246,437,236,1462
E01008452,542,414,140,51,1147
E01008453,557,456,237,45,1295
E01008455,362,299,465,62,1188
E01008456,414,174,67,547,1202
E01008457,359,166,91,649,1265
E01008458,621,560,136,50,1367
E01008459,225,81,62,937,1305
E01008460,357,228,85,497,1167
E01008461,426,281,61,358,1126
E01008462,401,171,96,314,982
E01008463,423,286,67,350,1126
E01008464,535,415,90,128,1168
E01008465,527,449,68,153,1197
E01008466,648,461,44,12,1165
E01008467,644,339,90,101,1174
E01008468,551,183,66,349,1149
E01008469,506,476,185,118,1285
E01008470,422,332,80,303,1137
E01008471,580,335,75,305,1295
E01008472,602,461,79,100,1242
E01008473,471,416,50,84,1021
E01008474,357,183,101,493,1134
E01008475,858,356,78,40,1332
E01008476,518,259,96,473,1346
E01008477,399,186,83,568,1236
E01008478,414,226,77,567,1284
E01008479,627,395,89,61,1172
E01008480,475,243,81,444,1243
E01008481,420,233,101,410,1164
E01008482,379,275,283,351,1288
E01008483,664,234,357,44,1299
E01008484,272,167,275,339,1053
E01008485,151,44,65,805,1065
E01008486,446,317,112,283,1158
E01008487,441,447,55,286,1229
E01008488,447,224,103,358,1132
E01008489,417,222,74,595,1308
E01008490,519,475,140,219,1353
E01008491,462,220,98,426,1206
E01008492,448,244,152,523,1367
E01008493,543,533,64,105,1245
E01008494,487,396,93,281,1257
E01008495,676,699,49,18,1442
E01008496,491,340,218,230,1279
E01008497,562,591,53,16,1222
E01008498,489,760,59,18,1326
E01008499,622,286,102,316,1326
E01008500,663,390,116,144,1313
E01008501,1040,295,111,116,1562
E01008502,549,303,79,377,1308
E01008503,485,287,168,346,1286
E01008504,747,485,35,28,1295
E01008505,568,408,175,241,1392
E01008506,519,227,71,326,1143
E01008507,692,365,48,137,1242
E01008508,487,224,51,464,1226
E01008509,469,149,98,577,1293
E01008510,534,340,199,217,1290
E01008511,522,236,222,365,1345
E01008512,379,170,57,658,1264
E01008513,773,223,288,588,1872
E01008514,531,300,134,479,1444
E01008516,463,519,82,71,1135
E01008517,681,467,53,8,1209
E01008518,573,530,108,151,1362
E01008519,542,299,95,216,1152
E01008520,500,432,101,65,1098
E01008521,546,532,133,29,1240
E01008522,667,522,75,28,1292
E01008523,564,382,57,7,1010
E01008524,354,268,480,443,1545
E01008525,536,496,177,53,1262
E01008526,668,471,58,30,1227
E01008527,600,391,277,21,1289
E01008528,600,313,234,15,1162
E01008529,608,480,191,49,1328
E01008530,485,618,120,165,1388
E01008531,697,473,73,15,1258
E01008532,573,235,112,295,1215
E01008533,452,188,75,457,1172
E01008534,600,501,69,26,1196
E01008535,590,378,126,162,1256
E01008536,581,220,306,109,1216
E01008537,470,252,155,246,1123
E01008538,631,357,76,4,1068
E01008539,666,178,209,138,1191
E01008540,263,149,205,614,1231
E01008541,434,112,203,523,1272
E01008542,303,107,142,627,1179
E01008543,676,200,310,438,1624
E01008544,303,152,378,528,1361
E01008545,187,37,133,642,999
E01008546,602,556,25,3,1186
E01008547,465,611,61,21,1158
E01008548,520,580,21,5,1126
E01008549,503,676,87,13,1279
E01008550,719,416,117,11,1263
E01008551,525,658,47,3,1233
E01008552,650,466,144,104,1364
E01008553,683,441,275,50,1449
E01008554,579,338,96,308,1321
E01008555,552,260,94,350,1256
E01008556,760,640,160,41,1601
E01008557,733,567,47,17,1364
E01008558,484,510,274,76,1344
E01008559,616,242,320,106,1284
E01008560,491,459,369,121,1440
E01008561,409,216,273,478,1376
E01008562,515,493,103,109,1220
E01008563,493,632,55,1,1181
E01008564,613,502,84,23,1222
E01008565,847,204,142,398,1591
E01008567,385,222,119,324,1050
E01008568,418,456,101,296,1271
E01008569,381,209,59,468,1117
E01008570,645,222,128,88,1083
E01008571,551,160,203,510,1424
E01008572,486,215,518,172,1391
E01008573,423,197,511,200,1331
E01008574,671,373,112,167,1323
E01008575,386,167,201,346,1100
E01008576,680,231,260,426,1597
E01008577,469,340,116,207,1132
E01008578,538,238,86,283,1145
E01008579,474,764,63,18,1319
E01008580,518,431,160,28,1137
E01008581,476,625,64,20,1185
E01008582,463,257,93,291,1104
E01008583,542,215,119,285,1161
E01008584,477,249,374,74,1174
E01008585,605,341,194,81,1221
E01008586,557,381,208,62,1208
E01008587,533,276,226,72,1107
E01008588,619,286,267,77,1249
E01008589,641,459,55,13,1168
E01008590,435,258,210,364,1267
E01008591,385,211,404,184,1184
E01008592,459,288,321,87,1155
E01008593,278,141,77,478,974
E01008594,574,192,115,481,1362
E01008595,551,267,308,179,1305
E01008596,314,146,168,400,1028
E01008597,1000,467,325,89,1881
E01008598,592,366,212,49,1219
E01008599,359,342,120,395,1216
E01008600,290,172,195,405,1062
E01008601,349,201,50,566,1166
E01008602,335,147,65,604,1151
E01008603,367,211,31,484,1093
E01008604,343,134,146,624,1247
E01008605,464,273,44,172,953
E01008606,321,171,79,531,1102
E01008607,217,131,47,630,1025
E01008608,216,169,40,482,907
E01008609,383,173,69,506,1131
E01008610,278,167,72,548,1065
E01008611,720,361,82,67,1230
E01008612,690,374,87,101,1252
E01008613,452,242,173,399,1266
E01008614,578,345,62,337,1322
E01008615,476,350,114,239,1179
E01008616,675,509,74,28,1286
E01008617,568,502,86,63,1219
E01008618,482,537,42,12,1073
E01008619,534,741,82,11,1368
E01008620,501,581,56,82,1220
E01008621,564,584,49,4,1201
E01008622,489,684,49,185,1407
E01008624,503,179,34,370,1086
E01008625,255,157,44,728,1184
E01008627,498,546,73,26,1143
E01008628,329,225,42,546,1142
E01008629,576,368,63,164,1171
E01008630,329,114,52,616,1111
E01008631,463,303,49,373,1188
E01008632,339,164,27,502,1032
E01008633,426,195,50,436,1107
E01008634,242,104,94,622,1062
E01008635,392,478,90,211,1171
E01008636,516,288,60,312,1176
E01008637,502,242,50,410,1204
E01008638,748,158,163,35,1104
E01008639,509,156,188,657,1510
E01008640,763,318,200,309,1590
E01008641,384,174,88,616,1262
E01008642,625,458,76,25,1184
E01008643,600,300,45,249,1194
E01008644,418,222,66,566,1272
E01008645,381,204,57,522,1164
E01008646,444,407,41,261,1153
E01008647,543,598,67,70,1278
E01008648,483,480,82,184,1229
E01008649,468,197,44,592,1301
E01008650,568,497,52,81,1198
E01008651,270,174,58,831,1333
E01008652,287,207,106,293,893
E01008653,326,105,56,511,998
E01008654,476,216,203,145,1040
E01008655,359,206,111,516,1192
E01008656,467,332,47,324,1170
E01008657,572,443,53,70,1138
E01008658,282,181,60,562,1085
E01008659,448,294,56,402,1200
E01008660,623,315,112,165,1215
E01008661,318,244,41,333,936
E01008662,404,133,45,422,1004
E01008663,327,243,56,495,1121
E01008664,293,269,315,284,1161
E01008665,316,241,231,413,1201
E01008666,117,92,157,789,1155
E01008667,292,234,255,569,1350
E01008668,340,222,279,428,1269
E01008669,319,132,86,584,1121
E01008670,446,249,68,497,1260
E01008671,327,214,140,331,1012
E01008672,416,336,59,299,1110
E01008673,474,395,129,17,1015
E01008674,554,460,48,20,1082
E01008675,515,279,333,81,1208
E01008676,465,237,163,109,974
E01008677,489,428,129,41,1087
E01008678,472,262,250,80,1064
E01008679,472,382,164,90,1108
E01008680,546,522,47,96,1211
E01008681,493,664,46,25,1228
E01008682,215,207,71,430,923
E01008683,513,270,319,104,1206
E01008684,361,224,48,396,1029
E01008685,613,531,101,292,1537
E01008686,586,439,71,313,1409
E01008687,511,582,105,271,1469
E01008688,390,257,60,421,1128
E01008689,383,199,58,669,1309
E01008690,483,185,59,429,1156
E01008691,553,436,23,66,1078
E01008692,426,277,76,379,1158
E01008693,359,274,114,265,1012
E01008694,395,259,93,383,1130
E01008695,422,226,73,460,1181
E01008696,612,254,39,138,1043
E01008697,339,261,52,418,1070
E01008698,404,171,97,549,1221
E01008699,342,215,98,473,1128
E01008700,285,268,277,89,919
E01008701,449,247,395,141,1232
E01008702,106,90,72,620,888
E01008703,103,90,728,701,1622
E01008704,468,300,283,104,1155
E01008705,252,205,352,137,946
E01008706,474,287,419,96,1276
E01008707,411,241,350,25,1027
E01008708,493,325,87,354,1259
E01008709,248,185,237,476,1146
E01008711,528,310,181,187,1206
E01008712,347,256,114,646,1363
E01008713,678,571,77,15,1341
E01008714,237,199,91,439,966
E01008715,472,308,129,159,1068
E01008716,524,604,21,30,1179
E01008717,530,301,98,383,1312
E01008718,424,400,72,281,1177
E01008719,330,292,167,181,970
E01008720,453,370,153,165,1141
E01008721,745,351,83,80,1259
E01008722,586,558,75,29,1248
E01008723,496,551,76,11,1134
E01008724,519,469,26,17,1031
E01008725,589,524,38,55,1206
E01008726,599,562,90,16,1267
E01008727,590,553,155,29,1327
E01008728,649,482,62,33,1226
E01008729,233,123,53,431,840
E01008730,322,170,69,730,1291
E01008731,242,210,56,489,997
E01008732,727,380,129,433,1669
E01008733,420,242,88,649,1399
E01008734,501,689,45,40,1275
E01008735,350,253,655,388,1646
E01008736,267,147,328,243,985
E01008737,355,271,343,131,1100
E01008738,344,289,333,110,1076
E01008739,414,302,127,397,1240
E01008740,477,583,124,15,1199
E01008741,527,434,118,120,1199
E01008742,621,455,175,158,1409
E01008743,313,190,81,717,1301
E01008744,426,323,223,310,1282
E01008745,600,646,79,77,1402
E01008746,311,236,126,602,1275
E01008747,458,392,60,311,1221
E01008748,351,473,54,328,1206
E01008749,479,639,51,88,1257
E01008750,773,470,100,177,1520
E01008751,359,202,39,279,879
E01008752,427,225,121,480,1253
E01008753,402,294,95,209,1000
E01008754,345,320,108,401,1174
E01008755,447,291,147,213,1098
E01008756,365,237,102,535,1239
E01008757,430,365,267,141,1203
E01008758,497,498,75,158,1228
E01008759,523,534,186,22,1265
E01008760,650,429,149,23,1251
E01008761,528,560,62,9,1159
E01008762,307,195,127,575,1204
E01008763,407,257,96,424,1184
E01008764,535,371,97,256,1259
E01008765,695,378,64,115,1252
E01008766,825,245,118,559,1747
E01008767,569,363,80,242,1254
E01008768,554,349,125,137,1165
E01008769,541,320,156,356,1373
E01008770,653,325,66,155,1199
E01008771,664,244,54,265,1227
E01008772,535,502,43,82,1162
E01008773,312,176,139,483,1110
E01008774,447,488,67,111,1113
E01008775,521,606,54,38,1219
E01008776,340,223,65,317,945
E01008777,210,123,70,845,1248
E01008778,424,318,93,285,1120
E01008779,464,347,160,242,1213
E01008780,605,316,127,485,1533
E01008781,632,529,134,12,1307
E01008782,544,626,57,32,1259
E01008783,553,570,98,10,1231
E01008784,626,597,79,31,1333
E01008785,491,701,65,13,1270
E01008786,515,462,143,76,1196
E01008787,540,456,297,69,1362
E01008788,532,501,211,46,1290
E01008789,503,392,248,34,1177
E01008790,540,439,176,130,1285
E01008791,253,179,488,662,1582
E01008792,399,525,69,9,1002
E01008793,308,172,133,716,1329
E01008795,773,364,80,221,1438
E01008796,695,310,137,101,1243
E01008797,793,647,89,88,1617
E01008799,764,396,77,103,1340
E01008800,282,118,71,625,1096
E01008801,698,497,75,35,1305
E01008802,540,456,69,169,1234
E01008803,423,348,125,262,1158
E01008804,496,269,88,445,1298
E01008805,488,298,205,184,1175
E01008808,616,475,126,26,1243
E01008809,561,402,85,258,1306
E01008810,493,193,108,532,1326
E01008811,663,375,106,197,1341
E01008812,446,175,109,606,1336
E01008813,399,281,84,478,1242
E01008814,531,372,92,275,1270
E01008817,121,112,66,551,850
E01008819,384,286,68,421,1159
E01008820,351,346,206,72,975
E01008821,269,190,82,450,991
E01008822,393,272,103,514,1282
E01008823,334,150,83,583,1150
E01008824,340,97,93,607,1137
E01008825,472,277,78,456,1283
E01008826,419,239,108,416,1182
E01008827,238,155,69,509,971
E01008828,288,192,69,653,1202
E01008829,274,113,61,604,1052
E01008830,463,228,506,25,1222
E01008831,325,167,1152,305,1949
E01008832,535,343,290,39,1207
E01008833,477,491,252,15,1235
E01008834,376,204,739,284,1603
E01008835,595,377,269,20,1261
E01008836,191,84,237,605,1117
E01008837,331,150,135,431,1047
E01008838,399,161,97,613,1270
E01008839,253,159,82,601,1095
E01008840,456,162,109,384,1111
E01008841,232,140,65,500,937
E01008842,507,349,56,258,1170
E01008843,530,433,81,54,1098
E01008844,458,458,94,235,1245
E01008845,535,471,114,110,1230
E01008846,253,95,65,456,869
E01008847,281,125,100,493,999
E01008848,452,462,58,213,1185
E01008849,232,105,79,504,920
E01008850,881,336,86,85,1388
E01008851,556,218,136,418,1328
E01008852,556,321,57,110,1044
E01008853,284,197,87,513,1081
E01008854,391,182,421,250,1244
E01008855,634,222,94,232,1182
E01008856,524,532,74,92,1222
E01008857,435,210,59,419,1123
E01008858,227,118,66,627,1038
E01008859,303,111,80,501,995
E01008860,391,232,86,407,1116
E01008861,480,389,84,316,1269
E01008862,692,448,25,83,1248
E01008863,749,494,46,76,1365
E01008864,509,480,49,81,1119
E01008865,438,258,71,371,1138
E01008866,520,161,91,352,1124
E01008867,383,101,127,683,1294
E01008868,563,379,51,61,1054
E01008869,537,311,54,168,1070
E01008870,734,305,73,77,1189
E01008871,564,141,94,379,1178
E01008872,658,351,83,179,1271
E01008873,549,386,61,101,1097
E01008874,379,175,74,716,1344
E01008875,556,140,147,388,1231
E01008876,603,513,56,80,1252
E01008877,554,484,105,43,1186
E01008878,571,337,86,241,1235
E01008879,559,286,102,258,1205
E01008880,402,247,58,256,963
E01008881,489,305,134,270,1198
E01008882,434,247,183,380,1244
E01008883,497,336,281,203,1317
E01008884,471,190,454,176,1291
E01008885,506,371,114,28,1019
E01008886,522,269,237,210,1238
E01008887,445,229,226,217,1117
E01008888,672,425,164,27,1288
E01008889,537,321,310,113,1281
E01008890,613,262,309,116,1300
E01008891,603,320,161,180,1264
E01008892,345,210,279,301,1135
E01008893,572,320,354,116,1362
E01008894,263,255,360,247,1125
E01008895,780,258,242,155,1435
E01008896,378,200,152,373,1103
E01008897,508,321,127,312,1268
E01008898,399,180,172,403,1154
E01008899,187,153,145,354,839
E01008901,323,270,178,427,1198
E01008905,348,381,171,224,1124
E01008906,275,209,229,402,1115
E01008907,206,159,221,569,1155
E01008909,303,104,93,512,1012
E01008910,250,98,153,695,1196
E01008911,131,53,117,739,1040
E01008913,174,86,79,739,1078
E01008914,154,69,473,825,1521
E01008915,348,250,319,62,979
E01008916,261,304,228,185,978
E01008917,556,288,82,146,1072
E01008918,358,249,108,554,1269
E01008919,420,338,184,313,1255
E01008920,521,380,104,97,1102
E01008921,371,350,137,291,1149
E01008923,290,165,95,477,1027
E01008924,480,364,108,172,1124
E01008925,502,462,81,30,1075
E01008927,287,171,104,524,1086
E01008928,272,170,91,629,1162
E01008929,385,128,116,500,1129
E01008930,559,174,127,280,1140
E01008931,379,200,79,423,1081
E01008932,397,291,170,348,1206
E01008933,540,377,119,164,1200
E01008934,466,485,110,69,1130
E01008935,369,193,178,476,1216
E01008936,457,405,99,296,1257
E01008937,389,299,132,339,1159
E01008938,419,223,143,392,1177
E01008939,500,335,117,257,1209
E01008940,365,214,154,343,1076
E01008941,409,259,99,357,1124
E01008942,556,213,86,341,1196
E01008943,437,226,126,314,1103
E01008944,495,353,165,308,1321
E01008945,686,310,216,209,1421
E01008946,550,304,118,237,1209
E01008947,523,301,140,95,1059
E01008948,517,519,126,50,1212
E01008949,553,436,57,10,1056
E01008950,277,309,62,577,1225
E01008951,472,224,135,262,1093
E01008952,547,196,497,102,1342
E01008953,501,347,206,175,1229
E01008954,209,340,85,493,1127
E01008955,528,332,297,102,1259
E01008956,560,314,122,134,1130
E01008957,590,234,313,141,1278
E01008958,221,226,102,761,1310
E01008959,506,420,156,289,1371
E01008960,649,336,165,79,1229
E01008961,472,360,378,39,1249
E01008962,404,293,141,570,1408
E01008963,489,253,141,174,1057
E01008964,439,281,122,293,1135
E01008965,628,413,117,50,1208
E01008966,443,205,213,396,1257
E01008967,549,607,101,107,1364
E01008968,596,552,140,74,1362
E01008969,622,415,166,111,1314
E01008970,388,346,112,285,1131
E01008971,584,412,158,196,1350
E01008972,534,261,146,421,1362
E01008973,685,441,186,196,1508
E01008974,1104,458,379,220,2161
E01008975,600,463,119,82,1264
E01008976,436,260,103,404,1203
E01008977,566,246,161,258,1231
E01008978,95,85,73,778,1031
E01008979,405,245,74,565,1289
E01008980,340,216,85,586,1227
E01008981,538,485,114,75,1212
E01008982,288,291,514,79,1172
E01008984,187,167,624,533,1511
E01008986,275,229,793,177,1474
E01008987,169,124,718,360,1371
E01008988,376,211,941,182,1710
E01008989,228,241,604,326,1399
E01008990,235,310,315,21,881
E01008991,473,562,161,14,1210
E01008992,283,346,276,65,970
E01008994,300,286,383,255,1224
E01008995,112,73,151,761,1097
E01008996,240,219,266,395,1120
E01008997,309,375,258,225,1167
E01008998,475,276,236,308,1295
E01008999,461,329,242,133,1165
E01009000,371,233,478,266,1348
E01009001,542,396,196,117,1251
E01009002,235,156,119,546,1056
E01009003,538,485,273,47,1343
E01009005,448,296,164,159,1067
E01009006,548,318,337,47,1250
E01009007,342,170,589,174,1275
E01009008,560,447,122,97,1226
E01009009,563,355,101,183,1202
E01009011,568,399,208,284,1459
E01009012,574,394,188,30,1186
E01009013,523,311,469,201,1504
E01009014,551,330,227,308,1416
E01009015,487,314,389,209,1399
E01009016,398,278,187,402,1265
E01009017,457,496,204,61,1218
E01009018,442,425,320,124,1311
E01009019,395,193,167,409,1164
E01009020,452,290,151,267,1160
E01009021,390,160,170,453,1173
E01009022,561,391,177,207,1336
E01009023,644,408,159,25,1236
E01009024,433,166,169,411,1179
E01009025,466,171,100,388,1125
E01009026,327,212,220,319,1078
E01009028,441,255,209,304,1209
E01009029,464,252,167,179,1062
E01009030,527,483,125,26,1161
E01009031,618,507,131,52,1308
E01009032,665,531,149,53,1398
E01009033,494,243,196,363,1296
E01009034,631,506,158,10,1305
E01009035,586,479,193,125,1383
E01009036,546,529,118,17,1210
E01009037,539,519,157,121,1336
E01009039,616,557,155,8,1336
E01009040,692,532,120,12,1356
E01009041,697,424,135,24,1280
E01009042,507,273,279,10,1069
E01009043,595,455,251,178,1479
E01009044,386,434,254,57,1131
E01009045,514,505,186,91,1296
E01009046,636,518,158,69,1381
E01009047,292,357,201,460,1310
E01009048,301,307,208,466,1282
E01009049,477,384,260,131,1252
E01009050,269,364,383,362,1378
E01009051,274,308,419,195,1196
E01009053,262,260,288,209,1019
E01009054,360,600,183,56,1199
E01009056,404,379,318,442,1543
E01009057,316,335,310,443,1404
E01009058,402,399,312,52,1165
E01009059,208,279,264,488,1239
E01009060,259,370,240,226,1095
E01009061,339,498,232,201,1270
E01009062,357,310,179,303,1149
E01009064,438,266,184,247,1135
E01009065,492,376,313,72,1253
E01009066,546,484,123,104,1257
E01009067,461,340,303,85,1189
E01009068,379,324,523,107,1333
E01009069,387,284,591,130,1392
E01009070,591,407,221,66,1285
E01009071,359,355,332,275,1321
E01009072,425,308,526,136,1395
E01009073,150,105,109,699,1063
E01009074,306,139,190,563,1198
E01009075,163,201,537,522,1423
E01009077,427,479,239,200,1345
E01009078,286,277,526,164,1253
E01009079,332,186,116,556,1190
E01009080,184,77,73,405,739
E01009081,274,113,135,436,958
E01009082,432,260,130,210,1032
E01009083,315,195,102,387,999
E01009084,582,407,164,77,1230
E01009085,722,481,157,23,1383
E01009086,609,434,208,95,1346
E01009087,493,504,182,12,1191
E01009088,521,442,101,235,1299
E01009089,544,433,133,8,1118
E01009090,550,500,200,50,1300
E01009091,473,237,141,357,1208
E01009092,326,111,125,543,1105
E01009093,407,135,159,421,1122
E01009094,385,189,116,323,1013
E01009095,559,382,251,73,1265
E01009096,318,235,92,690,1335
E01009097,253,190,79,917,1439
E01009098,615,243,238,555,1651
E01009099,200,109,94,904,1307
E01009100,664,268,206,417,1555
E01009101,348,226,59,549,1182
E01009102,377,210,217,337,1141
E01009103,217,156,54,730,1157
E01009104,413,183,193,345,1134
E01009105,647,395,129,130,1301
E01009106,466,370,70,224,1130
E01009107,308,143,168,661,1280
E01009108,419,457,41,159,1076
E01009109,132,42,63,607,844
E01009110,418,226,132,419,1195
E01009111,556,381,81,114,1132
E01009112,494,316,73,213,1096
E01009113,269,87,95,627,1078
E01009114,365,269,89,503,1226
E01009115,341,207,76,518,1142
E01009116,514,563,90,13,1180
E01009117,278,85,117,915,1395
E01009118,509,343,96,269,1217
E01009119,479,366,142,154,1141
E01009120,515,369,125,114,1123
E01009121,644,215,220,615,1694
E01009122,397,199,149,454,1199
E01009123,429,268,185,223,1105
E01009124,175,90,134,666,1065
E01009125,509,342,155,306,1312
E01009126,606,372,130,7,1115
E01009127,355,172,157,430,1114
E01009128,363,159,125,367,1014
E01009129,346,147,151,495,1139
E01009130,409,182,134,413,1138
E01009131,438,159,115,341,1053
E01009132,382,166,203,354,1105
E01009133,386,171,120,432,1109
E01009134,365,258,123,456,1202
E01009135,613,457,84,76,1230
E01009136,442,271,135,479,1327
E01009137,467,211,148,317,1143
E01009138,403,414,438,33,1288
E01009139,423,336,427,64,1250
E01009140,453,440,498,186,1577
E01009141,187,88,181,850,1306
E01009143,108,58,154,718,1038
E01009145,438,409,520,162,1529
E01009146,86,42,280,781,1189
E01009147,319,287,562,130,1298
E01009151,362,457,372,183,1374
E01009152,317,589,467,245,1618
E01009153,305,255,623,509,1692
E01009155,397,136,62,489,1084
E01009157,343,156,85,563,1147
E01009158,604,237,188,352,1381
E01009159,749,354,212,72,1387
E01009160,217,120,71,778,1186
E01009161,465,210,83,368,1126
E01009162,587,399,209,74,1269
E01009163,409,225,118,387,1139
E01009164,554,342,131,162,1189
E01009165,388,178,198,297,1061
E01009166,429,222,152,214,1017
E01009167,600,332,127,132,1191
E01009168,617,439,102,56,1214
E01009169,643,367,122,161,1293
E01009170,601,479,88,50,1218
E01009171,544,294,112,278,1228
E01009172,352,202,90,408,1052
E01009173,439,171,128,520,1258
E01009174,407,139,94,299,939
E01009175,513,319,295,58,1185
E01009176,427,524,211,177,1339
E01009177,543,345,284,55,1227
E01009178,469,272,416,114,1271
E01009179,607,468,199,113,1387
E01009182,216,350,329,377,1272
E01009183,581,482,205,46,1314
E01009184,391,258,476,197,1322
E01009185,463,462,379,75,1379
E01009186,468,409,359,169,1405
E01009187,458,383,252,148,1241
E01009188,449,343,288,151,1231
E01009189,479,435,191,65,1170
E01009192,502,879,295,123,1799
E01009194,558,676,372,278,1884
E01009195,516,535,304,308,1663
E01009197,386,233,202,245,1066
E01009198,284,270,319,158,1031
E01009199,299,136,352,250,1037
E01009200,306,115,209,550,1180
E01009201,349,199,117,598,1263
E01009202,178,135,116,619,1048
E01009203,116,59,174,1483,1832
E01009204,153,104,152,797,1206
E01009205,603,434,100,83,1220
E01009206,578,541,131,68,1318
E01009207,669,514,122,28,1333
E01009208,632,471,95,40,1238
E01009209,643,457,282,359,1741
E01009210,530,344,245,329,1448
E01009211,622,449,126,42,1239
E01009212,485,293,150,393,1321
E01009213,423,478,132,207,1240
E01009214,343,202,103,640,1288
E01009215,363,193,143,639,1338
E01009216,719,469,113,255,1556
E01009217,660,501,147,9,1317
E01009218,519,475,71,134,1199
E01009219,459,390,149,152,1150
E01009220,546,282,170,211,1209
E01009221,537,437,91,120,1185
E01009222,403,173,186,381,1143
E01009223,583,406,163,108,1260
E01009224,507,553,96,40,1196
E01009225,398,382,153,346,1279
E01009226,546,396,206,23,1171
E01009227,668,444,167,40,1319
E01009228,587,455,201,46,1289
E01009229,578,483,196,14,1271
E01009230,559,476,178,27,1240
E01009231,711,634,162,18,1525
E01009232,548,422,179,39,1188
E01009233,497,192,123,338,1150
E01009234,705,266,165,42,1178
E01009235,592,489,198,10,1289
E01009236,566,387,171,85,1209
E01009237,450,331,208,126,1115
E01009238,599,519,130,79,1327
E01009239,218,177,389,195,979
E01009240,564,409,234,11,1218
E01009241,643,367,269,16,1295
E01009242,520,405,449,15,1389
E01009243,557,466,136,74,1233
E01009244,559,289,186,65,1099
E01009245,515,431,147,50,1143
E01009246,524,500,180,64,1268
E01009247,605,434,123,13,1175
E01009248,754,395,192,39,1380
E01009249,515,400,167,143,1225
E01009250,516,502,176,119,1313
E01009251,583,507,110,42,1242
E01009252,513,451,247,31,1242
E01009253,535,467,126,113,1241
E01009254,405,286,212,353,1256
E01009255,487,356,139,217,1199
E01009256,505,319,154,247,1225
E01009257,422,311,132,261,1126
E01009258,357,197,127,464,1145
E01009259,326,207,99,546,1178
E01009260,444,674,147,30,1295
E01009261,526,564,200,20,1310
E01009262,677,507,164,29,1377
E01009263,438,311,298,245,1292
E01009264,81,65,504,189,839
E01009265,528,424,313,125,1390
E01009266,413,334,452,123,1322
E01009267,553,633,185,72,1443
E01009268,490,499,155,39,1183
E01009269,268,296,389,165,1118
E01009270,371,330,294,425,1420
E01009271,340,320,263,187,1110
E01009272,278,262,131,359,1030
E01009273,339,445,308,136,1228
E01009274,404,509,363,350,1626
E01009275,324,347,201,256,1128
E01009276,626,535,147,8,1316
E01009278,708,460,184,11,1363
E01009279,612,456,82,10,1160
E01009280,292,208,314,269,1083
E01009281,359,312,137,319,1127
E01009282,339,318,458,171,1286
E01009283,426,322,374,68,1190
E01009284,184,215,1105,169,1673
E01009286,100,106,1850,51,2107
E01009288,209,360,260,24,853
E01009289,68,72,1762,113,2015
E01009290,79,72,1721,70,1942
E01009291,438,265,159,317,1179
E01009292,552,453,338,17,1360
E01009293,383,347,544,32,1306
E01009294,446,422,285,283,1436
E01009295,316,446,581,154,1497
E01009296,315,241,653,56,1265
E01009297,468,333,120,393,1314
E01009298,435,99,112,442,1088
E01009299,405,226,117,483,1231
E01009300,425,171,174,523,1293
E01009301,320,175,185,587,1267
E01009302,463,522,113,100,1198
E01009303,467,253,157,321,1198
E01009304,544,322,105,453,1424
E01009305,372,177,89,570,1208
E01009306,420,327,113,369,1229
E01009307,327,250,107,533,1217
E01009308,501,206,147,534,1388
E01009309,291,192,112,472,1067
E01009310,482,294,146,490,1412
E01009311,474,216,114,334,1138
E01009312,662,427,107,76,1272
E01009313,563,429,93,164,1249
E01009314,508,354,135,241,1238
E01009315,435,519,205,211,1370
E01009316,530,449,164,176,1319
E01009317,504,374,147,295,1320
E01009318,654,463,107,16,1240
E01009319,649,515,159,21,1344
E01009320,527,497,220,18,1262
E01009321,301,170,141,735,1347
E01009322,324,171,91,463,1049
E01009323,438,250,81,357,1126
E01009324,614,567,126,41,1348
E01009325,368,283,224,271,1146
E01009326,441,284,202,336,1263
E01009327,269,431,269,60,1029
E01009328,551,720,282,66,1619
E01009329,431,624,421,170,1646
E01009331,469,569,323,52,1413
E01009332,178,213,173,551,1115
E01009333,248,275,275,216,1014
E01009334,456,552,216,80,1304
E01009335,486,479,246,51,1262
E01009337,395,380,284,109,1168
E01009338,303,354,238,173,1068
E01009339,310,312,252,148,1022
E01009340,769,381,517,168,1835
E01009341,244,197,187,450,1078
E01009342,433,377,251,98,1159
E01009343,370,317,288,174,1149
E01009344,254,261,267,231,1013
E01009345,213,123,186,468,990
E01009346,382,286,236,233,1137
E01009347,213,144,182,741,1280
E01009348,438,212,367,462,1479
E01009349,264,234,369,305,1172
E01009350,242,330,225,291,1088
E01009351,313,298,379,224,1214
E01009352,287,485,247,219,1238
E01009353,290,510,260,141,1201
E01009354,252,273,259,311,1095
E01009355,235,334,281,336,1186
E01009358,258,463,449,323,1493
E01009359,247,381,447,394,1469
E01009360,372,312,521,536,1741
E01009361,236,282,488,489,1495
E01009362,61,77,145,632,915
E01009363,304,297,148,376,1125
E01009364,111,105,78,609,903
E01009365,205,249,262,505,1221
E01009366,317,198,237,322,1074
E01009367,258,406,277,233,1174
E01009368,220,274,135,419,1048
E01009371,267,336,285,313,1201
E01009372,373,430,254,135,1192
E01009373,414,396,222,194,1226
E01009374,179,170,63,390,802
E01009375,315,369,228,342,1254
E01009376,199,248,336,364,1147
E01009377,137,117,204,424,882
E01009378,307,144,653,576,1680
E01009379,256,225,188,554,1223
E01009380,308,328,321,132,1089
E01009382,407,546,280,71,1304
E01009383,312,373,252,151,1088
E01009384,226,104,327,463,1120
E01009385,249,222,441,148,1060
E01009389,400,702,198,56,1356
E01009390,208,325,483,176,1192
E01009391,336,249,425,71,1081
E01009392,437,474,329,31,1271
E01009393,421,248,339,47,1055
E01009394,602,447,313,51,1413
E01009395,372,385,328,162,1247
E01009396,403,744,289,93,1529
E01009397,229,355,218,364,1166
E01009399,312,287,265,173,1037
E01009400,351,287,245,187,1070
E01009401,317,245,370,302,1234
E01009403,451,212,134,350,1147
E01009404,486,209,124,360,1179
E01009405,422,300,167,217,1106
E01009406,499,266,168,375,1308
E01009407,425,319,297,269,1310
E01009408,498,313,206,292,1309
E01009409,456,269,392,182,1299
E01009410,539,378,344,171,1432
E01009411,722,359,347,36,1464
E01009412,420,350,483,100,1353
E01009413,467,328,376,133,1304
E01009414,603,315,410,143,1471
E01009415,616,616,81,13,1326
E01009416,1110,567,202,78,1957
E01009417,528,404,87,150,1169
E01009418,504,409,78,205,1196
E01009419,441,466,94,97,1098
E01009420,605,478,79,53,1215
E01009421,674,661,34,7,1376
E01009422,651,681,184,33,1549
E01009423,556,415,157,261,1389
E01009424,515,403,246,47,1211
E01009425,476,681,167,113,1437
E01009426,484,640,61,14,1199
E01009427,434,545,210,90,1279
E01009428,571,747,52,6,1376
E01009429,555,554,71,6,1186
E01009430,546,662,93,47,1348
E01009431,584,592,61,13,1250
E01009432,455,414,118,202,1189
E01009433,621,718,121,7,1467
E01009434,689,367,123,27,1206
E01009435,856,422,123,43,1444
E01009436,608,505,45,7,1165
E01009437,669,495,165,137,1466
E01009438,630,483,77,16,1206
E01009439,495,512,109,34,1150
E01009440,560,613,88,11,1272
E01009441,517,276,235,197,1225
E01009442,608,544,47,29,1228
E01009443,528,368,101,4,1001
E01009444,567,648,56,9,1280
E01009445,454,162,113,479,1208
E01009446,922,506,218,242,1888
E01009447,594,376,95,175,1240
E01009448,521,325,103,336,1285
E01009449,472,456,552,87,1567
E01009450,713,501,111,52,1377
E01009451,513,277,267,74,1131
E01009452,625,469,118,127,1339
E01009453,624,381,88,62,1155
E01009454,626,459,132,8,1225
E01009455,340,212,82,491,1125
E01009456,672,494,117,29,1312
E01009457,550,692,26,24,1292
E01009458,578,301,117,292,1288
E01009459,513,660,151,3,1327
E01009460,569,345,361,121,1396
E01009461,516,526,41,19,1102
E01009462,623,350,260,192,1425
E01009463,506,609,131,5,1251
E01009464,560,516,67,4,1147
E01009465,644,390,49,15,1098
E01009466,577,574,174,12,1337
E01009467,558,510,77,168,1313
E01009468,515,643,73,21,1252
E01009469,504,571,118,18,1211
E01009470,603,565,29,9,1206
E01009471,614,570,189,22,1395
E01009472,656,517,90,35,1298
E01009473,602,401,195,75,1273
E01009474,611,460,125,85,1281
E01009475,444,319,161,389,1313
E01009476,333,297,212,372,1214
E01009477,387,248,243,314,1192
E01009478,316,207,177,541,1241
E01009479,362,435,269,377,1443
E01009480,450,219,195,301,1165
E01009481,618,555,305,63,1541
E01009482,246,335,218,341,1140
E01009483,331,383,258,216,1188
E01009484,278,333,191,342,1144
E01009485,391,501,188,134,1214
E01009486,513,438,322,70,1343
E01009487,573,469,255,123,1420
E01009488,319,310,195,606,1430
E01009489,329,422,287,236,1274
E01009490,420,329,208,395,1352
E01009491,336,463,220,180,1199
E01009492,375,281,245,245,1146
E01009493,241,71,335,542,1189
E01009494,45,33,105,946,1129
E01009495,259,254,61,349,923
E01009496,526,561,72,95,1254
E01009497,630,245,173,300,1348
E01009498,415,199,153,470,1237
E01009499,573,238,113,399,1323
E01009500,341,196,126,487,1150
E01009501,375,188,189,421,1173
E01009502,468,199,108,351,1126
E01009503,435,204,139,389,1167
E01009504,336,502,131,207,1176
E01009505,375,221,154,504,1254
E01009506,436,659,92,67,1254
E01009507,344,281,196,315,1136
E01009508,460,412,125,194,1191
E01009509,479,347,344,136,1306
E01009510,320,280,112,502,1214
E01009511,284,180,134,441,1039
E01009512,539,246,131,299,1215
E01009513,422,263,185,353,1223
E01009514,321,211,151,401,1084
E01009515,465,433,154,183,1235
E01009516,444,321,126,181,1072
E01009517,536,298,120,346,1300
E01009518,574,502,145,82,1303
E01009519,635,475,94,26,1230
E01009520,822,456,105,44,1427
E01009521,700,434,158,14,1306
E01009522,388,359,149,254,1150
E01009523,579,599,85,8,1271
E01009524,459,442,114,201,1216
E01009525,503,538,129,11,1181
E01009526,570,499,134,29,1232
E01009527,633,402,151,65,1251
E01009528,540,644,93,33,1310
E01009529,560,472,179,31,1242
E01009530,577,410,91,15,1093
E01009531,432,531,177,129,1269
E01009532,515,393,130,44,1082
E01009535,419,595,83,22,1119
E01009536,477,601,150,17,1245
E01009537,461,276,107,288,1132
E01009538,430,301,96,301,1128
E01009539,264,189,128,617,1198
E01009540,188,96,128,889,1301
E01009541,414,410,202,302,1328
E01009542,334,158,145,732,1369
E01009543,905,376,66,14,1361
E01009544,438,392,247,170,1247
E01009548,558,432,729,124,1843
E01009549,582,561,194,8,1345
E01009550,553,495,420,31,1499
E01009552,432,410,191,248,1281
E01009553,195,77,885,179,1336
E01009554,403,334,338,27,1102
E01009555,549,527,166,5,1247
E01009556,409,335,429,132,1305
E01009557,472,582,99,6,1159
E01009558,516,362,334,31,1243
E01009559,432,536,149,35,1152
E01009560,574,561,92,7,1234
E01009561,461,540,165,175,1341
E01009562,529,683,112,61,1385
E01009563,637,620,72,5,1334
E01009564,313,215,393,225,1146
E01009565,398,475,245,48,1166
E01009566,262,126,429,264,1081
E01009567,350,354,419,188,1311
E01009568,401,416,342,125,1284
E01009569,199,244,302,192,937
E01009570,362,297,438,198,1295
E01009571,187,180,354,420,1141
E01009572,231,168,561,527,1487
E01009573,213,344,322,249,1128
E01009574,177,208,300,391,1076
E01009575,305,232,250,158,945
E01009576,552,286,179,236,1253
E01009577,169,60,75,567,871
E01009578,595,460,84,47,1186
E01009579,191,123,118,766,1198
E01009580,336,351,255,46,988
E01009581,306,171,106,572,1155
E01009582,583,379,196,238,1396
E01009583,494,335,278,166,1273
E01009584,376,409,104,225,1114
E01009585,51,27,31,578,687
E01009586,697,480,137,21,1335
E01009587,443,335,339,33,1150
E01009588,435,220,201,348,1204
E01009589,455,293,219,125,1092
E01009590,474,389,106,86,1055
E01009591,612,299,230,35,1176
E01009592,495,224,252,213,1184
E01009593,530,500,250,28,1308
E01009594,546,410,89,77,1122
E01009596,393,324,336,92,1145
E01009597,529,432,276,85,1322
E01009598,488,716,150,22,1376
E01009599,267,429,257,72,1025
E01009604,463,383,209,73,1128
E01009605,342,201,148,458,1149
E01009606,469,398,188,42,1097
E01009607,222,148,147,678,1195
E01009608,429,321,218,215,1183
E01009609,438,338,210,176,1162
E01009610,379,247,203,295,1124
E01009611,357,99,194,787,1437
E01009612,273,112,135,513,1033
E01009613,491,410,139,14,1054
E01009614,569,396,165,7,1137
E01009615,451,362,586,36,1435
E01009616,527,408,276,29,1240
E01009617,476,294,172,43,985
E01009618,714,362,136,14,1226
E01009619,407,208,785,145,1545
E01009620,483,357,206,91,1137
E01009621,382,276,251,135,1044
E01009622,446,188,210,410,1254
E01009623,453,290,262,193,1198
E01009624,475,334,373,47,1229
E01009625,829,479,390,78,1776
E01009626,501,381,314,59,1255
E01009627,412,331,353,166,1262
E01009628,506,373,225,106,1210
E01009629,651,334,927,206,2118
E01009630,407,229,354,289,1279
E01009631,218,145,300,359,1022
E01009632,135,112,668,515,1430
E01009633,239,204,778,256,1477
E01009634,275,206,844,115,1440
E01009635,133,141,1383,250,1907
E01009636,330,220,1031,245,1826
E01009637,223,195,277,308,1003
E01009638,64,78,228,751,1121
E01009639,257,456,381,171,1265
E01009640,220,160,520,386,1286
E01009641,157,129,987,461,1734
E01009642,81,79,1101,376,1637
E01009643,613,363,184,6,1166
E01009644,637,477,179,33,1326
E01009645,560,404,164,15,1143
E01009646,601,424,168,8,1201
E01009647,558,423,414,24,1419
E01009648,582,416,179,12,1189
E01009649,517,406,193,20,1136
E01009650,260,139,895,126,1420
E01009651,132,101,303,751,1287
E01009652,495,548,103,37,1183
E01009653,573,517,134,10,1234
E01009654,747,357,230,18,1352
E01009655,513,201,308,382,1404
E01009656,388,239,337,311,1275
E01009657,637,424,240,16,1317
E01009658,537,391,237,35,1200
E01009659,268,163,550,353,1334
E01009660,378,455,535,43,1411
E01009661,284,270,864,117,1535
E01009662,482,391,174,141,1188
E01009663,393,591,168,36,1188
E01009664,558,288,204,101,1151
E01009665,392,501,109,25,1027
E01009666,513,429,82,8,1032
E01009667,428,707,36,13,1184
E01009668,697,395,142,42,1276
E01009669,537,337,86,21,981
E01009670,678,507,109,6,1300
E01009671,465,434,120,11,1030
E01009672,647,939,138,22,1746
E01009674,453,216,129,376,1174
E01009676,523,341,286,35,1185
E01009679,312,163,298,406,1179
E01009681,485,376,171,20,1052
E01009682,596,401,222,25,1244
E01009683,440,244,219,140,1043
E01009684,383,265,237,243,1128
E01009685,635,459,205,51,1350
E01009686,678,476,199,15,1368
E01009687,541,341,258,10,1150
E01009688,320,229,683,62,1294
E01009689,313,183,760,83,1339
E01009690,348,255,665,38,1306
E01009691,325,207,656,36,1224
E01009692,381,589,59,8,1037
E01009693,571,530,123,15,1239
E01009694,493,529,152,7,1181
E01009695,491,728,111,4,1334
E01009696,524,598,133,3,1258
E01009697,520,541,125,25,1211
E01009698,602,554,108,19,1283
E01009699,527,434,86,118,1165
E01009700,323,171,184,624,1302
E01009701,461,268,116,380,1225
E01009702,284,227,196,431,1138
E01009703,1017,170,240,582,2009
E01009704,612,512,95,8,1227
E01009705,566,566,79,2,1213
E01009706,526,550,140,30,1246
E01009707,755,484,140,75,1454
E01009708,456,547,174,42,1219
E01009709,43,58,128,484,713
E01009710,421,419,298,19,1157
E01009711,456,447,178,51,1132
E01009712,606,392,216,20,1234
E01009713,540,312,195,36,1083
E01009714,592,376,200,6,1174
E01009715,374,345,230,143,1092
E01009716,616,468,178,40,1302
E01009717,519,442,177,36,1174
E01009718,304,242,227,598,1371
E01009719,614,413,108,20,1155
E01009720,713,375,48,3,1139
E01009721,678,476,168,224,1546
E01009722,575,460,81,13,1129
E01009723,614,364,47,4,1029
E01009724,703,479,58,3,1243
E01009725,305,143,96,562,1106
E01009726,534,459,80,12,1085
E01009727,617,405,79,13,1114
E01009728,564,494,39,5,1102
E01009729,467,473,118,208,1266
E01009730,766,276,124,11,1177
E01009731,646,317,240,52,1255
E01009732,546,373,173,307,1399
E01009733,210,171,170,852,1403
E01009734,476,411,118,264,1269
E01009735,634,465,122,15,1236
E01009736,450,564,139,24,1177
E01009737,525,450,112,162,1249
E01009738,516,382,68,256,1222
E01009739,534,361,155,180,1230
E01009740,478,208,194,386,1266
E01009741,297,227,360,998,1882
E01009742,376,236,104,506,1222
E01009743,392,214,83,624,1313
E01009744,520,309,271,408,1508
E01009745,690,508,148,78,1424
E01009746,397,330,305,251,1283
E01009747,477,202,232,255,1166
E01009748,326,212,131,583,1252
E01009749,532,556,92,32,1212
E01009750,481,387,77,293,1238
E01009751,404,370,181,260,1215
E01009752,366,210,109,453,1138
E01009753,279,186,104,592,1161
E01009754,487,332,128,352,1299
E01009756,327,187,100,475,1089
E01009757,471,392,168,250,1281
E01009758,477,293,108,426,1304
E01009759,433,585,65,25,1108
E01009760,458,309,82,180,1029
E01009762,200,88,45,646,979
E01009763,507,207,96,540,1350
E01009764,560,496,77,67,1200
E01009765,569,526,90,114,1299
E01009766,534,385,88,279,1286
E01009767,472,396,72,252,1192
E01009768,415,415,112,199,1141
E01009769,272,234,119,603,1228
E01009770,364,459,59,312,1194
E01009771,409,673,54,47,1183
E01009772,312,163,57,470,1002
E01009773,407,379,135,321,1242
E01009774,540,477,84,125,1226
E01009775,502,342,90,315,1249
E01009776,571,528,65,84,1248
E01009777,422,319,62,375,1178
E01009778,650,379,106,113,1248
E01009779,412,441,141,198,1192
E01009780,1126,319,83,57,1585
E01009781,577,414,127,437,1555
E01009782,414,279,71,449,1213
E01009783,416,301,85,382,1184
E01009784,933,332,51,7,1323
E01009785,476,675,51,58,1260
E01009786,333,158,90,573,1154
E01009787,695,519,45,20,1279
E01009788,369,275,152,497,1293
E01009789,632,479,77,81,1269
E01009790,426,309,103,431,1269
E01009791,497,441,75,219,1232
E01009792,549,314,101,256,1220
E01009793,553,420,105,14,1092
E01009794,476,694,80,9,1259
E01009795,498,350,309,160,1317
E01009796,570,467,99,119,1255
E01009797,365,464,95,211,1135
E01009798,618,498,151,127,1394
E01009799,472,600,123,51,1246
E01009800,546,544,82,79,1251
E01009801,617,660,70,41,1388
E01009802,563,455,65,229,1312
E01009803,596,744,49,8,1397
E01009804,509,536,43,26,1114
E01009805,505,485,99,113,1202
E01009806,547,492,136,91,1266
E01009807,624,822,68,8,1522
E01009808,552,613,41,16,1222
E01009809,421,258,153,449,1281
E01009810,540,610,121,163,1434
E01009811,507,507,84,182,1280
E01009812,605,520,50,65,1240
E01009813,444,346,150,324,1264
E01009814,450,575,24,4,1053
E01009815,580,470,34,8,1092
E01009816,543,642,42,8,1235
E01009817,441,569,35,14,1059
E01009818,354,305,75,207,941
E01009819,628,523,85,22,1258
E01009820,543,511,119,65,1238
E01009821,426,725,33,11,1195
E01009822,424,657,104,62,1247
E01009823,567,537,36,26,1166
E01009824,522,304,104,379,1309
E01009825,494,389,96,206,1185
E01009826,454,727,68,15,1264
E01009827,601,649,38,19,1307
E01009828,463,541,66,110,1180
E01009829,540,656,66,14,1276
E01009830,537,659,71,50,1317
E01009831,374,282,93,461,1210
E01009832,367,220,111,563,1261
E01009833,383,299,212,106,1000
E01009834,437,394,131,330,1292
E01009835,507,378,184,35,1104
E01009836,233,272,275,620,1400
E01009837,518,414,197,126,1255
E01009838,495,355,167,290,1307
E01009839,428,402,152,225,1207
E01009840,349,369,198,119,1035
E01009841,313,255,123,492,1183
E01009842,329,312,211,647,1499
E01009843,553,481,93,156,1283
E01009844,300,273,217,296,1086
E01009845,528,670,52,40,1290
E01009846,490,587,74,93,1244
E01009847,523,497,39,163,1222
E01009848,520,374,113,159,1166
E01009849,480,428,83,262,1253
E01009850,495,525,114,68,1202
E01009851,515,495,83,110,1203
E01009852,482,689,58,4,1233
E01009853,410,749,45,17,1221
E01009854,488,711,75,11,1285
E01009855,551,738,54,17,1360
E01009856,581,389,268,331,1569
E01009857,463,270,115,417,1265
E01009858,317,370,252,61,1000
E01009859,591,562,113,22,1288
E01009860,496,732,53,33,1314
E01009861,490,374,175,182,1221
E01009862,506,380,160,338,1384
E01009863,665,306,98,307,1376
E01009864,498,400,79,299,1276
E01009865,394,320,104,355,1173
E01009866,542,411,268,136,1357
E01009867,574,530,99,201,1404
E01009868,490,326,180,238,1234
E01009869,655,489,147,24,1315
E01009870,587,472,186,4,1249
E01009871,555,473,165,349,1542
E01009872,414,210,128,396,1148
E01009873,495,556,101,117,1269
E01009874,400,337,69,426,1232
E01009875,504,355,78,247,1184
E01009876,463,445,115,283,1306
E01009877,312,241,81,541,1175
E01009878,764,575,118,92,1549
E01009879,683,410,227,256,1576
E01009880,685,361,118,26,1190
E01009881,305,240,466,667,1678
E01009882,506,450,113,38,1107
E01009883,361,240,85,356,1042
E01009884,275,262,213,450,1200
E01009885,280,499,212,278,1269
E01009886,291,253,108,689,1341
E01009887,485,423,175,280,1363
E01009888,524,462,140,153,1279
E01009889,358,465,376,171,1370
E01009890,424,201,128,508,1261
E01009891,405,244,113,465,1227
E01009892,259,262,232,424,1177
E01009893,289,176,126,582,1173
E01009894,538,394,137,310,1379
E01009895,402,372,84,287,1145
E01009896,490,594,63,110,1257
E01009897,479,725,33,7,1244
E01009898,409,675,67,108,1259
E01009899,464,702,46,28,1240
E01009900,424,798,30,16,1268
E01009901,459,631,43,48,1181
E01009902,412,608,41,30,1091
E01009903,490,644,63,12,1209
E01009904,525,551,81,32,1189
E01009905,450,432,151,149,1182
E01009906,345,250,218,535,1348
E01009907,521,383,194,81,1179
E01009908,632,464,175,40,1311
E01009909,447,441,83,177,1148
E01009910,400,387,84,415,1286
E01009911,504,573,97,8,1182
E01009912,734,506,56,60,1356
E01009913,538,473,80,175,1266
E01009914,467,695,35,6,1203
E01009915,660,511,166,23,1360
E01009916,597,415,178,201,1391
E01009917,479,470,35,37,1021
E01009918,368,268,69,441,1146
E01009919,434,564,37,16,1051
E01009920,595,395,136,29,1155
E01009921,470,294,497,45,1306
E01009922,420,263,87,241,1011
E01009923,490,453,112,136,1191
E01009924,466,366,263,23,1118
E01009925,537,387,158,22,1104
E01009926,462,326,299,53,1140
E01009927,410,319,534,29,1292
E01009928,431,252,417,258,1358
E01009929,408,267,131,521,1327
E01009930,448,265,106,371,1190
E01009931,948,563,224,86,1821
E01009932,399,217,270,469,1355
E01009933,466,268,79,320,1133
E01009934,352,228,99,420,1099
E01009935,357,290,136,756,1539
E01009936,558,626,87,89,1360
E01009937,485,188,86,418,1177
E01009938,493,329,129,404,1355
E01009939,594,516,142,132,1384
E01009940,389,304,129,367,1189
E01009941,467,411,127,191,1196
E01009942,494,317,145,356,1312
E01009943,367,272,84,356,1079
E01009944,437,228,124,373,1162
E01009946,543,615,125,54,1337
E01009947,614,508,195,231,1548
E01009948,509,610,89,54,1262
E01009949,569,621,72,18,1280
E01009950,559,515,104,196,1374
E01009951,311,207,340,671,1529
E01009952,367,116,211,812,1506
E01009953,509,278,245,340,1372
E01009954,476,409,125,359,1369
E01009955,476,374,338,274,1462
E01009956,465,320,192,264,1241
E01009957,337,165,146,568,1216
E01009958,586,540,113,79,1318
E01009959,569,547,63,23,1202
E01009960,384,263,104,513,1264
E01009961,490,485,52,38,1065
E01009962,276,164,72,501,1013
E01009963,324,160,72,466,1022
E01009964,312,189,74,552,1127
E01009965,305,121,58,531,1015
E01009966,310,230,56,318,914
E01009967,554,450,154,271,1429
E01009968,500,570,127,64,1261
E01009969,603,187,231,436,1457
E01009970,423,393,110,268,1194
E01009971,413,226,109,476,1224
E01009972,672,656,133,54,1515
E01009973,1074,479,178,112,1843
E01009974,583,597,79,14,1273
E01009975,624,569,88,69,1350
E01009976,1066,422,371,103,1962
E01009977,619,206,252,299,1376
E01009978,508,401,121,395,1425
E01009979,188,197,134,756,1275
E01009980,694,309,303,379,1685
E01009981,405,373,176,435,1389
E01009982,369,220,104,452,1145
E01009983,363,213,65,497,1138
E01009985,386,326,160,465,1337
E01009986,269,385,299,111,1064
E01009987,204,168,138,408,918
E01009988,345,247,143,621,1356
E01009989,401,412,252,227,1292
E01009991,562,296,257,488,1603
E01009992,516,330,249,212,1307
E01009993,407,237,196,547,1387
E01009994,381,300,150,399,1230
E01009995,470,357,151,234,1212
E01009996,332,202,105,634,1273
E01009997,464,262,156,403,1285
E01009998,460,280,205,520,1465
E01009999,430,379,115,158,1082
E01010000,538,452,127,166,1283
E01010001,501,373,139,356,1369
E01010002,769,446,336,58,1609
E01010003,371,207,201,452,1231
E01010004,400,313,209,360,1282
E01010005,501,436,146,92,1175
E01010006,598,490,170,75,1333
E01010007,391,359,133,134,1017
E01010008,517,487,119,155,1278
E01010009,459,337,72,228,1096
E01010010,303,230,129,390,1052
E01010011,544,549,217,27,1337
E01010012,558,487,86,23,1154
E01010013,367,547,98,17,1029
E01010014,542,601,178,55,1376
E01010015,539,563,225,30,1357
E01010016,471,340,246,157,1214
E01010017,335,307,397,459,1498
E01010018,674,290,310,301,1575
E01010019,504,329,278,143,1254
E01010020,516,436,184,312,1448
E01010021,453,370,254,236,1313
E01010022,584,496,114,48,1242
E01010023,593,552,206,128,1479
E01010024,496,590,141,32,1259
E01010025,469,256,123,385,1233
E01010026,633,462,86,220,1401
E01010027,561,487,136,46,1230
E01010028,446,178,96,377,1097
E01010029,201,127,137,549,1014
E01010030,282,197,105,578,1162
E01010031,273,238,70,653,1234
E01010032,140,84,49,684,957
E01010033,295,236,157,570,1258
E01010034,736,340,49,25,1150
E01010035,449,662,65,14,1190
E01010036,490,180,124,397,1191
E01010037,195,133,58,411,797
E01010038,546,275,117,416,1354
E01010039,323,209,90,386,1008
E01010040,445,403,90,231,1169
E01010041,370,322,146,504,1342
E01010042,567,405,170,292,1434
E01010043,598,496,45,72,1211
E01010044,388,329,75,297,1089
E01010045,484,287,120,341,1232
E01010046,569,233,277,310,1389
E01010047,455,501,265,121,1342
E01010048,387,447,424,40,1298
E01010049,349,397,413,143,1302
E01010050,385,495,236,88,1204
E01010051,364,247,109,236,956
E01010052,335,226,198,249,1008
E01010053,320,237,256,495,1308
E01010054,283,224,271,639,1417
E01010055,490,321,413,69,1293
E01010056,363,311,135,416,1225
E01010057,462,443,334,200,1439
E01010058,376,299,131,472,1278
E01010059,414,322,415,229,1380
E01010060,374,483,392,231,1480
E01010061,432,327,411,128,1298
E01010062,226,222,136,618,1202
E01010063,164,64,126,1079,1433
E01010064,383,238,325,351,1297
E01010065,572,236,514,504,1826
E01010066,290,294,104,486,1174
E01010067,352,286,267,238,1143
E01010068,514,263,139,302,1218
E01010069,748,363,181,123,1415
E01010070,526,376,168,236,1306
E01010071,424,281,215,434,1354
E01010072,744,260,416,284,1704
E01010073,494,294,160,250,1198
E01010074,680,276,230,566,1752
E01010075,678,216,108,60,1062
E01010076,278,204,67,482,1031
E01010077,394,267,67,477,1205
E01010078,411,588,51,24,1074
E01010079,610,415,111,120,1256
E01010080,391,234,134,493,1252
E01010081,577,520,86,75,1258
E01010082,1016,406,177,180,1779
E01010083,515,300,116,388,1319
E01010084,283,223,147,448,1101
E01010085,547,398,169,117,1231
E01010086,438,262,146,490,1336
E01010087,466,339,139,365,1309
E01010088,491,240,121,353,1205
E01010089,521,329,134,434,1418
E01010090,363,231,250,422,1266
E01010091,512,303,133,300,1248
E01010092,557,387,164,395,1503
E01010093,284,112,114,370,880
E01010094,460,402,180,132,1174
E01010095,336,209,82,422,1049
E01010096,392,316,155,395,1258
E01010097,485,698,85,185,1453
E01010098,308,293,113,662,1376
E01010099,511,420,150,254,1335
E01010100,613,432,256,131,1432
E01010101,254,273,165,837,1529
E01010102,370,428,286,287,1371
E01010103,361,416,293,364,1434
E01010104,351,408,283,351,1393
E01010105,370,515,220,106,1211
E01010106,344,389,260,151,1144
E01010107,311,345,346,325,1327
E01010108,689,652,187,96,1624
E01010109,558,476,109,10,1153
E01010110,631,381,88,133,1233
E01010111,337,208,102,474,1121
E01010112,609,264,157,211,1241
E01010113,402,316,86,222,1026
E01010114,687,603,132,87,1509
E01010115,513,379,142,196,1230
E01010116,600,531,49,26,1206
E01010117,673,453,59,8,1193
E01010118,499,361,37,194,1091
E01010119,573,639,52,6,1270
E01010120,417,250,79,359,1105
E01010121,518,601,84,19,1222
E01010122,532,591,75,22,1220
E01010123,605,523,42,31,1201
E01010124,594,641,62,24,1321
E01010125,289,157,82,629,1157
E01010126,310,219,79,526,1134
E01010127,576,251,107,406,1340
E01010128,397,352,117,266,1132
E01010129,378,185,89,507,1159
E01010130,371,181,94,688,1334
E01010131,330,209,99,436,1074
E01010132,467,403,188,115,1173
E01010133,486,650,126,31,1293
E01010134,550,495,94,8,1147
E01010135,492,462,109,182,1245
E01010136,532,325,106,31,994
E01010137,376,243,104,390,1113
E01010138,591,458,107,3,1159
E01010139,353,283,43,140,819
E01010140,398,211,95,466,1170
E01010141,245,86,50,652,1033
E01010142,301,155,104,511,1071
E01010143,329,192,71,505,1097
E01010144,579,380,115,267,1341
E01010145,469,499,62,211,1241
E01010146,471,274,72,442,1259
E01010147,310,120,89,533,1052
E01010148,352,160,156,630,1298
E01010149,515,484,47,171,1217
E01010150,595,604,74,23,1296
E01010151,439,425,256,192,1312
E01010152,571,505,29,5,1110
E01010153,460,656,83,37,1236
E01010154,455,727,128,26,1336
E01010155,545,609,85,41,1280
E01010156,546,660,60,3,1269
E01010157,618,346,149,23,1136
E01010158,424,241,127,337,1129
E01010159,577,379,93,55,1104
E01010160,502,452,90,205,1249
E01010161,616,466,106,61,1249
E01010162,634,524,71,23,1252
E01010163,598,403,103,42,1146
E01010164,522,623,107,63,1315
E01010165,383,465,163,232,1243
E01010166,512,586,65,12,1175
E01010167,512,444,125,170,1251
E01010168,732,525,189,55,1501
E01010169,567,602,125,16,1310
E01010170,647,496,55,4,1202
E01010171,526,422,53,95,1096
E01010172,627,545,72,4,1248
E01010173,525,530,74,8,1137
E01010174,645,488,172,23,1328
E01010175,571,603,159,41,1374
E01010176,573,418,56,2,1049
E01010177,501,401,111,98,1111
E01010178,461,331,258,352,1402
E01010179,502,617,223,14,1356
E01010180,502,430,76,17,1025
E01010181,811,502,170,23,1506
E01010183,541,454,74,19,1088
E01010184,545,371,67,153,1136
E01010185,550,622,55,36,1263
E01010186,662,636,198,15,1511
E01010187,643,416,60,9,1128
E01010188,549,762,66,15,1392
E01010189,630,498,112,52,1292
E01010190,684,499,157,12,1352
E01010191,660,655,201,39,1555
E01010192,474,533,274,17,1298
E01010193,607,450,41,6,1104
E01010194,702,473,121,5,1301
E01010195,580,596,51,22,1249
E01010196,641,677,50,5,1373
E01010197,602,701,61,3,1367
E01010198,462,603,193,76,1334
E01010199,669,626,112,27,1434
E01010200,389,455,129,204,1177
E01010201,720,506,67,32,1325
E01010202,598,575,67,19,1259
E01010203,649,497,195,72,1413
E01010204,333,246,97,359,1035
E01010205,530,585,78,11,1204
E01010206,654,523,100,31,1308
E01010207,553,557,100,17,1227
E01010208,552,599,98,17,1266
E01010209,664,497,139,81,1381
E01010210,606,684,53,12,1355
E01010211,497,407,55,270,1229
E01010212,637,425,69,3,1134
E01010213,516,378,129,233,1256
E01010214,508,416,79,24,1027
E01010215,663,486,153,44,1346
E01010216,666,417,143,8,1234
E01010217,574,627,85,8,1294
E01010218,422,384,93,206,1105
E01010219,638,542,120,38,1338
E01010220,667,510,125,9,1311
E01010221,535,476,152,61,1224
E01010222,578,500,107,41,1226
E01010223,429,302,94,142,967
E01010225,669,405,82,4,1160
E01010226,340,630,302,79,1351
E01010227,707,671,166,53,1597
E01010228,643,478,135,61,1317
E01010229,545,584,56,13,1198
E01010230,533,447,214,208,1402
E01010231,587,692,108,5,1392
E01010232,636,397,336,220,1589
E01010233,583,365,213,300,1461
E01010234,299,175,34,398,906
E01010235,314,247,80,460,1101
E01010236,294,165,72,578,1109
E01010237,602,509,60,328,1499
E01010238,310,195,47,562,1114
E01010239,480,283,89,337,1189
E01010240,367,194,107,369,1037
E01010241,757,717,282,84,1840
E01010242,457,380,106,403,1346
E01010243,479,643,75,74,1271
E01010244,396,234,125,379,1134
E01010245,550,627,70,38,1285
E01010246,636,529,62,49,1276
E01010247,505,632,97,134,1368
E01010248,639,637,65,16,1357
E01010249,527,336,230,280,1373
E01010250,474,507,93,97,1171
E01010251,651,431,52,10,1144
E01010252,551,378,147,331,1407
E01010253,408,260,46,290,1004
E01010254,505,298,111,273,1187
E01010255,412,663,54,29,1158
E01010256,569,405,134,158,1266
E01010257,433,538,62,9,1042
E01010258,345,179,83,696,1303
E01010259,501,508,111,199,1319
E01010260,462,328,111,383,1284
E01010261,400,235,159,424,1218
E01010262,546,227,143,302,1218
E01010263,380,509,171,127,1187
E01010264,436,292,167,334,1229
E01010265,423,291,239,376,1329
E01010266,389,142,63,451,1045
E01010267,653,332,193,179,1357
E01010268,394,383,284,167,1228
E01010269,393,267,276,141,1077
E01010270,528,384,194,278,1384
E01010271,370,221,140,588,1319
E01010272,249,159,193,597,1198
E01010273,278,187,101,587,1153
E01010274,295,176,105,611,1187
E01010275,324,200,118,538,1180
E01010277,435,335,156,309,1235
E01010279,399,220,158,471,1248
E01010282,325,240,157,259,981
E01010283,400,184,283,506,1373
E01010284,427,329,83,399,1238
E01010285,515,625,122,171,1433
E01010286,380,220,76,579,1255
E01010287,357,293,174,315,1139
E01010288,396,189,151,483,1219
E01010289,296,207,122,610,1235
E01010290,396,518,87,405,1406
E01010291,346,233,114,381,1074
E01010292,275,255,156,629,1315
E01010293,385,363,98,425,1271
E01010294,355,222,133,485,1195
E01010295,337,258,150,422,1167
E01010296,694,335,121,34,1184
E01010297,591,575,41,22,1229
E01010298,424,267,80,192,963
E01010299,460,207,140,377,1184
E01010300,320,285,117,456,1178
E01010301,339,265,96,481,1181
E01010302,433,381,88,325,1227
E01010303,508,485,121,118,1232
E01010304,569,602,116,142,1429
E01010305,364,315,85,317,1081
E01010306,770,444,233,103,1550
E01010307,897,285,81,85,1348
E01010308,317,205,99,412,1033
E01010309,479,338,241,336,1394
E01010310,430,331,137,402,1300
E01010311,382,313,134,463,1292
E01010312,459,266,152,452,1329
E01010313,353,262,107,400,1122
E01010314,367,276,116,502,1261
E01010315,319,246,101,373,1039
E01010316,348,154,112,613,1227
E01010317,515,741,110,15,1381
E01010318,274,204,240,543,1261
E01010319,679,391,61,24,1155
E01010320,456,305,65,281,1107
E01010321,553,330,102,278,1263
E01010322,534,369,109,233,1245
E01010323,429,428,102,246,1205
E01010324,559,336,181,158,1234
E01010325,535,489,200,101,1325
E01010326,602,567,142,17,1328
E01010327,469,330,300,79,1178
E01010328,567,591,54,2,1214
E01010329,581,688,61,13,1343
E01010330,411,372,300,73,1156
E01010331,490,833,78,3,1404
E01010332,637,754,106,12,1509
E01010333,552,650,87,69,1358
E01010334,559,668,60,4,1291
E01010335,369,218,196,445,1228
E01010336,501,338,216,162,1217
E01010337,435,422,109,159,1125
E01010338,553,338,190,223,1304
E01010339,593,368,136,82,1179
E01010340,261,334,252,399,1246
E01010341,380,436,196,171,1183
E01010342,332,277,376,137,1122
E01010343,288,351,219,224,1082
E01010344,390,250,243,316,1199
E01010345,374,467,47,61,949
E01010346,605,449,44,10,1108
E01010347,341,280,77,491,1189
E01010348,475,378,125,174,1152
E01010349,370,380,116,215,1081
E01010350,652,318,80,103,1153
E01010351,559,596,110,163,1428
E01010352,537,703,71,50,1361
E01010353,455,468,89,226,1238
E01010354,473,500,95,217,1285
E01010355,515,577,50,74,1216
E01010356,580,613,67,13,1273
E01010357,796,622,63,58,1539
E01010358,561,499,100,59,1219
E01010359,652,465,106,25,1248
E01010360,575,549,108,11,1243
E01010361,490,429,195,36,1150
E01010362,410,333,197,345,1285
E01010363,357,243,413,392,1405
E01010364,279,310,217,278,1084
E01010365,222,268,160,456,1106
E01010366,316,300,277,428,1321
E01010367,392,393,268,233,1286
E01010368,151,188,510,690,1539
E01010369,362,249,269,614,1494
E01010370,280,233,292,608,1413
E01010371,274,246,388,790,1698
E01010372,380,298,268,292,1238
E01010373,493,473,114,96,1176
E01010374,345,265,244,381,1235
E01010375,472,263,394,365,1494
E01010376,529,532,79,15,1155
E01010377,501,406,107,206,1220
E01010378,460,436,74,48,1018
E01010379,450,575,85,18,1128
E01010380,446,795,99,16,1356
E01010381,407,356,139,310,1212
E01010382,461,492,99,245,1297
E01010383,357,263,86,449,1155
E01010384,640,506,55,11,1212
E01010385,612,617,89,3,1321
E01010386,542,734,78,15,1369
E01010387,581,647,82,7,1317
E01010388,614,538,55,28,1235
E01010389,600,526,63,64,1253
E01010390,720,621,104,2,1447
E01010391,869,622,123,3,1617
E01010392,615,574,86,14,1289
E01010393,454,614,87,87,1242
E01010394,484,468,169,29,1150
E01010395,640,413,61,21,1135
E01010396,576,360,104,215,1255
E01010397,425,304,98,433,1260
E01010398,818,472,42,27,1359
E01010399,645,381,60,186,1272
E01010400,400,321,126,701,1548
E01010401,364,301,82,406,1153
E01010402,629,394,162,145,1330
E01010403,501,202,257,316,1276
E01010404,508,313,246,326,1393
E01010405,520,405,263,139,1327
E01010406,735,244,460,526,1965
E01010407,486,418,101,298,1303
E01010408,414,234,259,276,1183
E01010409,430,411,88,352,1281
E01010410,276,295,123,637,1331
E01010411,485,275,89,406,1255
E01010412,510,361,211,488,1570
E01010413,308,272,103,626,1309
E01010414,348,230,207,787,1572
E01010415,348,234,137,500,1219
E01010416,248,308,250,491,1297
E01010417,347,283,100,595,1325
E01010418,602,492,112,44,1250
E01010419,381,309,110,328,1128
E01010420,300,355,94,267,1016
E01010421,297,227,79,619,1222
E01010422,447,556,152,202,1357
E01010423,318,258,133,506,1215
E01010424,575,551,138,35,1299
E01010425,349,407,120,210,1086
E01010426,377,415,200,138,1130
E01010427,494,544,233,27,1298
E01010428,168,317,480,164,1129
E01010429,290,388,195,116,989
E01010430,405,426,260,243,1334
E01010431,626,613,88,7,1334
E01010432,461,700,108,40,1309
E01010433,117,258,270,231,876
E01010434,554,433,195,169,1351
E01010435,241,217,159,406,1023
E01010436,579,600,44,47,1270
E01010437,604,368,50,21,1043
E01010438,372,562,110,147,1191
E01010439,346,275,68,375,1064
E01010440,328,227,101,596,1252
E01010441,319,273,73,422,1087
E01010442,303,296,146,267,1012
E01010443,271,161,127,654,1213
E01010444,357,465,100,209,1131
E01010445,239,154,100,510,1003
E01010446,437,422,172,313,1344
E01010447,421,331,221,511,1484
E01010448,417,262,134,444,1257
E01010449,598,431,325,424,1778
E01010450,299,277,150,587,1313
E01010451,530,369,205,154,1258
E01010452,348,251,127,501,1227
E01010453,343,298,218,542,1401
E01010454,321,288,210,423,1242
E01010455,303,247,206,670,1426
E01010456,123,61,50,730,964
E01010457,565,435,91,178,1269
E01010458,494,346,106,472,1418
E01010459,674,409,147,105,1335
E01010460,611,462,155,91,1319
E01010461,640,528,103,22,1293
E01010462,340,215,75,562,1192
E01010463,264,345,426,286,1321
E01010464,171,213,209,661,1254
E01010465,421,378,309,123,1231
E01010466,278,302,419,133,1132
E01010467,441,386,372,63,1262
E01010468,586,367,104,149,1206
E01010469,542,382,183,59,1166
E01010470,264,337,271,245,1117
E01010471,195,190,303,670,1358
E01010472,369,243,292,563,1467
E01010473,103,72,139,1513,1827
E01010474,454,290,116,348,1208
E01010475,570,388,196,162,1316
E01010476,320,215,260,650,1445
E01010477,418,294,262,332,1306
E01010478,162,178,376,291,1007
E01010479,437,346,167,286,1236
E01010480,479,227,119,121,946
E01010481,282,199,91,545,1117
E01010482,76,172,53,689,990
E01010483,93,70,68,765,996
E01010484,195,101,53,673,1022
E01010485,317,225,235,389,1166
E01010486,208,69,103,807,1187
E01010487,588,493,110,16,1207
E01010488,468,480,89,161,1198
E01010489,517,403,99,241,1260
E01010490,289,188,87,841,1405
E01010491,436,345,122,277,1180
E01010492,604,428,60,10,1102
E01010493,546,473,89,105,1213
E01010494,636,536,66,32,1270
E01010495,483,369,121,393,1366
E01010496,407,145,122,454,1128
E01010497,569,355,70,23,1017
E01010498,721,331,132,46,1230
E01010499,521,343,131,78,1073
E01010500,328,181,100,389,998
E01010501,462,296,100,285,1143
E01010502,504,428,124,30,1086
E01010503,380,200,181,311,1072
E01010504,351,582,98,24,1055
E01010505,418,522,112,13,1065
E01010506,376,267,644,138,1425
E01010507,467,635,113,11,1226
E01010508,222,150,496,311,1179
E01010509,386,367,140,341,1234
E01010510,389,359,523,74,1345
E01010511,286,309,454,226,1275
E01010512,406,307,354,82,1149
E01010513,445,642,93,56,1236
E01010514,657,477,153,8,1295
E01010515,562,591,152,23,1328
E01010516,569,506,83,8,1166
E01010517,565,434,100,184,1283
E01010518,585,599,84,60,1328
E01010519,522,459,172,62,1215
E01010520,573,666,140,10,1389
E01010521,273,107,760,477,1617
E01010522,386,172,251,446,1255
E01010523,405,379,357,123,1264
E01010524,334,177,188,456,1155
E01010525,305,221,301,210,1037
E01010526,261,238,349,224,1072
E01010527,207,252,324,683,1466
E01010528,51,107,300,427,885
E01010529,159,295,606,318,1378
E01010530,130,273,311,341,1055
E01010531,429,373,129,461,1392
E01010532,432,310,92,407,1241
E01010533,484,286,144,388,1302
E01010534,604,497,118,28,1247
E01010535,342,300,128,415,1185
E01010536,531,719,78,55,1383
E01010537,480,712,61,8,1261
E01010538,508,412,98,259,1277
E01010539,596,385,185,94,1260
E01010540,429,545,163,26,1163
E01010541,296,102,83,639,1120
E01010542,568,357,115,166,1206
E01010543,331,111,79,540,1061
E01010544,525,619,84,32,1260
E01010545,646,497,133,33,1309
E01010546,498,616,44,8,1166
E01010547,396,613,189,105,1303
E01010548,392,516,118,215,1241
E01010549,520,430,144,155,1249
E01010550,591,689,56,20,1356
E01010551,495,616,204,108,1423
E01010552,637,503,132,247,1519
E01010553,489,616,115,92,1312
E01010554,486,530,56,140,1212
E01010555,345,277,78,537,1237
E01010556,563,293,59,273,1188
E01010557,461,637,53,104,1255
E01010558,564,619,76,125,1384
E01010559,360,325,73,432,1190
E01010560,427,427,79,446,1379
E01010561,543,648,72,48,1311
E01010562,394,494,72,337,1297
E01010563,379,309,80,428,1196
E01010564,585,334,440,168,1527
E01010565,788,632,104,20,1544
E01010566,545,367,140,360,1412
E01010567,412,341,84,389,1226
E01010568,703,494,139,139,1475
E01010569,587,341,156,334,1418
E01010570,602,536,31,3,1172
E01010571,654,297,261,156,1368
E01010572,607,507,81,39,1234
E01010573,646,682,73,54,1455
E01010574,533,447,110,85,1175
E01010575,568,544,165,90,1367
E01010576,599,515,119,33,1266
E01010577,657,514,98,19,1288
E01010578,561,376,277,49,1263
E01010579,589,591,62,19,1261
E01010580,1085,682,141,11,1919
E01010581,623,426,195,71,1315
E01010582,615,342,336,31,1324
E01010583,458,333,135,391,1317
E01010584,444,230,477,327,1478
E01010585,535,493,371,207,1606
E01010586,578,625,126,15,1344
E01010587,798,465,192,67,1522
E01010588,690,481,111,73,1355
E01010589,598,516,135,13,1262
E01010590,676,542,205,44,1467
E01010591,520,319,144,250,1233
E01010592,441,496,118,183,1238
E01010593,641,482,128,107,1358
E01010594,709,454,119,99,1381
E01010595,648,333,256,191,1428
E01010596,616,512,79,3,1210
E01010597,550,295,166,148,1159
E01010598,688,580,145,8,1421
E01010599,547,322,166,8,1043
E01010600,510,389,162,6,1067
E01010601,747,368,224,9,1348
E01010602,571,435,187,8,1201
E01010603,692,450,123,38,1303
E01010604,723,585,167,25,1500
E01010605,551,203,149,291,1194
E01010606,228,305,356,422,1311
E01010607,454,389,311,202,1356
E01010608,360,345,248,212,1165
E01010609,457,337,237,178,1209
E01010610,177,42,148,780,1147
E01010611,537,363,339,392,1631
E01010612,212,85,135,530,962
E01010613,366,310,319,144,1139
E01010614,343,250,223,202,1018
E01010615,523,358,195,17,1093
E01010616,509,361,198,240,1308
E01010617,147,148,146,559,1000
E01010618,449,310,200,199,1158
E01010619,664,597,268,28,1557
E01010620,386,418,307,102,1213
E01010621,598,576,268,30,1472
E01010622,504,521,374,120,1519
E01010623,274,369,211,332,1186
E01010624,372,643,337,142,1494
E01010625,388,188,126,407,1109
E01010626,520,395,206,178,1299
E01010627,485,368,242,66,1161
E01010628,568,431,198,94,1291
E01010629,648,401,254,36,1339
E01010630,485,301,162,196,1144
E01010631,378,137,149,369,1033
E01010632,346,105,190,290,931
E01010633,564,447,199,52,1262
E01010634,610,449,103,22,1184
E01010635,379,153,141,441,1114
E01010636,696,467,204,42,1409
E01010637,513,298,206,25,1042
E01010638,493,595,112,63,1263
E01010639,607,496,290,68,1461
E01010640,604,380,389,14,1387
E01010641,523,532,76,98,1229
E01010642,690,685,99,25,1499
E01010643,499,360,273,11,1143
E01010644,566,379,186,92,1223
E01010645,500,494,72,6,1072
E01010646,428,541,103,40,1112
E01010647,365,320,69,144,898
E01010648,475,529,96,19,1119
E01010649,494,269,180,159,1102
E01010650,313,165,137,488,1103
E01010651,640,459,117,6,1222
E01010652,616,380,203,141,1340
E01010653,415,188,208,380,1191
E01010654,285,184,130,446,1045
E01010655,415,166,133,291,1005
E01010656,624,457,95,50,1226
E01010657,616,349,265,13,1243
E01010658,510,388,366,115,1379
E01010659,391,283,168,429,1271
E01010662,521,405,126,18,1070
E01010663,370,321,401,122,1214
E01010664,547,409,142,69,1167
E01010665,522,405,231,74,1232
E01010666,300,158,341,318,1117
E01010667,488,299,289,85,1161
E01010668,517,474,82,13,1086
E01010669,663,447,228,10,1348
E01010670,538,375,225,8,1146
E01010671,634,403,132,35,1204
E01010672,558,340,138,9,1045
E01010673,528,449,239,21,1237
E01010674,485,168,177,239,1069
E01010675,686,461,238,75,1460
E01010676,588,715,245,44,1592
E01010677,575,178,215,363,1331
E01010678,476,409,128,86,1099
E01010679,254,501,251,205,1211
E01010680,441,104,184,711,1440
E01010681,602,453,69,6,1130
E01010682,488,159,172,372,1191
E01010683,691,352,250,55,1348
E01010684,655,407,111,81,1254
E01010685,659,462,188,69,1378
E01010686,612,532,153,56,1353
E01010687,951,367,116,24,1458
E01010688,911,314,227,34,1486
E01010689,755,339,251,46,1391
E01010690,863,367,167,145,1542
E01010691,470,659,89,11,1229
E01010692,610,649,189,38,1486
E01010693,469,610,56,14,1149
E01010694,442,662,103,12,1219
E01010695,421,455,376,94,1346
E01010696,507,603,95,5,1210
E01010697,458,604,110,23,1195
E01010698,657,447,283,99,1486
E01010699,537,413,142,297,1389
E01010700,365,413,237,37,1052
E01010701,315,332,239,78,964
E01010702,377,745,210,94,1426
E01010703,527,388,209,134,1258
E01010704,501,333,202,128,1164
E01010705,615,604,115,34,1368
E01010706,618,522,163,23,1326
E01010707,680,616,146,2,1444
E01010708,541,546,193,14,1294
E01010709,1190,701,156,22,2069
E01010710,308,313,632,332,1585
E01010711,178,158,291,555,1182
E01010712,496,287,261,52,1096
E01010713,381,266,166,244,1057
E01010714,489,318,206,79,1092
E01010715,371,250,72,192,885
E01010716,625,365,307,194,1491
E01010717,541,328,183,171,1223
E01010718,519,176,121,409,1225
E01010719,440,447,202,74,1163
E01010720,438,200,116,393,1147
E01010721,372,257,97,397,1123
E01010722,469,266,204,236,1175
E01010723,443,267,269,58,1037
E01010724,406,251,131,295,1083
E01010725,499,384,262,73,1218
E01010726,673,532,67,12,1284
E01010727,714,491,156,86,1447
E01010728,486,537,256,23,1302
E01010729,563,447,61,3,1074
E01010730,59,54,241,904,1258
E01010731,176,225,627,281,1309
E01010732,226,279,247,640,1392
E01010733,252,366,339,421,1378
E01010734,405,191,422,41,1059
E01010735,302,163,125,501,1091
E01010736,336,284,567,218,1405
E01010737,185,375,289,318,1167
E01010738,540,377,250,130,1297
E01010739,300,197,229,438,1164
E01010740,379,558,234,103,1274
E01010741,603,394,174,54,1225
E01010742,367,458,300,180,1305
E01010743,369,371,238,315,1293
E01010744,512,368,229,71,1180
E01010745,465,252,291,169,1177
E01010746,551,637,175,13,1376
E01010747,529,360,216,137,1242
E01010748,420,171,134,461,1186
E01010749,462,238,188,197,1085
E01010750,650,454,146,73,1323
E01010751,533,354,110,276,1273
E01010752,660,337,385,51,1433
E01010753,606,538,71,17,1232
E01010754,739,288,161,66,1254
E01010755,477,102,315,284,1178
E01010756,649,290,160,72,1171
E01010758,695,273,51,17,1036
E01010759,524,337,160,211,1232
E01010760,735,378,113,15,1241
E01010761,568,389,230,86,1273
E01010762,589,338,199,67,1193
E01010763,589,422,197,14,1222
E01010764,600,681,92,1,1374
E01010765,762,610,261,264,1897
E01010766,522,451,84,4,1061
E01010767,445,435,75,187,1142
E01010768,679,501,86,7,1273
E01010769,573,383,212,82,1250
E01010770,605,621,59,4,1289
E01010771,455,475,54,15,999
E01010772,436,541,35,25,1037
E01010773,498,513,93,39,1143
E01010774,509,574,164,86,1333
E01010775,853,505,94,9,1461
E01010776,597,309,100,277,1283
E01010777,327,197,150,489,1163
E01010778,581,292,263,279,1415
E01010779,476,287,144,236,1143
E01010781,536,234,191,158,1119
E01010782,426,163,443,406,1438
E01010783,593,391,161,114,1259
E01010784,528,308,298,184,1318
E01010785,489,343,406,81,1319
E01010786,576,455,84,21,1136
E01010787,604,532,126,58,1320
E01010788,491,395,224,31,1141
E01010789,560,458,269,76,1363
E01010790,533,567,79,6,1185
E01010791,637,430,164,17,1248
E01010792,559,443,256,94,1352
E01010793,607,404,283,64,1358
E01010794,598,496,190,155,1439
E01010795,761,419,211,48,1439
E01010796,525,311,173,273,1282
E01010797,661,370,98,7,1136
E01010798,598,327,233,75,1233
E01010799,486,344,202,158,1190
E01010800,314,133,125,622,1194
E01010801,731,337,203,44,1315
E01010802,450,216,143,363,1172
E01010803,467,474,283,34,1258
E01010804,800,673,214,12,1699
E01010805,581,352,176,20,1129
E01010806,518,338,188,93,1137
E01010807,489,435,417,249,1590
E01010808,664,487,275,30,1456
E01010809,655,679,233,11,1578
E01010810,583,442,251,47,1323
E01010811,623,373,385,27,1408
E01010812,399,344,455,164,1362
E01010813,418,339,202,219,1178
E01010814,532,298,327,187,1344
E01010815,758,336,364,263,1721
E01010816,802,461,168,36,1467
E01010817,604,120,265,580,1569
E01010818,748,447,182,43,1420
E01010819,223,104,117,663,1107
E01010820,225,83,126,641,1075
E01010821,473,119,153,669,1414
E01010822,295,145,155,392,987
E01010824,203,241,278,555,1277
E01010825,544,321,156,27,1048
E01010826,359,91,109,455,1014
E01010827,465,365,153,21,1004
E01010828,484,290,313,202,1289
E01010829,424,335,307,117,1183
E01010830,480,311,394,81,1266
E01010831,433,417,335,117,1302
E01010832,524,382,157,71,1134
E01010833,219,318,384,291,1212
E01010834,163,296,970,71,1500
E01010835,563,1010,647,16,2236
E01010836,217,531,611,31,1390
E01010837,568,688,256,21,1533
E01010838,317,521,391,41,1270
E01010839,320,352,423,65,1160
E01010840,333,430,187,214,1164
E01010841,306,554,145,261,1266
E01010842,327,384,217,385,1313
E01010843,434,469,193,273,1369
E01010845,557,156,216,560,1489
E01010846,836,390,252,174,1652
E01010847,600,397,200,20,1217
E01010848,638,373,181,36,1228
E01010849,575,445,127,19,1166
E01010850,340,119,143,376,978
E01010851,697,370,173,31,1271
E01010852,534,420,192,41,1187
E01010853,523,367,135,13,1038
E01010854,696,399,274,59,1428
E01010855,627,503,228,77,1435
E01010856,547,360,352,25,1284
E01010857,565,644,143,26,1378
E01010858,598,469,183,35,1285
E01010859,705,593,75,14,1387
E01010860,633,474,172,19,1298
E01010861,697,618,145,17,1477
E01010862,756,356,177,67,1356
E01010863,667,447,103,2,1219
E01010864,495,155,108,209,967
E01010865,689,403,178,50,1320
E01010866,593,320,176,8,1097
E01010867,515,221,159,186,1081
E01010868,481,222,191,362,1256
E01010869,595,383,245,146,1369
E01010870,613,444,123,105,1285
E01010871,659,365,290,55,1369
E01010872,386,280,136,417,1219
E01010873,472,437,77,50,1036
E01010874,351,108,125,307,891
E01010875,614,680,119,27,1440
E01010876,656,552,101,21,1330
E01010877,464,450,305,67,1286
E01010878,533,336,440,153,1462
E01010879,623,588,183,158,1552
E01010880,308,164,126,590,1188
E01010881,494,495,133,183,1305
E01010882,518,390,83,163,1154
E01010883,586,537,100,14,1237
E01010884,535,435,143,215,1328
E01010885,503,428,189,41,1161
E01010886,375,286,139,122,922
E01010887,531,562,203,27,1323
E01010888,500,399,312,69,1280
E01010889,302,225,245,649,1421
E01010890,535,271,442,218,1466
E01010891,494,288,172,435,1389
E01010892,817,433,118,98,1466
E01010893,510,350,159,114,1133
E01010894,478,349,378,61,1266
E01010895,417,367,86,288,1158
E01010896,664,484,137,27,1312
E01010897,636,492,173,83,1384
E01010898,649,326,289,87,1351
E01010899,502,391,113,107,1113
E01010900,668,549,73,11,1301
E01010901,554,597,171,45,1367
E01010902,541,189,172,288,1190
E01010903,624,449,94,165,1332
E01010904,604,457,96,3,1160
E01010905,740,533,146,26,1445
E01010906,462,588,77,31,1158
E01010907,527,494,141,11,1173
E01010908,790,516,327,77,1710
E01010909,501,395,190,132,1218
E01010910,409,243,85,293,1030
E01010911,736,530,113,17,1396
E01010912,451,306,107,332,1196
E01010913,513,538,44,19,1114
E01010914,600,325,212,277,1414
E01010915,621,279,130,106,1136
E01010916,397,248,123,311,1079
E01010917,567,674,245,31,1517
E01010918,609,558,130,65,1362
E01010919,449,357,156,346,1308
E01010920,578,553,206,41,1378
E01010921,489,372,187,240,1288
E01010922,755,449,263,50,1517
E01010923,495,356,297,138,1286
E01010924,178,112,83,603,976
E01010925,412,221,146,309,1088
E01010926,183,87,124,413,807
E01010927,611,601,115,32,1359
E01010928,314,172,110,479,1075
E01010929,773,322,463,93,1651
E01010930,430,293,262,229,1214
E01010931,584,377,86,134,1181
E01010932,629,546,141,2,1318
E01010933,566,531,183,40,1320
E01010934,671,592,302,74,1639
E01010935,544,639,133,6,1322
E01010936,822,551,100,80,1553
E01010937,590,487,143,52,1272
E01010938,317,158,120,449,1044
E01010939,803,473,114,21,1411
E01010940,541,322,155,145,1163
E01010941,397,215,79,331,1022
E01010942,482,239,279,280,1280
E01010943,274,136,125,580,1115
E01010944,338,147,139,407,1031
E01010945,615,453,117,117,1302
E01010946,497,573,50,37,1157
E01010947,593,515,104,9,1221
E01010948,493,391,91,188,1163
E01010949,506,376,309,74,1265
E01010950,467,259,256,188,1170
E01010951,579,344,186,48,1157
E01010952,532,459,177,120,1288
E01010953,527,432,146,54,1159
E01010954,997,533,229,49,1808
E01010955,546,400,130,67,1143
E01010956,561,465,180,103,1309
E01010957,609,495,128,16,1248
E01010958,372,194,88,527,1181
E01010959,565,380,158,288,1391
E01010960,309,371,304,102,1086
E01010961,437,205,217,47,906
E01010964,210,251,258,434,1153
E01010965,215,372,152,359,1098
E01010966,267,396,205,282,1150
E01010967,288,171,300,452,1211
E01010968,620,499,289,22,1430
E01010969,625,460,261,32,1378
E01010970,607,557,317,50,1531
E01010971,689,570,226,12,1497
E01010972,528,510,197,50,1285
E01010973,569,532,133,162,1396
E01010974,395,361,218,205,1179
E01010975,428,529,106,265,1328
E01010976,700,581,132,89,1502
E01010977,619,541,113,13,1286
E01010978,486,264,158,137,1045
E01010979,316,191,396,396,1299
E01010980,536,258,266,121,1181
E01010981,478,267,377,76,1198
E01010982,471,435,167,35,1108
E01010983,397,420,368,97,1282
E01010984,416,341,251,25,1033
E01010985,487,317,186,173,1163
E01010986,530,357,235,204,1326
E01010987,581,441,227,126,1375
E01010988,420,305,84,385,1194
E01010989,448,385,314,131,1278
E01010990,606,439,144,132,1321
E01010991,596,478,152,54,1280
E01010992,605,359,279,92,1335
E01010993,504,331,217,266,1318
E01010994,190,152,719,398,1459
E01010995,249,367,236,96,948
E01010996,390,414,253,24,1081
E01010997,546,597,94,10,1247
E01010998,493,377,220,172,1262
E01010999,582,525,107,32,1246
E01011000,620,370,272,92,1354
E01011001,434,416,206,72,1128
E01011002,548,409,264,56,1277
E01011003,310,251,285,84,930
E01011004,292,186,98,540,1116
E01011005,520,606,106,45,1277
E01011006,530,410,177,131,1248
E01011007,460,310,437,51,1258
E01011008,488,308,421,15,1232
E01011009,400,434,145,119,1098
E01011010,417,232,216,323,1188
E01011011,537,626,123,38,1324
E01011012,536,304,319,171,1330
E01011013,487,628,93,9,1217
E01011014,374,364,285,152,1175
E01011015,185,447,174,359,1165
E01011016,409,462,242,100,1213
E01011017,310,641,111,182,1244
E01011018,301,488,130,145,1064
E01011019,360,826,126,38,1350
E01011020,204,297,138,292,931
E01011021,672,540,135,10,1357
E01011022,544,487,163,7,1201
E01011023,525,489,239,21,1274
E01011024,465,376,163,287,1291
E01011025,389,230,188,329,1136
E01011026,492,349,236,88,1165
E01011027,399,281,139,155,974
E01011028,513,239,218,174,1144
E01011029,175,210,119,600,1104
E01011030,420,166,153,347,1086
E01011031,625,572,141,30,1368
E01011032,377,245,150,342,1114
E01011033,638,445,206,41,1330
E01011034,389,466,110,177,1142
E01011035,422,480,103,166,1171
E01011036,478,226,142,324,1170
E01011037,715,411,335,69,1530
E01011038,246,186,231,501,1164
E01011039,515,663,216,63,1457
E01011040,551,383,462,26,1422
E01011041,465,313,324,58,1160
E01011042,641,463,165,10,1279
E01011043,601,462,669,109,1841
E01011044,543,411,197,14,1165
E01011045,324,420,448,244,1436
E01011046,477,573,50,1,1101
E01011047,496,677,138,11,1322
E01011048,476,305,308,320,1409
E01011049,604,343,166,196,1309
E01011050,616,516,75,49,1256
E01011051,678,439,139,38,1294
E01011052,588,307,119,282,1296
E01011053,596,490,106,38,1230
E01011054,512,545,83,22,1162
E01011055,505,388,118,17,1028
E01011056,629,509,130,43,1311
E01011057,481,386,186,76,1129
E01011058,435,332,96,109,972
E01011059,363,126,54,527,1070
E01011060,538,391,104,340,1373
E01011061,429,245,363,330,1367
E01011062,672,414,231,44,1361
E01011063,755,445,332,141,1673
E01011064,414,333,134,268,1149
E01011065,683,327,258,43,1311
E01011066,576,529,126,17,1248
E01011067,574,475,121,126,1296
E01011068,697,503,157,13,1370
E01011069,537,418,109,68,1132
E01011070,519,573,118,67,1277
E01011071,626,559,132,59,1376
E01011072,671,404,121,98,1294
E01011073,474,344,238,144,1200
E01011074,694,520,266,70,1550
E01011075,491,405,194,110,1200
E01011076,500,443,97,163,1203
E01011077,600,384,292,47,1323
E01011078,656,389,285,46,1376
E01011079,645,366,387,103,1501
E01011080,553,370,442,74,1439
E01011081,407,389,383,185,1364
E01011082,358,560,249,102,1269
E01011083,640,565,149,40,1394
E01011084,293,184,213,538,1228
E01011085,437,480,114,237,1268
E01011086,573,708,83,24,1388
E01011087,490,374,138,313,1315
E01011088,491,651,69,4,1215
E01011089,406,410,97,157,1070
E01011090,537,358,160,208,1263
E01011091,557,508,71,18,1154
E01011092,474,546,70,11,1101
E01011093,308,185,126,490,1109
E01011094,273,146,109,635,1163
E01011095,494,470,106,92,1162
E01011096,583,465,146,59,1253
E01011097,611,356,149,169,1285
E01011098,447,293,456,65,1261
E01011099,536,411,99,153,1199
E01011100,474,306,150,284,1214
E01011101,279,109,121,718,1227
E01011102,639,353,104,18,1114
E01011103,325,280,137,316,1058
E01011104,428,332,136,372,1268
E01011105,476,109,267,577,1429
E01011106,292,150,225,448,1115
E01011107,138,191,708,406,1443
E01011108,588,422,196,29,1235
E01011109,684,498,207,34,1423
E01011110,482,445,160,29,1116
E01011111,631,477,134,44,1286
E01011112,557,451,158,122,1288
E01011113,627,632,143,20,1422
E01011114,443,416,124,252,1235
E01011115,667,545,197,31,1440
E01011116,597,559,123,100,1379
E01011117,676,611,109,37,1433
E01011118,633,398,130,83,1244
E01011119,480,471,110,179,1240
E01011120,730,418,79,3,1230
E01011121,509,159,128,346,1142
E01011122,300,115,83,473,971
E01011123,477,365,233,176,1251
E01011124,839,281,184,209,1513
E01011125,516,384,99,241,1240
E01011126,386,360,172,379,1297
E01011127,544,473,108,17,1142
E01011128,344,447,499,199,1489
E01011129,515,290,84,166,1055
E01011130,359,212,453,528,1552
E01011132,520,570,60,11,1161
E01011133,404,248,149,176,977
E01011134,377,304,259,309,1249
E01011136,404,241,140,297,1082
E01011137,514,235,158,251,1158
E01011138,422,195,145,422,1184
E01011139,452,366,105,139,1062
E01011140,345,130,116,435,1026
E01011141,516,365,216,93,1190
E01011142,643,462,191,21,1317
E01011143,322,345,260,157,1084
E01011144,258,347,225,188,1018
E01011145,554,496,130,60,1240
E01011146,694,482,109,5,1290
E01011147,625,366,156,56,1203
E01011148,389,199,121,570,1279
E01011149,537,263,479,251,1530
E01011150,600,361,282,61,1304
E01011151,682,511,102,7,1302
E01011152,659,387,332,11,1389
E01011153,681,420,258,50,1409
E01011154,551,282,148,180,1161
E01011155,799,471,258,14,1542
E01011156,541,427,105,192,1265
E01011157,644,336,153,110,1243
E01011158,649,421,282,43,1395
E01011159,612,560,171,36,1379
E01011160,628,380,81,17,1106
E01011161,540,371,118,7,1036
E01011162,499,608,129,14,1250
E01011163,419,247,93,304,1063
E01011164,669,464,87,130,1350
E01011165,729,418,187,12,1346
E01011166,591,293,237,148,1269
E01011167,562,347,262,235,1406
E01011168,624,588,100,31,1343
E01011169,511,563,102,19,1195
E01011170,683,667,108,20,1478
E01011171,530,362,209,50,1151
E01011172,244,192,110,303,849
E01011173,504,432,77,23,1036
E01011174,748,587,89,15,1439
E01011175,402,295,125,278,1100
E01011176,494,456,129,77,1156
E01011177,625,546,178,44,1393
E01011178,591,396,284,258,1529
E01011179,600,639,192,23,1454
E01011180,726,570,202,57,1555
E01011181,644,524,268,32,1468
E01011182,597,558,177,65,1397
E01011183,795,567,196,16,1574
E01011184,394,380,78,280,1132
E01011185,556,500,93,116,1265
E01011186,548,580,152,17,1297
E01011187,608,520,158,96,1382
E01011188,543,537,118,155,1353
E01011189,583,640,87,13,1323
E01011190,570,608,197,3,1378
E01011191,567,557,100,73,1297
E01011192,455,382,156,272,1265
E01011193,711,544,111,153,1519
E01011194,517,597,48,6,1168
E01011195,360,406,90,31,887
E01011196,722,591,121,27,1461
E01011197,527,410,155,161,1253
E01011198,567,553,126,25,1271
E01011199,530,488,107,68,1193
E01011200,1022,419,349,27,1817
E01011201,428,443,350,192,1413
E01011202,502,487,130,168,1287
E01011203,695,561,135,60,1451
E01011204,463,582,98,11,1154
E01011205,650,510,177,8,1345
E01011206,545,359,272,194,1370
E01011207,543,541,91,21,1196
E01011208,432,342,414,94,1282
E01011209,569,613,86,7,1275
E01011210,705,503,295,38,1541
E01011211,577,625,83,40,1325
E01011212,481,317,169,380,1347
E01011213,567,631,81,28,1307
E01011214,556,416,186,96,1254
E01011215,613,493,442,121,1669
E01011216,534,491,78,22,1125
E01011217,528,660,114,85,1387
E01011218,525,475,164,168,1332
E01011219,620,516,122,64,1322
E01011220,519,255,165,424,1363
E01011221,675,583,142,25,1425
E01011222,512,390,338,309,1549
E01011223,361,247,276,444,1328
E01011224,385,275,268,401,1329
E01011225,358,251,527,299,1435
E01011226,566,561,109,58,1294
E01011227,361,220,157,615,1353
E01011228,525,496,126,115,1262
E01011229,211,191,679,429,1510
E01011230,416,450,413,110,1389
E01011231,446,422,392,35,1295
E01011232,330,399,347,230,1306
E01011233,646,389,173,32,1240
E01011234,458,248,153,334,1193
E01011235,205,337,715,325,1582
E01011236,210,233,836,170,1449
E01011237,455,325,341,103,1224
E01011238,358,411,454,127,1350
E01011239,456,439,316,105,1316
E01011240,510,407,307,147,1371
E01011241,677,448,134,40,1299
E01011242,533,299,109,340,1281
E01011243,665,533,156,40,1394
E01011244,868,399,207,115,1589
E01011245,507,376,194,168,1245
E01011246,393,185,118,437,1133
E01011247,680,396,155,34,1265
E01011248,517,263,171,283,1234
E01011249,483,307,113,322,1225
E01011250,541,207,325,282,1355
E01011251,390,146,165,533,1234
E01011252,422,475,89,24,1010
E01011253,330,200,79,384,993
E01011254,554,588,78,47,1267
E01011255,359,173,104,486,1122
E01011256,365,238,110,379,1092
E01011257,355,1109,148,14,1626
E01011258,365,895,156,18,1434
E01011259,364,320,188,370,1242
E01011260,420,252,133,187,992
E01011261,358,253,105,177,893
E01011262,327,344,130,297,1098
E01011263,585,403,151,109,1248
E01011264,390,444,57,193,1084
E01011265,498,391,298,100,1287
E01011266,865,498,197,114,1674
E01011267,401,345,109,336,1191
E01011268,384,167,99,435,1085
E01011269,489,339,177,284,1289
E01011270,560,699,47,7,1313
E01011271,834,672,141,67,1714
E01011272,600,484,82,21,1187
E01011273,549,394,178,98,1219
E01011274,295,141,165,539,1140
E01011275,462,375,115,153,1105
E01011276,533,385,156,46,1120
E01011277,696,301,126,39,1162
E01011278,610,527,169,24,1330
E01011279,484,355,102,117,1058
E01011280,720,516,131,35,1402
E01011281,499,279,350,338,1466
E01011282,436,171,187,289,1083
E01011283,244,190,64,490,988
E01011284,306,146,747,238,1437
E01011286,529,303,110,95,1037
E01011287,507,299,126,154,1086
E01011292,205,194,328,609,1336
E01011293,357,217,359,393,1326
E01011294,209,113,166,299,787
E01011295,527,152,155,357,1191
E01011296,524,718,102,80,1424
E01011297,651,331,151,121,1254
E01011298,491,205,197,317,1210
E01011299,902,434,272,164,1772
E01011300,539,252,54,280,1125
E01011301,628,402,39,31,1100
E01011302,548,621,51,15,1235
E01011303,411,303,64,142,920
E01011304,556,260,123,317,1256
E01011305,692,380,104,46,1222
E01011306,637,409,47,16,1109
E01011307,528,335,87,234,1184
E01011308,546,434,83,156,1219
E01011309,467,530,121,122,1240
E01011310,553,470,158,160,1341
E01011311,460,422,78,23,983
E01011312,191,148,432,372,1143
E01011313,517,270,373,44,1204
E01011314,501,262,374,37,1174
E01011315,487,382,228,153,1250
E01011316,300,206,473,265,1244
E01011317,368,163,124,672,1327
E01011318,272,105,103,603,1083
E01011319,529,352,238,80,1199
E01011320,592,481,234,29,1336
E01011321,324,149,104,573,1150
E01011322,502,418,121,194,1235
E01011323,450,298,91,219,1058
E01011324,137,50,160,583,930
E01011325,548,237,121,267,1173
E01011326,326,153,89,472,1040
E01011327,400,185,169,340,1094
E01011328,479,229,110,368,1186
E01011329,695,413,117,44,1269
E01011330,411,328,81,195,1015
E01011331,469,240,197,132,1038
E01011332,336,179,81,374,970
E01011333,445,257,100,229,1031
E01011334,425,238,224,180,1067
E01011335,645,285,278,162,1370
E01011336,419,207,159,460,1245
E01011337,219,46,76,576,917
E01011338,54,19,80,1018,1171
E01011339,330,145,116,794,1385
E01011340,336,153,127,614,1230
E01011341,448,228,109,384,1169
E01011342,245,97,109,545,996
E01011343,618,304,145,331,1398
E01011344,323,158,563,279,1323
E01011345,305,140,135,515,1095
E01011346,330,130,83,816,1359
E01011347,274,148,460,352,1234
E01011348,271,122,180,552,1125
E01011349,275,204,149,811,1439
E01011350,627,443,246,37,1353
E01011351,563,403,461,96,1523
E01011352,430,215,751,162,1558
E01011353,792,415,312,33,1552
E01011354,236,121,90,614,1061
E01011355,342,146,123,453,1064
E01011356,589,434,389,215,1627
E01011357,248,140,201,842,1431
E01011358,298,234,129,491,1152
E01011359,401,320,378,271,1370
E01011360,337,488,332,298,1455
E01011361,322,241,333,944,1840
E01011362,451,170,359,514,1494
E01011363,276,115,133,667,1191
E01011364,280,103,376,521,1280
E01011366,214,166,388,463,1231
E01011368,162,86,356,385,989
E01011369,433,379,248,212,1272
E01011370,452,255,478,118,1303
E01011371,191,83,201,680,1155
E01011372,179,165,323,272,939
E01011373,194,93,277,447,1011
E01011374,335,181,388,60,964
E01011375,288,264,512,212,1276
E01011376,574,628,52,16,1270
E01011377,529,618,24,23,1194
E01011378,347,176,92,512,1127
E01011379,378,269,119,456,1222
E01011380,506,577,98,91,1272
E01011381,524,464,70,11,1069
E01011382,539,556,85,35,1215
E01011383,455,478,188,197,1318
E01011384,544,398,87,198,1227
E01011385,426,447,73,64,1010
E01011386,502,507,139,24,1172
E01011388,483,382,93,204,1162
E01011390,491,327,98,250,1166
E01011391,446,552,87,299,1384
E01011392,429,513,59,221,1222
E01011393,690,363,116,141,1310
E01011394,449,382,62,65,958
E01011395,537,163,85,99,884
E01011396,625,370,374,121,1490
E01011397,597,464,73,89,1223
E01011398,585,378,66,5,1034
E01011399,518,433,139,102,1192
E01011400,464,389,124,186,1163
E01011401,585,528,70,6,1189
E01011402,546,693,128,146,1513
E01011403,403,531,91,88,1113
E01011404,578,423,38,15,1054
E01011405,494,627,46,57,1224
E01011406,550,491,107,17,1165
E01011407,518,436,112,106,1172
E01011408,464,689,119,30,1302
E01011409,538,407,226,6,1177
E01011410,509,529,65,13,1116
E01011411,676,440,140,32,1288
E01011412,510,571,76,13,1170
E01011413,666,473,86,9,1234
E01011414,618,489,118,11,1236
E01011415,631,474,184,30,1319
E01011416,555,428,104,108,1195
E01011417,527,528,127,118,1300
E01011418,675,407,104,6,1192
E01011419,514,485,32,16,1047
E01011420,417,679,47,16,1159
E01011421,427,196,171,364,1158
E01011422,265,254,390,138,1047
E01011423,342,238,106,466,1152
E01011424,353,226,122,348,1049
E01011425,665,401,118,65,1249
E01011426,273,300,281,265,1119
E01011427,289,204,186,485,1164
E01011428,396,305,504,123,1328
E01011429,293,271,374,479,1417
E01011430,269,345,303,118,1035
E01011431,245,106,171,778,1300
E01011432,295,244,388,130,1057
E01011433,228,165,542,166,1101
E01011434,214,119,475,192,1000
E01011435,43,76,1576,62,1757
E01011440,137,93,1185,178,1593
E01011441,177,160,1286,144,1767
E01011442,80,72,1293,117,1562
E01011443,78,76,1081,82,1317
E01011444,53,51,1533,134,1771
E01011445,54,72,1489,31,1646
E01011446,74,105,1256,63,1498
E01011447,59,103,968,139,1269
E01011448,46,66,1086,213,1411
E01011449,109,67,845,203,1224
E01011450,377,108,176,329,990
E01011451,188,138,421,115,862
E01011452,584,505,112,5,1206
E01011453,564,467,151,47,1229
E01011454,560,425,243,9,1237
E01011455,405,482,40,18,945
E01011456,593,573,164,61,1391
E01011457,541,429,152,51,1173
E01011458,539,477,66,18,1100
E01011459,460,520,296,58,1334
E01011460,480,267,243,161,1151
E01011461,552,630,46,10,1238
E01011462,498,284,161,394,1337
E01011463,465,241,106,506,1318
E01011464,561,371,455,71,1458
E01011465,441,332,271,264,1308
E01011466,462,272,88,367,1189
E01011467,303,104,340,339,1086
E01011468,262,139,114,687,1202
E01011469,585,418,100,109,1212
E01011470,456,266,111,217,1050
E01011471,279,219,107,498,1103
E01011472,292,141,91,675,1199
E01011473,242,44,76,674,1036
E01011474,252,93,116,625,1086
E01011475,312,152,118,568,1150
E01011476,306,123,100,364,893
E01011477,312,252,432,512,1508
E01011478,234,162,867,268,1531
E01011479,155,100,1071,97,1423
E01011480,479,506,343,48,1376
E01011481,129,148,773,306,1356
E01011482,423,227,736,125,1511
E01011483,134,115,635,419,1303
E01011484,234,106,100,721,1161
E01011485,423,233,169,413,1238
E01011488,304,181,508,269,1262
E01011489,358,161,465,485,1469
E01011490,1276,320,272,173,2041
E01011491,327,118,71,513,1029
E01011492,184,102,90,605,981
E01011493,349,154,114,531,1148
E01011494,353,138,136,357,984
E01011496,762,242,136,15,1155
E01011497,352,115,76,650,1193
E01011499,1181,207,213,356,1957
E01011500,617,470,92,132,1311
E01011502,455,213,80,304,1052
E01011504,305,147,95,584,1131
E01011505,525,469,144,164,1302
E01011506,581,369,150,9,1109
E01011507,685,477,116,24,1302
E01011508,573,360,123,15,1071
E01011509,470,488,141,42,1141
E01011510,239,180,122,753,1294
E01011511,481,347,170,77,1075
E01011512,538,406,299,53,1296
E01011513,855,415,284,155,1709
E01011514,607,464,214,38,1323
E01011515,497,369,325,19,1210
E01011516,753,484,115,15,1367
E01011517,615,344,156,209,1324
E01011518,931,353,295,166,1745
E01011519,483,307,85,300,1175
E01011520,586,475,129,50,1240
E01011521,814,515,228,85,1642
E01011522,554,490,99,24,1167
E01011523,664,377,179,162,1382
E01011524,529,370,94,32,1025
E01011525,659,375,183,44,1261
E01011526,629,324,62,10,1025
E01011527,656,676,143,11,1486
E01011528,770,320,105,54,1249
E01011529,479,287,91,236,1093
E01011530,553,406,216,42,1217
E01011531,479,702,70,24,1275
E01011532,551,170,140,373,1234
E01011533,444,271,246,146,1107
E01011534,503,370,238,60,1171
E01011535,661,546,107,23,1337
E01011536,692,487,64,59,1302
E01011537,655,651,238,171,1715
E01011538,519,256,149,271,1195
E01011540,458,212,84,362,1116
E01011541,463,220,422,404,1509
E01011545,557,273,231,75,1136
E01011546,593,344,239,156,1332
E01011547,630,231,223,347,1431
E01011548,527,482,128,63,1200
E01011549,847,268,68,10,1193
E01011550,627,366,109,17,1119
E01011551,707,244,126,143,1220
E01011552,391,221,86,410,1108
E01011553,666,376,89,53,1184
E01011554,498,522,141,16,1177
E01011555,519,491,89,45,1144
E01011556,477,354,365,77,1273
E01011557,554,525,117,65,1261
E01011558,354,171,151,536,1212
E01011559,249,157,100,450,956
E01011560,400,166,101,779,1446
E01011561,394,369,196,61,1020
E01011562,595,599,121,10,1325
E01011563,471,570,150,10,1201
E01011564,586,520,85,16,1207
E01011565,598,446,100,31,1175
E01011566,478,424,132,34,1068
E01011567,573,428,108,6,1115
E01011568,697,599,236,27,1559
E01011569,497,474,345,85,1401
E01011570,786,656,168,155,1765
E01011571,558,441,185,136,1320
E01011572,729,536,155,33,1453
E01011573,496,425,73,106,1100
E01011574,393,463,143,195,1194
E01011576,471,543,105,57,1176
E01011578,456,424,114,132,1126
E01011579,501,270,94,116,981
E01011580,496,484,86,63,1129
E01011581,502,480,64,159,1205
E01011582,455,260,97,487,1299
E01011583,488,512,74,121,1195
E01011584,454,447,70,50,1021
E01011585,491,296,124,240,1151
E01011586,523,498,143,33,1197
E01011587,758,356,229,51,1394
E01011588,695,370,138,120,1323
E01011589,599,341,211,90,1241
E01011590,600,511,86,40,1237
E01011591,714,332,305,58,1409
E01011592,521,366,196,140,1223
E01011593,762,509,197,8,1476
E01011594,491,193,82,374,1140
E01011595,674,614,128,17,1433
E01011596,711,430,222,19,1382
E01011597,539,395,179,36,1149
E01011598,657,344,222,61,1284
E01011599,607,357,166,106,1236
E01011600,630,392,125,102,1249
E01011601,535,199,160,266,1160
E01011602,481,364,199,207,1251
E01011603,530,423,203,67,1223
E01011604,528,277,176,86,1067
E01011605,591,519,78,38,1226
E01011606,586,488,174,32,1280
E01011607,615,325,147,159,1246
E01011608,440,252,87,322,1101
E01011609,426,242,77,400,1145
E01011610,591,389,129,55,1164
E01011611,366,164,65,472,1067
E01011612,339,237,199,295,1070
E01011613,448,249,105,202,1004
E01011614,755,447,219,75,1496
E01011615,598,369,196,36,1199
E01011616,264,232,63,590,1149
E01011617,420,210,117,466,1213
E01011618,483,241,338,156,1218
E01011620,236,216,37,448,937
E01011621,327,183,86,505,1101
E01011622,206,98,74,805,1183
E01011623,235,135,336,418,1124
E01011624,196,91,149,836,1272
E01011625,355,203,373,212,1143
E01011626,239,72,456,698,1465
E01011627,402,349,83,282,1116
E01011628,505,538,52,29,1124
E01011629,421,325,98,234,1078
E01011630,955,446,206,56,1663
E01011632,343,144,86,467,1040
E01011633,520,395,142,137,1194
E01011634,456,398,104,260,1218
E01011635,526,426,238,97,1287
E01011636,556,523,183,92,1354
E01011637,761,377,120,142,1400
E01011638,582,450,73,77,1182
E01011639,447,298,96,359,1200
E01011641,567,461,125,36,1189
E01011642,566,333,98,17,1014
E01011643,335,525,204,24,1088
E01011644,330,268,99,276,973
E01011645,504,320,264,52,1140
E01011646,573,443,197,56,1269
E01011647,488,436,256,61,1241
E01011648,626,469,188,8,1291
E01011649,555,594,71,8,1228
E01011650,512,479,114,57,1162
E01011651,466,292,186,196,1140
E01011652,531,324,130,62,1047
E01011653,372,322,405,18,1117
E01011654,571,456,56,10,1093
E01011655,356,495,259,45,1155
E01011656,379,132,87,490,1088
E01011657,293,121,73,549,1036
E01011658,121,95,77,711,1004
E01011659,310,142,71,583,1106
E01011660,329,142,63,479,1013
E01011661,259,141,86,824,1310
E01011662,137,44,55,614,850
E01011663,159,65,67,523,814
E01011664,263,166,52,385,866
E01011665,467,267,70,326,1130
E01011666,645,441,84,48,1218
E01011667,127,36,69,694,926
E01011668,101,72,1140,208,1521
E01011669,145,79,744,162,1130
E01011670,128,128,603,746,1605
E01011671,183,96,259,618,1156
E01011673,112,101,655,405,1273
E01011677,143,133,365,581,1222
E01011678,78,55,888,284,1305
E01011681,104,125,659,437,1325
E01011684,568,434,121,136,1259
E01011685,502,434,485,66,1487
E01011686,325,206,76,675,1282
E01011687,538,461,148,57,1204
E01011688,547,273,185,181,1186
E01011689,463,464,179,212,1318
E01011690,324,404,461,22,1211
E01011691,275,159,318,443,1195
E01011692,442,342,361,60,1205
E01011693,429,193,713,63,1398
E01011694,361,312,876,33,1582
E01011695,344,150,108,571,1173
E01011696,527,575,48,90,1240
E01011697,429,350,102,153,1034
E01011698,503,549,84,101,1237
E01011699,527,496,85,19,1127
E01011700,377,425,80,65,947
E01011701,463,462,63,54,1042
E01011702,443,495,35,15,988
E01011703,430,635,37,8,1110
E01011704,402,440,357,335,1534
E01011705,406,268,86,341,1101
E01011706,524,551,96,34,1205
E01011707,448,472,73,136,1129
E01011708,525,515,94,81,1215
E01011709,484,575,91,105,1255
E01011710,547,410,121,73,1151
E01011711,402,510,133,121,1166
E01011712,477,356,175,133,1141
E01011713,701,584,105,74,1464
E01011714,663,367,70,110,1210
E01011715,476,466,82,30,1054
E01011716,625,501,93,40,1259
E01011717,518,315,68,293,1194
E01011718,485,176,90,333,1084
E01011719,506,563,55,89,1213
E01011720,474,191,91,462,1218
E01011721,424,176,84,443,1127
E01011722,633,196,120,510,1459
E01011723,307,144,76,541,1068
E01011724,500,223,114,584,1421
E01011725,253,108,121,662,1144
E01011726,379,193,97,457,1126
E01011727,675,384,111,96,1266
E01011728,473,501,133,73,1180
E01011729,378,138,353,359,1228
E01011730,450,161,137,400,1148
E01011731,589,458,53,81,1181
E01011732,781,427,172,97,1477
E01011733,582,465,113,90,1250
E01011734,1044,458,288,75,1865
E01011735,362,210,94,613,1279
E01011736,608,395,100,138,1241
E01011737,517,247,234,249,1247
E01011738,580,399,113,86,1178
E01011739,345,228,102,555,1230
E01011740,329,190,67,577,1163
E01011741,539,485,67,155,1246
E01011742,469,240,94,496,1299
E01011743,555,630,39,37,1261
E01011744,710,508,71,44,1333
E01011745,336,158,74,695,1263
E01011746,264,173,64,545,1046
E01011747,401,132,89,626,1248
E01011748,571,540,122,106,1339
E01011749,843,402,390,105,1740
E01011750,305,160,68,598,1131
E01011751,558,398,76,24,1056
E01011752,569,372,244,91,1276
E01011753,471,447,178,53,1149
E01011754,430,336,99,340,1205
E01011755,759,495,105,32,1391
E01011756,281,266,140,562,1249
E01011757,639,338,116,318,1411
E01011758,484,236,154,232,1106
E01011759,541,282,107,605,1535
E01011760,550,413,391,49,1403
E01011761,659,503,200,158,1520
E01011762,553,439,283,36,1311
E01011763,429,311,124,361,1225
E01011764,445,260,134,383,1222
E01011765,560,411,99,196,1266
E01011766,574,330,87,206,1197
E01011767,607,677,97,90,1471
E01011768,487,522,104,37,1150
E01011769,931,456,266,85,1738
E01011770,636,439,129,280,1484
E01011771,339,219,64,479,1101
E01011772,615,432,158,103,1308
E01011773,571,653,52,12,1288
E01011774,465,418,78,180,1141
E01011775,1297,451,201,275,2224
E01011776,467,306,96,327,1196
E01011777,468,420,102,136,1126
E01011778,535,419,124,163,1241
E01011779,458,385,73,301,1217
E01011780,340,171,76,866,1453
E01011781,527,269,166,408,1370
E01011782,547,450,97,144,1238
E01011783,391,394,252,59,1096
E01011784,571,451,135,295,1452
E01011785,500,328,166,214,1208
E01011786,524,363,174,190,1251
E01011787,615,548,191,86,1440
E01011788,642,608,97,93,1440
E01011789,313,241,121,289,964
E01011790,467,286,221,372,1346
E01011791,358,331,114,370,1173
E01011792,248,174,86,645,1153
E01011793,573,515,105,195,1388
E01011794,466,277,104,295,1142
E01011795,367,285,76,327,1055
E01011796,579,375,90,117,1161
E01011797,709,544,111,12,1376
E01011798,433,333,281,82,1129
E01011799,462,314,107,439,1322
E01011800,659,433,175,83,1350
E01011801,566,307,99,223,1195
E01011802,484,491,113,145,1233
E01011803,359,195,87,440,1081
E01011804,495,414,88,316,1313
E01011805,374,252,138,438,1202
E01011806,486,427,110,231,1254
E01011807,464,243,170,278,1155
E01011808,572,516,124,209,1421
E01011809,364,330,81,495,1270
E01011810,577,307,91,246,1221
E01011811,311,176,137,583,1207
E01011812,1223,580,189,39,2031
E01011813,503,161,81,482,1227
E01011814,487,206,132,540,1365
E01011815,406,361,137,348,1252
E01011816,323,193,74,525,1115
E01011817,437,221,57,339,1054
E01011818,470,400,75,168,1113
E01011819,573,359,303,81,1316
E01011820,639,307,129,110,1185
E01011821,446,368,50,249,1113
E01011822,471,371,190,110,1142
E01011823,489,372,136,147,1144
E01011824,413,136,122,463,1134
E01011825,737,339,235,100,1411
E01011826,536,467,74,87,1164
E01011827,388,514,50,69,1021
E01011828,490,387,238,50,1165
E01011829,556,416,129,60,1161
E01011830,352,365,129,259,1105
E01011831,578,298,170,360,1406
E01011832,420,343,107,285,1155
E01011833,502,508,107,134,1251
E01011834,566,203,154,230,1153
E01011835,527,621,105,15,1268
E01011836,629,246,121,120,1116
E01011837,471,290,107,315,1183
E01011838,511,165,368,635,1679
E01011839,547,502,74,172,1295
E01011840,449,242,100,451,1242
E01011841,466,425,159,239,1289
E01011842,242,183,62,644,1131
E01011843,517,344,118,272,1251
E01011844,1066,266,112,16,1460
E01011845,470,686,50,7,1213
E01011846,507,467,91,74,1139
E01011847,535,581,59,24,1199
E01011848,465,621,60,74,1220
E01011849,497,704,105,67,1373
E01011850,363,236,58,527,1184
E01011851,408,338,172,288,1206
E01011852,357,265,89,487,1198
E01011853,471,269,44,380,1164
E01011854,402,276,224,46,948
E01011855,628,375,140,136,1279
E01011856,485,457,197,30,1169
E01011857,557,700,83,60,1400
E01011858,615,318,122,191,1246
E01011859,358,294,136,408,1196
E01011860,516,482,104,157,1259
E01011861,750,428,212,190,1580
E01011862,449,201,140,329,1119
E01011863,324,140,88,516,1068
E01011864,381,222,101,579,1283
E01011865,433,327,82,525,1367
E01011866,497,348,71,320,1236
E01011867,551,239,110,411,1311
E01011868,588,283,181,405,1457
E01011869,330,220,452,162,1164
E01011870,432,591,80,129,1232
E01011871,557,374,173,157,1261
E01011872,492,267,100,352,1211
E01011873,808,358,111,12,1289
E01011874,643,513,110,74,1340
E01011875,482,227,134,312,1155
E01011876,391,318,137,295,1141
E01011877,611,392,104,14,1121
E01011878,689,433,125,58,1305
E01011879,603,415,153,24,1195
E01011880,648,441,107,34,1230
E01011881,494,421,162,142,1219
E01011882,525,547,71,148,1291
E01011883,535,289,100,253,1177
E01011884,833,443,480,71,1827
E01011885,550,522,48,53,1173
E01011886,557,534,85,70,1246
E01011887,495,403,75,23,996
E01011888,540,592,70,18,1220
E01011889,556,341,67,34,998
E01011890,493,361,63,108,1025
E01011891,434,371,75,379,1259
E01011892,669,234,144,367,1414
E01011893,607,405,115,7,1134
E01011894,629,401,80,27,1137
E01011895,654,305,71,172,1202
E01011896,430,410,111,200,1151
E01011897,353,267,128,442,1190
E01011898,386,216,417,189,1208
E01011899,269,173,61,594,1097
E01011900,355,193,95,624,1267
E01011901,135,136,55,819,1145
E01011902,389,517,177,119,1202
E01011903,348,444,55,221,1068
E01011904,143,133,42,660,978
E01011905,603,616,92,22,1333
E01011906,222,80,71,777,1150
E01011907,460,389,381,303,1533
E01011908,590,498,551,119,1758
E01011909,403,434,129,210,1176
E01011910,249,138,82,738,1207
E01011911,303,140,86,605,1134
E01011912,331,231,446,276,1284
E01011913,402,289,368,184,1243
E01011914,413,175,71,534,1193
E01011915,403,162,297,363,1225
E01011916,202,127,743,759,1831
E01011917,254,206,363,429,1252
E01011918,316,212,70,564,1162
E01011919,590,263,234,372,1459
E01011920,389,297,474,115,1275
E01011921,493,382,92,223,1190
E01011922,320,75,71,643,1109
E01011923,494,476,352,26,1348
E01011924,530,444,185,96,1255
E01011925,352,134,128,606,1220
E01011926,366,195,219,440,1220
E01011927,414,195,90,340,1039
E01011928,393,354,85,305,1137
E01011929,636,645,115,13,1409
E01011930,653,569,144,23,1389
E01011931,512,461,86,174,1233
E01011932,522,522,124,21,1189
E01011933,604,426,146,100,1276
E01011934,516,533,122,32,1203
E01011935,752,461,180,48,1441
E01011936,371,200,69,559,1199
E01011937,592,491,117,11,1211
E01011938,569,419,115,24,1127
E01011939,547,645,54,5,1251
E01011940,415,260,52,437,1164
E01011941,486,433,63,254,1236
E01011942,366,565,77,47,1055
E01011943,490,217,80,587,1374
E01011944,430,281,264,109,1084
E01011945,509,507,118,89,1223
E01011946,564,585,75,14,1238
E01011947,506,771,71,25,1373
E01011948,589,687,59,9,1344
E01011949,574,356,187,390,1507
E01011950,349,284,513,62,1208
E01011951,386,217,447,50,1100
E01011952,352,209,114,540,1215
E01011953,338,163,137,776,1414
E01011954,710,397,172,430,1709
E01011955,329,193,163,367,1052
E01011957,392,294,183,184,1053
E01011959,752,655,164,101,1672
E01011960,493,678,57,7,1235
E01011961,382,368,100,300,1150
E01011962,323,337,86,387,1133
E01011963,515,616,69,30,1230
E01011964,487,290,225,91,1093
E01011965,679,572,53,15,1319
E01011966,497,419,158,85,1159
E01011967,675,316,132,27,1150
E01011968,705,672,171,235,1783
E01011969,557,542,52,32,1183
E01011970,539,364,48,7,958
E01011971,756,247,52,9,1064
E01011973,169,156,469,230,1024
E01011974,223,156,754,322,1455
E01011975,462,291,315,23,1091
E01011976,283,151,280,108,822
E01011977,428,204,139,570,1341
E01011978,254,129,172,589,1144
E01011979,353,200,126,464,1143
E01011980,475,273,117,499,1364
E01011981,370,229,135,528,1262
E01011982,505,550,35,5,1095
E01011983,683,553,100,14,1350
E01011984,452,538,55,41,1086
E01011985,421,377,128,24,950
E01011986,474,405,78,92,1049
E01011987,530,349,212,41,1132
E01011988,633,338,102,429,1502
E01011989,462,232,121,639,1454
E01011990,662,426,134,166,1388
E01011991,567,450,203,307,1527
E01011992,348,175,218,501,1242
E01011993,404,207,178,635,1424
E01011994,226,124,88,695,1133
E01011995,493,604,81,7,1185
E01011996,531,470,140,69,1210
E01011997,862,612,73,92,1639
E01011998,546,444,92,133,1215
E01011999,426,258,713,209,1606
E01012000,158,80,202,682,1122
E01012001,418,232,294,598,1542
E01012002,589,356,122,79,1146
E01012003,604,613,93,4,1314
E01012005,1083,366,50,31,1530
E01012007,550,578,116,21,1265
E01012008,603,403,67,46,1119
E01012009,730,494,214,10,1448
E01012010,494,564,75,6,1139
E01012011,403,167,110,736,1416
E01012012,770,412,129,62,1373
E01012013,439,263,132,195,1029
E01012014,412,198,173,384,1167
E01012015,385,234,92,544,1255
E01012016,359,217,195,521,1292
E01012017,481,488,209,179,1357
E01012018,368,205,323,240,1136
E01012019,107,30,61,745,943
E01012020,458,195,116,398,1167
E01012021,261,132,118,492,1003
E01012022,687,434,114,42,1277
E01012023,367,807,74,14,1262
E01012024,546,602,122,9,1279
E01012025,519,507,57,7,1090
E01012026,666,394,142,55,1257
E01012027,436,175,193,530,1334
E01012030,693,319,82,111,1205
E01012031,527,201,107,473,1308
E01012032,925,260,64,82,1331
E01012033,303,115,81,544,1043
E01012034,624,165,68,321,1178
E01012035,410,202,126,383,1121
E01012036,180,240,745,81,1246
E01012037,251,211,596,143,1201
E01012038,273,239,603,54,1169
E01012039,118,183,917,100,1318
E01012040,200,197,667,87,1151
E01012041,120,72,176,532,900
E01012042,403,188,110,490,1191
E01012043,498,535,88,112,1233
E01012044,213,48,110,749,1120
E01012045,274,116,129,534,1053
E01012046,514,808,175,18,1515
E01012047,624,479,75,53,1231
E01012048,690,691,67,18,1466
E01012049,539,501,120,46,1206
E01012050,416,206,191,297,1110
E01012051,393,207,140,290,1030
E01012052,522,394,69,96,1081
E01012053,652,529,142,17,1340
E01012054,668,448,214,16,1346
E01012055,663,650,235,21,1569
E01012056,836,269,574,125,1804
E01012057,764,415,268,71,1518
E01012058,294,297,584,126,1301
E01012059,341,218,372,289,1220
E01012060,351,149,155,540,1195
E01012061,363,157,148,410,1078
E01012062,581,593,55,3,1232
E01012063,561,543,67,39,1210
E01012064,677,545,222,44,1488
E01012065,580,627,130,59,1396
E01012066,1039,382,89,19,1529
E01012067,574,689,71,62,1396
E01012068,161,104,1076,221,1562
E01012071,529,681,26,3,1239
E01012073,531,574,89,12,1206
E01012074,490,244,131,317,1182
E01012075,352,217,133,435,1137
E01012076,243,135,120,579,1077
E01012077,366,283,99,370,1118
E01012078,337,230,473,129,1169
E01012079,508,375,134,54,1071
E01012080,494,287,155,85,1021
E01012081,565,350,321,84,1320
E01012082,489,240,112,371,1212
E01012083,434,157,129,435,1155
E01012084,365,149,164,560,1238
E01012085,392,182,107,413,1094
E01012088,311,116,120,444,991
E01012089,293,156,128,567,1144
E01012090,225,105,113,763,1206
E01012091,270,153,114,644,1181
E01012092,128,222,595,342,1287
E01012093,303,236,784,129,1452
E01012094,464,480,777,284,2005
E01012095,534,470,67,15,1086
E01012096,384,403,283,171,1241
E01012097,360,460,44,133,997
E01012098,529,343,101,89,1062
E01012099,375,277,267,274,1193
E01012100,321,210,659,137,1327
E01012101,438,416,306,80,1240
E01012102,688,409,602,33,1732
E01012105,556,301,118,137,1112
E01012106,515,442,82,94,1133
E01012107,344,228,124,449,1145
E01012108,443,222,104,377,1146
E01012109,498,374,146,93,1111
E01012110,656,349,156,20,1181
E01012111,379,189,120,388,1076
E01012112,301,116,94,677,1188
E01012113,224,100,107,578,1009
E01012114,171,112,157,605,1045
E01012117,276,287,337,305,1205
E01012118,438,440,219,41,1138
E01012119,662,383,227,378,1650
E01012120,383,620,138,25,1166
E01012121,345,193,113,423,1074
E01012124,449,725,55,8,1237
E01012127,121,34,36,605,796
E01012128,226,94,85,497,902
E01012129,787,536,112,297,1732
E01012130,507,438,96,77,1118
E01012131,192,247,73,557,1069
E01012132,489,574,216,402,1681
E01012134,307,491,138,324,1260
E01012136,396,408,254,80,1138
E01012137,377,525,102,118,1122
E01012138,1279,617,129,36,2061
E01012139,762,803,72,6,1643
E01012140,425,419,178,84,1106
E01012141,417,458,60,11,946
E01012142,595,409,133,242,1379
E01012143,181,115,67,566,929
E01012144,538,451,100,90,1179
E01012145,530,340,162,185,1217
E01012146,445,552,57,24,1078
E01012147,655,603,50,43,1351
E01012148,335,174,94,547,1150
E01012149,439,506,48,34,1027
E01012150,439,237,150,412,1238
E01012151,563,605,85,24,1277
E01012152,601,632,93,23,1349
E01012154,421,594,96,12,1123
E01012155,397,365,134,373,1269
E01012156,622,751,76,20,1469
E01012157,452,542,221,147,1362
E01012158,462,632,60,50,1204
E01012159,335,311,483,255,1384
E01012160,489,370,92,198,1149
E01012161,428,384,255,46,1113
E01012162,554,326,233,33,1146
E01012163,923,646,149,39,1757
E01012164,519,463,274,99,1355
E01012165,587,254,211,671,1723
E01012167,607,364,91,115,1177
E01012168,671,291,109,461,1532
E01012170,197,154,79,558,988
E01012171,418,379,102,302,1201
E01012172,517,525,68,72,1182
E01012173,418,473,88,33,1012
E01012174,393,505,52,18,968
E01012175,263,169,91,567,1090
E01012176,518,614,103,6,1241
E01012177,707,379,106,7,1199
E01012178,566,477,91,34,1168
E01012179,587,496,91,10,1184
E01012180,920,344,97,11,1372
E01012181,579,353,178,216,1326
E01012182,538,584,74,0,1196
E01012183,652,515,84,7,1258
E01012184,546,358,191,72,1167
E01012185,555,322,150,149,1176
E01012186,640,583,141,24,1388
E01012187,625,397,100,10,1132
E01012188,551,403,54,2,1010
E01012189,568,573,67,8,1216
E01012190,728,439,74,11,1252
E01012191,465,568,88,210,1331
E01012192,543,464,158,168,1333
E01012193,508,224,196,246,1174
E01012194,511,278,238,123,1150
E01012195,237,97,148,674,1156
E01012196,626,325,136,247,1334
E01012197,643,334,396,142,1515
E01012198,343,166,164,466,1139
E01012199,550,603,64,16,1233
E01012200,644,665,273,100,1682
E01012201,660,677,102,1,1440
E01012202,467,414,179,90,1150
E01012203,875,380,109,37,1401
E01012204,450,656,47,33,1186
E01012205,539,474,94,98,1205
E01012206,470,426,95,264,1255
E01012207,740,552,117,131,1540
E01012208,740,585,45,13,1383
E01012209,654,493,101,151,1399
E01012210,650,615,77,6,1348
E01012211,821,563,88,10,1482
E01012212,655,514,91,24,1284
E01012213,422,626,85,124,1257
E01012214,593,326,168,169,1256
E01012215,337,161,142,293,933
E01012216,415,236,140,217,1008
E01012217,395,222,326,272,1215
E01012218,571,537,129,14,1251
E01012219,725,495,122,114,1456
E01012223,543,616,83,27,1269
E01012224,648,722,117,7,1494
E01012225,593,627,94,8,1322
E01012226,560,599,52,4,1215
E01012227,756,111,202,42,1111
E01012228,712,285,79,11,1087
E01012230,782,254,180,7,1223
E01012231,1077,197,124,8,1406
E01012232,779,217,78,2,1076
E01012233,630,456,72,18,1176
E01012234,899,275,92,2,1268
E01012235,418,444,79,2,943
E01012236,599,372,121,6,1098
E01012237,714,342,58,4,1118
E01012238,421,228,103,460,1212
E01012239,639,138,164,502,1443
E01012240,671,373,124,309,1477
E01012241,681,461,91,31,1264
E01012242,671,524,66,18,1279
E01012243,784,381,121,3,1289
E01012244,687,450,77,6,1220
E01012245,377,264,154,481,1276
E01012246,711,403,105,3,1222
E01012247,497,142,88,264,991
E01012248,439,283,110,339,1171
E01012249,523,201,127,367,1218
E01012250,328,211,82,491,1112
E01012251,478,288,279,193,1238
E01012252,226,86,130,649,1091
E01012253,478,242,107,171,998
E01012254,313,170,296,303,1082
E01012255,501,730,43,4,1278
E01012256,411,600,112,64,1187
E01012257,563,568,69,16,1216
E01012258,272,206,147,258,883
E01012259,670,479,238,65,1452
E01012260,550,530,277,72,1429
E01012261,615,397,220,13,1245
E01012262,451,166,484,335,1436
E01012264,843,340,447,253,1883
E01012266,263,111,259,1131,1764
E01012267,284,207,340,558,1389
E01012268,352,285,302,334,1273
E01012269,601,611,106,30,1348
E01012270,512,373,129,94,1108
E01012271,411,115,112,436,1074
E01012272,418,439,66,32,955
E01012273,391,165,123,509,1188
E01012274,486,142,114,288,1030
E01012275,501,281,161,285,1228
E01012276,477,290,148,472,1387
E01012277,606,339,155,202,1302
E01012278,445,218,111,220,994
E01012279,744,301,210,58,1313
E01012280,548,375,174,185,1282
E01012281,343,200,150,351,1044
E01012282,387,328,120,196,1031
E01012283,308,187,109,383,987
E01012284,258,217,127,596,1198
E01012285,356,428,105,260,1149
E01012286,230,121,417,365,1133
E01012287,283,80,700,468,1531
E01012288,296,190,416,230,1132
E01012289,454,286,159,90,989
E01012290,569,717,119,130,1535
E01012291,511,316,217,324,1368
E01012292,777,333,328,414,1852
E01012294,469,432,64,23,988
E01012295,498,255,69,136,958
E01012296,562,338,98,103,1101
E01012297,1325,602,100,93,2120
E01012298,539,582,63,1,1185
E01012299,429,401,394,13,1237
E01012300,386,384,133,383,1286
E01012301,579,463,84,5,1131
E01012302,543,369,70,4,986
E01012303,594,469,97,10,1170
E01012304,207,196,335,260,998
E01012305,350,205,373,84,1012
E01012306,490,408,191,59,1148
E01012307,506,417,409,156,1488
E01012309,954,339,131,56,1480
E01012310,772,537,114,181,1604
E01012311,420,268,89,463,1240
E01012312,252,143,70,546,1011
E01012313,386,297,102,329,1114
E01012314,362,156,111,424,1053
E01012315,645,551,107,13,1316
E01012316,863,635,420,107,2025
E01012317,485,467,130,60,1142
E01012318,592,177,314,637,1720
E01012319,966,500,356,287,2109
E01012323,670,367,173,20,1230
E01012324,541,453,139,11,1144
E01012325,549,415,127,124,1215
E01012326,369,213,71,254,907
E01012327,187,129,100,682,1098
E01012328,485,330,104,366,1285
E01012329,686,732,103,22,1543
E01012330,546,321,58,7,932
E01012331,502,354,108,33,997
E01012332,445,197,70,356,1068
E01012333,475,389,108,173,1145
E01012334,852,605,376,51,1884
E01012335,474,532,83,64,1153
E01012336,569,719,53,80,1421
E01012337,587,760,57,16,1420
E01012338,651,547,188,174,1560
E01012339,590,683,150,33,1456
E01012340,802,438,445,159,1844
E01012341,406,192,174,578,1350
E01012342,417,347,187,432,1383
E01012343,723,633,162,138,1656
E01012344,496,297,204,113,1110
E01012345,513,507,93,4,1117
E01012346,871,334,123,73,1401
E01012347,619,646,118,74,1457
E01012348,619,925,127,7,1678
E01012349,282,107,508,289,1186
E01012350,468,308,307,172,1255
E01012351,631,317,115,101,1164
E01012352,389,232,292,327,1240
E01012353,437,214,604,32,1287
E01012354,356,209,593,70,1228
E01012355,356,228,449,142,1175
E01012356,472,320,432,44,1268
E01012357,459,242,365,66,1132
E01012358,470,373,218,256,1317
E01012359,201,74,76,751,1102
E01012360,548,562,149,133,1392
E01012361,694,756,94,19,1563
E01012362,379,216,496,17,1108
E01012363,447,251,401,9,1108
E01012364,512,314,384,10,1220
E01012365,535,411,98,5,1049
E01012366,681,714,225,98,1718
E01012367,349,226,243,475,1293
E01012368,638,399,217,260,1514
E01012369,526,361,72,271,1230
E01012370,513,369,449,65,1396
E01012371,618,363,67,0,1048
E01012372,499,427,61,13,1000
E01012373,561,516,21,11,1109
E01012374,1281,636,199,14,2130
E01012375,783,467,35,12,1297
E01012376,1473,331,124,17,1945
E01012377,497,385,109,474,1465
E01012378,573,607,55,53,1288
E01012379,591,355,167,98,1211
E01012380,364,170,73,435,1042
E01012381,187,81,38,750,1056
E01012382,201,181,42,740,1164
E01012383,577,362,84,367,1390
E01012384,469,405,76,410,1360
E01012385,720,307,88,38,1153
E01012386,1140,254,48,3,1445
E01012387,444,442,40,12,938
E01012388,577,271,106,432,1386
E01012389,663,796,56,11,1526
E01012390,434,431,102,281,1248
E01012391,703,509,237,310,1759
E01012392,1172,501,139,27,1839
E01012393,793,731,143,12,1679
E01012394,433,364,105,304,1206
E01012395,531,658,42,9,1240
E01012396,348,217,107,442,1114
E01012397,339,171,74,546,1130
E01012398,430,328,60,168,986
E01012399,402,219,70,413,1104
E01012400,525,307,94,60,986
E01012401,713,743,100,39,1595
E01012402,400,263,103,444,1210
E01012403,317,204,88,579,1188
E01012404,559,337,64,140,1100
E01012405,779,550,120,174,1623
E01012406,459,270,85,451,1265
E01012407,321,185,92,689,1287
E01012408,271,136,111,903,1421
E01012409,439,289,90,300,1118
E01012410,550,439,64,28,1081
E01012411,445,529,91,64,1129
E01012412,435,279,175,247,1136
E01012413,374,285,146,351,1156
E01012414,482,466,77,14,1039
E01012415,582,512,52,4,1150
E01012416,670,518,105,163,1456
E01012417,541,282,158,56,1037
E01012418,489,664,52,7,1212
E01012419,321,142,43,378,884
E01012420,219,127,91,765,1202
E01012421,694,410,41,4,1149
E01012422,346,188,91,470,1095
E01012423,665,336,85,100,1186
E01012424,316,207,115,781,1419
E01012425,444,342,147,378,1311
E01012426,554,473,79,41,1147
E01012427,658,293,103,305,1359
E01012428,777,400,415,196,1788
E01012429,461,276,128,242,1107
E01012430,289,195,366,558,1408
E01012431,697,389,475,112,1673
E01012432,584,243,143,185,1155
E01012433,408,202,130,469,1209
E01012434,836,286,87,29,1238
E01012435,1108,426,53,56,1643
E01012436,236,112,54,495,897
E01012437,325,170,62,447,1004
E01012438,207,110,59,517,893
E01012439,438,164,90,490,1182
E01012440,729,278,45,53,1105
E01012441,520,255,442,566,1783
E01012442,319,182,75,594,1170
E01012443,679,301,140,114,1234
E01012444,115,86,27,600,828
E01012445,175,77,50,702,1004
E01012446,571,572,15,19,1177
E01012447,676,406,29,5,1116
E01012448,540,443,47,10,1040
E01012449,483,723,21,8,1235
E01012450,500,547,74,54,1175
E01012451,499,340,78,283,1200
E01012452,627,746,67,0,1440
E01012453,387,131,116,600,1234
E01012454,724,267,343,221,1555
E01012455,377,172,233,653,1435
E01012457,433,270,425,184,1312
E01012458,873,354,426,168,1821
E01012459,373,128,68,526,1095
E01012460,450,218,90,375,1133
E01012461,629,343,74,28,1074
E01012462,610,210,151,103,1074
E01012463,411,537,48,14,1010
E01012464,479,292,110,264,1145
E01012465,580,216,136,139,1071
E01012466,356,87,91,624,1158
E01012467,416,602,32,7,1057
E01012468,935,603,168,91,1797
E01012469,602,423,119,57,1201
E01012470,369,307,58,203,937
E01012471,435,490,70,3,998
E01012472,583,696,70,107,1456
E01012473,516,646,53,56,1271
E01012474,419,318,97,295,1129
E01012475,549,412,134,105,1200
E01012476,561,520,121,118,1320
E01012477,598,536,81,8,1223
E01012478,511,320,141,197,1169
E01012479,422,239,303,339,1303
E01012480,452,254,551,229,1486
E01012481,564,257,213,219,1253
E01012482,507,251,186,398,1342
E01012483,347,196,215,586,1344
E01012485,567,434,61,174,1236
E01012486,638,481,63,14,1196
E01012487,618,499,77,51,1245
E01012488,583,735,92,10,1420
E01012489,738,575,65,8,1386
E01012490,505,646,58,7,1216
E01012491,461,457,57,193,1168
E01012492,564,585,48,8,1205
E01012493,797,467,82,10,1356
E01012494,807,414,83,7,1311
E01012495,857,319,148,8,1332
E01012496,615,442,40,62,1159
E01012497,391,213,53,352,1009
E01012498,498,249,91,363,1201
E01012499,888,408,125,39,1460
E01012500,534,540,78,7,1159
E01012501,615,412,118,21,1166
E01012502,655,528,74,12,1269
E01012503,635,377,111,13,1136
E01012504,604,303,222,238,1367
E01012505,426,248,121,335,1130
E01012506,413,196,150,441,1200
E01012507,502,328,481,206,1517
E01012508,388,192,120,514,1214
E01012509,563,698,234,72,1567
E01012510,494,362,402,222,1480
E01012511,557,353,386,88,1384
E01012512,525,689,159,17,1390
E01012513,663,559,205,90,1517
E01012514,702,531,126,50,1409
E01012515,482,438,133,144,1197
E01012516,398,441,141,91,1071
E01012517,919,553,205,28,1705
E01012518,736,530,159,139,1564
E01012519,498,534,113,72,1217
E01012520,354,232,98,448,1132
E01012521,466,508,87,205,1266
E01012522,451,258,86,316,1111
E01012523,505,351,205,100,1161
E01012524,633,514,100,31,1278
E01012525,540,307,178,161,1186
E01012526,332,125,134,610,1201
E01012527,595,475,90,77,1237
E01012528,440,538,43,11,1032
E01012529,519,556,90,15,1180
E01012530,614,401,98,7,1120
E01012531,531,610,78,27,1246
E01012532,507,602,53,5,1167
E01012533,199,126,66,619,1010
E01012534,386,216,88,480,1170
E01012535,443,202,116,491,1252
E01012536,421,248,74,362,1105
E01012537,406,220,74,476,1176
E01012538,705,399,111,4,1219
E01012539,515,269,60,386,1230
E01012540,580,412,67,69,1128
E01012541,509,264,112,168,1053
E01012542,483,383,112,193,1171
E01012543,517,488,109,49,1163
E01012544,462,434,89,185,1170
E01012545,250,104,99,751,1204
E01012546,250,37,73,777,1137
E01012547,719,525,83,59,1386
E01012548,798,475,89,105,1467
E01012549,488,637,54,21,1200
E01012550,576,679,86,12,1353
E01012551,689,515,45,11,1260
E01012552,491,418,100,136,1145
E01012553,643,422,35,2,1102
E01012554,782,661,103,95,1641
E01012555,559,449,54,19,1081
E01012556,589,597,56,38,1280
E01012557,597,378,270,55,1300
E01012558,726,466,197,10,1399
E01012559,609,487,55,35,1186
E01012560,497,437,46,204,1184
E01012561,791,232,153,74,1250
E01012562,904,273,158,7,1342
E01012563,855,475,70,4,1404
E01012564,697,302,75,6,1080
E01012565,1211,308,139,176,1834
E01012566,1138,244,145,25,1552
E01012567,1036,284,88,11,1419
E01012568,1350,267,187,69,1873
E01012569,906,374,158,53,1491
E01012570,352,233,80,361,1026
E01012571,208,434,139,231,1012
E01012572,178,349,107,468,1102
E01012573,171,795,149,128,1243
E01012574,285,249,94,433,1061
E01012575,145,324,126,380,975
E01012576,279,335,158,333,1105
E01012577,395,482,226,161,1264
E01012578,307,614,213,232,1366
E01012579,337,436,136,302,1211
E01012580,254,926,193,165,1538
E01012581,449,490,62,2,1003
E01012582,612,539,96,9,1256
E01012583,608,636,64,14,1322
E01012584,529,485,99,25,1138
E01012585,444,519,137,39,1139
E01012586,386,504,213,86,1189
E01012587,672,549,193,9,1423
E01012588,583,564,229,11,1387
E01012589,391,300,321,103,1115
E01012590,419,281,186,183,1069
E01012591,468,282,137,300,1187
E01012592,764,748,132,7,1651
E01012593,714,437,223,13,1387
E01012594,321,212,119,431,1083
E01012595,472,281,413,299,1465
E01012596,558,311,378,143,1390
E01012597,899,372,120,6,1397
E01012598,1595,407,171,5,2178
E01012599,505,323,108,8,944
E01012600,290,203,88,489,1070
E01012601,233,150,72,659,1114
E01012602,875,243,116,20,1254
E01012603,389,116,161,471,1137
E01012604,610,227,218,139,1194
E01012605,283,662,248,113,1306
E01012606,272,506,171,160,1109
E01012607,422,557,67,184,1230
E01012608,460,295,189,297,1241
E01012609,631,661,42,6,1340
E01012610,542,330,47,96,1015
E01012611,384,410,100,13,907
E01012612,467,660,64,7,1198
E01012613,553,448,96,10,1107
E01012614,804,411,122,56,1393
E01012615,437,402,180,238,1257
E01012616,761,388,147,130,1426
E01012617,498,362,215,37,1112
E01012618,563,487,121,43,1214
E01012619,250,202,91,474,1017
E01012620,453,604,77,79,1213
E01012621,515,259,144,230,1148
E01012622,203,216,318,499,1236
E01012623,617,309,168,99,1193
E01012624,510,235,271,218,1234
E01012625,505,303,295,151,1254
E01012628,459,427,92,8,986
E01012629,378,145,245,70,838
E01012630,262,897,234,138,1531
E01012631,148,112,118,564,942
E01012632,518,518,288,283,1607
E01012633,571,461,155,130,1317
E01012634,577,367,90,70,1104
E01012635,602,518,96,27,1243
E01012636,456,667,114,51,1288
E01012637,219,121,99,705,1144
E01012638,354,144,121,549,1168
E01012639,242,192,180,690,1304
E01012640,528,401,243,167,1339
E01012641,320,259,156,359,1094
E01012642,259,549,181,166,1155
E01012643,168,478,126,410,1182
E01012644,340,1198,291,53,1882
E01012645,518,693,130,12,1353
E01012646,372,284,331,267,1254
E01012647,295,331,125,346,1097
E01012648,383,270,238,24,915
E01012649,341,235,260,254,1090
E01012650,412,289,284,56,1041
E01012651,622,417,242,21,1302
E01012652,562,608,120,35,1325
E01012653,467,269,240,55,1031
E01012654,468,315,435,97,1315
E01012655,82,75,275,864,1296
E01012656,266,347,281,303,1197
E01012657,373,493,322,245,1433
E01012658,622,429,260,76,1387
E01012659,572,389,150,22,1133
E01012660,486,401,64,16,967
E01012661,614,326,262,17,1219
E01012662,424,540,165,190,1319
E01012663,538,504,268,10,1320
E01012664,660,462,183,9,1314
E01012665,533,710,197,13,1453
E01012666,427,340,346,36,1149
E01012667,604,541,124,3,1272
E01012668,584,496,223,7,1310
E01012669,555,526,414,12,1507
E01012670,224,142,465,83,914
E01012671,158,162,526,43,889
E01012672,191,130,470,62,853
E01012673,167,92,512,319,1090
E01012674,353,238,618,59,1268
E01012675,274,205,598,88,1165
E01012676,483,315,228,98,1124
E01012677,514,345,253,24,1136
E01012678,166,112,206,642,1126
E01012679,273,136,440,229,1078
E01012680,436,210,420,148,1214
E01012681,122,145,687,123,1077
E01012682,271,195,498,189,1153
E01012683,256,193,582,125,1156
E01012684,354,174,332,243,1103
E01012685,597,249,279,14,1139
E01012686,360,160,97,481,1098
E01012687,347,160,106,485,1098
E01012688,345,404,185,142,1076
E01012689,433,385,192,74,1084
E01012690,759,422,199,17,1397
E01012691,672,438,243,128,1481
E01012692,622,278,183,328,1411
E01012693,543,552,201,8,1304
E01012694,450,325,241,74,1090
E01012695,449,245,334,57,1085
E01012696,508,354,308,26,1196
E01012697,390,501,175,99,1165
E01012698,361,241,239,319,1160
E01012699,660,511,199,43,1413
E01012700,685,568,203,26,1482
E01012701,520,462,191,7,1180
E01012702,368,386,172,303,1229
E01012703,463,541,159,99,1262
E01012704,431,223,197,796,1647
E01012705,511,370,190,197,1268
E01012706,678,451,172,19,1320
E01012707,357,244,231,197,1029
E01012708,498,336,253,4,1091
E01012709,487,290,441,7,1225
E01012710,438,367,146,5,956
E01012711,499,316,240,64,1119
E01012712,707,484,178,3,1372
E01012713,781,437,300,7,1525
E01012714,594,530,209,70,1403
E01012715,562,441,250,9,1262
E01012716,566,441,167,8,1182
E01012717,640,621,129,23,1413
E01012718,534,741,126,22,1423
E01012719,497,507,129,8,1141
E01012720,270,186,126,558,1140
E01012721,156,109,80,941,1286
E01012722,473,276,233,11,993
E01012723,569,419,160,56,1204
E01012724,266,153,108,465,992
E01012725,541,438,151,1,1131
E01012726,551,529,241,62,1383
E01012727,636,523,140,18,1317
E01012728,434,353,422,21,1230
E01012729,512,717,135,4,1368
E01012730,722,487,168,2,1379
E01012731,593,480,212,22,1307
E01012732,513,459,194,255,1421
E01012733,288,171,305,46,810
E01012734,518,290,297,28,1133
E01012735,251,264,547,14,1076
E01012736,118,146,392,20,676
E01012737,174,205,763,52,1194
E01012738,305,218,397,67,987
E01012739,391,263,238,180,1072
E01012740,559,382,266,21,1228
E01012741,510,414,195,5,1124
E01012742,420,262,235,46,963
E01012743,513,344,448,28,1333
E01012744,446,284,363,180,1273
E01012745,592,445,298,27,1362
E01012746,577,393,373,48,1391
E01012747,603,548,85,2,1238
E01012748,358,304,532,25,1219
E01012749,460,320,494,15,1289
E01012750,697,460,246,7,1410
E01012751,137,137,766,12,1052
E01012752,390,257,358,3,1008
E01012753,431,325,179,4,939
E01012754,368,210,330,13,921
E01012755,504,449,224,16,1193
E01012756,551,396,310,21,1278
E01012757,478,237,502,29,1246
E01012758,576,355,318,46,1295
E01012759,526,317,479,50,1372
E01012760,398,271,540,23,1232
E01012761,167,109,870,340,1486
E01012762,480,311,487,48,1326
E01012763,368,233,1024,111,1736
E01012764,379,511,87,15,992
E01012765,647,399,167,5,1218
E01012766,659,355,167,15,1196
E01012767,423,267,707,103,1500
E01012768,530,488,181,11,1210
E01012769,413,676,95,4,1188
E01012770,646,470,85,14,1215
E01012771,673,423,87,87,1270
E01012772,640,370,163,21,1194
E01012773,729,391,237,15,1372
E01012774,541,254,163,285,1243
E01012775,418,259,137,364,1178
E01012776,632,351,201,23,1207
E01012777,360,281,107,452,1200
E01012778,308,89,119,557,1073
E01012779,238,70,139,462,909
E01012780,339,144,115,516,1114
E01012781,206,111,73,473,863
E01012782,237,91,77,626,1031
E01012783,247,50,112,486,895
E01012784,797,137,252,346,1532
E01012785,171,81,63,637,952
E01012786,347,195,72,388,1002
E01012787,274,155,128,616,1173
E01012788,282,133,82,618,1115
E01012789,337,164,67,456,1024
E01012790,317,212,90,422,1041
E01012791,731,564,81,20,1396
E01012792,691,369,144,75,1279
E01012793,466,481,149,112,1208
E01012794,689,387,198,21,1295
E01012795,557,311,165,548,1581
E01012796,537,385,123,53,1098
E01012797,485,246,156,239,1126
E01012798,341,165,104,706,1316
E01012799,507,200,303,12,1022
E01012800,533,349,288,97,1267
E01012801,563,313,193,132,1201
E01012802,554,314,240,61,1169
E01012803,484,323,285,73,1165
E01012804,674,381,179,14,1248
E01012805,377,185,381,179,1122
E01012806,402,253,436,98,1189
E01012807,487,380,185,75,1127
E01012808,389,210,312,498,1409
E01012809,465,212,653,148,1478
E01012810,624,247,384,281,1536
E01012811,533,219,528,67,1347
E01012812,615,462,79,2,1158
E01012813,747,563,102,31,1443
E01012814,647,533,63,26,1269
E01012815,746,378,124,37,1285
E01012816,519,362,155,93,1129
E01012817,506,304,321,18,1149
E01012818,538,401,74,26,1039
E01012819,587,339,207,50,1183
E01012820,573,305,194,25,1097
E01012821,382,129,66,453,1030
E01012822,564,356,168,127,1215
E01012823,333,205,116,419,1073
E01012824,702,285,83,237,1307
E01012825,530,523,82,146,1281
E01012826,456,270,121,383,1230
E01012827,500,322,95,373,1290
E01012828,535,348,91,296,1270
E01012829,708,468,115,50,1341
E01012830,687,439,102,12,1240
E01012832,599,110,148,182,1039
E01012833,315,200,83,567,1165
E01012834,352,185,121,505,1163
E01012835,400,539,60,22,1021
E01012836,361,189,91,607,1248
E01012837,401,224,90,565,1280
E01012838,326,130,92,532,1080
E01012839,372,387,84,198,1041
E01012840,329,224,119,488,1160
E01012841,155,49,59,871,1134
E01012842,339,171,107,509,1126
E01012843,255,127,121,558,1061
E01012844,179,33,55,755,1022
E01012845,313,172,133,530,1148
E01012846,351,160,121,492,1124
E01012847,245,122,116,461,944
E01012848,397,164,289,175,1025
E01012849,347,225,119,534,1225
E01012850,209,106,796,442,1553
E01012851,175,103,854,850,1982
E01012852,302,155,382,544,1383
E01012854,162,106,426,1026,1720
E01012855,184,95,195,961,1435
E01012856,225,127,191,755,1298
E01012857,256,110,348,558,1272
E01012858,402,113,161,704,1380
E01012859,287,173,607,79,1146
E01012860,565,239,164,321,1289
E01012862,333,176,260,287,1056
E01012863,518,276,304,33,1131
E01012864,432,240,553,83,1308
E01012865,372,269,384,42,1067
E01012866,324,218,773,44,1359
E01012867,166,116,662,281,1225
E01012868,197,138,1113,145,1593
E01012869,215,142,1101,152,1610
E01012870,304,143,996,78,1521
E01012871,326,167,963,95,1551
E01012872,172,127,1251,148,1698
E01012873,198,64,123,748,1133
E01012874,272,141,88,647,1148
E01012875,116,59,94,801,1070
E01012876,249,193,91,689,1222
E01012877,197,89,62,637,985
E01012878,241,135,113,713,1202
E01012879,148,103,92,713,1056
E01012880,225,95,118,826,1264
E01012881,231,122,111,690,1154
E01012882,760,348,151,44,1303
E01012883,541,337,156,285,1319
E01012884,457,333,127,527,1444
E01012886,476,186,118,500,1280
E01012887,282,205,83,592,1162
E01012888,342,223,522,137,1224
E01012889,201,130,358,381,1070
E01012891,293,176,970,305,1744
E01012892,432,277,661,81,1451
E01012893,255,139,366,404,1164
E01012894,379,223,87,570,1259
E01012895,99,76,96,807,1078
E01012896,886,303,202,240,1631
E01012897,81,50,69,936,1136
E01012898,310,137,107,595,1149
E01012899,594,376,224,21,1215
E01012900,388,191,543,126,1248
E01012901,582,378,138,67,1165
E01012902,705,445,117,20,1287
E01012903,510,244,506,129,1389
E01012904,489,383,162,159,1193
E01012905,388,226,72,375,1061
E01012906,377,145,100,590,1212
E01012907,502,338,96,196,1132
E01012908,290,168,61,338,857
E01012909,670,259,131,39,1099
E01012910,565,346,83,25,1019
E01012911,569,357,72,16,1014
E01012912,749,591,157,14,1511
E01012913,513,289,376,351,1529
E01012914,130,140,1161,211,1642
E01012915,336,171,139,518,1164
E01012916,494,382,338,80,1294
E01012917,287,193,195,640,1315
E01012918,314,132,160,571,1177
E01012919,485,327,123,42,977
E01012920,558,478,119,46,1201
E01012921,414,386,83,39,922
E01012922,487,522,175,76,1260
E01012923,358,305,468,59,1190
E01012924,697,598,110,21,1426
E01012925,436,434,157,35,1062
E01012926,883,943,176,45,2047
E01012927,637,607,87,11,1342
E01012928,364,202,156,548,1270
E01012929,621,403,283,205,1512
E01012930,439,573,169,24,1205
E01012931,312,236,223,543,1314
E01012932,310,375,258,314,1257
E01012933,318,519,61,12,910
E01012934,433,566,220,84,1303
E01012935,395,687,58,8,1148
E01012936,242,561,291,53,1147
E01012937,543,1076,234,76,1929
E01012938,670,916,254,92,1932
E01012939,563,810,132,29,1534
E01012940,455,846,176,11,1488
E01012941,371,715,118,50,1254
E01012942,216,797,117,6,1136
E01012943,498,335,341,91,1265
E01012944,283,212,629,48,1172
E01012945,406,298,451,94,1249
E01012946,311,168,150,575,1204
E01012947,396,520,205,44,1165
E01012948,200,248,544,91,1083
E01012949,315,327,198,274,1114
E01012950,438,568,137,13,1156
E01012951,255,385,361,9,1010
E01012952,359,349,399,21,1128
E01012953,412,404,98,13,927
E01012954,397,535,108,24,1064
E01012955,569,547,135,22,1273
E01012956,450,412,42,101,1005
E01012957,419,480,259,84,1242
E01012958,364,522,32,14,932
E01012959,575,520,119,3,1217
E01012960,536,592,173,35,1336
E01012961,411,636,75,129,1251
E01012962,424,399,76,10,909
E01012963,298,344,135,430,1207
E01012964,573,421,115,273,1382
E01012965,344,390,84,32,850
E01012966,419,566,71,69,1125
E01012967,610,557,92,23,1282
E01012968,662,624,103,11,1400
E01012969,420,333,81,99,933
E01012970,542,500,143,57,1242
E01012972,573,566,60,21,1220
E01012973,1348,462,338,9,2157
E01012974,646,385,125,87,1243
E01012975,535,600,131,16,1282
E01012976,441,333,126,287,1187
E01012977,1041,633,280,65,2019
E01012978,454,650,107,19,1230
E01012979,476,526,272,19,1293
E01012980,458,389,358,218,1423
E01012981,326,388,368,122,1204
E01012982,549,505,316,24,1394
E01012983,727,510,204,12,1453
E01012984,620,603,130,50,1403
E01012985,558,554,159,102,1373
E01012986,393,642,213,126,1374
E01012987,617,596,152,46,1411
E01012988,521,451,168,76,1216
E01012989,519,654,194,90,1457
E01012990,379,466,221,82,1148
E01012991,489,549,159,124,1321
E01012992,315,466,358,126,1265
E01012993,410,573,87,79,1149
E01012994,559,372,168,338,1437
E01012995,567,334,178,395,1474
E01012996,608,555,84,22,1269
E01012997,421,355,629,123,1528
E01012998,953,640,129,41,1763
E01012999,385,251,653,64,1353
E01013000,361,262,580,289,1492
E01013001,555,538,222,107,1422
E01013002,413,312,221,316,1262
E01013003,431,427,99,229,1186
E01013004,505,284,327,169,1285
E01013005,473,483,85,6,1047
E01013006,642,338,160,67,1207
E01013007,552,454,167,80,1253
E01013008,631,290,251,20,1192
E01013009,433,311,215,311,1270
E01013010,512,381,199,136,1228
E01013011,620,337,156,122,1235
E01013012,613,452,50,1,1116
E01013013,610,378,244,17,1249
E01013014,593,346,128,138,1205
E01013015,572,411,278,16,1277
E01013016,635,670,104,12,1421
E01013017,503,441,165,228,1337
E01013018,679,507,138,137,1461
E01013019,431,422,85,65,1003
E01013020,711,547,163,45,1466
E01013021,579,514,177,15,1285
E01013022,732,577,130,121,1560
E01013023,612,724,173,20,1529
E01013024,749,487,127,129,1492
E01013025,463,404,128,122,1117
E01013026,653,514,110,104,1381
E01013027,517,574,191,142,1424
E01013028,600,504,132,69,1305
E01013029,417,500,187,121,1225
E01013030,475,529,164,108,1276
E01013031,595,616,69,23,1303
E01013032,539,587,101,15,1242
E01013033,720,392,109,80,1301
E01013034,621,605,184,42,1452
E01013035,550,521,58,11,1140
E01013036,414,330,347,212,1303
E01013037,599,321,270,26,1216
E01013038,346,145,90,566,1147
E01013039,682,577,137,111,1507
E01013040,697,393,421,76,1587
E01013041,364,486,276,245,1371
E01013042,745,471,83,26,1325
E01013043,596,336,92,76,1100
E01013044,680,524,90,9,1303
E01013045,377,219,105,470,1171
E01013046,476,801,165,9,1451
E01013047,473,458,192,193,1316
E01013048,754,610,208,140,1712
E01013049,406,485,252,176,1319
E01013050,511,692,156,27,1386
E01013051,490,390,174,192,1246
E01013052,645,477,109,48,1279
E01013053,384,717,99,15,1215
E01013054,735,408,329,7,1479
E01013055,475,457,170,171,1273
E01013056,451,263,306,282,1302
E01013057,570,515,137,21,1243
E01013058,384,442,139,155,1120
E01013059,602,577,88,75,1342
E01013060,730,674,126,8,1538
E01013061,570,528,79,161,1338
E01013062,392,536,404,124,1456
E01013063,505,540,141,86,1272
E01013064,753,271,57,6,1087
E01013065,641,632,75,72,1420
E01013066,694,583,71,4,1352
E01013067,756,501,136,5,1398
E01013068,386,727,70,41,1224
E01013069,540,485,152,144,1321
E01013070,477,659,104,21,1261
E01013071,353,179,226,536,1294
E01013072,570,400,130,229,1329
E01013073,579,514,142,86,1321
E01013074,567,608,127,50,1352
E01013075,513,481,66,45,1105
E01013076,491,403,177,136,1207
E01013077,792,568,115,120,1595
E01013078,501,504,93,86,1184
E01013079,478,648,173,22,1321
E01013080,348,262,286,144,1040
E01013081,505,476,248,59,1288
E01013082,526,549,201,17,1293
E01013083,367,351,326,77,1121
E01013084,261,262,170,450,1143
E01013085,611,533,132,97,1373
E01013086,399,376,137,276,1188
E01013087,405,469,118,132,1124
E01013088,557,726,65,10,1358
E01013089,633,576,116,14,1339
E01013090,594,439,77,66,1176
E01013091,596,529,99,63,1287
E01013092,828,542,138,98,1606
E01013093,469,654,99,12,1234
E01013094,534,434,93,105,1166
E01013095,483,535,198,21,1237
E01013096,675,428,157,84,1344
E01013097,514,511,184,14,1223
E01013098,927,579,229,36,1771
E01013099,381,358,123,260,1122
E01013100,634,647,89,16,1386
E01013101,721,477,98,86,1382
E01013102,566,522,110,39,1237
E01013103,546,566,82,9,1203
E01013104,428,546,84,6,1064
E01013105,503,395,73,199,1170
E01013106,432,226,51,224,933
E01013107,372,401,183,311,1267
E01013108,537,660,70,6,1273
E01013110,645,391,117,78,1231
E01013111,635,462,95,9,1201
E01013112,483,695,45,19,1242
E01013113,572,593,68,8,1241
E01013114,532,698,56,4,1290
E01013115,644,477,117,12,1250
E01013116,638,570,58,0,1266
E01013117,623,538,82,6,1249
E01013118,501,684,49,23,1257
E01013119,319,339,495,63,1216
E01013120,712,698,170,46,1626
E01013121,841,490,174,75,1580
E01013122,522,528,119,42,1211
E01013123,593,452,148,60,1253
E01013124,595,530,261,312,1698
E01013125,606,463,203,148,1420
E01013126,620,450,133,25,1228
E01013127,540,498,128,54,1220
E01013128,379,269,412,64,1124
E01013129,363,236,562,51,1212
E01013130,485,232,90,347,1154
E01013131,395,250,394,202,1241
E01013132,567,383,164,95,1209
E01013133,527,289,417,53,1286
E01013134,453,421,149,208,1231
E01013135,370,505,98,305,1278
E01013136,102,67,275,826,1270
E01013137,73,53,122,1072,1320
E01013138,185,175,411,260,1031
E01013139,157,123,214,472,966
E01013140,375,196,506,110,1187
E01013141,483,260,381,98,1222
E01013142,374,157,477,263,1271
E01013143,445,262,298,41,1046
E01013144,302,100,131,641,1174
E01013145,531,471,52,10,1064
E01013146,765,313,160,112,1350
E01013147,412,277,153,265,1107
E01013148,747,411,55,6,1219
E01013149,499,409,67,1,976
E01013150,624,409,57,14,1104
E01013151,465,539,60,0,1064
E01013152,546,569,80,7,1202
E01013153,425,679,73,9,1186
E01013154,500,638,63,15,1216
E01013155,535,550,79,1,1165
E01013156,304,349,137,329,1119
E01013157,795,493,157,8,1453
E01013158,602,341,141,84,1168
E01013159,372,189,509,56,1126
E01013160,641,466,134,9,1250
E01013161,438,163,382,54,1037
E01013162,493,237,442,50,1222
E01013163,525,533,78,23,1159
E01013164,656,313,216,158,1343
E01013165,313,227,371,139,1050
E01013166,584,656,81,10,1331
E01013167,592,815,89,6,1502
E01013168,631,691,69,12,1403
E01013169,326,410,69,129,934
E01013170,584,492,102,80,1258
E01013171,874,375,77,24,1350
E01013172,515,610,106,48,1279
E01013173,495,387,72,59,1013
E01013174,299,104,110,456,969
E01013175,572,424,133,50,1179
E01013176,560,387,169,17,1133
E01013177,345,211,139,576,1271
E01013178,523,541,136,30,1230
E01013179,494,379,129,196,1198
E01013180,546,462,127,69,1204
E01013181,420,191,474,50,1135
E01013182,462,612,134,4,1212
E01013183,642,403,158,52,1255
E01013184,544,297,313,29,1183
E01013185,538,399,261,83,1281
E01013186,579,385,74,4,1042
E01013187,305,225,317,319,1166
E01013188,642,526,174,16,1358
E01013189,543,555,93,12,1203
E01013190,1375,547,231,20,2173
E01013191,611,594,67,16,1288
E01013192,427,294,131,360,1212
E01013193,592,706,59,10,1367
E01013194,518,614,98,13,1243
E01013195,441,277,325,48,1091
E01013196,402,190,431,27,1050
E01013197,527,336,149,26,1038
E01013198,554,294,267,45,1160
E01013199,303,163,371,34,871
E01013200,615,334,84,8,1041
E01013201,395,197,490,78,1160
E01013202,512,254,370,10,1146
E01013203,371,194,601,87,1253
E01013204,415,247,118,322,1102
E01013205,268,90,113,464,935
E01013206,401,274,112,290,1077
E01013207,443,446,130,127,1146
E01013208,173,85,86,605,949
E01013209,290,177,111,545,1123
E01013210,269,156,94,457,976
E01013211,578,416,185,40,1219
E01013212,193,80,82,621,976
E01013213,336,298,124,245,1003
E01013214,481,657,84,33,1255
E01013215,580,589,88,5,1262
E01013216,624,358,57,3,1042
E01013217,546,545,92,33,1216
E01013218,424,200,366,93,1083
E01013219,392,297,344,77,1110
E01013220,410,236,468,148,1262
E01013221,368,178,545,349,1440
E01013222,438,272,476,40,1226
E01013223,1242,868,185,37,2332
E01013224,737,514,113,126,1490
E01013225,329,355,172,13,869
E01013226,622,490,127,18,1257
E01013227,546,553,132,144,1375
E01013228,804,300,153,35,1292
E01013229,463,211,164,276,1114
E01013231,532,319,379,54,1284
E01013233,566,284,312,10,1172
E01013234,551,346,190,35,1122
E01013236,542,504,140,122,1308
E01013237,446,190,141,490,1267
E01013238,541,248,269,307,1365
E01013239,511,446,300,62,1319
E01013240,801,272,202,548,1823
E01013241,453,643,176,41,1313
E01013242,738,600,95,32,1465
E01013243,844,661,167,55,1727
E01013244,631,383,114,300,1428
E01013245,522,276,151,192,1141
E01013246,573,413,134,149,1269
E01013247,770,455,152,56,1433
E01013248,708,586,152,36,1482
E01013249,626,324,165,283,1398
E01013250,543,555,68,176,1342
E01013251,661,761,102,33,1557
E01013252,652,606,102,28,1388
E01013253,714,509,184,158,1565
E01013254,493,412,239,246,1390
E01013255,522,538,301,56,1417
E01013256,1050,605,258,40,1953
E01013257,647,682,139,36,1504
E01013258,481,364,163,304,1312
E01013259,448,353,101,384,1286
E01013260,570,638,65,15,1288
E01013261,503,656,60,13,1232
E01013262,434,617,73,30,1154
E01013263,553,578,68,51,1250
E01013264,748,490,125,54,1417
E01013265,614,703,89,8,1414
E01013266,840,553,187,4,1584
E01013267,374,403,138,89,1004
E01013268,376,369,194,96,1035
E01013269,610,605,123,119,1457
E01013270,691,525,201,142,1559
E01013271,672,302,215,282,1471
E01013272,404,386,316,281,1387
E01013273,597,672,140,42,1451
E01013274,684,451,408,46,1589
E01013275,657,489,82,50,1278
E01013276,524,458,159,190,1331
E01013277,646,466,111,27,1250
E01013278,238,106,120,653,1117
E01013279,304,111,107,632,1154
E01013280,511,458,119,114,1202
E01013281,349,179,113,374,1015
E01013282,542,263,142,281,1228
E01013283,349,218,89,422,1078
E01013284,422,240,129,463,1254
E01013285,463,461,64,75,1063
E01013286,480,805,321,370,1976
E01013287,582,473,159,57,1271
E01013288,633,512,117,28,1290
E01013289,669,397,250,20,1336
E01013290,618,537,187,69,1411
E01013291,379,219,158,392,1148
E01013292,630,633,145,26,1434
E01013293,569,576,87,52,1284
E01013294,565,483,137,119,1304
E01013295,431,613,85,38,1167
E01013296,267,164,575,219,1225
E01013297,881,383,323,159,1746
E01013298,283,208,207,400,1098
E01013299,261,92,160,673,1186
E01013300,334,225,533,208,1300
E01013301,606,409,185,92,1292
E01013302,532,430,131,82,1175
E01013303,486,329,154,121,1090
E01013304,688,476,115,47,1326
E01013305,650,504,129,27,1310
E01013306,576,423,129,129,1257
E01013307,593,482,196,137,1408
E01013308,658,453,141,189,1441
E01013309,561,424,271,91,1347
E01013310,482,352,146,192,1172
E01013311,329,172,136,698,1335
E01013312,410,185,332,477,1404
E01013313,645,333,218,70,1266
E01013314,567,341,156,152,1216
E01013315,363,269,165,476,1273
E01013316,574,539,84,6,1203
E01013317,542,361,86,115,1104
E01013318,602,348,143,129,1222
E01013319,620,278,290,476,1664
E01013320,506,326,158,212,1202
E01013321,733,446,128,41,1348
E01013322,690,491,248,111,1540
E01013323,512,379,271,138,1300
E01013324,574,525,163,38,1300
E01013325,540,614,145,20,1319
E01013326,533,571,145,98,1347
E01013327,436,564,144,89,1233
E01013328,527,411,66,40,1044
E01013329,581,469,196,219,1465
E01013330,266,198,677,207,1348
E01013331,333,192,288,601,1414
E01013332,379,302,520,202,1403
E01013333,532,373,298,49,1252
E01013334,563,425,193,79,1260
E01013335,372,266,89,504,1231
E01013336,538,402,102,183,1225
E01013337,667,498,117,72,1354
E01013338,865,536,217,157,1775
E01013339,677,519,55,33,1284
E01013340,409,523,76,9,1017
E01013341,392,500,82,89,1063
E01013342,455,621,82,15,1173
E01013343,416,342,809,92,1659
E01013344,341,401,468,28,1238
E01013345,477,342,562,133,1514
E01013346,433,513,297,162,1405
E01013347,322,179,223,546,1270
E01013348,320,185,757,93,1355
E01013349,273,105,135,489,1002
E01013350,414,176,258,460,1308
E01013351,601,767,117,32,1517
E01013352,471,703,123,107,1404
E01013353,569,291,128,326,1314
E01013354,631,492,77,13,1213
E01013355,487,708,100,22,1317
E01013356,528,525,97,89,1239
E01013357,678,741,117,41,1577
E01013358,553,543,165,18,1279
E01013359,466,369,136,264,1235
E01013360,385,354,599,60,1398
E01013361,471,381,719,61,1632
E01013362,413,558,384,86,1441
E01013363,290,217,1000,191,1698
E01013364,251,223,1164,181,1819
E01013365,707,870,489,169,2235
E01013366,210,208,805,365,1588
E01013368,449,372,1100,76,1997
E01013369,230,320,867,248,1665
E01013370,525,539,119,107,1290
E01013371,614,521,72,7,1214
E01013372,550,720,99,12,1381
E01013373,472,482,61,151,1166
E01013374,588,556,89,8,1241
E01013375,456,608,72,4,1140
E01013376,518,650,40,46,1254
E01013377,670,560,77,31,1338
E01013378,224,308,332,96,960
E01013379,506,504,130,58,1198
E01013380,446,404,491,101,1442
E01013381,550,454,229,46,1279
E01013382,395,341,295,328,1359
E01013383,403,223,958,391,1975
E01013384,407,195,490,375,1467
E01013385,399,298,105,374,1176
E01013386,441,178,256,512,1387
E01013387,439,713,98,5,1255
E01013388,276,564,82,6,928
E01013389,447,474,49,15,985
E01013390,490,182,582,99,1353
E01013391,552,346,830,111,1839
E01013392,644,371,165,50,1230
E01013393,592,309,236,163,1300
E01013394,311,274,85,406,1076
E01013395,588,382,187,38,1195
E01013396,407,555,232,124,1318
E01013397,566,459,151,52,1228
E01013398,297,242,552,261,1352
E01013399,227,91,305,683,1306
E01013400,274,188,1213,113,1788
E01013401,404,287,674,106,1471
E01013402,384,588,556,6,1534
E01013403,332,355,917,137,1741
E01013404,385,285,78,450,1198
E01013405,543,589,59,7,1198
E01013406,647,442,212,295,1596
E01013407,397,594,67,139,1197
E01013408,359,739,60,22,1180
E01013409,522,564,95,148,1329
E01013410,183,74,46,826,1129
E01013411,507,728,79,12,1326
E01013412,469,322,636,100,1527
E01013413,591,458,296,17,1362
E01013414,473,400,499,39,1411
E01013416,278,155,446,438,1317
E01013417,508,487,425,81,1501
E01013418,398,285,451,209,1343
E01013419,433,541,201,98,1273
E01013420,629,694,333,48,1704
E01013421,394,441,140,48,1023
E01013422,695,454,108,51,1308
E01013423,442,573,39,8,1062
E01013424,525,480,40,36,1081
E01013425,567,513,119,67,1266
E01013426,458,729,98,98,1383
E01013427,433,690,49,14,1186
E01013428,604,387,131,188,1310
E01013429,927,322,209,90,1548
E01013430,564,474,95,165,1298
E01013431,691,260,175,70,1196
E01013432,792,558,195,58,1603
E01013433,565,602,65,15,1247
E01013434,530,513,114,18,1175
E01013435,567,490,64,80,1201
E01013436,471,406,335,59,1271
E01013437,323,486,127,80,1016
E01013438,659,408,136,208,1411
E01013439,665,351,68,4,1088
E01013440,795,602,134,6,1537
E01013441,557,429,248,53,1287
E01013442,451,407,75,211,1144
E01013443,300,172,106,569,1147
E01013444,393,175,86,414,1068
E01013445,400,291,170,395,1256
E01013446,544,335,121,321,1321
E01013447,397,243,105,426,1171
E01013448,365,107,98,475,1045
E01013449,572,449,100,233,1354
E01013450,426,433,105,43,1007
E01013451,528,291,98,26,943
E01013452,620,513,80,57,1270
E01013453,426,176,1032,402,2036
E01013454,289,169,314,232,1004
E01013455,590,394,233,290,1507
E01013456,242,125,746,613,1726
E01013457,409,278,616,179,1482
E01013458,488,494,158,122,1262
E01013459,575,540,215,77,1407
E01013460,244,152,1109,167,1672
E01013461,583,639,123,13,1358
E01013462,568,463,88,92,1211
E01013463,547,604,75,9,1235
E01013464,476,641,57,40,1214
E01013465,569,689,61,28,1347
E01013466,568,648,59,2,1277
E01013467,440,626,64,9,1139
E01013468,563,710,82,9,1364
E01013469,264,701,214,9,1188
E01013470,551,352,103,184,1190
E01013471,596,264,387,182,1429
E01013472,398,208,231,752,1589
E01013473,400,221,247,323,1191
E01013474,451,310,145,330,1236
E01013475,364,151,170,451,1136
E01013476,631,359,176,81,1247
E01013477,539,396,324,186,1445
E01013479,117,79,961,638,1795
E01013480,178,174,860,506,1718
E01013481,292,516,312,227,1347
E01013483,505,474,442,116,1537
E01013484,254,371,454,304,1383
E01013485,438,321,446,223,1428
E01013486,300,464,401,198,1363
E01013487,367,427,492,287,1573
E01013488,622,564,91,13,1290
E01013489,499,639,126,11,1275
E01013490,509,520,78,154,1261
E01013491,542,562,110,52,1266
E01013492,577,558,93,49,1277
E01013493,477,441,134,178,1230
E01013494,434,417,131,452,1434
E01013495,616,447,133,190,1386
E01013496,277,192,118,536,1123
E01013497,381,238,144,373,1136
E01013498,544,421,94,117,1176
E01013499,390,334,85,349,1158
E01013500,537,585,94,199,1415
E01013501,521,477,73,104,1175
E01013502,465,246,122,289,1122
E01013503,600,401,142,72,1215
E01013504,445,232,223,474,1374
E01013505,666,414,72,51,1203
E01013506,432,584,123,195,1334
E01013507,619,500,76,77,1272
E01013508,351,210,80,316,957
E01013509,645,461,138,91,1335
E01013510,441,278,89,345,1153
E01013511,590,612,75,22,1299
E01013512,423,276,140,305,1144
E01013513,421,263,56,253,993
E01013514,631,479,133,78,1321
E01013515,641,310,94,358,1403
E01013517,398,486,92,213,1189
E01013518,500,466,123,54,1143
E01013519,615,165,107,244,1131
E01013520,587,552,104,13,1256
E01013521,393,245,123,368,1129
E01013522,297,179,591,451,1518
E01013523,238,133,586,440,1397
E01013524,211,92,504,318,1125
E01013525,633,295,573,242,1743
E01013526,545,519,183,79,1326
E01013527,538,522,113,15,1188
E01013528,471,395,316,150,1332
E01013529,733,318,587,236,1874
E01013530,490,252,238,195,1175
E01013531,449,317,102,257,1125
E01013532,420,321,87,320,1148
E01013533,245,125,86,746,1202
E01013534,615,394,120,147,1276
E01013535,220,81,72,676,1049
E01013536,290,133,107,640,1170
E01013537,559,438,158,175,1330
E01013538,428,307,239,185,1159
E01013539,1142,476,110,40,1768
E01013540,575,555,99,52,1281
E01013541,533,190,204,244,1171
E01013542,520,384,179,250,1333
E01013543,719,480,129,19,1347
E01013544,702,600,120,36,1458
E01013545,448,471,188,193,1300
E01013546,582,560,151,31,1324
E01013547,328,234,852,118,1532
E01013548,471,358,108,286,1223
E01013549,375,349,86,339,1149
E01013550,270,170,179,381,1000
E01013551,268,155,815,152,1390
E01013552,379,328,112,496,1315
E01013553,477,341,74,306,1198
E01013554,242,151,599,421,1413
E01013555,502,361,85,249,1197
E01013556,521,544,108,3,1176
E01013557,422,691,61,9,1183
E01013558,687,672,129,131,1619
E01013559,518,519,105,11,1153
E01013560,593,563,80,11,1247
E01013561,549,625,116,16,1306
E01013562,389,449,134,206,1178
E01013563,538,510,123,7,1178
E01013564,800,675,138,28,1641
E01013565,381,394,336,57,1168
E01013566,351,343,537,217,1448
E01013567,362,455,449,157,1423
E01013568,449,445,416,196,1506
E01013569,391,393,316,52,1152
E01013570,418,263,352,367,1400
E01013571,371,300,301,321,1293
E01013572,504,436,145,237,1322
E01013573,391,141,114,822,1468
E01013574,633,434,43,13,1123
E01013575,601,398,141,11,1151
E01013576,677,350,119,29,1175
E01013577,801,321,87,8,1217
E01013578,690,243,146,8,1087
E01013579,675,323,164,16,1178
E01013580,615,322,269,3,1209
E01013581,357,202,112,443,1114
E01013582,551,370,173,173,1267
E01013583,293,137,205,504,1139
E01013584,291,130,99,740,1260
E01013585,451,215,136,469,1271
E01013586,262,80,156,572,1070
E01013587,575,426,143,60,1204
E01013588,439,277,124,358,1198
E01013589,535,481,93,72,1181
E01013590,218,140,136,716,1210
E01013591,362,208,422,463,1455
E01013592,551,468,124,28,1171
E01013593,519,557,75,18,1169
E01013594,426,663,54,38,1181
E01013595,802,459,233,239,1733
E01013596,544,601,95,58,1298
E01013597,391,317,90,396,1194
E01013598,498,316,124,289,1227
E01013599,530,613,61,5,1209
E01013600,363,182,119,735,1399
E01013601,430,204,139,485,1258
E01013602,392,230,220,534,1376
E01013603,267,151,128,774,1320
E01013604,366,177,150,527,1220
E01013605,511,315,334,204,1364
E01013606,609,623,158,36,1426
E01013607,735,544,696,213,2188
E01013608,599,473,141,31,1244
E01013609,556,496,157,141,1350
E01013610,491,317,162,364,1334
E01013611,490,333,114,228,1165
E01013612,561,410,197,44,1212
E01013613,511,238,451,90,1290
E01013614,524,353,314,74,1265
E01013615,736,284,126,57,1203
E01013616,568,196,166,279,1209
E01013617,938,248,410,337,1933
E01013618,594,292,113,262,1261
E01013619,258,166,116,697,1237
E01013620,206,72,111,845,1234
E01013621,240,74,120,890,1324
E01013622,287,131,123,670,1211
E01013623,844,485,218,160,1707
E01013624,253,268,154,476,1151
E01013625,365,345,462,316,1488
E01013626,382,319,342,385,1428
E01013627,391,505,174,36,1106
E01013628,309,172,248,479,1208
E01013629,484,351,271,232,1338
E01013630,358,420,399,225,1402
E01013631,385,134,68,509,1096
E01013632,230,71,57,988,1346
E01013633,358,134,113,635,1240
E01013634,352,169,95,575,1191
E01013635,459,481,292,39,1271
E01013636,511,521,115,16,1163
E01013637,474,164,113,616,1367
E01013638,230,90,59,825,1204
E01013639,449,100,114,364,1027
E01013640,193,51,60,913,1217
E01013641,330,249,609,137,1325
E01013642,334,299,917,41,1591
E01013643,379,279,959,33,1650
E01013646,246,151,1244,332,1973
E01013647,59,47,498,936,1540
E01013648,91,98,1281,377,1847
E01013649,237,235,673,60,1205
E01013650,328,228,1097,25,1678
E01013651,399,210,169,464,1242
E01013652,317,185,159,544,1205
E01013653,364,183,216,637,1400
E01013654,225,220,491,624,1560
E01013655,404,248,515,314,1481
E01013656,333,375,507,157,1372
E01013657,270,337,337,340,1284
E01013658,382,246,608,156,1392
E01013659,304,337,585,192,1418
E01013660,544,276,345,200,1365
E01013661,349,165,170,523,1207
E01013662,460,487,410,25,1382
E01013663,584,472,222,73,1351
E01013664,409,192,200,610,1411
E01013665,484,466,253,198,1401
E01013666,600,667,95,14,1376
E01013667,470,193,135,449,1247
E01013668,382,328,344,106,1160
E01013669,554,545,76,6,1181
E01013670,667,545,149,110,1471
E01013671,640,398,152,142,1332
E01013672,478,546,58,47,1129
E01013673,443,156,88,454,1141
E01013674,340,214,108,633,1295
E01013675,494,254,102,412,1262
E01013676,510,212,134,573,1429
E01013677,375,219,98,500,1192
E01013678,467,339,141,294,1241
E01013679,271,137,80,572,1060
E01013680,713,463,422,77,1675
E01013681,315,163,755,215,1448
E01013682,421,217,582,167,1387
E01013683,396,238,869,191,1694
E01013684,253,164,904,279,1600
E01013685,613,490,110,11,1224
E01013686,633,580,301,29,1543
E01013687,388,189,589,98,1264
E01013688,332,168,479,244,1223
E01013689,281,124,608,112,1125
E01013690,430,235,305,303,1273
E01013691,192,95,63,803,1153
E01013692,148,41,38,717,944
E01013693,144,49,72,782,1047
E01013694,438,175,154,446,1213
E01013695,346,241,90,468,1145
E01013696,934,336,253,245,1768
E01013697,896,512,284,248,1940
E01013698,454,323,99,305,1181
E01013699,647,474,178,118,1417
E01013700,539,371,106,169,1185
E01013702,528,434,331,19,1312
E01013703,462,431,140,17,1050
E01013704,456,431,221,13,1121
E01013705,492,414,144,213,1263
E01013706,592,518,173,28,1311
E01013707,638,425,144,16,1223
E01013709,541,572,150,4,1267
E01013710,408,335,401,40,1184
E01013711,333,363,421,122,1239
E01013712,354,464,222,27,1067
E01013713,356,403,391,138,1288
E01013714,442,568,323,93,1426
E01013715,251,457,298,106,1112
E01013716,302,488,495,204,1489
E01013717,400,334,240,212,1186
E01013718,423,344,305,212,1284
E01013719,326,361,437,170,1294
E01013720,234,169,151,589,1143
E01013721,406,402,129,291,1228
E01013722,300,258,87,541,1186
E01013723,291,163,69,445,968
E01013725,222,72,84,567,945
E01013726,213,85,115,903,1316
E01013727,413,204,109,419,1145
E01013728,311,139,100,580,1130
E01013729,506,272,121,135,1034
E01013730,271,140,96,631,1138
E01013731,448,132,124,467,1171
E01013732,723,450,366,67,1606
E01013733,705,251,200,30,1186
E01013734,453,530,197,73,1253
E01013735,451,574,127,12,1164
E01013736,680,501,163,45,1389
E01013737,524,454,178,9,1165
E01013738,471,646,162,7,1286
E01013739,400,477,164,168,1209
E01013740,465,562,185,35,1247
E01013741,572,492,244,14,1322
E01013742,263,430,351,303,1347
E01013743,303,444,344,149,1240
E01013744,355,681,319,119,1474
E01013745,269,552,286,125,1232
E01013746,108,106,209,1012,1435
E01013747,494,465,378,40,1377
E01013748,107,147,230,1017,1501
E01013749,495,407,199,80,1181
E01013750,374,477,256,22,1129
E01013751,300,564,388,109,1361
E01013752,282,499,317,72,1170
E01013753,264,342,363,265,1234
E01013754,87,54,157,991,1289
E01013755,42,46,82,1160,1330
E01013756,438,426,531,115,1510
E01013757,504,542,200,16,1262
E01013758,407,495,290,18,1210
E01013759,574,694,167,22,1457
E01013760,210,178,840,323,1551
E01013761,237,171,429,544,1381
E01013762,256,424,538,194,1412
E01013763,164,154,996,375,1689
E01013764,506,604,156,13,1279
E01013765,261,279,694,130,1364
E01013766,471,657,220,53,1401
E01013767,525,452,93,167,1237
E01013768,383,312,118,401,1214
E01013770,467,364,119,140,1090
E01013771,684,433,97,35,1249
E01013772,397,319,108,371,1195
E01013773,503,280,89,304,1176
E01013774,168,235,1071,72,1546
E01013775,407,158,1217,96,1878
E01013776,209,164,1036,90,1499
E01013777,408,193,691,35,1327
E01013778,185,62,911,548,1706
E01013779,243,165,1220,88,1716
E01013780,581,463,169,13,1226
E01013781,290,147,779,179,1395
E01013782,377,248,501,103,1229
E01013783,562,523,165,16,1266
E01013784,262,293,619,25,1199
E01013785,610,468,84,9,1171
E01013786,514,423,294,50,1281
E01013787,381,424,162,65,1032
E01013788,577,582,586,180,1925
E01013789,362,449,245,97,1153
E01013790,443,373,141,64,1021
E01013791,308,343,117,125,893
E01013792,495,624,159,42,1320
E01013793,400,536,141,53,1130
E01013794,436,483,115,50,1084
E01013795,279,416,173,68,936
E01013796,320,322,320,117,1079
E01013797,528,514,256,73,1371
E01013798,582,393,141,29,1145
E01013799,259,242,350,197,1048
E01013800,547,508,96,136,1287
E01013801,459,360,236,244,1299
E01013802,720,903,291,222,2136
E01013803,683,825,151,193,1852
E01013804,565,545,118,64,1292
E01013805,448,308,122,161,1039
E01013806,342,324,169,67,902
E01013807,416,381,165,141,1103
E01013808,360,354,144,209,1067
E01013809,387,476,83,104,1050
E01013810,302,158,421,319,1200
E01013811,122,79,607,351,1159
E01013812,175,109,580,348,1212
E01013813,33,33,443,846,1355
E01013814,154,68,1107,394,1723
E01013815,70,81,988,329,1468
E01013816,115,68,1150,507,1840
E01013817,221,137,179,558,1095
E01013818,192,114,106,738,1150
E01013819,378,192,179,508,1257
E01013820,338,111,197,579,1225
E01013821,311,156,197,473,1137
E01013822,263,123,126,616,1128
E01013823,480,196,188,447,1311
E01013824,350,125,166,448,1089
E01013825,506,195,170,454,1325
E01013826,319,97,181,643,1240
E01013827,396,162,174,357,1089
E01013828,559,289,363,157,1368
E01013829,537,187,306,286,1316
E01013830,589,397,182,184,1352
E01013831,677,416,119,75,1287
E01013832,404,254,319,321,1298
E01013833,442,118,104,366,1030
E01013834,362,185,150,467,1164
E01013835,437,162,190,464,1253
E01013836,504,178,373,374,1429
E01013837,649,404,329,56,1438
E01013838,576,409,227,46,1258
E01013839,307,145,450,473,1375
E01013840,773,342,595,49,1759
E01013841,379,125,435,273,1212
E01013842,248,140,611,257,1256
E01013843,258,210,674,77,1219
E01013844,237,140,579,215,1171
E01013845,383,216,470,163,1232
E01013846,220,186,734,247,1387
E01013847,291,294,452,84,1121
E01013849,413,166,107,474,1160
E01013850,386,262,95,456,1199
E01013851,329,127,144,638,1238
E01013852,487,272,111,427,1297
E01013853,484,356,86,270,1196
E01013854,415,222,87,392,1116
E01013855,233,160,136,544,1073
E01013856,424,249,141,385,1199
E01013858,440,270,95,316,1121
E01013859,393,300,118,447,1258
E01013860,386,276,130,472,1264
E01013861,256,199,87,686,1228
E01013862,287,167,91,608,1153
E01013863,508,332,146,187,1173
E01013864,281,101,121,601,1104
E01013865,390,317,108,409,1224
E01013866,434,235,110,377,1156
E01013867,378,144,140,470,1132
E01013868,292,174,100,582,1148
E01013870,327,155,545,648,1675
E01013871,311,173,175,692,1351
E01013872,360,211,388,482,1441
E01013873,358,244,496,213,1311
E01013874,386,244,505,133,1268
E01013875,587,403,63,36,1089
E01013876,359,152,373,454,1338
E01013877,175,117,110,614,1016
E01013878,279,167,68,417,931
E01013879,281,130,104,444,959
E01013880,352,173,166,454,1145
E01013881,331,177,123,479,1110
E01013882,365,274,207,246,1092
E01013883,442,261,102,397,1202
E01013884,347,156,118,417,1038
E01013885,333,187,327,416,1263
E01013886,523,269,157,262,1211
E01013887,571,629,72,46,1318
E01013888,483,419,220,116,1238
E01013889,547,491,186,136,1360
E01013890,609,349,221,48,1227
E01013891,459,237,215,369,1280
E01013892,486,641,74,23,1224
E01013893,371,108,94,405,978
E01013894,591,572,49,39,1251
E01013895,546,640,78,18,1282
E01013896,328,194,117,367,1006
E01013897,391,333,159,304,1187
E01013898,282,197,141,197,817
E01013899,427,240,86,234,987
E01013900,477,306,112,299,1194
E01013901,578,420,189,19,1206
E01013902,550,513,146,46,1255
E01013903,409,374,131,129,1043
E01013904,545,290,112,254,1201
E01013905,425,234,152,394,1205
E01013906,554,333,143,263,1293
E01013907,342,278,151,439,1210
E01013908,522,294,116,411,1343
E01013909,414,169,131,548,1262
E01013910,440,318,163,240,1161
E01013911,434,354,107,330,1225
E01013912,569,488,134,136,1327
E01013913,560,589,151,125,1425
E01013914,601,590,147,24,1362
E01013915,523,456,177,105,1261
E01013916,422,191,126,376,1115
E01013917,556,220,247,357,1380
E01013918,406,193,686,199,1484
E01013919,419,221,761,217,1618
E01013920,237,121,564,942,1864
E01013921,286,155,651,479,1571
E01013924,16,30,994,561,1601
E01013926,159,119,991,235,1504
E01013928,99,94,1119,116,1428
E01013929,679,412,192,180,1463
E01013930,589,351,326,182,1448
E01013931,531,618,129,69,1347
E01013932,489,521,243,118,1371
E01013933,371,209,295,491,1366
E01013934,457,367,215,212,1251
E01013935,482,521,241,36,1280
E01013936,717,315,547,241,1820
E01013937,445,392,426,118,1381
E01013938,487,360,363,57,1267
E01013939,517,395,297,110,1319
E01013940,271,93,208,698,1270
E01013941,337,308,639,44,1328
E01013942,378,163,280,768,1589
E01013943,239,184,759,211,1393
E01013944,486,301,473,74,1334
E01013945,149,92,646,320,1207
E01013947,160,85,867,455,1567
E01013948,76,36,183,782,1077
E01013953,91,71,1434,45,1641
E01013954,305,164,217,355,1041
E01013957,337,201,350,294,1182
E01013958,206,147,339,701,1393
E01013959,288,182,211,702,1383
E01013960,212,113,156,726,1207
E01013961,141,134,1196,520,1991
E01013962,458,263,300,428,1449
E01013963,454,261,123,388,1226
E01013964,477,390,161,283,1311
E01013965,469,255,162,281,1167
E01013966,445,192,139,303,1079
E01013967,354,313,168,89,924
E01013968,370,389,148,200,1107
E01013969,453,276,598,69,1396
E01013970,536,296,358,73,1263
E01013971,387,303,482,98,1270
E01013972,346,251,468,143,1208
E01013973,101,55,243,246,645
E01013974,274,374,491,247,1386
E01013975,229,316,277,103,925
E01013976,309,122,412,411,1254
E01013977,661,564,194,93,1512
E01013978,558,356,266,152,1332
E01013979,555,466,194,21,1236
E01013980,580,584,126,25,1315
E01013981,634,547,152,31,1364
E01013982,543,593,93,45,1274
E01013983,303,253,129,489,1174
E01013984,402,758,68,13,1241
E01013985,511,742,159,66,1478
E01013986,393,236,245,495,1369
E01013987,499,563,153,103,1318
E01013988,546,717,226,111,1600
E01013989,398,186,161,393,1138
E01013990,474,662,198,77,1411
E01013991,366,385,172,140,1063
E01013992,417,172,140,402,1131
E01013993,394,272,102,454,1222
E01013994,336,214,106,555,1211
E01013995,205,155,84,797,1241
E01013996,627,373,238,21,1259
E01013997,844,406,270,81,1601
E01013998,377,603,131,53,1164
E01013999,283,645,171,76,1175
E01014000,398,548,160,51,1157
E01014001,402,558,174,103,1237
E01014002,334,652,126,41,1153
E01014003,445,395,153,185,1178
E01014004,303,592,182,97,1174
E01014005,315,279,303,393,1290
E01014006,530,531,167,95,1323
E01014007,645,603,113,27,1388
E01014008,387,644,220,110,1361
E01014009,301,672,148,142,1263
E01014010,204,222,766,181,1373
E01014011,385,264,369,181,1199
E01014012,477,656,187,71,1391
E01014013,503,284,280,245,1312
E01014014,540,605,234,108,1487
E01014015,489,545,221,106,1361
E01014016,236,513,245,243,1237
E01014017,363,615,205,50,1233
E01014018,272,697,225,54,1248
E01014019,407,555,189,145,1296
E01014020,362,709,171,35,1277
E01014021,317,578,186,124,1205
E01014022,791,642,176,41,1650
E01014023,515,521,207,132,1375
E01014024,313,529,176,71,1089
E01014025,339,584,149,117,1189
E01014026,533,773,344,128,1778
E01014027,315,465,147,112,1039
E01014028,365,642,160,58,1225
E01014029,322,522,169,183,1196
E01014030,429,541,93,105,1168
E01014031,488,517,141,69,1215
E01014032,486,568,229,58,1341
E01014033,337,671,288,132,1428
E01014034,313,364,267,249,1193
E01014035,330,347,303,395,1375
E01014036,297,622,326,51,1296
E01014037,389,685,134,93,1301
E01014038,338,427,173,257,1195
E01014039,659,368,259,73,1359
E01014040,438,546,224,160,1368
E01014041,367,543,253,90,1253
E01014042,286,183,198,542,1209
E01014043,267,526,119,38,950
E01014044,487,369,154,169,1179
E01014045,499,482,265,54,1300
E01014046,425,594,106,92,1217
E01014047,342,335,148,323,1148
E01014048,244,270,421,279,1214
E01014049,417,570,255,50,1292
E01014050,521,667,194,62,1444
E01014051,459,505,269,136,1369
E01014052,319,594,331,23,1267
E01014053,432,561,373,94,1460
E01014054,353,499,195,113,1160
E01014055,385,554,224,157,1320
E01014056,300,593,273,45,1211
E01014057,473,560,168,196,1397
E01014058,446,774,142,14,1376
E01014059,562,725,273,47,1607
E01014060,415,631,214,64,1324
E01014061,437,692,92,78,1299
E01014062,376,463,408,136,1383
E01014063,458,511,113,292,1374
E01014064,396,253,196,452,1297
E01014065,480,411,199,128,1218
E01014066,285,312,219,126,942
E01014067,525,537,115,15,1192
E01014068,491,407,135,206,1239
E01014069,642,282,276,206,1406
E01014070,823,504,305,163,1795
E01014071,321,198,123,500,1142
E01014072,629,361,229,384,1603
E01014073,402,189,364,459,1414
E01014074,272,238,251,510,1271
E01014075,523,531,213,82,1349
E01014076,661,408,605,107,1781
E01014077,527,550,151,82,1310
E01014078,465,370,133,203,1171
E01014079,401,569,152,201,1323
E01014080,363,551,102,149,1165
E01014081,415,580,151,62,1208
E01014082,525,583,156,139,1403
E01014083,516,624,177,19,1336
E01014084,519,323,248,202,1292
E01014085,401,335,181,233,1150
E01014086,316,150,379,344,1189
E01014087,501,403,341,24,1269
E01014088,472,333,307,87,1199
E01014089,495,390,136,170,1191
E01014090,560,568,93,10,1231
E01014091,452,668,103,16,1239
E01014092,491,530,403,117,1541
E01014093,432,466,93,145,1136
E01014094,569,505,103,64,1241
E01014095,376,429,201,176,1182
E01014096,434,627,156,49,1266
E01014097,310,527,194,95,1126
E01014098,412,314,158,332,1216
E01014099,460,678,294,49,1481
E01014100,471,540,182,96,1289
E01014101,219,320,326,39,904
E01014102,770,453,172,26,1421
E01014103,594,254,96,65,1009
E01014104,535,353,176,247,1311
E01014105,482,213,274,455,1424
E01014106,551,254,196,199,1200
E01014107,519,382,73,21,995
E01014108,277,126,325,361,1089
E01014109,447,221,138,111,917
E01014110,291,98,273,356,1018
E01014111,530,480,149,98,1257
E01014112,511,576,163,54,1304
E01014113,357,240,316,334,1247
E01014114,383,487,206,113,1189
E01014115,358,244,271,176,1049
E01014116,276,357,256,422,1311
E01014117,429,458,97,33,1017
E01014118,297,137,276,147,857
E01014119,707,395,104,153,1359
E01014120,338,213,132,682,1365
E01014121,538,382,95,189,1204
E01014122,571,198,385,123,1277
E01014123,763,292,161,22,1238
E01014124,430,206,276,415,1327
E01014125,414,246,142,423,1225
E01014126,399,377,131,248,1155
E01014127,357,142,168,595,1262
E01014128,627,230,290,416,1563
E01014129,290,263,86,228,867
E01014130,565,404,139,45,1153
E01014131,457,518,213,80,1268
E01014132,351,416,95,53,915
E01014133,629,533,164,121,1447
E01014134,453,553,80,25,1111
E01014135,406,394,148,64,1012
E01014136,467,473,219,161,1320
E01014137,695,261,149,60,1165
E01014138,473,276,131,286,1166
E01014139,417,219,200,203,1039
E01014140,464,178,258,265,1165
E01014141,818,263,533,474,2088
E01014142,289,133,199,337,958
E01014143,350,242,237,320,1149
E01014144,322,340,137,399,1198
E01014145,420,265,367,400,1452
E01014146,758,362,150,305,1575
E01014147,956,345,211,88,1600
E01014148,534,448,236,55,1273
E01014149,375,283,133,73,864
E01014150,667,431,199,72,1369
E01014151,414,204,150,413,1181
E01014152,355,332,87,309,1083
E01014153,586,339,223,278,1426
E01014154,660,295,204,202,1361
E01014155,555,302,152,296,1305
E01014156,764,155,283,375,1577
E01014157,744,275,161,20,1200
E01014158,582,253,142,242,1219
E01014159,363,293,126,251,1033
E01014160,517,379,109,82,1087
E01014161,391,269,104,196,960
E01014162,367,254,239,474,1334
E01014163,289,122,192,463,1066
E01014164,286,97,112,722,1217
E01014165,348,111,271,383,1113
E01014166,567,279,198,203,1247
E01014167,870,262,141,169,1442
E01014168,674,291,90,10,1065
E01014169,518,117,312,347,1294
E01014170,546,577,73,34,1230
E01014171,343,346,272,219,1180
E01014172,559,417,161,10,1147
E01014173,429,345,291,203,1268
E01014174,672,457,92,27,1248
E01014175,351,326,122,147,946
E01014176,442,561,211,43,1257
E01014177,487,471,151,65,1174
E01014178,330,233,486,194,1243
E01014179,451,454,68,12,985
E01014180,418,444,102,133,1097
E01014181,981,310,177,13,1481
E01014182,515,366,98,12,991
E01014183,606,508,110,60,1284
E01014184,334,344,271,158,1107
E01014185,313,272,228,577,1390
E01014186,525,283,195,142,1145
E01014187,538,325,195,175,1233
E01014188,612,392,195,36,1235
E01014189,591,290,165,151,1197
E01014190,901,344,88,16,1349
E01014191,429,191,431,346,1397
E01014192,439,189,275,177,1080
E01014193,580,245,164,271,1260
E01014194,561,207,149,259,1176
E01014195,659,344,120,36,1159
E01014196,445,213,169,405,1232
E01014197,362,212,264,248,1086
E01014198,156,108,158,354,776
E01014199,475,188,309,202,1174
E01014200,203,130,272,282,887
E01014201,272,149,280,186,887
E01014202,974,533,255,96,1858
E01014203,644,451,106,35,1236
E01014204,767,515,198,88,1568
E01014205,495,544,136,16,1191
E01014206,433,288,165,153,1039
E01014207,457,358,217,15,1047
E01014208,322,249,89,296,956
E01014209,492,386,197,137,1212
E01014210,299,302,78,501,1180
E01014211,228,116,71,749,1164
E01014212,281,195,64,513,1053
E01014213,295,270,95,326,986
E01014214,523,693,46,10,1272
E01014215,513,545,119,49,1226
E01014216,496,566,69,61,1192
E01014217,223,164,80,619,1086
E01014218,270,202,102,567,1141
E01014219,482,363,118,126,1089
E01014220,266,197,109,660,1232
E01014221,287,184,115,621,1207
E01014222,209,183,103,633,1128
E01014223,208,184,113,734,1239
E01014224,226,233,91,601,1151
E01014225,551,588,89,15,1243
E01014226,383,349,98,403,1233
E01014228,414,680,41,14,1149
E01014229,331,121,88,750,1290
E01014230,458,435,120,217,1230
E01014231,368,153,245,553,1319
E01014233,414,606,72,104,1196
E01014234,329,174,94,545,1142
E01014235,360,353,133,448,1294
E01014236,625,262,246,601,1734
E01014237,344,205,89,614,1252
E01014238,274,166,92,628,1160
E01014239,560,465,62,108,1195
E01014240,492,348,109,255,1204
E01014241,498,348,164,225,1235
E01014242,338,265,82,461,1146
E01014243,589,474,78,52,1193
E01014244,202,175,82,636,1095
E01014245,592,469,212,80,1353
E01014246,418,318,170,372,1278
E01014247,376,406,379,184,1345
E01014248,456,287,297,141,1181
E01014249,294,374,436,217,1321
E01014250,159,218,202,312,891
E01014251,393,220,408,448,1469
E01014252,480,274,393,174,1321
E01014253,623,384,106,148,1261
E01014254,232,321,457,145,1155
E01014255,361,215,271,483,1330
E01014256,335,326,248,408,1317
E01014257,410,445,99,230,1184
E01014258,814,275,56,32,1177
E01014259,534,482,73,129,1218
E01014260,307,366,45,362,1080
E01014261,155,150,82,635,1022
E01014262,350,261,59,371,1041
E01014263,429,208,85,532,1254
E01014264,834,459,89,118,1500
E01014265,610,578,101,13,1302
E01014266,333,269,187,205,994
E01014267,872,533,312,182,1899
E01014268,679,263,215,502,1659
E01014269,295,219,131,555,1200
E01014270,575,563,59,77,1274
E01014271,569,432,100,107,1208
E01014272,558,540,121,9,1228
E01014273,326,228,336,84,974
E01014274,432,285,262,434,1413
E01014275,254,192,224,480,1150
E01014276,492,293,309,167,1261
E01014277,524,456,208,115,1303
E01014278,433,393,137,126,1089
E01014279,535,333,398,122,1388
E01014280,515,476,80,58,1129
E01014281,257,202,589,286,1334
E01014282,138,153,257,283,831
E01014283,317,224,1211,89,1841
E01014284,96,91,1112,58,1357
E01014285,590,314,545,261,1710
E01014286,290,276,275,191,1032
E01014287,235,214,291,394,1134
E01014288,510,364,388,69,1331
E01014289,510,450,255,91,1306
E01014290,428,309,340,148,1225
E01014291,452,253,205,212,1122
E01014292,525,440,312,52,1329
E01014293,380,262,633,106,1381
E01014294,356,225,202,264,1047
E01014295,465,500,276,185,1426
E01014296,503,385,90,187,1165
E01014297,637,346,52,30,1065
E01014298,408,216,94,510,1228
E01014299,668,423,57,32,1180
E01014300,369,238,154,357,1118
E01014301,957,245,70,81,1353
E01014302,421,356,246,479,1502
E01014303,811,376,73,32,1292
E01014304,584,481,113,22,1200
E01014305,365,320,201,73,959
E01014306,351,287,248,163,1049
E01014307,374,318,163,107,962
E01014308,537,719,82,112,1450
E01014309,296,264,158,283,1001
E01014310,884,490,122,49,1545
E01014311,344,412,141,206,1103
E01014312,431,459,180,79,1149
E01014313,298,334,158,542,1332
E01014314,668,371,63,35,1137
E01014315,491,623,56,11,1181
E01014316,230,126,84,650,1090
E01014317,299,126,86,686,1197
E01014318,705,438,49,6,1198
E01014319,598,322,66,189,1175
E01014320,631,339,64,9,1043
E01014321,502,444,216,43,1205
E01014322,505,318,171,290,1284
E01014323,439,265,250,80,1034
E01014324,476,627,125,33,1261
E01014325,649,389,42,36,1116
E01014326,676,499,38,28,1241
E01014327,498,372,251,56,1177
E01014328,360,313,366,140,1179
E01014329,527,290,216,199,1232
E01014330,204,177,300,654,1335
E01014331,302,263,123,477,1165
E01014332,437,717,81,229,1464
E01014333,623,440,70,72,1205
E01014334,376,499,62,368,1305
E01014335,608,522,133,131,1394
E01014336,343,222,116,553,1234
E01014337,442,355,131,427,1355
E01014338,544,412,149,150,1255
E01014339,471,297,489,109,1366
E01014340,556,292,398,270,1516
E01014341,505,291,286,385,1467
E01014342,324,170,89,553,1136
E01014343,536,302,404,193,1435
E01014344,435,293,94,342,1164
E01014345,340,274,410,397,1421
E01014346,520,733,79,41,1373
E01014347,672,467,51,8,1198
E01014348,440,630,63,28,1161
E01014349,456,643,102,13,1214
E01014350,542,547,58,16,1163
E01014351,591,415,96,6,1108
E01014352,606,492,44,39,1181
E01014353,499,318,107,377,1301
E01014354,312,303,285,463,1363
E01014355,597,428,331,85,1441
E01014356,503,453,333,80,1369
E01014357,441,279,161,312,1193
E01014358,295,158,128,458,1039
E01014359,542,432,147,290,1411
E01014360,852,424,194,64,1534
E01014361,343,258,421,163,1185
E01014362,599,544,22,14,1179
E01014363,405,650,34,89,1178
E01014364,515,386,59,166,1126
E01014365,436,627,68,132,1263
E01014366,280,318,99,708,1405
E01014367,198,183,108,633,1122
E01014368,367,241,195,430,1233
E01014369,382,448,76,166,1072
E01014370,154,220,773,444,1591
E01014371,261,349,898,191,1699
E01014372,257,300,1000,289,1846
E01014373,485,389,161,195,1230
E01014374,411,471,88,171,1141
E01014375,398,496,142,16,1052
E01014376,479,646,103,10,1238
E01014377,396,658,119,17,1190
E01014379,590,667,295,121,1673
E01014380,277,551,148,14,990
E01014381,262,596,286,16,1160
E01014382,766,897,179,126,1968
E01014383,339,379,72,53,843
E01014384,460,471,93,73,1097
E01014385,460,467,96,59,1082
E01014386,448,349,58,78,933
E01014387,330,330,186,148,994
E01014388,353,508,157,31,1049
E01014389,373,403,188,175,1139
E01014390,258,136,101,634,1129
E01014391,447,506,134,122,1209
E01014392,329,392,68,62,851
E01014393,463,467,80,17,1027
E01014394,596,519,108,130,1353
E01014395,437,596,33,4,1070
E01014396,423,486,191,41,1141
E01014397,484,548,35,7,1074
E01014398,495,509,101,95,1200
E01014399,555,517,101,151,1324
E01014400,663,536,258,132,1589
E01014401,462,319,104,393,1278
E01014402,580,491,136,150,1357
E01014403,470,489,141,307,1407
E01014404,421,340,97,448,1306
E01014405,583,526,560,56,1725
E01014407,103,83,389,364,939
E01014409,418,379,165,311,1273
E01014410,581,625,154,38,1398
E01014411,647,552,435,60,1694
E01014412,430,385,367,30,1212
E01014413,341,578,218,15,1152
E01014414,197,245,577,318,1337
E01014415,622,542,395,28,1587
E01014416,480,537,164,192,1373
E01014417,532,728,191,36,1487
E01014418,421,526,111,82,1140
E01014419,443,307,93,125,968
E01014420,634,310,203,89,1236
E01014421,610,427,55,39,1131
E01014422,555,565,85,25,1230
E01014423,482,369,234,24,1109
E01014424,562,653,116,42,1373
E01014425,642,695,154,146,1637
E01014426,383,408,88,296,1175
E01014427,351,222,419,134,1126
E01014428,427,307,241,90,1065
E01014429,547,384,195,114,1240
E01014430,416,497,159,192,1264
E01014431,398,245,189,187,1019
E01014432,340,311,242,166,1059
E01014433,384,178,174,281,1017
E01014434,662,552,227,99,1540
E01014435,262,240,944,23,1469
E01014436,340,290,581,157,1368
E01014437,386,276,163,335,1160
E01014438,366,225,214,249,1054
E01014439,498,451,96,307,1352
E01014440,752,522,163,68,1505
E01014441,567,644,133,6,1350
E01014442,721,392,192,66,1371
E01014443,618,500,136,33,1287
E01014444,641,350,128,31,1150
E01014445,521,246,149,356,1272
E01014446,452,326,98,63,939
E01014447,551,369,81,78,1079
E01014448,460,344,136,308,1248
E01014449,631,276,137,66,1110
E01014450,366,220,80,340,1006
E01014451,490,290,137,91,1008
E01014452,431,537,83,209,1260
E01014453,446,515,47,22,1030
E01014454,534,506,33,11,1084
E01014455,407,298,139,237,1081
E01014456,502,411,180,148,1241
E01014457,434,551,131,50,1166
E01014458,270,153,124,465,1012
E01014459,424,397,122,208,1151
E01014460,384,503,57,33,977
E01014461,308,184,157,270,919
E01014462,271,164,96,574,1105
E01014463,336,157,99,461,1053
E01014464,244,129,175,432,980
E01014465,511,388,247,65,1211
E01014466,256,229,203,321,1009
E01014467,432,370,533,72,1407
E01014468,361,306,611,46,1324
E01014469,411,296,81,203,991
E01014470,709,406,95,42,1252
E01014471,590,356,176,104,1226
E01014472,565,405,89,54,1113
E01014473,325,321,744,19,1409
E01014474,290,222,366,163,1041
E01014475,320,278,772,104,1474
E01014476,312,334,612,26,1284
E01014477,487,616,113,28,1244
E01014478,314,199,77,325,915
E01014479,355,523,229,58,1165
E01014480,341,283,221,157,1002
E01014481,254,238,650,31,1173
E01014482,354,456,166,5,981
E01014483,310,305,466,125,1206
E01014484,289,261,820,50,1420
E01014485,506,367,413,177,1463
E01014486,365,237,689,519,1810
E01014487,400,343,949,56,1748
E01014488,469,293,570,293,1625
E01014489,437,279,873,484,2073
E01014491,597,345,554,52,1548
E01014492,318,322,137,449,1226
E01014493,475,272,139,306,1192
E01014494,554,444,160,80,1238
E01014495,511,438,177,245,1371
E01014496,532,290,310,141,1273
E01014497,397,253,110,452,1212
E01014498,333,266,86,483,1168
E01014499,529,258,156,279,1222
E01014500,538,393,282,70,1283
E01014501,499,490,158,266,1413
E01014502,485,374,254,321,1434
E01014504,547,336,342,53,1278
E01014505,625,318,511,67,1521
E01014506,643,528,77,30,1278
E01014507,536,261,543,33,1373
E01014508,420,261,439,34,1154
E01014509,728,278,687,46,1739
E01014510,563,319,642,44,1568
E01014511,480,277,325,10,1092
E01014512,504,338,281,67,1190
E01014513,581,414,204,19,1218
E01014514,527,346,703,28,1604
E01014515,366,367,94,340,1167
E01014516,254,167,66,577,1064
E01014517,257,167,87,427,938
E01014518,595,385,228,150,1358
E01014519,455,292,118,184,1049
E01014520,551,602,108,64,1325
E01014521,428,367,110,121,1026
E01014522,445,248,122,418,1233
E01014523,446,439,100,71,1056
E01014524,551,403,127,98,1179
E01014525,653,330,221,57,1261
E01014526,419,286,96,378,1179
E01014527,421,300,198,212,1131
E01014528,623,299,308,17,1247
E01014529,476,140,139,363,1118
E01014530,530,237,303,92,1162
E01014531,582,333,400,50,1365
E01014532,542,266,198,176,1182
E01014533,599,338,242,16,1195
E01014534,609,359,235,82,1285
E01014535,764,529,173,87,1553
E01014536,370,327,92,379,1168
E01014537,595,351,211,252,1409
E01014538,183,137,1239,171,1730
E01014539,332,314,909,91,1646
E01014540,182,178,1397,468,2225
E01014542,147,117,1512,173,1949
E01014544,220,310,497,13,1040
E01014545,282,337,744,79,1442
E01014546,172,206,994,19,1391
E01014547,392,349,743,19,1503
E01014548,303,292,723,169,1487
E01014549,193,212,433,219,1057
E01014550,472,384,811,79,1746
E01014551,277,138,1208,38,1661
E01014552,310,256,1084,40,1690
E01014553,282,205,1057,24,1568
E01014554,323,208,988,31,1550
E01014555,207,119,744,156,1226
E01014556,400,384,714,29,1527
E01014557,332,294,760,60,1446
E01014558,210,122,1325,70,1727
E01014559,382,388,946,47,1763
E01014560,312,252,893,68,1525
E01014561,365,264,819,75,1523
E01014562,256,182,1233,22,1693
E01014563,282,173,1099,104,1658
E01014564,427,306,423,241,1397
E01014565,443,211,456,210,1320
E01014566,479,236,593,67,1375
E01014567,608,244,623,62,1537
E01014568,528,261,666,338,1793
E01014569,585,330,516,206,1637
E01014570,578,312,401,115,1406
E01014571,420,299,314,298,1331
E01014572,550,238,611,71,1470
E01014573,608,362,499,52,1521
E01014574,468,225,657,273,1623
E01014575,451,267,308,164,1190
E01014576,636,424,318,139,1517
E01014577,523,427,262,33,1245
E01014578,551,287,130,308,1276
E01014579,439,303,137,167,1046
E01014580,317,176,100,568,1161
E01014581,280,161,120,574,1135
E01014582,343,181,127,375,1026
E01014583,327,147,85,475,1034
E01014584,343,143,86,398,970
E01014585,258,105,139,745,1247
E01014586,399,452,200,193,1244
E01014587,355,303,204,230,1092
E01014588,418,390,365,211,1384
E01014589,198,163,122,582,1065
E01014590,371,388,486,171,1416
E01014591,602,571,232,75,1480
E01014592,464,359,322,162,1307
E01014593,240,156,78,561,1035
E01014594,210,201,90,590,1091
E01014595,388,251,84,399,1122
E01014596,313,285,84,482,1164
E01014597,289,287,64,418,1058
E01014598,513,627,68,29,1237
E01014599,491,373,116,34,1014
E01014600,465,328,100,203,1096
E01014601,463,412,121,272,1268
E01014602,375,284,122,615,1396
E01014603,697,389,297,336,1719
E01014605,239,153,164,690,1246
E01014607,544,412,103,18,1077
E01014608,513,249,121,419,1302
E01014609,592,304,171,260,1327
E01014610,318,187,232,430,1167
E01014611,472,560,44,32,1108
E01014612,495,448,122,131,1196
E01014613,543,453,177,70,1243
E01014614,477,418,79,53,1027
E01014615,472,646,84,14,1216
E01014616,379,517,240,69,1205
E01014617,535,473,68,8,1084
E01014618,510,605,88,5,1208
E01014619,473,337,299,35,1144
E01014620,433,588,99,23,1143
E01014621,458,330,241,95,1124
E01014622,487,371,277,74,1209
E01014623,512,317,260,165,1254
E01014624,499,296,202,291,1288
E01014626,545,321,377,311,1554
E01014627,718,468,365,119,1670
E01014629,389,203,151,321,1064
E01014630,384,133,449,751,1717
E01014631,365,296,150,167,978
E01014632,390,338,355,169,1252
E01014633,477,405,217,149,1248
E01014634,406,301,742,57,1506
E01014635,538,373,622,59,1592
E01014636,270,241,149,452,1112
E01014637,381,250,511,31,1173
E01014638,220,189,129,721,1259
E01014639,169,107,63,694,1033
E01014640,350,252,79,429,1110
E01014641,450,455,95,201,1201
E01014642,415,358,152,239,1164
E01014643,334,189,80,456,1059
E01014644,450,292,81,378,1201
E01014645,507,431,155,205,1298
E01014646,542,419,120,191,1272
E01014647,419,191,125,496,1231
E01014648,623,353,259,58,1293
E01014649,531,505,221,36,1293
E01014650,538,390,114,197,1239
E01014651,637,427,227,12,1303
E01014653,245,151,398,928,1722
E01014654,286,166,516,665,1633
E01014655,365,266,725,415,1771
E01014658,95,57,144,1078,1374
E01014659,430,156,385,571,1542
E01014660,328,215,202,496,1241
E01014661,399,235,209,387,1230
E01014662,431,304,372,166,1273
E01014663,362,207,166,409,1144
E01014664,434,300,266,290,1290
E01014665,665,501,296,78,1540
E01014666,650,419,230,62,1361
E01014667,561,317,385,12,1275
E01014668,492,347,439,12,1290
E01014669,370,276,568,35,1249
E01014670,430,281,508,22,1241
E01014671,359,212,667,83,1321
E01014672,447,379,808,76,1710
E01014673,573,319,412,85,1389
E01014674,565,322,220,159,1266
E01014675,537,360,245,72,1214
E01014676,474,401,141,229,1245
E01014677,557,330,288,39,1214
E01014678,543,442,233,56,1274
E01014679,610,380,189,67,1246
E01014680,534,386,90,11,1021
E01014681,621,331,548,243,1743
E01014682,529,337,255,53,1174
E01014683,449,266,370,283,1368
E01014684,517,202,613,53,1385
E01014685,451,194,173,348,1166
E01014686,553,332,201,197,1283
E01014687,505,314,283,151,1253
E01014688,341,187,188,526,1242
E01014689,210,75,132,702,1119
E01014690,594,239,208,472,1513
E01014691,461,408,159,486,1514
E01014692,385,176,233,404,1198
E01014693,527,444,191,26,1188
E01014694,468,302,210,299,1279
E01014695,369,256,351,472,1448
E01014696,587,269,435,59,1350
E01014698,597,285,579,103,1564
E01014699,337,175,444,252,1208
E01014700,540,460,305,23,1328
E01014701,478,307,556,83,1424
E01014702,533,508,63,68,1172
E01014703,445,217,105,388,1155
E01014704,659,359,145,272,1435
E01014705,486,509,53,127,1175
E01014706,299,258,108,360,1025
E01014707,556,596,83,90,1325
E01014708,634,578,112,131,1455
E01014709,318,512,183,9,1022
E01014710,318,381,199,23,921
E01014711,379,560,69,14,1022
E01014712,365,363,97,122,947
E01014713,403,535,120,13,1071
E01014714,440,501,97,4,1042
E01014715,590,527,90,29,1236
E01014716,505,591,80,11,1187
E01014717,413,475,71,164,1123
E01014718,450,528,156,16,1150
E01014719,455,364,256,51,1126
E01014720,478,395,166,273,1312
E01014721,506,460,102,126,1194
E01014722,641,547,68,8,1264
E01014723,556,467,78,13,1114
E01014725,594,596,59,15,1264
E01014726,190,145,57,813,1205
E01014727,303,172,80,565,1120
E01014729,358,150,215,360,1083
E01014730,460,139,541,225,1365
E01014731,500,193,464,178,1335
E01014732,505,233,525,119,1382
E01014733,570,251,418,178,1417
E01014734,514,251,390,116,1271
E01014735,612,414,293,95,1414
E01014736,543,290,391,331,1555
E01014737,542,618,52,11,1223
E01014738,553,358,103,99,1113
E01014739,484,605,72,59,1220
E01014740,466,429,115,32,1042
E01014741,401,501,153,101,1156
E01014742,425,643,117,26,1211
E01014744,441,598,91,17,1147
E01014745,433,649,81,85,1248
E01014746,450,399,121,152,1122
E01014747,381,498,197,54,1130
E01014748,327,317,192,70,906
E01014749,534,432,90,17,1073
E01014750,512,368,269,133,1282
E01014751,508,367,173,239,1287
E01014752,577,518,147,9,1251
E01014753,577,398,204,258,1437
E01014754,320,384,269,26,999
E01014755,343,391,231,69,1034
E01014756,616,467,208,56,1347
E01014757,674,367,117,35,1193
E01014758,384,509,106,16,1015
E01014759,441,657,66,0,1164
E01014760,501,507,89,118,1215
E01014761,669,503,167,3,1342
E01014762,603,444,116,4,1167
E01014763,733,294,253,128,1408
E01014764,478,504,153,201,1336
E01014765,613,650,175,51,1489
E01014766,345,558,135,17,1055
E01014767,439,584,92,11,1126
E01014769,905,531,258,106,1800
E01014770,438,662,71,24,1195
E01014771,480,595,81,51,1207
E01014772,383,633,104,35,1155
E01014773,721,362,203,22,1308
E01014774,610,537,161,51,1359
E01014775,536,403,71,6,1016
E01014776,541,444,66,1,1052
E01014777,575,441,142,35,1193
E01014778,468,625,17,10,1120
E01014779,395,413,94,77,979
E01014780,482,462,174,154,1272
E01014781,489,525,110,213,1337
E01014782,521,591,67,5,1184
E01014783,542,450,142,173,1307
E01014784,536,595,132,38,1301
E01014785,481,656,62,22,1221
E01014786,495,314,136,358,1303
E01014787,720,571,112,138,1541
E01014789,423,603,107,1,1134
E01014790,514,539,61,86,1200
E01014792,565,710,155,116,1546
E01014793,620,514,103,0,1237
E01014794,636,671,42,74,1423
E01014795,499,282,98,215,1094
E01014796,605,621,94,59,1379
E01014797,602,448,124,248,1422
E01014798,641,545,51,11,1248
E01014799,382,255,554,69,1260
E01014800,270,170,664,134,1238
E01014801,186,417,518,75,1196
E01014802,303,254,546,81,1184
E01014803,489,553,150,23,1215
E01014804,397,428,173,92,1090
E01014805,403,813,64,14,1294
E01014806,305,363,419,88,1175
E01014807,495,308,490,63,1356
E01014808,526,457,154,28,1165
E01014809,534,326,385,90,1335
E01014810,339,217,289,239,1084
E01014811,506,347,204,242,1299
E01014812,419,598,149,37,1203
E01014813,678,486,158,53,1375
E01014815,441,307,124,189,1061
E01014816,553,561,117,17,1248
E01014817,492,616,121,38,1267
E01014818,668,694,92,9,1463
E01014819,541,669,88,21,1319
E01014820,364,517,154,171,1206
E01014821,568,187,177,7,939
E01014822,736,318,74,2,1130
E01014823,606,319,109,2,1036
E01014824,586,432,122,71,1211
E01014825,490,399,107,3,999
E01014826,664,266,250,7,1187
E01014827,443,205,210,199,1057
E01014828,340,256,193,271,1060
E01014829,393,131,305,569,1398
E01014830,532,264,314,107,1217
E01014831,192,59,63,633,947
E01014832,234,116,82,671,1103
E01014833,227,138,99,653,1117
E01014834,379,241,132,334,1086
E01014835,429,331,128,248,1136
E01014836,466,459,195,73,1193
E01014838,496,459,140,30,1125
E01014839,650,271,209,75,1205
E01014840,409,445,173,85,1112
E01014841,380,382,663,43,1468
E01014842,280,370,565,16,1231
E01014843,400,395,301,21,1117
E01014844,234,216,534,91,1075
E01014845,415,507,95,28,1045
E01014846,438,499,223,46,1206
E01014847,633,579,156,18,1386
E01014848,419,503,91,68,1081
E01014849,520,678,82,27,1307
E01014850,703,650,149,99,1601
E01014851,927,626,221,179,1953
E01014852,589,455,114,78,1236
E01014853,517,507,195,112,1331
E01014854,424,547,144,6,1121
E01014855,588,516,80,12,1196
E01014856,587,370,129,117,1203
E01014857,528,473,97,118,1216
E01014858,681,444,225,28,1378
E01014859,601,465,101,57,1224
E01014860,528,424,98,162,1212
E01014861,672,584,187,94,1537
E01014862,1060,738,177,172,2147
E01014863,463,606,72,136,1277
E01014864,458,649,127,27,1261
E01014865,584,512,146,265,1507
E01014866,630,561,73,60,1324
E01014867,401,440,58,134,1033
E01014868,719,393,94,46,1252
E01014869,502,554,200,104,1360
E01014870,514,535,195,98,1342
E01014871,399,418,76,122,1015
E01014872,605,122,516,24,1267
E01014873,720,322,119,15,1176
E01014874,635,206,258,0,1099
E01014875,582,167,626,26,1401
E01014876,703,114,460,16,1293
E01014877,725,203,232,6,1166
E01014878,892,259,434,19,1604
E01014879,629,478,276,3,1386
E01014880,787,168,309,85,1349
E01014881,917,170,343,5,1435
E01014882,621,156,363,424,1564
E01014883,501,244,210,28,983
E01014884,538,332,184,149,1203
E01014885,782,583,99,28,1492
E01014886,480,480,188,350,1498
E01014887,511,526,117,21,1175
E01014888,505,547,92,31,1175
E01014889,636,510,96,11,1253
E01014890,642,653,231,118,1644
E01014891,457,467,416,65,1405
E01014892,649,284,257,67,1257
E01014893,660,340,158,13,1171
E01014894,555,336,115,6,1012
E01014895,628,290,163,10,1091
E01014896,610,227,135,5,977
E01014897,563,558,63,2,1186
E01014898,682,506,96,55,1339
E01014899,579,513,174,91,1357
E01014900,532,407,163,90,1192
E01014901,598,596,101,21,1316
E01014902,507,499,51,2,1059
E01014903,534,606,71,29,1240
E01014904,335,439,234,222,1230
E01014905,642,431,291,17,1381
E01014906,364,267,259,443,1333
E01014907,465,394,382,74,1315
E01014908,470,438,180,16,1104
E01014909,447,326,463,24,1260
E01014910,479,287,278,140,1184
E01014911,481,550,66,32,1129
E01014912,694,648,110,18,1470
E01014913,619,612,64,26,1321
E01014914,521,310,90,385,1306
E01014915,546,361,173,175,1255
E01014916,536,391,174,132,1233
E01014917,507,493,104,99,1203
E01014918,514,581,93,24,1212
E01014919,428,562,47,7,1044
E01014920,507,512,52,61,1132
E01014921,554,468,44,54,1120
E01014922,593,392,116,20,1121
E01014923,479,387,124,165,1155
E01014924,585,349,381,69,1384
E01014925,524,441,104,149,1218
E01014926,384,304,136,473,1297
E01014927,482,369,272,239,1362
E01014928,399,371,117,337,1224
E01014929,689,660,162,117,1628
E01014930,749,499,95,130,1473
E01014931,512,531,103,47,1193
E01014932,605,660,111,32,1408
E01014933,602,478,124,3,1207
E01014934,473,515,52,0,1040
E01014935,665,456,117,12,1250
E01014936,513,372,101,141,1127
E01014937,511,490,58,8,1067
E01014938,652,303,102,162,1219
E01014939,495,277,95,84,951
E01014940,665,306,61,58,1090
E01014941,346,315,92,491,1244
E01014942,450,341,85,313,1189
E01014943,866,196,256,90,1408
E01014944,920,317,151,19,1407
E01014945,621,475,99,172,1367
E01014946,598,286,111,266,1261
E01014947,494,650,53,56,1253
E01014948,401,211,167,555,1334
E01014949,636,329,102,61,1128
E01014950,573,313,217,57,1160
E01014951,514,220,114,208,1056
E01014952,680,516,138,91,1425
E01014953,899,525,169,47,1640
E01014954,575,424,193,76,1268
E01014955,511,521,58,18,1108
E01014956,582,607,87,42,1318
E01014957,472,467,78,15,1032
E01014958,381,278,68,204,931
E01014959,483,381,96,168,1128
E01014960,544,349,186,238,1317
E01014961,510,330,102,334,1276
E01014962,523,657,216,36,1432
E01014963,653,666,174,44,1537
E01014964,753,412,133,13,1311
E01014965,548,590,50,39,1227
E01014966,665,197,289,18,1169
E01014967,875,406,283,14,1578
E01014968,441,353,118,453,1365
E01014969,649,460,121,9,1239
E01014972,734,459,76,87,1356
E01014973,481,355,125,232,1193
E01014974,576,485,131,92,1284
E01014975,544,406,288,67,1305
E01014976,444,359,200,207,1210
E01014977,228,158,272,401,1059
E01014978,652,316,152,65,1185
E01014979,597,431,196,16,1240
E01014980,741,444,124,12,1321
E01014981,938,435,567,245,2185
E01014982,641,340,139,82,1202
E01014983,503,270,117,306,1196
E01014984,522,382,116,168,1188
E01014985,543,481,143,11,1178
E01014986,346,461,154,270,1231
E01014987,437,464,95,11,1007
E01014988,476,512,102,12,1102
E01014989,352,404,113,28,897
E01014990,547,659,64,10,1280
E01014991,611,369,205,533,1718
E01014992,592,495,85,34,1206
E01014993,531,483,107,47,1168
E01014994,595,634,114,116,1459
E01014995,618,694,82,17,1411
E01014996,450,617,200,10,1277
E01014998,442,564,59,167,1232
E01014999,563,639,67,10,1279
E01015000,448,459,146,192,1245
E01015001,597,575,59,68,1299
E01015002,587,373,142,138,1240
E01015003,612,577,101,35,1325
E01015004,721,427,138,114,1400
E01015005,790,331,355,91,1567
E01015006,579,417,98,216,1310
E01015007,503,361,277,243,1384
E01015008,594,428,138,147,1307
E01015009,516,449,100,61,1126
E01015010,528,396,122,13,1059
E01015011,492,389,144,223,1248
E01015012,502,456,47,15,1020
E01015013,549,304,150,20,1023
E01015014,680,399,85,2,1166
E01015015,633,233,239,11,1116
E01015016,530,429,35,4,998
E01015017,513,424,119,82,1138
E01015018,574,407,59,171,1211
E01015019,698,283,219,212,1412
E01015020,536,266,190,187,1179
E01015021,717,441,118,25,1301
E01015022,694,322,230,25,1271
E01015023,467,305,102,432,1306
E01015024,582,336,168,115,1201
E01015025,475,756,76,14,1321
E01015026,441,205,165,448,1259
E01015027,631,414,95,176,1316
E01015028,297,165,119,533,1114
E01015029,419,308,376,269,1372
E01015030,289,228,96,636,1249
E01015031,376,248,733,12,1369
E01015032,204,160,1386,16,1766
E01015033,644,520,100,24,1288
E01015034,521,395,138,19,1073
E01015035,690,407,131,31,1259
E01015036,514,356,162,139,1171
E01015037,470,328,110,190,1098
E01015038,655,502,203,38,1398
E01015039,329,198,214,112,853
E01015040,390,196,140,435,1161
E01015041,543,218,269,113,1143
E01015042,536,261,310,63,1170
E01015043,227,153,309,469,1158
E01015044,431,240,511,53,1235
E01015045,217,114,368,458,1157
E01015046,171,81,144,1100,1496
E01015047,149,98,227,635,1109
E01015048,164,68,196,479,907
E01015049,317,204,923,20,1464
E01015050,144,87,1416,19,1666
E01015051,187,206,1039,16,1448
E01015052,157,127,1246,222,1752
E01015053,109,111,785,213,1218
E01015054,133,37,1039,190,1399
E01015055,422,216,117,386,1141
E01015056,595,336,199,182,1312
E01015057,399,165,149,448,1161
E01015058,308,135,102,516,1061
E01015059,595,235,209,185,1224
E01015060,469,311,176,254,1210
E01015061,349,202,545,100,1196
E01015062,334,211,1156,85,1786
E01015063,517,215,165,277,1174
E01015064,585,696,70,31,1382
E01015065,374,295,261,226,1156
E01015066,610,474,103,27,1214
E01015067,520,712,42,12,1286
E01015068,684,444,106,29,1263
E01015069,475,305,155,329,1264
E01015070,861,390,370,382,2003
E01015071,444,378,223,222,1267
E01015072,461,274,113,388,1236
E01015073,478,195,116,398,1187
E01015074,381,248,118,449,1196
E01015075,385,229,142,377,1133
E01015076,638,380,128,41,1187
E01015077,558,420,136,272,1386
E01015078,252,144,33,507,936
E01015079,566,473,76,104,1219
E01015080,139,50,66,674,929
E01015081,407,228,122,458,1215
E01015082,362,233,102,584,1281
E01015083,365,275,94,470,1204
E01015084,439,395,94,274,1202
E01015085,552,473,102,183,1310
E01015086,252,222,135,503,1112
E01015087,384,198,68,517,1167
E01015088,231,126,85,666,1108
E01015089,541,355,207,227,1330
E01015090,504,489,124,34,1151
E01015091,501,552,59,201,1313
E01015092,386,164,144,191,885
E01015093,486,214,104,349,1153
E01015094,500,204,86,339,1129
E01015095,495,358,91,239,1183
E01015096,340,227,78,517,1162
E01015097,472,983,78,10,1543
E01015098,524,353,361,10,1248
E01015099,552,333,322,6,1213
E01015100,504,292,378,46,1220
E01015101,546,602,80,11,1239
E01015102,622,373,307,72,1374
E01015103,614,319,226,17,1176
E01015104,611,500,77,22,1210
E01015105,598,377,206,16,1197
E01015106,443,332,115,133,1023
E01015107,691,276,121,110,1198
E01015108,628,389,392,64,1473
E01015109,648,358,183,31,1220
E01015110,745,436,103,16,1300
E01015111,749,231,277,43,1300
E01015112,624,345,106,33,1108
E01015113,603,531,90,3,1227
E01015114,591,444,120,53,1208
E01015115,365,296,93,411,1165
E01015116,559,473,100,98,1230
E01015117,544,412,93,158,1207
E01015118,676,515,88,23,1302
E01015119,789,387,117,43,1336
E01015120,567,478,90,89,1224
E01015121,540,641,56,13,1250
E01015122,588,524,135,35,1282
E01015123,486,569,192,45,1292
E01015124,555,604,109,44,1312
E01015125,589,510,61,112,1272
E01015126,420,691,73,24,1208
E01015127,506,476,129,84,1195
E01015128,517,644,189,58,1408
E01015129,586,246,273,56,1161
E01015130,601,354,298,30,1283
E01015131,482,706,79,5,1272
E01015132,404,520,200,135,1259
E01015133,511,717,77,19,1324
E01015134,522,459,216,42,1239
E01015135,629,398,145,96,1268
E01015136,555,486,174,19,1234
E01015137,604,434,153,55,1246
E01015138,562,547,158,16,1283
E01015139,436,450,173,104,1163
E01015140,312,632,258,27,1229
E01015141,622,681,132,46,1481
E01015142,567,336,177,35,1115
E01015143,434,360,141,194,1129
E01015144,422,230,162,341,1155
E01015145,150,39,84,895,1168
E01015146,349,143,167,597,1256
E01015147,488,355,70,107,1020
E01015148,546,212,148,286,1192
E01015149,213,125,71,739,1148
E01015150,479,420,115,160,1174
E01015151,237,132,820,473,1662
E01015152,136,114,410,825,1485
E01015153,159,98,581,579,1417
E01015155,119,59,308,916,1402
E01015156,149,148,497,314,1108
E01015157,423,251,841,295,1810
E01015158,220,371,1104,268,1963
E01015159,449,426,103,359,1337
E01015160,529,612,94,18,1253
E01015161,450,303,123,327,1203
E01015162,401,252,111,430,1194
E01015163,469,354,109,217,1149
E01015164,595,319,352,206,1472
E01015165,683,296,206,63,1248
E01015166,543,214,148,536,1441
E01015167,556,280,327,104,1267
E01015168,580,329,452,149,1510
E01015169,472,321,708,119,1620
E01015170,361,250,339,362,1312
E01015171,422,273,529,138,1362
E01015172,496,291,654,70,1511
E01015173,552,350,425,70,1397
E01015174,671,436,188,25,1320
E01015175,495,246,608,54,1403
E01015176,407,285,189,302,1183
E01015177,567,351,560,13,1491
E01015178,431,260,1100,35,1826
E01015179,348,211,877,32,1468
E01015180,424,172,501,361,1458
E01015181,460,264,926,90,1740
E01015182,542,247,391,319,1499
E01015183,409,445,124,121,1099
E01015184,309,730,93,9,1141
E01015185,372,440,238,99,1149
E01015186,324,329,427,49,1129
E01015187,348,647,218,18,1231
E01015188,379,598,193,76,1246
E01015189,292,350,319,24,985
E01015190,435,561,206,131,1333
E01015191,594,299,297,73,1263
E01015192,429,261,190,239,1119
E01015193,407,380,148,124,1059
E01015194,414,377,115,226,1132
E01015195,536,334,131,199,1200
E01015196,333,171,111,475,1090
E01015197,422,761,74,6,1263
E01015198,489,776,115,9,1389
E01015199,337,775,55,14,1181
E01015200,298,325,125,80,828
E01015201,352,545,137,95,1129
E01015202,590,463,110,43,1206
E01015203,422,524,108,11,1065
E01015204,438,372,298,8,1116
E01015205,593,458,153,29,1233
E01015206,530,380,195,39,1144
E01015207,573,438,211,32,1254
E01015208,532,923,126,12,1593
E01015209,363,357,342,17,1079
E01015210,462,255,245,219,1181
E01015211,519,501,138,18,1176
E01015212,495,292,294,10,1091
E01015213,552,355,145,84,1136
E01015214,465,230,385,51,1131
E01015215,577,336,230,20,1163
E01015216,503,239,360,20,1122
E01015217,304,257,547,97,1205
E01015218,517,307,207,49,1080
E01015219,357,436,236,147,1176
E01015220,498,535,121,19,1173
E01015221,533,391,196,67,1187
E01015222,507,486,173,20,1186
E01015223,584,380,90,12,1066
E01015224,545,405,209,8,1167
E01015225,509,402,140,111,1162
E01015226,488,556,130,0,1174
E01015227,596,548,106,11,1261
E01015228,402,519,332,13,1266
E01015229,333,389,296,66,1084
E01015230,466,678,83,5,1232
E01015231,237,154,651,249,1291
E01015232,287,431,585,18,1321
E01015233,333,289,464,27,1113
E01015234,392,240,284,103,1019
E01015235,278,606,472,18,1374
E01015236,479,469,211,53,1212
E01015237,479,300,206,45,1030
E01015238,440,349,281,30,1100
E01015239,324,395,477,50,1246
E01015240,288,479,397,46,1210
E01015241,480,403,233,51,1167
E01015242,369,230,196,180,975
E01015243,447,492,142,26,1107
E01015244,519,539,112,38,1208
E01015245,355,469,126,172,1122
E01015246,408,502,175,26,1111
E01015247,525,505,227,132,1389
E01015248,456,327,282,121,1186
E01015249,489,244,124,307,1164
E01015250,527,317,255,11,1110
E01015251,459,334,85,48,926
E01015252,746,436,492,130,1804
E01015253,555,223,337,63,1178
E01015254,511,546,81,55,1193
E01015255,203,120,809,117,1249
E01015256,263,319,923,66,1571
E01015257,377,203,161,307,1048
E01015258,550,457,284,265,1556
E01015259,491,275,280,49,1095
E01015260,374,287,536,61,1258
E01015261,534,328,486,153,1501
E01015262,445,297,135,200,1077
E01015263,376,188,158,386,1108
E01015264,470,554,91,32,1147
E01015265,471,542,119,130,1262
E01015266,370,142,140,487,1139
E01015267,291,441,536,6,1274
E01015268,353,561,409,75,1398
E01015269,407,498,392,41,1338
E01015270,378,500,461,65,1404
E01015271,380,740,160,0,1280
E01015272,403,639,418,24,1484
E01015273,516,253,715,135,1619
E01015274,600,377,416,79,1472
E01015275,487,323,583,86,1479
E01015276,602,255,349,56,1262
E01015277,544,292,622,122,1580
E01015279,259,166,989,123,1537
E01015280,328,135,961,130,1554
E01015281,280,112,759,296,1447
E01015282,206,96,1271,111,1684
E01015283,247,187,1154,78,1666
E01015285,211,405,1127,51,1794
E01015286,432,482,611,183,1708
E01015287,330,264,684,344,1622
E01015288,271,109,933,245,1558
E01015289,336,297,898,138,1669
E01015290,234,199,892,167,1492
E01015291,245,706,750,87,1788
E01015292,442,235,572,131,1380
E01015293,412,194,443,168,1217
E01015294,517,170,658,194,1539
E01015295,443,677,122,7,1249
E01015296,377,477,530,108,1492
E01015297,347,500,305,24,1176
E01015298,318,822,144,90,1374
E01015299,569,584,244,5,1402
E01015300,528,568,176,12,1284
E01015301,473,526,152,109,1260
E01015302,584,602,197,176,1559
E01015303,511,463,184,122,1280
E01015304,452,279,135,493,1359
E01015305,482,288,97,363,1230
E01015306,387,407,113,434,1341
E01015307,315,180,92,498,1085
E01015308,517,284,197,348,1346
E01015309,280,153,104,555,1092
E01015310,428,292,161,338,1219
E01015311,426,737,76,27,1266
E01015312,286,202,74,383,945
E01015313,256,83,69,632,1040
E01015314,636,440,107,41,1224
E01015315,762,689,144,11,1606
E01015316,569,585,153,25,1332
E01015317,568,391,174,142,1275
E01015318,562,373,371,44,1350
E01015319,474,341,285,25,1125
E01015320,726,425,206,12,1369
E01015321,583,216,478,252,1529
E01015322,636,455,227,37,1355
E01015323,663,372,202,1,1238
E01015324,551,310,340,54,1255
E01015325,763,379,175,8,1325
E01015326,564,270,759,29,1622
E01015327,516,248,653,177,1594
E01015328,423,203,750,187,1563
E01015329,532,279,567,20,1398
E01015330,592,414,327,87,1420
E01015331,540,281,965,102,1888
E01015332,483,603,176,17,1279
E01015333,597,597,105,22,1321
E01015334,508,495,113,154,1270
E01015335,673,551,157,20,1401
E01015336,658,437,198,46,1339
E01015337,621,428,289,43,1381
E01015338,339,227,112,762,1440
E01015339,475,329,176,292,1272
E01015340,520,627,100,113,1360
E01015341,347,144,127,461,1079
E01015342,606,499,153,9,1267
E01015343,502,362,140,211,1215
E01015344,539,618,289,14,1460
E01015345,493,247,807,38,1585
E01015346,410,290,553,149,1402
E01015348,500,652,387,34,1573
E01015349,525,396,167,84,1172
E01015350,549,541,97,7,1194
E01015351,622,343,167,17,1149
E01015352,645,286,173,43,1147
E01015353,413,286,162,57,918
E01015354,631,388,251,76,1346
E01015355,628,395,282,80,1385
E01015356,598,363,423,78,1462
E01015357,407,299,237,343,1286
E01015358,592,403,460,112,1567
E01015359,458,322,256,304,1340
E01015360,479,320,691,22,1512
E01015361,537,260,207,70,1074
E01015362,353,131,66,386,936
E01015363,655,310,268,54,1287
E01015364,548,544,192,27,1311
E01015365,465,254,570,109,1398
E01015366,369,418,488,147,1422
E01015367,378,282,1030,82,1772
E01015368,302,734,516,12,1564
E01015369,368,569,518,40,1495
E01015370,439,365,558,7,1369
E01015371,289,166,774,159,1388
E01015372,326,411,628,207,1572
E01015373,524,221,608,37,1390
E01015374,365,241,1328,94,2028
E01015375,337,224,995,79,1635
E01015376,477,215,793,19,1504
E01015377,490,264,511,98,1363
E01015378,649,282,455,35,1421
E01015379,407,190,119,316,1032
E01015380,575,658,145,103,1481
E01015381,445,297,137,408,1287
E01015382,664,226,320,199,1409
E01015383,485,564,206,33,1288
E01015384,360,112,95,551,1118
E01015385,500,340,210,383,1433
E01015386,334,208,456,393,1391
E01015387,541,398,196,114,1249
E01015388,428,335,221,85,1069
E01015389,533,414,266,30,1243
E01015390,557,290,357,166,1370
E01015391,651,414,134,20,1219
E01015392,593,345,235,16,1189
E01015393,495,203,181,109,988
E01015394,669,377,217,20,1283
E01015395,403,544,105,85,1137
E01015396,561,674,48,9,1292
E01015397,655,451,49,4,1159
E01015398,575,493,39,5,1112
E01015399,460,701,73,5,1239
E01015400,538,668,48,4,1258
E01015401,563,654,51,1,1269
E01015402,367,614,342,30,1353
E01015403,245,1051,330,8,1634
E01015404,316,887,261,16,1480
E01015405,451,715,282,6,1454
E01015406,302,736,383,79,1500
E01015407,586,512,136,11,1245
E01015408,521,384,88,73,1066
E01015409,398,183,175,364,1120
E01015410,660,247,250,54,1211
E01015411,600,358,106,34,1098
E01015412,567,480,46,5,1098
E01015413,576,296,135,168,1175
E01015414,494,454,151,111,1210
E01015415,313,95,189,371,968
E01015416,580,292,96,74,1042
E01015417,509,334,119,243,1205
E01015418,670,355,161,68,1254
E01015419,678,605,143,22,1448
E01015420,495,274,91,370,1230
E01015421,440,563,78,131,1212
E01015422,715,249,170,30,1164
E01015423,580,362,388,373,1703
E01015424,510,412,180,31,1133
E01015425,460,447,104,80,1091
E01015426,371,247,119,329,1066
E01015427,490,203,367,167,1227
E01015428,595,689,351,167,1802
E01015429,505,311,171,332,1319
E01015430,252,176,155,559,1142
E01015431,373,416,121,1,911
E01015432,561,579,141,99,1380
E01015433,520,649,94,3,1266
E01015434,595,690,48,7,1340
E01015435,659,214,154,171,1198
E01015436,543,394,117,52,1106
E01015437,570,443,59,27,1099
E01015438,661,426,155,24,1266
E01015439,609,280,230,290,1409
E01015440,719,564,285,34,1602
E01015441,629,350,341,212,1532
E01015442,532,266,157,547,1502
E01015443,551,517,252,128,1448
E01015444,696,363,229,99,1387
E01015445,788,663,126,7,1584
E01015446,547,367,154,205,1273
E01015447,614,559,116,17,1306
E01015448,593,417,135,89,1234
E01015449,597,268,213,288,1366
E01015450,646,494,161,114,1415
E01015451,550,577,99,15,1241
E01015452,566,731,125,44,1466
E01015453,463,488,551,59,1561
E01015454,533,412,474,73,1492
E01015455,554,736,259,40,1589
E01015456,405,352,279,400,1436
E01015457,427,543,306,100,1376
E01015458,477,644,99,4,1224
E01015459,490,745,199,7,1441
E01015460,602,354,355,36,1347
E01015461,567,271,328,47,1213
E01015462,562,261,356,92,1271
E01015463,531,402,298,51,1282
E01015464,572,556,139,2,1269
E01015465,512,323,334,285,1454
E01015466,475,476,307,131,1389
E01015468,328,509,518,171,1526
E01015471,795,252,197,18,1262
E01015472,1201,247,386,188,2022
E01015473,579,579,133,110,1401
E01015474,567,463,147,174,1351
E01015475,662,251,724,95,1732
E01015476,390,137,847,557,1931
E01015477,457,164,514,146,1281
E01015478,546,297,287,71,1201
E01015479,607,316,313,59,1295
E01015480,708,221,907,23,1859
E01015481,783,404,128,99,1414
E01015482,598,424,56,6,1084
E01015483,513,668,62,16,1259
E01015484,568,548,81,15,1212
E01015485,680,320,172,28,1200
E01015486,530,483,102,88,1203
E01015487,696,486,121,25,1328
E01015488,417,260,87,393,1157
E01015489,631,419,89,29,1168
E01015490,560,279,122,80,1041
E01015491,420,238,98,456,1212
E01015492,472,270,85,254,1081
E01015493,568,344,481,33,1426
E01015494,490,235,771,25,1521
E01015496,547,198,601,34,1380
E01015497,560,264,368,47,1239
E01015498,710,377,308,37,1432
E01015499,702,259,82,7,1050
E01015500,745,253,187,39,1224
E01015501,682,327,101,12,1122
E01015502,492,140,166,395,1193
E01015503,412,126,141,379,1058
E01015504,701,225,78,67,1071
E01015505,595,178,219,172,1164
E01015506,452,244,109,395,1200
E01015507,295,94,56,699,1144
E01015508,365,174,134,433,1106
E01015509,624,288,306,100,1318
E01015510,527,305,469,236,1537
E01015511,602,307,331,53,1293
E01015512,862,181,187,8,1238
E01015513,776,224,217,17,1234
E01015514,418,568,49,18,1053
E01015515,646,432,92,2,1172
E01015516,414,353,88,250,1105
E01015517,453,699,68,18,1238
E01015518,774,160,165,18,1117
E01015519,377,250,118,456,1201
E01015520,343,423,131,97,994
E01015521,608,501,63,21,1193
E01015522,501,445,160,105,1211
E01015523,495,538,171,70,1274
E01015524,502,226,91,118,937
E01015525,812,263,160,18,1253
E01015526,667,264,144,94,1169
E01015527,564,289,124,342,1319
E01015528,442,203,105,652,1402
E01015529,538,433,159,160,1290
E01015530,533,258,72,464,1327
E01015532,549,320,244,24,1137
E01015533,488,701,76,20,1285
E01015534,522,526,423,192,1663
E01015535,574,529,96,17,1216
E01015536,886,658,138,228,1910
E01015537,514,199,88,529,1330
E01015538,406,195,104,692,1397
E01015539,564,263,103,315,1245
E01015540,449,201,135,612,1397
E01015541,466,182,135,607,1390
E01015542,284,173,110,551,1118
E01015543,390,365,78,282,1115
E01015544,284,165,78,745,1272
E01015545,216,117,69,772,1174
E01015546,235,118,68,771,1192
E01015547,560,424,171,106,1261
E01015548,563,472,157,53,1245
E01015549,694,539,149,31,1413
E01015550,700,668,152,49,1569
E01015551,586,512,88,39,1225
E01015552,902,419,203,85,1609
E01015553,770,278,207,20,1275
E01015554,458,476,41,213,1188
E01015555,497,420,114,201,1232
E01015556,652,431,152,66,1301
E01015557,560,464,135,37,1196
E01015558,247,156,68,720,1191
E01015559,482,504,114,141,1241
E01015560,675,470,109,45,1299
E01015561,668,284,252,8,1212
E01015562,690,179,155,141,1165
E01015563,807,264,133,9,1213
E01015564,746,349,152,16,1263
E01015565,654,221,201,190,1266
E01015566,787,254,224,14,1279
E01015567,645,303,269,8,1225
E01015568,614,288,233,40,1175
E01015569,411,270,111,435,1227
E01015570,416,165,163,513,1257
E01015571,584,436,165,100,1285
E01015572,215,113,87,550,965
E01015573,503,153,128,812,1596
E01015574,590,446,164,89,1289
E01015575,207,120,80,475,882
E01015576,497,637,98,84,1316
E01015578,610,263,320,112,1305
E01015579,688,287,249,33,1257
E01015580,529,332,87,357,1305
E01015581,711,401,114,16,1242
E01015582,703,443,345,53,1544
E01015583,875,441,245,172,1733
E01015584,414,599,62,142,1217
E01015585,624,442,122,97,1285
E01015586,434,701,58,32,1225
E01015587,547,472,133,412,1564
E01015588,557,523,131,266,1477
E01015589,517,607,138,63,1325
E01015590,324,378,165,140,1007
E01015591,546,428,111,115,1200
E01015592,423,295,263,194,1175
E01015593,325,158,240,352,1075
E01015594,500,327,308,248,1383
E01015595,386,221,180,366,1153
E01015596,388,215,309,296,1208
E01015597,341,124,161,529,1155
E01015598,558,487,138,91,1274
E01015599,238,205,696,333,1472
E01015600,337,419,538,88,1382
E01015601,554,419,419,42,1434
E01015602,300,297,886,153,1636
E01015603,421,338,767,188,1714
E01015604,506,281,438,129,1354
E01015605,450,257,178,374,1259
E01015606,511,444,218,233,1406
E01015607,289,137,135,509,1070
E01015608,426,300,194,322,1242
E01015609,276,114,175,669,1234
E01015610,429,172,174,433,1208
E01015611,387,361,414,493,1655
E01015612,506,281,711,190,1688
E01015613,276,248,309,322,1155
E01015614,539,236,479,116,1370
E01015615,443,371,210,243,1267
E01015616,346,129,315,500,1290
E01015617,478,333,210,43,1064
E01015618,335,280,119,145,879
E01015619,663,333,222,386,1604
E01015620,669,551,125,25,1370
E01015621,519,330,611,162,1622
E01015622,755,247,672,285,1959
E01015623,556,431,251,168,1406
E01015624,560,303,363,93,1319
E01015626,262,57,601,128,1048
E01015627,498,555,284,100,1437
E01015628,654,295,395,87,1431
E01015629,676,532,73,81,1362
E01015630,594,407,122,133,1256
E01015631,544,385,78,49,1056
E01015632,445,243,575,262,1525
E01015633,531,388,233,612,1764
E01015634,443,275,216,496,1430
E01015635,603,598,73,12,1286
E01015636,409,404,85,53,951
E01015637,428,111,239,293,1071
E01015638,475,496,96,127,1194
E01015639,298,107,285,504,1194
E01015640,524,217,206,197,1144
E01015641,349,238,202,161,950
E01015642,290,117,224,442,1073
E01015643,480,263,161,175,1079
E01015644,821,283,264,166,1534
E01015645,715,368,200,76,1359
E01015646,631,911,139,14,1695
E01015647,280,109,181,490,1060
E01015648,516,578,49,84,1227
E01015650,793,449,313,74,1629
E01015651,646,479,379,26,1530
E01015652,556,301,572,41,1470
E01015653,587,497,293,37,1414
E01015654,536,280,569,288,1673
E01015655,523,367,746,59,1695
E01015656,409,204,99,488,1200
E01015657,519,133,275,443,1370
E01015658,315,99,139,573,1126
E01015659,954,297,251,66,1568
E01015660,448,256,143,392,1239
E01015661,441,274,211,250,1176
E01015662,375,183,307,175,1040
E01015663,264,133,166,573,1136
E01015664,333,134,194,571,1232
E01015665,485,260,390,114,1249
E01015666,327,231,195,307,1060
E01015667,498,253,182,143,1076
E01015668,488,202,393,342,1425
E01015669,449,460,145,138,1192
E01015670,518,450,111,123,1202
E01015671,552,588,137,61,1338
E01015672,602,416,156,82,1256
E01015673,396,179,116,477,1168
E01015674,481,265,151,318,1215
E01015675,567,462,139,117,1285
E01015676,513,368,225,151,1257
E01015677,392,171,222,58,843
E01015678,681,236,159,45,1121
E01015679,710,435,240,97,1482
E01015680,406,103,227,411,1147
E01015681,743,315,108,68,1234
E01015682,622,273,201,96,1192
E01015683,585,771,138,100,1594
E01015684,552,628,30,11,1221
E01015685,608,642,106,18,1374
E01015686,509,667,114,17,1307
E01015687,525,647,120,12,1304
E01015688,352,354,353,98,1157
E01015689,405,665,133,33,1236
E01015690,379,506,105,13,1003
E01015691,408,491,107,49,1055
E01015692,370,295,298,53,1016
E01015693,695,434,67,5,1201
E01015694,555,460,109,2,1126
E01015695,696,345,121,6,1168
E01015696,576,211,133,62,982
E01015697,774,363,175,15,1327
E01015698,361,260,621,75,1317
E01015699,330,149,583,287,1349
E01015700,784,351,547,98,1780
E01015701,704,372,347,91,1514
E01015702,452,311,335,122,1220
E01015703,669,481,279,55,1484
E01015704,606,186,474,101,1367
E01015705,352,140,636,150,1278
E01015706,589,387,116,73,1165
E01015707,636,428,123,5,1192
E01015708,699,348,68,7,1122
E01015709,633,353,185,36,1207
E01015710,691,345,173,14,1223
E01015711,604,352,243,30,1229
E01015712,500,511,306,39,1356
E01015713,422,430,233,31,1116
E01015714,490,465,314,87,1356
E01015715,562,301,241,147,1251
E01015716,365,129,285,447,1226
E01015717,488,263,254,77,1082
E01015718,438,398,300,154,1290
E01015719,541,456,143,26,1166
E01015720,394,148,210,393,1145
E01015721,547,408,216,78,1249
E01015722,452,236,224,84,996
E01015723,466,254,157,135,1012
E01015724,639,329,527,141,1636
E01015725,298,216,406,215,1135
E01015726,587,469,405,182,1643
E01015727,445,308,512,72,1337
E01015728,545,290,340,58,1233
E01015729,295,207,729,214,1445
E01015730,440,271,834,160,1705
E01015731,595,292,449,37,1373
E01015732,328,204,120,467,1119
E01015733,451,274,132,456,1313
E01015734,693,350,268,149,1460
E01015735,319,99,755,202,1375
E01015736,362,154,206,564,1286
E01015737,454,239,189,261,1143
E01015738,360,259,808,102,1529
E01015739,350,283,982,32,1647
E01015740,571,305,315,41,1232
E01015741,273,176,985,429,1863
E01015742,510,189,697,69,1465
E01015743,280,137,669,175,1261
E01015744,468,192,164,288,1112
E01015745,613,574,95,18,1300
E01015746,474,509,113,101,1197
E01015747,552,526,64,21,1163
E01015748,494,633,120,117,1364
E01015749,354,145,147,688,1334
E01015750,729,331,456,66,1582
E01015751,453,292,164,323,1232
E01015752,476,286,135,154,1051
E01015753,572,282,177,102,1133
E01015754,335,218,153,657,1363
E01015755,544,446,166,159,1315
E01015756,668,161,165,207,1201
E01015757,395,214,124,439,1172
E01015758,507,107,177,292,1083
E01015759,363,145,176,461,1145
E01015760,377,150,121,458,1106
E01015761,497,268,127,317,1209
E01015762,578,400,294,61,1333
E01015763,509,456,133,152,1250
E01015764,547,576,92,24,1239
E01015765,438,312,281,231,1262
E01015766,587,351,232,42,1212
E01015767,603,380,212,63,1258
E01015768,498,476,90,99,1163
E01015769,422,202,133,174,931
E01015770,531,457,67,9,1064
E01015771,321,89,108,533,1051
E01015772,358,119,189,394,1060
E01015773,342,99,59,423,923
E01015774,427,97,201,282,1007
E01015775,521,368,383,40,1312
E01015776,564,467,201,252,1484
E01015777,625,342,374,46,1387
E01015778,713,355,267,20,1355
E01015779,288,141,154,519,1102
E01015780,641,320,229,115,1305
E01015781,532,227,167,224,1150
E01015782,739,437,250,64,1490
E01015783,569,219,210,223,1221
E01015784,810,310,295,42,1457
E01015785,630,348,497,79,1554
E01015786,720,383,384,68,1555
E01015787,621,358,360,79,1418
E01015788,649,406,253,122,1430
E01015789,104,83,635,634,1456
E01015790,436,309,472,82,1299
E01015791,253,114,1212,479,2058
E01015792,316,202,799,114,1431
E01015793,581,310,378,96,1365
E01015794,112,105,1455,217,1889
E01015795,197,73,1210,268,1748
E01015796,487,526,183,71,1267
E01015797,543,477,46,20,1086
E01015798,434,293,130,214,1071
E01015799,527,509,109,22,1167
E01015800,632,367,196,26,1221
E01015801,476,318,206,337,1337
E01015802,397,219,104,409,1129
E01015803,594,547,71,36,1248
E01015804,625,376,165,191,1357
E01015805,587,427,56,18,1088
E01015806,618,194,209,31,1052
E01015807,461,280,85,243,1069
E01015808,617,203,282,53,1155
E01015809,696,392,52,13,1153
E01015810,526,164,134,217,1041
E01015811,684,293,168,12,1157
E01015812,652,338,84,8,1082
E01015813,397,252,239,258,1146
E01015814,489,407,102,160,1158
E01015815,614,486,139,22,1261
E01015816,420,620,164,108,1312
E01015817,564,690,88,14,1356
E01015818,581,617,162,104,1464
E01015819,418,333,140,252,1143
E01015820,337,198,121,480,1136
E01015821,584,501,163,69,1317
E01015822,456,372,121,48,997
E01015823,634,461,196,36,1327
E01015824,472,201,110,410,1193
E01015825,541,345,89,276,1251
E01015826,509,414,115,96,1134
E01015827,503,466,265,12,1246
E01015828,387,147,663,122,1319
E01015829,544,353,259,5,1161
E01015830,583,500,162,4,1249
E01015831,706,217,713,27,1663
E01015832,382,473,332,69,1256
E01015833,575,583,109,6,1273
E01015834,553,589,81,9,1232
E01015835,505,493,193,136,1327
E01015836,618,561,90,6,1275
E01015837,651,530,133,55,1369
E01015838,514,690,72,9,1285
E01015839,452,195,487,198,1332
E01015840,479,199,499,126,1303
E01015841,434,237,1080,92,1843
E01015842,119,59,257,1002,1437
E01015843,492,211,473,126,1302
E01015844,445,170,564,312,1491
E01015845,697,349,232,5,1283
E01015846,611,357,380,10,1358
E01015847,581,305,455,16,1357
E01015848,462,540,431,6,1439
E01015849,626,314,374,22,1336
E01015850,737,336,188,6,1267
E01015851,320,430,747,22,1519
E01015852,331,198,849,49,1427
E01015853,448,332,701,13,1494
E01015854,398,158,893,75,1524
E01015855,437,241,861,70,1609
E01015856,536,246,573,47,1402
E01015857,591,616,83,11,1301
E01015858,617,562,211,26,1416
E01015859,655,490,220,168,1533
E01015860,608,484,128,23,1243
E01015861,441,312,232,310,1295
E01015862,471,308,364,50,1193
E01015863,1022,549,141,198,1910
E01015864,486,495,88,76,1145
E01015865,545,535,111,33,1224
E01015866,616,528,112,24,1280
E01015867,342,281,182,353,1158
E01015868,517,327,178,219,1241
E01015869,580,270,280,108,1238
E01015870,650,311,281,32,1274
E01015871,580,457,149,134,1320
E01015872,605,310,361,30,1306
E01015873,483,242,270,21,1016
E01015874,591,409,276,84,1360
E01015875,449,240,205,381,1275
E01015876,901,555,237,50,1743
E01015877,598,235,287,302,1422
E01015878,514,263,236,92,1105
E01015879,341,121,204,386,1052
E01015880,255,159,197,541,1152
E01015881,429,397,90,230,1146
E01015882,417,250,269,304,1240
E01015883,468,585,61,22,1136
E01015884,732,351,398,149,1630
E01015885,556,741,67,11,1375
E01015886,281,149,96,584,1110
E01015887,354,241,114,468,1177
E01015888,367,651,90,155,1263
E01015889,445,678,90,9,1222
E01015890,533,586,142,9,1270
E01015891,488,313,347,20,1168
E01015892,736,382,197,5,1320
E01015893,396,964,72,1,1433
E01015894,602,535,105,9,1251
E01015895,220,144,443,800,1607
E01015896,309,234,504,358,1405
E01015897,453,213,252,682,1600
E01015898,452,254,440,153,1299
E01015899,590,307,511,96,1504
E01015900,402,185,465,79,1131
E01015901,542,197,358,6,1103
E01015902,558,181,514,16,1269
E01015903,602,269,361,14,1246
E01015904,610,289,369,22,1290
E01015905,489,275,314,7,1085
E01015906,544,178,434,44,1200
E01015907,538,217,336,15,1106
E01015908,560,603,101,2,1266
E01015909,544,405,215,22,1186
E01015910,592,530,101,3,1226
E01015911,540,438,40,20,1038
E01015912,607,511,82,18,1218
E01015913,553,479,338,19,1389
E01015914,534,519,42,18,1113
E01015915,554,516,117,43,1230
E01015916,209,158,84,579,1030
E01015917,341,190,218,477,1226
E01015918,548,255,223,19,1045
E01015919,482,312,87,140,1021
E01015920,538,626,88,18,1270
E01015921,472,129,228,81,910
E01015922,428,174,73,520,1195
E01015923,583,233,150,273,1239
E01015924,604,234,88,261,1187
E01015925,661,441,57,109,1268
E01015926,575,354,113,195,1237
E01015927,597,230,93,413,1333
E01015928,704,338,74,243,1359
E01015929,394,125,106,513,1138
E01015930,662,271,105,312,1350
E01015931,389,75,117,427,1008
E01015932,492,371,102,253,1218
E01015933,552,281,93,279,1205
E01015934,391,189,78,440,1098
E01015935,495,252,91,408,1246
E01015936,468,372,46,460,1346
E01015937,571,553,41,248,1413
E01015938,356,289,65,697,1407
E01015939,779,221,163,7,1170
E01015941,714,150,154,31,1049
E01015942,718,234,162,47,1161
E01015943,607,547,88,8,1250
E01015944,450,556,38,10,1054
E01015945,406,423,47,129,1005
E01015946,610,536,89,23,1258
E01015947,603,197,170,109,1079
E01015948,595,318,248,43,1204
E01015949,761,327,74,136,1298
E01015950,724,497,178,24,1423
E01015951,451,181,439,186,1257
E01015952,592,152,548,229,1521
E01015953,606,224,689,158,1677
E01015954,319,73,602,704,1698
E01015955,676,249,256,32,1213
E01015956,618,258,647,74,1597
E01015957,459,238,100,398,1195
E01015958,415,257,93,287,1052
E01015959,469,300,298,232,1299
E01015960,558,472,73,107,1210
E01015961,566,324,277,36,1203
E01015962,513,191,415,88,1207
E01015963,299,196,63,331,889
E01015964,632,496,80,66,1274
E01015965,541,586,78,24,1229
E01015966,634,609,66,18,1327
E01015967,697,357,134,40,1228
E01015968,576,404,145,19,1144
E01015969,678,446,167,132,1423
E01015970,544,377,96,21,1038
E01015971,461,248,186,290,1185
E01015972,612,316,96,339,1363
E01015973,508,244,100,451,1303
E01015974,652,308,65,93,1118
E01015975,632,356,98,142,1228
E01015976,415,256,92,619,1382
E01015977,737,443,125,144,1449
E01015978,520,437,110,12,1079
E01015979,707,265,108,10,1090
E01015980,568,554,110,69,1301
E01015982,1201,273,331,6,1811
E01015983,467,567,147,62,1243
E01015984,502,448,55,57,1062
E01015985,400,623,65,105,1193
E01015986,466,200,97,414,1177
E01015987,436,319,120,293,1168
E01015988,418,168,111,408,1105
E01015989,547,252,345,102,1246
E01015990,549,334,79,258,1220
E01015991,580,457,92,52,1181
E01015992,696,420,229,159,1504
E01015993,574,366,67,296,1303
E01015994,501,381,62,279,1223
E01015995,677,636,59,32,1404
E01015996,545,279,63,388,1275
E01015997,607,475,71,10,1163
E01015998,685,466,76,67,1294
E01015999,592,413,70,14,1089
E01016000,568,422,138,38,1166
E01016001,550,431,68,25,1074
E01016002,576,495,45,27,1143
E01016003,623,275,431,148,1477
E01016004,346,234,127,523,1230
E01016005,487,220,128,312,1147
E01016006,225,108,99,679,1111
E01016007,316,179,115,527,1137
E01016008,603,266,201,95,1165
E01016009,462,157,160,511,1290
E01016010,305,114,93,539,1051
E01016011,494,152,462,85,1193
E01016012,767,166,512,425,1870
E01016013,844,152,643,76,1715
E01016014,717,84,374,605,1780
E01016015,669,301,216,146,1332
E01016016,445,208,303,265,1221
E01016017,286,208,570,290,1354
E01016018,567,248,545,78,1438
E01016019,451,175,566,146,1338
E01016020,326,234,249,153,962
E01016021,401,318,434,39,1192
E01016022,375,253,383,101,1112
E01016023,298,134,167,559,1158
E01016024,539,245,591,62,1437
E01016025,440,309,100,334,1183
E01016026,636,209,85,32,962
E01016027,631,516,70,12,1229
E01016028,506,487,84,70,1147
E01016029,505,259,130,144,1038
E01016030,555,233,111,424,1323
E01016031,357,112,546,344,1359
E01016032,209,77,104,531,921
E01016033,238,87,167,377,869
E01016034,1084,386,433,86,1989
E01016035,396,207,555,260,1418
E01016036,493,263,616,140,1512
E01016037,515,213,546,91,1365
E01016038,519,249,270,108,1146
E01016039,496,233,527,53,1309
E01016040,544,348,377,89,1358
E01016041,518,248,490,78,1334
E01016042,499,212,338,48,1097
E01016043,588,308,114,117,1127
E01016044,562,261,471,13,1307
E01016045,504,264,471,39,1278
E01016046,493,263,418,26,1200
E01016047,557,241,468,36,1302
E01016048,525,268,498,9,1300
E01016049,391,241,602,272,1506
E01016050,756,539,108,7,1410
E01016051,704,402,95,3,1204
E01016052,682,644,64,12,1402
E01016053,511,694,81,9,1295
E01016054,638,502,92,5,1237
E01016055,627,362,123,157,1269
E01016056,577,236,187,112,1112
E01016057,808,313,128,69,1318
E01016058,633,400,134,42,1209
E01016059,469,142,113,293,1017
E01016060,731,541,62,10,1344
E01016061,525,227,495,51,1298
E01016062,473,245,189,210,1117
E01016063,355,181,454,276,1266
E01016064,440,234,259,247,1180
E01016065,572,403,104,111,1190
E01016066,478,321,108,281,1188
E01016067,609,298,135,255,1297
E01016068,425,181,133,497,1236
E01016069,407,177,661,126,1371
E01016070,631,562,108,67,1368
E01016071,658,332,142,140,1272
E01016072,477,285,120,161,1043
E01016073,869,639,76,75,1659
E01016074,394,862,104,87,1447
E01016075,580,398,49,147,1174
E01016076,1012,533,176,175,1896
E01016077,492,357,117,231,1197
E01016078,795,115,246,14,1170
E01016079,675,227,85,88,1075
E01016080,749,202,125,108,1184
E01016081,844,223,119,12,1198
E01016082,775,333,123,8,1239
E01016083,357,172,95,415,1039
E01016084,522,158,86,330,1096
E01016085,575,698,75,2,1350
E01016086,580,466,33,9,1088
E01016087,647,542,171,8,1368
E01016088,531,439,84,158,1212
E01016089,598,458,139,92,1287
E01016090,603,527,99,8,1237
E01016091,545,632,45,59,1281
E01016092,684,499,101,5,1289
E01016093,553,665,83,12,1313
E01016094,581,443,139,42,1205
E01016095,573,273,93,59,998
E01016096,503,583,105,17,1208
E01016097,462,322,191,182,1157
E01016098,304,271,370,176,1121
E01016099,671,331,163,18,1183
E01016100,548,373,143,186,1250
E01016101,681,310,139,13,1143
E01016102,324,285,144,428,1181
E01016103,680,389,113,8,1190
E01016104,685,319,114,3,1121
E01016105,521,502,118,13,1154
E01016106,572,409,122,43,1146
E01016107,736,362,117,10,1225
E01016110,278,181,904,276,1639
E01016111,107,120,393,308,928
E01016112,1215,339,544,102,2200
E01016113,539,441,165,55,1200
E01016114,495,240,294,212,1241
E01016115,604,354,136,370,1464
E01016116,569,338,134,399,1440
E01016117,354,148,515,407,1424
E01016118,615,331,430,42,1418
E01016119,518,512,99,55,1184
E01016120,408,329,132,259,1128
E01016121,544,570,110,28,1252
E01016122,579,556,100,13,1248
E01016123,567,491,148,77,1283
E01016124,598,513,184,50,1345
E01016125,682,360,283,31,1356
E01016126,741,416,102,57,1316
E01016127,532,382,203,122,1239
E01016128,447,352,93,168,1060
E01016129,453,229,461,395,1538
E01016130,463,338,582,169,1552
E01016131,623,310,306,177,1416
E01016132,687,492,124,24,1327
E01016133,549,549,59,10,1167
E01016134,586,343,75,121,1125
E01016135,632,344,161,67,1204
E01016136,421,247,233,261,1162
E01016137,509,274,350,73,1206
E01016138,586,586,88,3,1263
E01016139,708,442,116,46,1312
E01016140,406,251,312,127,1096
E01016141,577,300,385,33,1295
E01016142,586,312,102,26,1026
E01016143,912,393,189,287,1781
E01016144,577,485,106,57,1225
E01016145,656,283,48,45,1032
E01016146,705,377,135,383,1600
E01016147,770,581,142,20,1513
E01016148,894,503,121,34,1552
E01016149,523,294,129,172,1118
E01016150,551,195,123,316,1185
E01016151,636,368,182,121,1307
E01016152,455,308,93,345,1201
E01016153,343,192,124,446,1105
E01016154,633,333,228,73,1267
E01016155,501,366,92,272,1231
E01016156,779,222,146,112,1259
E01016157,813,356,176,194,1539
E01016158,888,399,126,262,1675
E01016159,370,149,82,392,993
E01016160,429,267,91,408,1195
E01016161,390,218,121,535,1264
E01016162,658,448,146,52,1304
E01016163,527,277,72,191,1067
E01016164,506,300,100,295,1201
E01016165,524,367,86,79,1056
E01016166,589,446,84,73,1192
E01016167,546,421,67,122,1156
E01016168,499,432,89,250,1270
E01016169,818,453,108,24,1403
E01016170,719,319,187,44,1269
E01016171,495,292,89,346,1222
E01016172,627,473,69,15,1184
E01016173,566,325,99,256,1246
E01016174,541,315,231,24,1111
E01016175,756,569,126,42,1493
E01016176,738,435,73,10,1256
E01016177,619,285,219,89,1212
E01016178,564,335,207,18,1124
E01016179,621,405,62,38,1126
E01016180,442,292,141,144,1019
E01016181,390,388,236,13,1027
E01016182,614,360,144,62,1180
E01016183,558,331,85,11,985
E01016184,939,397,258,88,1682
E01016185,504,231,311,12,1058
E01016186,643,476,214,136,1469
E01016187,648,486,113,51,1298
E01016188,783,217,155,95,1250
E01016190,515,377,104,230,1226
E01016191,573,360,94,291,1318
E01016192,464,264,192,166,1086
E01016193,597,165,159,82,1003
E01016194,529,459,51,11,1050
E01016195,531,148,93,113,885
E01016196,438,209,472,55,1174
E01016197,553,261,89,160,1063
E01016198,556,329,95,9,989
E01016199,546,330,106,24,1006
E01016200,654,146,166,101,1067
E01016201,639,158,191,108,1096
E01016202,596,125,286,20,1027
E01016203,435,89,138,382,1044
E01016204,492,106,124,247,969
E01016205,591,114,129,243,1077
E01016206,595,582,208,59,1444
E01016207,555,209,101,199,1064
E01016208,694,502,242,98,1536
E01016209,604,310,83,186,1183
E01016210,416,121,100,299,936
E01016212,516,165,90,212,983
E01016213,572,211,47,96,926
E01016214,621,452,34,35,1142
E01016215,430,108,108,295,941
E01016216,494,221,114,203,1032
E01016217,601,190,136,193,1120
E01016218,509,199,107,307,1122
E01016219,522,354,90,152,1118
E01016220,562,132,140,201,1035
E01016221,551,218,136,141,1046
E01016222,584,311,129,4,1028
E01016223,444,207,200,304,1155
E01016224,524,244,161,384,1313
E01016225,762,358,183,366,1669
E01016226,462,216,159,286,1123
E01016227,560,325,63,59,1007
E01016228,606,456,96,39,1197
E01016229,506,362,79,8,955
E01016230,268,254,311,11,844
E01016231,710,273,189,316,1488
E01016232,538,263,158,186,1145
E01016233,691,216,257,599,1763
E01016234,595,266,79,13,953
E01016235,657,327,55,31,1070
E01016236,619,179,77,238,1113
E01016237,593,240,90,22,945
E01016238,398,323,105,150,976
E01016239,557,263,87,302,1209
E01016240,511,190,96,405,1202
E01016241,471,205,122,436,1234
E01016242,486,187,179,518,1370
E01016243,595,227,173,123,1118
E01016245,1142,387,189,72,1790
E01016246,836,197,133,6,1172
E01016247,833,210,165,77,1285
E01016248,527,242,119,285,1173
E01016249,309,171,241,505,1226
E01016250,551,336,200,220,1307
E01016252,421,573,175,33,1202
E01016253,610,303,100,30,1043
E01016254,430,503,124,76,1133
E01016255,423,387,263,106,1179
E01016256,634,501,155,101,1391
E01016257,435,404,149,42,1030
E01016258,595,633,58,6,1292
E01016259,714,425,66,35,1240
E01016260,734,511,75,27,1347
E01016261,851,348,67,9,1275
E01016262,512,553,35,14,1114
E01016263,786,442,291,142,1661
E01016264,230,280,260,34,804
E01016265,457,495,92,118,1162
E01016266,474,391,64,161,1090
E01016267,601,399,88,46,1134
E01016268,473,336,105,324,1238
E01016269,566,352,185,32,1135
E01016270,463,221,348,50,1082
E01016271,483,267,55,377,1182
E01016272,655,466,96,51,1268
E01016273,401,247,89,436,1173
E01016274,497,393,79,137,1106
E01016275,654,242,179,77,1152
E01016276,741,248,127,24,1140
E01016277,393,414,140,84,1031
E01016278,317,236,286,23,862
E01016279,695,252,373,345,1665
E01016280,501,238,238,385,1362
E01016281,509,361,126,149,1145
E01016282,553,312,207,98,1170
E01016283,513,506,134,42,1195
E01016284,563,357,83,95,1098
E01016285,386,313,358,189,1246
E01016286,500,286,140,272,1198
E01016287,396,280,297,157,1130
E01016288,453,421,190,254,1318
E01016289,490,586,45,65,1186
E01016290,556,492,160,23,1231
E01016291,648,527,141,41,1357
E01016292,563,371,101,239,1274
E01016293,994,488,209,379,2070
E01016294,593,462,168,32,1255
E01016295,259,112,110,610,1091
E01016296,527,365,229,198,1319
E01016297,457,349,110,311,1227
E01016298,290,322,288,53,953
E01016299,487,398,236,63,1184
E01016300,457,354,158,184,1153
E01016301,495,548,402,131,1576
E01016302,520,408,151,225,1304
E01016303,439,379,212,145,1175
E01016304,413,350,260,250,1273
E01016305,356,276,264,148,1044
E01016306,351,260,90,346,1047
E01016307,433,372,133,323,1261
E01016308,632,529,195,121,1477
E01016309,719,509,262,166,1656
E01016310,491,371,210,413,1485
E01016311,470,418,390,113,1391
E01016312,625,338,264,304,1531
E01016313,577,418,159,153,1307
E01016314,322,411,216,19,968
E01016315,617,560,150,13,1340
E01016316,872,581,130,54,1637
E01016317,467,440,86,108,1101
E01016318,691,451,90,16,1248
E01016319,496,353,208,256,1313
E01016320,462,354,197,134,1147
E01016321,440,393,196,170,1199
E01016322,470,488,52,22,1032
E01016323,371,473,144,142,1130
E01016324,442,355,132,212,1141
E01016325,368,272,143,418,1201
E01016326,375,319,246,86,1026
E01016327,438,299,116,90,943
E01016328,513,298,312,254,1377
E01016329,776,229,131,29,1165
E01016330,602,246,157,168,1173
E01016331,515,231,144,297,1187
E01016332,437,434,150,256,1277
E01016333,664,191,122,13,990
E01016334,623,178,179,272,1252
E01016335,646,392,131,56,1225
E01016336,276,180,46,433,935
E01016337,832,395,190,276,1693
E01016338,883,401,142,64,1490
E01016339,1184,490,322,160,2156
E01016340,539,390,97,228,1254
E01016341,557,273,76,194,1100
E01016342,908,338,233,85,1564
E01016343,602,482,66,61,1211
E01016344,451,244,179,338,1212
E01016345,565,271,151,61,1048
E01016346,299,171,376,286,1132
E01016347,296,230,538,254,1318
E01016348,694,295,534,164,1687
E01016349,491,469,35,5,1000
E01016350,631,500,69,8,1208
E01016353,294,140,819,235,1488
E01016355,528,236,704,64,1532
E01016356,405,140,452,188,1185
E01016357,528,215,559,43,1345
E01016358,385,147,772,107,1411
E01016359,639,237,552,130,1558
E01016360,478,186,765,157,1586
E01016361,558,216,547,41,1362
E01016362,442,313,467,88,1310
E01016363,407,115,212,570,1304
E01016364,566,368,191,18,1143
E01016365,532,321,466,37,1356
E01016366,553,323,204,185,1265
E01016367,542,271,243,205,1261
E01016368,317,103,99,515,1034
E01016369,553,435,146,176,1310
E01016370,240,248,324,137,949
E01016371,422,363,268,168,1221
E01016372,269,124,109,428,930
E01016373,324,125,207,440,1096
E01016374,449,184,661,79,1373
E01016375,223,94,486,236,1039
E01016376,347,165,746,71,1329
E01016377,378,196,407,317,1298
E01016378,399,106,938,216,1659
E01016379,437,137,878,66,1518
E01016380,672,457,162,32,1323
E01016381,503,199,119,251,1072
E01016382,474,176,274,394,1318
E01016383,665,304,152,73,1194
E01016384,676,538,99,16,1329
E01016385,702,252,158,74,1186
E01016386,457,650,75,17,1199
E01016387,652,524,46,2,1224
E01016388,504,359,157,173,1193
E01016389,246,136,159,688,1229
E01016390,430,259,575,30,1294
E01016391,395,152,544,364,1455
E01016392,479,283,737,74,1573
E01016393,520,334,269,107,1230
E01016394,262,207,78,483,1030
E01016395,439,382,158,170,1149
E01016396,360,142,65,389,956
E01016397,349,126,93,448,1016
E01016398,584,167,475,105,1331
E01016399,549,289,226,68,1132
E01016400,493,262,406,56,1217
E01016401,378,310,528,29,1245
E01016402,279,162,1145,38,1624
E01016403,619,344,505,37,1505
E01016404,598,189,601,215,1603
E01016405,624,213,732,62,1631
E01016406,325,189,835,19,1368
E01016407,540,511,129,37,1217
E01016408,610,403,156,23,1192
E01016409,594,489,105,163,1351
E01016410,679,469,152,35,1335
E01016411,546,636,56,54,1292
E01016412,699,355,126,24,1204
E01016413,243,234,381,45,903
E01016414,256,217,588,130,1191
E01016415,301,193,208,504,1206
E01016416,233,117,1094,40,1484
E01016417,224,236,1013,31,1504
E01016418,273,202,942,31,1448
E01016419,511,306,302,242,1361
E01016420,269,93,81,531,974
E01016421,454,411,77,108,1050
E01016422,330,306,106,381,1123
E01016423,352,323,94,378,1147
E01016424,549,387,86,36,1058
E01016425,691,510,95,31,1327
E01016426,543,446,49,7,1045
E01016427,461,443,202,86,1192
E01016428,627,475,138,138,1378
E01016429,665,450,100,23,1238
E01016430,630,361,56,17,1064
E01016431,661,420,141,38,1260
E01016432,610,466,110,18,1204
E01016433,542,330,143,110,1125
E01016434,657,480,172,66,1375
E01016435,429,312,74,280,1095
E01016436,581,313,90,212,1196
E01016437,552,186,132,188,1058
E01016438,272,146,120,444,982
E01016439,549,220,142,278,1189
E01016440,466,258,120,289,1133
E01016441,315,124,91,529,1059
E01016442,851,163,462,641,2117
E01016443,346,97,101,512,1056
E01016444,559,196,218,251,1224
E01016445,490,177,231,401,1299
E01016446,537,254,259,147,1197
E01016447,478,367,455,41,1341
E01016448,594,493,593,137,1817
E01016449,620,227,275,410,1532
E01016450,365,112,84,532,1093
E01016451,229,58,102,679,1068
E01016452,544,232,122,362,1260
E01016453,511,286,80,326,1203
E01016454,498,208,105,344,1155
E01016455,512,117,123,269,1021
E01016456,551,326,519,247,1643
E01016457,596,381,407,53,1437
E01016458,361,157,246,463,1227
E01016459,630,243,503,245,1621
E01016460,404,569,426,59,1458
E01016461,606,361,833,147,1947
E01016462,557,234,934,149,1874
E01016463,471,199,439,270,1379
E01016464,483,300,559,97,1439
E01016465,596,309,848,245,1998
E01016467,480,262,206,160,1108
E01016468,745,276,221,77,1319
E01016469,548,292,296,171,1307
E01016470,653,277,295,36,1261
E01016471,493,266,140,145,1044
E01016472,537,292,135,298,1262
E01016473,829,190,308,172,1499
E01016474,596,223,284,400,1503
E01016475,620,388,373,201,1582
E01016476,623,93,237,276,1229
E01016477,854,210,509,181,1754
E01016478,686,220,397,103,1406
E01016479,522,164,412,75,1173
E01016480,368,192,202,314,1076
E01016481,366,130,469,212,1177
E01016482,601,285,509,45,1440
E01016483,491,351,481,31,1354
E01016484,435,325,350,106,1216
E01016485,486,384,320,92,1282
E01016486,426,150,244,391,1211
E01016487,533,415,299,97,1344
E01016488,620,287,388,51,1346
E01016490,368,105,187,784,1444
E01016491,600,449,198,127,1374
E01016492,591,284,185,199,1259
E01016493,507,243,144,81,975
E01016494,647,224,489,132,1492
E01016495,519,217,344,104,1184
E01016496,351,141,132,337,961
E01016497,570,383,97,58,1108
E01016498,562,163,225,308,1258
E01016499,313,53,125,502,993
E01016500,661,342,217,160,1380
E01016501,421,108,105,522,1156
E01016502,497,202,143,210,1052
E01016503,534,191,157,322,1204
E01016504,505,402,195,57,1159
E01016505,521,179,173,399,1272
E01016506,628,123,509,149,1409
E01016507,603,286,156,199,1244
E01016508,594,394,242,99,1329
E01016509,595,326,254,69,1244
E01016510,659,446,127,12,1244
E01016511,403,260,531,251,1445
E01016512,320,134,870,145,1469
E01016513,737,535,214,14,1500
E01016514,391,183,651,188,1413
E01016515,716,564,317,12,1609
E01016516,531,238,263,188,1220
E01016517,486,213,230,230,1159
E01016518,561,287,432,59,1339
E01016519,642,304,381,590,1917
E01016520,295,201,185,531,1212
E01016521,507,249,253,377,1386
E01016522,710,569,143,39,1461
E01016523,435,381,284,45,1145
E01016524,604,508,249,208,1569
E01016525,613,412,208,21,1254
E01016526,721,329,290,41,1381
E01016527,579,293,245,102,1219
E01016528,539,430,261,38,1268
E01016529,308,184,296,462,1250
E01016530,394,410,76,314,1194
E01016531,441,523,182,14,1160
E01016532,625,715,239,29,1608
E01016533,675,646,140,40,1501
E01016534,542,564,159,14,1279
E01016535,443,342,208,19,1012
E01016536,539,279,521,176,1515
E01016537,407,326,264,140,1137
E01016538,588,381,252,43,1264
E01016539,588,492,134,62,1276
E01016540,610,467,152,74,1303
E01016541,563,415,128,17,1123
E01016542,428,276,76,146,926
E01016543,591,503,185,25,1304
E01016544,394,270,541,121,1326
E01016545,462,314,612,255,1643
E01016546,502,339,453,7,1301
E01016547,613,301,391,54,1359
E01016548,654,438,341,114,1547
E01016549,514,398,268,358,1538
E01016550,398,198,211,175,982
E01016551,527,600,147,42,1316
E01016552,542,399,249,102,1292
E01016553,397,667,125,66,1255
E01016554,382,271,108,421,1182
E01016555,356,146,117,523,1142
E01016556,528,368,122,412,1430
E01016557,654,525,192,209,1580
E01016558,218,139,584,239,1180
E01016559,607,495,86,13,1201
E01016560,386,225,102,471,1184
E01016561,750,482,135,82,1449
E01016562,583,465,67,16,1131
E01016563,590,418,64,23,1095
E01016564,600,350,156,164,1270
E01016565,578,462,206,17,1263
E01016566,528,294,266,274,1362
E01016567,247,164,840,161,1412
E01016568,398,330,141,158,1027
E01016569,353,238,146,137,874
E01016570,583,517,154,21,1275
E01016571,525,467,112,116,1220
E01016572,408,499,78,99,1084
E01016573,331,165,77,493,1066
E01016574,423,400,189,199,1211
E01016575,667,678,93,14,1452
E01016576,669,490,183,40,1382
E01016577,652,354,203,191,1400
E01016578,421,455,268,42,1186
E01016579,436,511,209,187,1343
E01016580,401,256,72,477,1206
E01016581,452,483,131,72,1138
E01016582,443,441,217,34,1135
E01016583,609,520,208,4,1341
E01016584,485,258,338,214,1295
E01016585,504,444,395,37,1380
E01016586,483,507,110,3,1103
E01016587,642,473,92,90,1297
E01016588,441,288,525,205,1459
E01016589,576,539,146,20,1281
E01016591,647,552,140,8,1347
E01016592,521,514,367,87,1489
E01016593,420,266,119,486,1291
E01016594,374,165,139,457,1135
E01016595,598,292,281,142,1313
E01016596,505,423,431,83,1442
E01016597,649,535,184,23,1391
E01016598,538,454,66,12,1070
E01016599,416,188,99,538,1241
E01016600,421,399,92,7,919
E01016601,523,358,149,187,1217
E01016602,559,613,99,16,1287
E01016603,470,552,332,30,1384
E01016604,529,581,320,54,1484
E01016605,475,343,172,198,1188
E01016606,606,480,162,33,1281
E01016607,472,500,155,11,1138
E01016608,502,346,281,287,1416
E01016609,543,267,166,409,1385
E01016610,1048,460,421,181,2110
E01016611,296,133,342,76,847
E01016612,951,633,79,23,1686
E01016613,548,374,164,78,1164
E01016614,527,442,140,22,1131
E01016615,452,348,102,308,1210
E01016616,474,502,110,138,1224
E01016617,474,449,56,44,1023
E01016618,479,348,157,62,1046
E01016619,624,445,72,60,1201
E01016620,574,335,87,136,1132
E01016621,564,428,142,48,1182
E01016622,524,417,57,4,1002
E01016623,569,509,105,28,1211
E01016624,561,549,31,8,1149
E01016625,625,535,115,16,1291
E01016626,502,373,271,188,1334
E01016627,764,496,144,67,1471
E01016628,607,542,76,17,1242
E01016629,481,607,49,1,1138
E01016630,688,405,77,7,1177
E01016631,537,277,93,161,1068
E01016632,656,438,91,17,1202
E01016633,593,382,67,15,1057
E01016634,586,463,99,29,1177
E01016635,647,317,91,4,1059
E01016636,598,561,38,3,1200
E01016637,427,420,33,3,883
E01016638,650,292,60,5,1007
E01016639,650,369,79,123,1221
E01016640,536,618,83,33,1270
E01016641,513,510,77,10,1110
E01016642,306,181,84,332,903
E01016643,615,368,59,8,1050
E01016644,678,275,132,12,1097
E01016645,670,257,322,8,1257
E01016646,818,276,137,4,1235
E01016647,812,256,167,128,1363
E01016648,677,218,218,42,1155
E01016649,689,301,187,11,1188
E01016651,488,407,203,49,1147
E01016652,515,393,80,0,988
E01016653,484,383,87,64,1018
E01016654,590,412,116,21,1139
E01016655,641,296,103,8,1048
E01016656,493,388,206,61,1148
E01016657,618,351,90,20,1079
E01016658,681,237,87,26,1031
E01016659,647,272,211,10,1140
E01016660,768,386,110,13,1277
E01016661,653,364,56,5,1078
E01016662,459,205,153,488,1305
E01016663,649,450,116,21,1236
E01016664,469,436,64,4,973
E01016665,670,414,156,8,1248
E01016666,670,324,95,14,1103
E01016668,589,441,172,54,1256
E01016669,726,502,202,15,1445
E01016670,954,415,169,39,1577
E01016671,424,634,225,116,1399
E01016672,750,585,87,11,1433
E01016673,385,214,157,596,1352
E01016674,463,353,106,199,1121
E01016675,275,382,166,41,864
E01016676,537,577,96,21,1231
E01016677,456,382,120,229,1187
E01016678,382,421,131,164,1098
E01016679,731,358,367,242,1698
E01016680,394,201,193,178,966
E01016682,755,396,239,62,1452
E01016683,821,454,128,63,1466
E01016684,646,513,100,31,1290
E01016685,515,434,174,123,1246
E01016686,538,265,118,13,934
E01016687,500,456,73,11,1040
E01016688,553,323,89,7,972
E01016689,537,562,60,9,1168
E01016690,620,434,184,167,1405
E01016691,383,338,148,55,924
E01016692,486,409,131,150,1176
E01016693,534,316,234,12,1096
E01016694,438,417,248,58,1161
E01016695,600,525,73,13,1211
E01016696,439,240,392,149,1220
E01016699,538,396,170,87,1191
E01016700,857,487,149,29,1522
E01016701,779,479,96,17,1371
E01016702,783,399,133,107,1422
E01016703,780,310,174,121,1385
E01016704,644,290,204,393,1531
E01016705,416,266,234,68,984
E01016706,742,475,93,3,1313
E01016707,628,521,84,27,1260
E01016708,615,628,78,1,1322
E01016709,553,644,52,10,1259
E01016710,519,419,135,331,1404
E01016711,890,619,279,98,1886
E01016713,633,544,190,33,1400
E01016714,505,440,389,94,1428
E01016715,531,325,124,295,1275
E01016716,584,473,246,176,1479
E01016717,586,195,234,199,1214
E01016718,248,54,451,443,1196
E01016719,612,296,165,136,1209
E01016720,310,108,173,555,1146
E01016721,443,187,422,236,1288
E01016722,770,300,147,116,1333
E01016723,716,362,212,78,1368
E01016724,461,149,429,311,1350
E01016725,335,84,454,349,1222
E01016726,274,79,408,474,1235
E01016727,505,199,363,299,1366
E01016728,561,131,687,122,1501
E01016729,435,118,638,458,1649
E01016731,513,314,213,189,1229
E01016732,592,309,162,93,1156
E01016733,396,94,457,396,1343
E01016734,379,392,125,95,991
E01016735,773,488,278,103,1642
E01016736,427,462,138,63,1090
E01016737,636,383,106,148,1273
E01016738,497,253,143,484,1377
E01016739,617,374,197,65,1253
E01016740,521,461,118,24,1124
E01016741,461,277,143,419,1300
E01016742,255,84,106,626,1071
E01016743,540,141,232,524,1437
E01016744,324,139,149,478,1090
E01016745,637,468,123,43,1271
E01016746,497,353,157,331,1338
E01016748,853,238,282,118,1491
E01016750,793,252,170,63,1278
E01016751,728,194,162,110,1194
E01016752,631,190,170,246,1237
E01016753,798,165,327,351,1641
E01016754,679,281,221,167,1348
E01016755,777,198,263,149,1387
E01016756,808,144,245,475,1672
E01016757,700,283,167,69,1219
E01016758,728,261,234,107,1330
E01016759,492,315,95,199,1101
E01016760,1007,488,148,209,1852
E01016761,546,462,118,4,1130
E01016762,458,281,111,174,1024
E01016763,643,283,149,87,1162
E01016764,607,368,135,101,1211
E01016765,476,295,137,351,1259
E01016766,524,218,107,238,1087
E01016767,660,344,82,23,1109
E01016768,575,195,671,280,1721
E01016769,669,290,146,31,1136
E01016770,766,259,217,130,1372
E01016771,440,219,192,161,1012
E01016772,374,166,207,259,1006
E01016773,848,429,141,123,1541
E01016774,695,365,206,113,1379
E01016775,612,290,282,147,1331
E01016776,733,326,126,15,1200
E01016777,750,182,195,97,1224
E01016778,788,138,272,152,1350
E01016780,827,195,248,47,1317
E01016781,704,329,73,74,1180
E01016783,760,127,343,151,1381
E01016784,367,322,361,276,1326
E01016786,555,516,126,29,1226
E01016787,495,328,148,274,1245
E01016788,720,451,121,13,1305
E01016789,625,191,169,54,1039
E01016790,519,516,60,18,1113
E01016791,583,459,107,36,1185
E01016792,656,253,116,9,1034
E01016793,808,412,216,107,1543
E01016794,530,379,306,21,1236
E01016795,673,271,255,77,1276
E01016796,450,458,266,37,1211
E01016797,558,484,310,88,1440
E01016798,825,450,178,21,1474
E01016799,636,440,215,195,1486
E01016800,583,443,195,87,1308
E01016801,422,397,125,175,1119
E01016802,486,447,136,68,1137
E01016803,474,346,181,88,1089
E01016804,427,127,304,403,1261
E01016805,584,408,180,11,1183
E01016806,529,123,205,539,1396
E01016807,624,362,204,184,1374
E01016808,581,352,136,27,1096
E01016809,512,293,176,93,1074
E01016810,307,125,156,409,997
E01016811,247,88,116,518,969
E01016812,552,486,168,64,1270
E01016813,513,130,479,9,1131
E01016814,527,651,133,115,1426
E01016815,662,153,158,58,1031
E01016816,659,431,110,22,1222
E01016817,509,401,173,179,1262
E01016818,490,467,344,130,1431
E01016819,296,92,111,351,850
E01016820,548,287,207,204,1246
E01016821,576,125,196,67,964
E01016822,415,104,259,388,1166
E01016823,614,102,579,26,1321
E01016824,634,190,148,233,1205
E01016825,634,115,250,140,1139
E01016826,811,235,103,21,1170
E01016827,707,119,282,173,1281
E01016828,845,336,187,55,1423
E01016829,415,341,139,338,1233
E01016830,606,166,154,20,946
E01016831,629,415,147,85,1276
E01016832,485,313,85,130,1013
E01016833,516,480,55,41,1092
E01016834,447,266,125,370,1208
E01016835,378,194,193,469,1234
E01016836,609,339,288,65,1301
E01016837,702,279,347,86,1414
E01016838,564,285,154,214,1217
E01016839,438,91,146,443,1118
E01016840,1046,521,384,114,2065
E01016841,692,222,493,257,1664
E01016842,147,74,139,744,1104
E01016843,194,93,230,483,1000
E01016844,303,127,120,637,1187
E01016845,198,64,259,747,1268
E01016846,436,280,343,185,1244
E01016847,515,106,182,711,1514
E01016848,431,148,230,282,1091
E01016849,364,198,809,38,1409
E01016850,385,177,969,64,1595
E01016851,418,203,922,31,1574
E01016852,318,107,1003,44,1472
E01016853,427,221,994,58,1700
E01016854,343,92,833,215,1483
E01016855,431,154,941,44,1570
E01016856,301,289,847,45,1482
E01016857,352,212,668,49,1281
E01016858,331,168,778,10,1287
E01016859,353,440,503,42,1338
E01016860,335,153,719,93,1300
E01016861,435,259,700,66,1460
E01016862,414,240,638,85,1377
E01016863,341,172,405,478,1396
E01016864,205,272,134,556,1167
E01016865,106,29,69,920,1124
E01016866,166,96,81,719,1062
E01016867,210,150,140,612,1112
E01016868,119,62,91,906,1178
E01016869,465,293,446,305,1509
E01016870,549,258,435,18,1260
E01016871,301,216,969,129,1615
E01016872,538,166,811,74,1589
E01016873,364,161,729,286,1540
E01016874,404,441,675,39,1559
E01016875,556,284,359,18,1217
E01016876,434,285,587,57,1363
E01016877,461,339,617,69,1486
E01016878,563,349,504,75,1491
E01016879,448,221,116,357,1142
E01016880,243,78,84,576,981
E01016881,409,245,170,324,1148
E01016882,376,329,119,323,1147
E01016883,410,671,92,82,1255
E01016884,523,331,148,256,1258
E01016885,227,116,160,516,1019
E01016886,559,399,109,164,1231
E01016887,539,446,124,53,1162
E01016888,538,471,111,20,1140
E01016889,421,209,920,83,1633
E01016890,390,102,1018,72,1582
E01016891,433,166,786,171,1556
E01016892,461,270,602,57,1390
E01016893,628,318,625,24,1595
E01016894,379,195,622,243,1439
E01016895,291,124,145,621,1181
E01016896,511,242,707,45,1505
E01016897,589,256,539,90,1474
E01016898,499,429,304,325,1557
E01016899,308,195,204,160,867
E01016900,142,156,244,678,1220
E01016901,624,330,322,20,1296
E01016902,420,332,167,264,1183
E01016903,658,271,606,47,1582
E01016904,204,108,280,625,1217
E01016905,323,169,419,529,1440
E01016906,320,201,113,619,1253
E01016907,301,252,674,346,1573
E01016908,220,131,169,609,1129
E01016909,297,281,708,335,1621
E01016910,203,99,316,578,1196
E01016911,390,292,286,271,1239
E01016912,473,164,928,121,1686
E01016913,408,287,836,49,1580
E01016914,185,133,273,575,1166
E01016915,115,59,299,707,1180
E01016916,550,440,146,57,1193
E01016917,596,423,89,32,1140
E01016918,376,212,91,444,1123
E01016919,431,209,115,325,1080
E01016920,711,337,135,31,1214
E01016921,555,270,104,296,1225
E01016922,456,263,93,201,1013
E01016923,562,374,192,123,1251
E01016924,575,467,93,26,1161
E01016925,561,331,122,203,1217
E01016926,420,285,67,394,1166
E01016927,662,342,132,89,1225
E01016928,508,553,200,25,1286
E01016929,613,409,139,101,1262
E01016930,705,610,154,48,1517
E01016931,612,517,94,17,1240
E01016932,591,320,306,58,1275
E01016933,473,286,337,68,1164
E01016934,538,341,153,24,1056
E01016935,461,279,433,159,1332
E01016936,563,250,469,50,1332
E01016937,575,143,970,107,1795
E01016938,487,230,809,22,1548
E01016939,617,360,210,8,1195
E01016940,630,295,303,22,1250
E01016941,233,228,999,354,1814
E01016942,153,161,169,963,1446
E01016943,461,228,509,70,1268
E01016944,360,176,785,67,1388
E01016945,253,123,1092,63,1531
E01016946,519,351,303,16,1189
E01016947,136,61,435,756,1388
E01016948,443,220,490,285,1438
E01016949,281,176,558,491,1506
E01016950,418,263,867,12,1560
E01016951,285,152,683,181,1301
E01016952,172,143,1089,51,1455
E01016953,375,303,754,36,1468
E01016954,310,181,1105,79,1675
E01016955,251,233,1086,64,1634
E01016956,569,574,129,31,1303
E01016957,323,396,650,16,1385
E01016958,578,691,179,21,1469
E01016959,515,557,101,19,1192
E01016960,459,604,309,41,1413
E01016961,685,480,206,72,1443
E01016962,562,653,135,33,1383
E01016963,487,353,718,94,1652
E01016964,241,126,1152,389,1908
E01016966,303,166,976,160,1605
E01016967,474,194,1046,56,1770
E01016968,357,119,945,44,1465
E01016969,305,245,1053,233,1836
E01016970,476,243,557,103,1379
E01016971,323,167,1220,92,1802
E01016972,526,270,776,31,1603
E01016973,561,352,165,105,1183
E01016974,614,280,321,76,1291
E01016975,476,172,185,325,1158
E01016976,680,468,125,54,1327
E01016977,531,318,108,248,1205
E01016978,522,235,257,228,1242
E01016979,653,329,238,25,1245
E01016980,529,387,200,39,1155
E01016981,508,598,175,7,1288
E01016982,510,423,77,9,1019
E01016983,510,519,112,3,1144
E01016984,558,547,80,6,1191
E01016985,605,335,262,14,1216
E01016986,378,382,487,86,1333
E01016987,565,337,426,66,1394
E01016988,421,245,437,69,1172
E01016989,443,356,390,83,1272
E01016990,564,205,354,159,1282
E01016991,602,199,496,91,1388
E01016992,584,457,187,22,1250
E01016993,284,198,217,496,1195
E01016994,539,257,425,81,1302
E01016995,577,440,237,23,1277
E01016996,575,274,359,53,1261
E01016997,560,376,240,33,1209
E01016998,610,483,80,11,1184
E01016999,548,523,87,20,1178
E01017000,531,482,301,98,1412
E01017001,532,539,93,37,1201
E01017002,501,480,392,23,1396
E01017003,580,386,259,50,1275
E01017004,526,282,465,66,1339
E01017005,624,297,369,19,1309
E01017006,567,301,409,29,1306
E01017007,417,295,161,370,1243
E01017008,637,593,119,33,1382
E01017009,547,469,85,145,1246
E01017010,610,638,114,76,1438
E01017011,289,240,55,485,1069
E01017012,652,491,140,140,1423
E01017013,613,297,261,41,1212
E01017014,695,362,163,21,1241
E01017015,529,375,137,130,1171
E01017016,588,373,229,28,1218
E01017017,667,422,101,36,1226
E01017018,659,469,95,54,1277
E01017019,686,291,211,202,1390
E01017020,741,451,216,375,1783
E01017021,446,550,88,125,1209
E01017022,293,219,688,100,1300
E01017023,493,333,561,21,1408
E01017024,409,255,947,47,1658
E01017025,465,291,1022,37,1815
E01017026,465,298,744,181,1688
E01017027,352,240,988,53,1633
E01017028,308,250,1371,54,1983
E01017029,529,307,601,54,1491
E01017030,411,275,982,33,1701
E01017031,239,81,241,1000,1561
E01017032,65,44,257,599,965
E01017034,48,38,234,639,959
E01017035,68,50,112,956,1186
E01017036,288,138,138,579,1143
E01017037,87,43,84,904,1118
E01017038,163,54,175,877,1269
E01017039,262,150,294,654,1360
E01017040,56,26,104,921,1107
E01017041,608,325,147,14,1094
E01017042,545,263,162,93,1063
E01017043,585,272,209,21,1087
E01017044,627,280,269,32,1208
E01017045,580,204,200,44,1028
E01017046,776,466,232,10,1484
E01017047,702,404,157,10,1273
E01017048,670,432,127,16,1245
E01017049,639,479,106,22,1246
E01017050,489,570,127,117,1303
E01017051,346,256,327,513,1442
E01017052,413,243,106,328,1090
E01017053,250,160,106,492,1008
E01017054,525,296,151,195,1167
E01017055,497,489,142,107,1235
E01017056,586,348,104,14,1052
E01017057,638,456,102,14,1210
E01017058,569,310,84,301,1264
E01017059,538,541,122,51,1252
E01017060,629,444,110,18,1201
E01017061,560,711,109,12,1392
E01017062,527,405,301,23,1256
E01017063,612,635,50,8,1305
E01017064,530,645,136,29,1340
E01017066,659,519,174,126,1478
E01017067,424,403,222,143,1192
E01017068,555,447,463,42,1507
E01017069,582,380,406,26,1394
E01017070,403,353,464,90,1310
E01017071,382,240,685,49,1356
E01017072,445,395,371,33,1244
E01017073,315,275,752,183,1525
E01017074,289,231,835,23,1378
E01017075,495,239,416,71,1221
E01017076,594,243,388,78,1303
E01017077,389,140,456,397,1382
E01017078,524,237,411,45,1217
E01017079,519,214,449,125,1307
E01017080,432,230,784,216,1662
E01017081,603,212,447,70,1332
E01017082,581,186,491,67,1325
E01017083,732,210,354,48,1344
E01017084,581,319,225,26,1151
E01017085,465,492,141,127,1225
E01017086,577,385,72,18,1052
E01017087,605,240,307,32,1184
E01017088,649,384,261,65,1359
E01017089,432,183,223,355,1193
E01017090,437,329,233,207,1206
E01017091,278,168,300,463,1209
E01017092,513,432,217,57,1219
E01017093,333,292,119,152,896
E01017094,584,355,266,42,1247
E01017095,610,354,424,107,1495
E01017096,497,392,224,50,1163
E01017097,527,272,487,41,1327
E01017098,327,205,439,168,1139
E01017099,547,289,333,162,1331
E01017100,575,331,130,23,1059
E01017101,556,351,272,50,1229
E01017102,352,143,262,511,1268
E01017103,132,70,106,596,904
E01017104,434,227,171,77,909
E01017105,540,230,240,121,1131
E01017106,514,211,218,218,1161
E01017107,562,250,368,40,1220
E01017108,486,252,308,200,1246
E01017109,405,215,248,173,1041
E01017110,563,262,290,39,1154
E01017111,504,200,352,73,1129
E01017112,489,193,91,595,1368
E01017113,566,374,154,103,1197
E01017114,430,404,324,40,1198
E01017115,447,184,68,315,1014
E01017116,309,196,249,376,1130
E01017117,450,225,130,360,1165
E01017118,335,153,114,553,1155
E01017119,532,236,99,427,1294
E01017120,339,185,84,569,1177
E01017121,388,331,668,40,1427
E01017122,362,216,797,97,1472
E01017123,431,350,981,39,1801
E01017124,448,254,698,78,1478
E01017125,338,323,512,290,1463
E01017126,480,245,800,29,1554
E01017127,327,191,1121,83,1722
E01017128,225,173,1052,77,1527
E01017129,308,140,1174,130,1752
E01017130,81,73,292,994,1440
E01017131,181,345,655,174,1355
E01017132,166,87,429,1048,1730
E01017133,208,289,733,399,1629
E01017135,307,259,697,211,1474
E01017136,148,174,1141,90,1553
E01017137,89,42,1488,64,1683
E01017138,242,150,1291,193,1876
E01017139,176,96,588,664,1524
E01017140,123,117,517,516,1273
E01017142,340,221,979,81,1621
E01017144,259,253,259,91,862
E01017145,475,448,264,69,1256
E01017146,550,463,283,56,1352
E01017147,392,429,359,36,1216
E01017148,375,350,245,73,1043
E01017149,210,163,499,286,1158
E01017150,406,470,272,78,1226
E01017151,478,360,179,304,1321
E01017152,399,304,371,178,1252
E01017153,260,156,618,180,1214
E01017154,201,115,365,896,1577
E01017155,234,241,686,134,1295
E01017156,313,222,560,207,1302
E01017157,95,121,1188,47,1451
E01017158,276,173,1072,210,1731
E01017159,147,96,1211,84,1538
E01017160,312,160,785,87,1344
E01017162,409,483,88,224,1204
E01017163,163,104,79,764,1110
E01017164,539,451,93,170,1253
E01017165,391,238,75,465,1169
E01017166,210,110,73,734,1127
E01017167,153,120,81,743,1097
E01017168,401,195,116,630,1342
E01017169,367,162,86,540,1155
E01017170,505,265,145,331,1246
E01017171,600,242,492,176,1510
E01017172,534,290,527,108,1459
E01017173,583,308,159,119,1169
E01017174,467,475,101,39,1082
E01017175,633,374,180,34,1221
E01017176,560,404,264,86,1314
E01017177,418,391,415,62,1286
E01017178,670,289,219,19,1197
E01017179,382,249,172,321,1124
E01017180,615,416,105,58,1194
E01017181,487,173,71,367,1098
E01017182,382,160,74,597,1213
E01017183,662,402,126,115,1305
E01017184,474,262,88,303,1127
E01017185,492,340,164,370,1366
E01017186,410,112,168,602,1292
E01017187,482,314,227,247,1270
E01017188,345,117,182,634,1278
E01017189,245,146,846,32,1269
E01017190,374,252,670,38,1334
E01017191,353,153,866,85,1457
E01017192,543,268,636,209,1656
E01017193,478,258,528,165,1429
E01017194,339,211,718,271,1539
E01017195,483,287,712,145,1627
E01017196,470,251,906,88,1715
E01017197,589,308,249,47,1193
E01017198,472,369,106,290,1237
E01017199,446,482,162,270,1360
E01017200,633,591,218,84,1526
E01017201,300,235,161,360,1056
E01017202,358,215,160,497,1230
E01017203,587,364,155,175,1281
E01017204,651,441,100,60,1252
E01017205,299,111,51,548,1009
E01017206,601,346,118,239,1304
E01017207,225,117,105,698,1145
E01017208,301,163,101,484,1049
E01017209,453,248,368,57,1126
E01017210,252,122,111,618,1103
E01017211,443,347,475,233,1498
E01017212,461,333,212,95,1101
E01017213,499,287,468,52,1306
E01017214,457,335,241,52,1085
E01017215,714,477,163,29,1383
E01017216,444,212,243,267,1166
E01017217,543,391,181,110,1225
E01017218,413,140,112,360,1025
E01017219,431,199,314,470,1414
E01017220,602,311,239,329,1481
E01017221,686,328,235,42,1291
E01017222,648,284,191,86,1209
E01017223,699,450,199,18,1366
E01017224,568,364,159,27,1118
E01017225,523,291,145,212,1171
E01017226,272,441,485,147,1345
E01017227,86,90,952,65,1193
E01017228,337,208,430,313,1288
E01017231,278,218,1010,68,1574
E01017232,291,271,475,46,1083
E01017233,394,226,436,289,1345
E01017234,227,240,960,234,1661
E01017235,151,132,1041,92,1416
E01017236,330,174,72,483,1059
E01017237,275,138,88,610,1111
E01017238,319,243,124,407,1093
E01017239,363,214,202,411,1190
E01017240,205,165,81,498,949
E01017241,350,190,85,476,1101
E01017242,473,235,238,273,1219
E01017243,593,471,152,183,1399
E01017244,464,216,80,264,1024
E01017245,178,109,51,725,1063
E01017246,439,261,686,182,1568
E01017247,582,463,212,22,1279
E01017248,617,414,155,33,1219
E01017249,519,467,102,15,1103
E01017250,219,159,167,594,1139
E01017251,267,161,397,392,1217
E01017252,539,495,221,43,1298
E01017253,425,266,257,337,1285
E01017254,532,309,254,179,1274
E01017255,632,405,229,30,1296
E01017256,841,600,163,60,1664
E01017257,613,328,266,99,1306
E01017258,635,237,162,193,1227
E01017259,610,391,127,47,1175
E01017260,462,425,121,172,1180
E01017261,683,416,222,55,1376
E01017262,490,214,99,237,1040
E01017263,479,279,134,261,1153
E01017264,143,64,187,380,774
E01017265,368,215,125,588,1296
E01017266,217,136,431,363,1147
E01017267,200,124,555,197,1076
E01017270,338,153,170,312,973
E01017271,337,325,208,55,925
E01017272,294,142,189,410,1035
E01017273,490,415,163,49,1117
E01017274,270,163,89,595,1117
E01017275,591,382,210,147,1330
E01017276,431,207,431,290,1359
E01017277,579,269,88,197,1133
E01017278,512,236,298,42,1088
E01017279,547,344,277,150,1318
E01017280,302,154,109,523,1088
E01017281,93,57,64,983,1197
E01017282,497,351,161,116,1125
E01017283,515,526,161,52,1254
E01017284,430,773,184,20,1407
E01017285,371,943,178,140,1632
E01017286,397,730,157,34,1318
E01017287,636,605,132,14,1387
E01017288,357,470,181,34,1042
E01017289,646,698,169,218,1731
E01017290,346,603,155,52,1156
E01017291,279,628,68,60,1035
E01017292,517,491,205,76,1289
E01017293,776,539,165,50,1530
E01017294,537,548,177,34,1296
E01017295,385,278,171,167,1001
E01017296,403,514,113,35,1065
E01017297,434,509,133,111,1187
E01017298,419,685,141,42,1287
E01017299,287,485,118,160,1050
E01017300,485,732,609,81,1907
E01017301,317,472,85,6,880
E01017302,636,494,158,50,1338
E01017303,442,274,264,20,1000
E01017304,504,323,139,109,1075
E01017305,377,232,361,109,1079
E01017306,477,209,192,161,1039
E01017307,585,774,236,58,1653
E01017308,520,405,217,220,1362
E01017309,579,291,339,88,1297
E01017310,431,514,80,27,1052
E01017311,491,443,221,120,1275
E01017312,328,540,268,166,1302
E01017315,315,500,117,301,1233
E01017316,474,725,189,39,1427
E01017317,526,486,145,113,1270
E01017318,320,289,122,222,953
E01017319,332,495,153,142,1122
E01017320,286,585,75,33,979
E01017321,382,441,84,58,965
E01017322,353,228,183,414,1178
E01017323,375,546,69,27,1017
E01017324,493,548,122,60,1223
E01017325,385,258,191,233,1067
E01017326,290,260,525,228,1303
E01017327,524,464,194,115,1297
E01017328,340,236,416,118,1110
E01017329,737,920,152,115,1924
E01017331,344,364,141,302,1151
E01017332,299,206,92,403,1000
E01017333,716,369,224,85,1394
E01017334,455,293,100,121,969
E01017335,405,334,407,94,1240
E01017336,269,265,698,59,1291
E01017337,382,333,530,40,1285
E01017338,364,550,147,57,1118
E01017339,564,396,230,110,1300
E01017340,549,300,379,137,1365
E01017341,406,376,139,295,1216
E01017342,501,458,215,134,1308
E01017343,325,318,183,208,1034
E01017344,448,708,178,36,1370
E01017345,354,247,278,562,1441
E01017346,412,323,390,77,1202
E01017347,450,523,195,158,1326
E01017348,384,306,273,74,1037
E01017349,647,471,548,22,1688
E01017350,530,447,202,289,1468
E01017351,335,632,190,44,1201
E01017352,299,659,65,10,1033
E01017353,400,531,57,69,1057
E01017354,236,481,175,113,1005
E01017355,498,587,138,57,1280
E01017356,362,346,353,109,1170
E01017357,383,458,141,250,1232
E01017358,362,577,72,91,1102
E01017359,386,594,229,39,1248
E01017360,304,483,493,47,1327
E01017361,311,666,135,45,1157
E01017362,371,497,242,101,1211
E01017363,315,396,377,184,1272
E01017364,413,534,246,37,1230
E01017365,267,782,173,47,1269
E01017366,349,399,167,256,1171
E01017367,516,892,188,12,1608
E01017368,485,442,195,138,1260
E01017369,431,524,145,118,1218
E01017370,481,677,106,251,1515
E01017371,462,484,70,32,1048
E01017372,483,372,123,213,1191
E01017373,548,416,86,83,1133
E01017374,534,394,182,25,1135
E01017375,490,354,202,127,1173
E01017376,863,320,227,78,1488
E01017377,842,396,133,175,1546
E01017378,577,227,147,484,1435
E01017379,306,317,176,171,970
E01017380,430,439,127,32,1028
E01017381,566,520,113,30,1229
E01017382,481,345,68,251,1145
E01017383,747,367,320,86,1520
E01017384,479,242,169,338,1228
E01017385,518,425,349,78,1370
E01017386,701,313,230,182,1426
E01017387,536,363,48,110,1057
E01017388,452,357,120,170,1099
E01017389,827,389,113,151,1480
E01017390,671,309,120,470,1570
E01017391,452,275,66,262,1055
E01017392,529,605,87,16,1237
E01017393,649,500,97,120,1366
E01017394,543,354,184,141,1222
E01017397,520,493,260,78,1351
E01017398,947,723,135,127,1932
E01017399,630,266,164,83,1143
E01017400,315,174,63,606,1158
E01017401,519,241,180,79,1019
E01017402,593,575,117,21,1306
E01017403,604,367,102,70,1143
E01017404,607,463,40,11,1121
E01017405,676,344,169,12,1201
E01017406,666,343,181,26,1216
E01017407,718,347,240,38,1343
E01017408,451,326,73,7,857
E01017409,422,403,78,121,1024
E01017410,422,402,62,109,995
E01017411,564,424,143,109,1240
E01017412,335,280,404,194,1213
E01017413,730,539,106,79,1454
E01017414,653,458,98,188,1397
E01017415,713,372,112,256,1453
E01017416,808,451,207,108,1574
E01017417,1100,384,227,95,1806
E01017418,481,325,115,297,1218
E01017419,657,514,81,24,1276
E01017420,492,351,121,273,1237
E01017421,640,496,74,183,1393
E01017422,497,527,66,160,1250
E01017423,474,458,123,194,1249
E01017424,483,463,82,131,1159
E01017425,384,300,103,110,897
E01017426,488,471,101,82,1142
E01017427,620,374,192,223,1409
E01017428,595,415,124,165,1299
E01017429,564,364,179,41,1148
E01017430,528,282,98,213,1121
E01017431,591,352,186,101,1230
E01017432,570,469,70,87,1196
E01017433,401,131,71,597,1200
E01017434,688,319,202,159,1368
E01017435,545,290,191,286,1312
E01017436,1171,399,167,42,1779
E01017437,424,321,211,281,1237
E01017438,692,412,150,60,1314
E01017439,680,320,183,78,1261
E01017440,390,203,127,355,1075
E01017441,523,303,329,107,1262
E01017442,867,503,142,116,1628
E01017443,360,281,551,76,1268
E01017444,608,506,166,222,1502
E01017445,693,502,176,105,1476
E01017446,591,394,111,297,1393
E01017447,870,561,155,80,1666
E01017449,578,450,109,87,1224
E01017450,928,595,132,186,1841
E01017451,353,289,393,107,1142
E01017452,282,373,256,100,1011
E01017453,318,328,87,337,1070
E01017454,520,539,94,59,1212
E01017455,505,579,114,43,1241
E01017456,436,667,82,56,1241
E01017457,358,326,64,187,935
E01017458,492,350,85,86,1013
E01017459,627,580,106,12,1325
E01017460,621,515,138,29,1303
E01017461,735,477,128,142,1482
E01017462,674,507,62,10,1253
E01017463,434,530,55,111,1130
E01017464,479,587,78,61,1205
E01017465,426,551,119,75,1171
E01017466,360,173,777,190,1500
E01017467,435,254,309,72,1070
E01017468,425,323,313,20,1081
E01017469,345,265,630,172,1412
E01017470,395,398,219,12,1024
E01017471,127,78,528,505,1238
E01017472,296,138,209,397,1040
E01017473,580,243,739,246,1808
E01017474,400,201,444,246,1291
E01017475,500,299,299,74,1172
E01017476,439,444,207,92,1182
E01017477,161,106,98,573,938
E01017478,621,488,141,139,1389
E01017479,376,492,135,64,1067
E01017480,754,384,186,104,1428
E01017481,408,337,73,120,938
E01017482,303,289,281,185,1058
E01017483,426,500,200,29,1155
E01017484,176,165,348,48,737
E01017485,406,262,387,44,1099
E01017486,619,291,224,186,1320
E01017487,653,184,126,348,1311
E01017488,443,634,103,55,1235
E01017489,302,235,112,491,1140
E01017490,289,143,115,500,1047
E01017491,486,455,158,152,1251
E01017492,369,165,137,411,1082
E01017493,533,152,139,377,1201
E01017495,749,535,185,116,1585
E01017496,509,538,89,110,1246
E01017497,357,201,500,90,1148
E01017498,432,366,223,26,1047
E01017499,320,194,428,96,1038
E01017500,262,122,439,165,988
E01017501,182,217,361,174,934
E01017502,158,69,410,660,1297
E01017503,445,324,137,90,996
E01017504,676,520,218,107,1521
E01017505,508,388,219,130,1245
E01017506,512,259,270,180,1221
E01017507,518,324,137,67,1046
E01017508,628,393,218,54,1293
E01017509,229,168,38,491,926
E01017510,584,381,156,125,1246
E01017511,447,344,114,115,1020
E01017512,431,295,142,255,1123
E01017513,562,405,144,51,1162
E01017514,374,259,140,492,1265
E01017515,442,305,93,379,1219
E01017516,632,388,106,48,1174
E01017517,623,443,114,80,1260
E01017518,406,233,215,294,1148
E01017519,365,207,136,506,1214
E01017520,592,280,177,132,1181
E01017521,607,291,166,131,1195
E01017522,354,264,490,349,1457
E01017523,281,100,107,584,1072
E01017524,542,433,178,96,1249
E01017525,368,282,99,200,949
E01017526,615,262,212,38,1127
E01017527,386,310,219,27,942
E01017528,952,744,141,87,1924
E01017529,501,455,80,25,1061
E01017530,492,642,46,21,1201
E01017531,326,240,81,423,1070
E01017532,422,549,65,7,1043
E01017533,415,549,41,24,1029
E01017534,537,638,85,8,1268
E01017535,484,338,163,86,1071
E01017536,523,266,752,241,1782
E01017537,245,260,162,333,1000
E01017538,463,367,376,109,1315
E01017539,414,318,282,83,1097
E01017540,474,548,144,55,1221
E01017541,415,412,76,118,1021
E01017542,485,384,155,138,1162
E01017543,530,418,153,77,1178
E01017544,426,511,106,84,1127
E01017545,508,422,169,68,1167
E01017546,384,330,174,100,988
E01017547,589,531,116,64,1300
E01017548,719,372,76,284,1451
E01017549,468,591,72,66,1197
E01017550,1168,400,240,261,2069
E01017551,640,365,94,53,1152
E01017552,521,178,172,46,917
E01017553,506,414,43,37,1000
E01017554,464,439,72,214,1189
E01017555,513,350,443,261,1567
E01017556,695,290,234,47,1266
E01017557,451,428,200,408,1487
E01017558,795,366,157,59,1377
E01017559,639,512,99,123,1373
E01017560,564,608,52,9,1233
E01017561,637,506,52,64,1259
E01017562,361,520,124,231,1236
E01017563,600,602,91,23,1316
E01017564,481,388,225,43,1137
E01017565,505,645,56,59,1265
E01017566,585,623,52,19,1279
E01017567,605,307,150,230,1292
E01017568,558,246,415,224,1443
E01017569,552,308,281,145,1286
E01017570,633,370,460,127,1590
E01017571,398,412,41,185,1036
E01017572,537,419,106,49,1111
E01017573,541,552,103,12,1208
E01017575,984,388,352,212,1936
E01017576,614,294,54,167,1129
E01017577,899,565,156,181,1801
E01017578,788,400,146,46,1380
E01017579,521,309,78,265,1173
E01017580,777,175,241,367,1560
E01017581,600,309,188,332,1429
E01017582,620,494,116,18,1248
E01017583,796,474,160,37,1467
E01017584,706,548,198,78,1530
E01017585,584,538,52,10,1184
E01017586,493,409,83,223,1208
E01017587,514,660,105,60,1339
E01017588,379,471,70,108,1028
E01017589,560,271,370,164,1365
E01017590,521,577,123,27,1248
E01017591,575,485,184,176,1420
E01017592,576,359,166,161,1262
E01017593,543,465,95,135,1238
E01017594,466,151,94,794,1505
E01017595,347,251,48,290,936
E01017596,431,217,101,407,1156
E01017597,546,314,61,225,1146
E01017598,466,298,59,36,859
E01017599,699,277,292,326,1594
E01017600,921,252,270,64,1507
E01017601,388,182,109,339,1018
E01017602,479,195,96,427,1197
E01017603,671,430,128,20,1249
E01017604,787,409,101,45,1342
E01017605,446,175,63,341,1025
E01017606,577,668,51,15,1311
E01017607,509,506,67,13,1095
E01017608,594,378,170,217,1359
E01017609,409,163,133,548,1253
E01017610,446,434,45,23,948
E01017611,556,377,107,0,1040
E01017612,635,307,92,11,1045
E01017613,567,413,123,37,1140
E01017614,662,370,105,64,1201
E01017615,759,716,142,131,1748
E01017616,949,440,285,128,1802
E01017617,469,364,91,118,1042
E01017618,405,225,137,420,1187
E01017619,617,273,117,559,1566
E01017620,722,487,192,60,1461
E01017621,637,578,63,30,1308
E01017622,505,355,168,303,1331
E01017623,640,313,292,119,1364
E01017624,786,477,195,35,1493
E01017625,635,689,35,5,1364
E01017626,682,650,94,18,1444
E01017627,604,355,164,151,1274
E01017628,661,495,82,48,1286
E01017629,609,565,99,32,1305
E01017630,530,539,72,112,1253
E01017631,588,458,136,113,1295
E01017632,628,528,108,9,1273
E01017634,463,274,421,77,1235
E01017635,490,468,177,2,1137
E01017636,557,590,96,15,1258
E01017637,579,272,130,49,1030
E01017638,432,496,116,15,1059
E01017639,635,601,83,5,1324
E01017640,617,549,49,51,1266
E01017641,647,559,113,75,1394
E01017642,438,374,132,77,1021
E01017643,448,340,186,88,1062
E01017644,596,340,220,57,1213
E01017645,285,146,423,159,1013
E01017646,507,397,130,421,1455
E01017647,626,577,68,21,1292
E01017648,772,497,153,26,1448
E01017649,645,499,248,207,1599
E01017650,742,366,147,2,1257
E01017651,630,476,69,62,1237
E01017652,578,352,124,123,1177
E01017653,635,310,168,97,1210
E01017654,373,151,152,363,1039
E01017655,914,248,266,70,1498
E01017657,457,587,60,42,1146
E01017658,589,381,120,65,1155
E01017659,444,301,181,291,1217
E01017660,651,204,339,80,1274
E01017661,481,242,162,295,1180
E01017662,338,290,227,161,1016
E01017663,373,336,329,183,1221
E01017664,673,258,230,15,1176
E01017665,473,235,129,313,1150
E01017666,513,394,314,89,1310
E01017667,426,173,82,296,977
E01017668,640,308,137,130,1215
E01017669,507,504,81,135,1227
E01017670,544,447,165,121,1277
E01017671,614,468,94,89,1265
E01017672,592,383,130,72,1177
E01017673,455,393,105,66,1019
E01017674,633,280,105,38,1056
E01017675,484,541,110,26,1161
E01017676,453,593,93,27,1166
E01017677,408,606,95,35,1144
E01017678,436,438,187,44,1105
E01017679,606,363,94,161,1224
E01017680,284,239,68,240,831
E01017681,411,251,70,267,999
E01017682,416,427,86,15,944
E01017683,599,541,116,147,1403
E01017684,351,435,55,68,909
E01017687,606,215,267,450,1538
E01017688,516,197,163,81,957
E01017689,617,341,133,47,1138
E01017690,468,306,122,63,959
E01017691,637,384,62,17,1100
E01017692,539,390,306,24,1259
E01017693,403,262,114,106,885
E01017694,984,440,144,130,1698
E01017695,449,409,47,102,1007
E01017696,477,399,82,69,1027
E01017697,652,256,199,35,1142
E01017698,526,223,125,205,1079
E01017699,402,150,230,54,836
E01017700,550,568,149,6,1273
E01017701,903,425,140,143,1611
E01017702,521,350,103,231,1205
E01017703,388,392,135,110,1025
E01017704,462,380,71,70,983
E01017705,606,242,89,41,978
E01017706,493,146,75,288,1002
E01017707,325,80,92,463,960
E01017708,465,192,189,304,1150
E01017709,404,181,158,506,1249
E01017710,533,246,94,296,1169
E01017711,366,177,144,498,1185
E01017712,536,178,320,517,1551
E01017713,578,279,126,172,1155
E01017714,558,347,148,41,1094
E01017715,329,322,215,57,923
E01017716,665,489,129,160,1443
E01017717,526,489,193,139,1347
E01017718,585,405,175,84,1249
E01017719,440,211,129,186,966
E01017720,403,263,300,59,1025
E01017721,692,228,254,98,1272
E01017722,696,272,150,73,1191
E01017723,386,133,116,377,1012
E01017724,414,134,129,326,1003
E01017726,242,420,169,107,938
E01017727,575,588,97,15,1275
E01017728,493,152,597,206,1448
E01017729,664,491,71,99,1325
E01017730,455,339,137,329,1260
E01017731,424,259,134,246,1063
E01017732,526,408,128,50,1112
E01017733,373,364,92,152,981
E01017734,558,408,115,24,1105
E01017735,458,363,149,101,1071
E01017736,443,370,126,301,1240
E01017737,533,542,73,6,1154
E01017738,496,413,246,69,1224
E01017739,471,395,94,25,985
E01017740,469,287,176,106,1038
E01017741,435,445,92,256,1228
E01017742,466,511,296,52,1325
E01017743,380,232,167,463,1242
E01017744,513,384,117,128,1142
E01017745,466,532,275,170,1443
E01017746,548,417,132,100,1197
E01017747,452,341,123,166,1082
E01017748,468,275,69,579,1391
E01017749,620,624,52,35,1331
E01017750,727,763,178,123,1791
E01017751,791,752,130,25,1698
E01017752,704,862,120,91,1777
E01017753,403,243,74,264,984
E01017754,530,544,59,30,1163
E01017755,531,437,224,40,1232
E01017756,489,638,66,9,1202
E01017757,428,397,40,85,950
E01017758,422,395,80,21,918
E01017759,467,558,188,213,1426
E01017760,532,678,83,59,1352
E01017761,761,692,134,78,1665
E01017762,453,563,96,17,1129
E01017763,434,636,255,31,1356
E01017764,620,612,66,22,1320
E01017765,547,706,64,23,1340
E01017766,643,994,133,91,1861
E01017767,721,589,126,263,1699
E01017768,626,802,215,161,1804
E01017769,691,439,136,25,1291
E01017770,468,246,290,172,1176
E01017771,550,575,69,15,1209
E01017773,550,559,84,49,1242
E01017774,467,521,41,24,1053
E01017775,439,402,131,280,1252
E01017776,415,361,127,356,1259
E01017777,546,650,68,30,1294
E01017778,351,473,70,107,1001
E01017779,364,426,52,61,903
E01017780,520,352,114,22,1008
E01017781,368,173,126,229,896
E01017782,467,591,62,9,1129
E01017783,494,457,132,95,1178
E01017784,533,569,119,62,1283
E01017785,597,690,105,16,1408
E01017786,615,490,81,53,1239
E01017787,545,624,88,22,1279
E01017788,529,380,113,341,1363
E01017789,365,298,59,273,995
E01017790,299,201,57,452,1009
E01017791,465,284,97,280,1126
E01017792,456,422,348,318,1544
E01017793,457,405,85,294,1241
E01017794,824,712,157,109,1802
E01017795,656,514,181,310,1661
E01017796,344,439,371,277,1431
E01017797,455,613,79,21,1168
E01017798,481,726,174,58,1439
E01017799,600,496,291,127,1514
E01017800,381,239,338,251,1209
E01017801,562,495,127,44,1228
E01017802,385,434,85,342,1246
E01017803,429,458,108,25,1020
E01017804,473,445,190,175,1283
E01017805,513,254,110,545,1422
E01017806,637,617,89,47,1390
E01017807,606,425,125,49,1205
E01017808,491,340,153,197,1181
E01017809,529,256,90,287,1162
E01017810,439,401,216,426,1482
E01017811,356,473,95,71,995
E01017812,560,388,168,206,1322
E01017813,823,573,142,28,1566
E01017814,576,486,146,74,1282
E01017815,635,615,130,55,1435
E01017816,533,499,182,147,1361
E01017817,676,498,121,195,1490
E01017818,691,496,206,120,1513
E01017819,506,547,136,11,1200
E01017820,304,582,321,60,1267
E01017821,506,532,177,16,1231
E01017822,744,638,127,9,1518
E01017823,435,361,159,127,1082
E01017824,698,474,106,115,1393
E01017825,754,491,118,36,1399
E01017826,572,287,70,291,1220
E01017827,566,448,166,191,1371
E01017828,527,329,108,319,1283
E01017829,940,534,158,20,1652
E01017830,678,469,150,210,1507
E01017831,608,608,127,31,1374
E01017832,600,481,143,137,1361
E01017833,507,604,260,45,1416
E01017834,508,481,93,124,1206
E01017835,576,684,112,69,1441
E01017836,624,351,259,28,1262
E01017837,335,153,709,300,1497
E01017838,553,325,313,28,1219
E01017839,259,309,353,49,970
E01017840,672,471,257,58,1458
E01017841,530,385,204,23,1142
E01017842,802,836,417,101,2156
E01017843,551,577,71,125,1324
E01017844,567,298,127,345,1337
E01017845,587,295,181,239,1302
E01017846,335,355,177,297,1164
E01017847,485,506,177,60,1228
E01017848,448,483,62,2,995
E01017849,524,428,207,22,1181
E01017850,389,132,184,310,1015
E01017851,555,266,336,206,1363
E01017852,869,539,375,69,1852
E01017853,528,292,196,67,1083
E01017854,456,409,106,54,1025
E01017855,462,404,143,157,1166
E01017856,394,232,88,356,1070
E01017857,406,144,132,433,1115
E01017858,457,120,305,230,1112
E01017859,508,441,151,33,1133
E01017860,466,247,168,198,1079
E01017861,620,457,118,41,1236
E01017862,742,469,121,99,1431
E01017863,717,536,94,22,1369
E01017864,532,506,58,11,1107
E01017865,613,593,53,10,1269
E01017866,438,599,143,13,1193
E01017867,512,288,90,291,1181
E01017868,561,545,140,14,1260
E01017869,524,504,64,11,1103
E01017870,466,469,82,8,1025
E01017871,582,606,74,10,1272
E01017872,570,715,84,18,1387
E01017873,641,413,55,22,1131
E01017874,239,228,347,55,869
E01017875,298,329,459,21,1107
E01017876,798,723,77,19,1617
E01017877,542,526,80,148,1296
E01017878,692,840,489,84,2105
E01017880,574,488,41,3,1106
E01017881,654,658,81,48,1441
E01017882,624,492,110,53,1279
E01017883,600,525,92,54,1271
E01017884,574,350,93,128,1145
E01017885,558,554,159,94,1365
E01017886,485,530,139,46,1200
E01017887,376,428,82,40,926
E01017888,389,409,423,65,1286
E01017889,417,253,131,241,1042
E01017890,497,495,40,17,1049
E01017891,512,455,165,34,1166
E01017892,510,615,88,16,1229
E01017893,352,322,300,359,1333
E01017894,480,544,174,38,1236
E01017895,351,331,204,171,1057
E01017896,447,464,229,19,1159
E01017897,603,339,210,104,1256
E01017898,410,169,160,239,978
E01017899,530,223,136,403,1292
E01017900,353,206,139,318,1016
E01017901,342,164,64,325,895
E01017902,459,177,174,375,1185
E01017903,487,249,314,181,1231
E01017904,537,238,437,138,1350
E01017905,504,290,797,177,1768
E01017906,607,206,188,304,1305
E01017907,481,307,258,293,1339
E01017908,772,259,383,556,1970
E01017909,802,307,408,161,1678
E01017910,737,422,633,211,2003
E01017911,537,254,164,331,1286
E01017912,501,335,247,29,1112
E01017913,526,202,494,146,1368
E01017914,658,282,84,59,1083
E01017915,522,330,118,113,1083
E01017916,446,417,102,34,999
E01017917,583,358,193,35,1169
E01017918,488,338,157,260,1243
E01017919,340,176,480,150,1146
E01017920,519,319,74,66,978
E01017921,565,344,457,40,1406
E01017922,592,321,283,121,1317
E01017923,269,254,590,148,1261
E01017924,571,429,180,20,1200
E01017925,709,279,343,286,1617
E01017926,372,99,126,487,1084
E01017927,591,389,93,136,1209
E01017928,499,316,133,243,1191
E01017929,350,301,231,382,1264
E01017930,631,640,146,26,1443
E01017931,483,395,86,194,1158
E01017932,501,613,97,111,1322
E01017933,502,567,90,237,1396
E01017934,561,281,139,376,1357
E01017935,759,395,270,132,1556
E01017936,515,554,149,72,1290
E01017937,603,480,72,26,1181
E01017938,557,431,70,11,1069
E01017939,531,324,152,87,1094
E01017940,687,364,160,29,1240
E01017941,499,312,208,162,1181
E01017942,621,456,30,97,1204
E01017943,368,284,580,230,1462
E01017944,336,192,171,429,1128
E01017945,373,207,572,294,1446
E01017946,301,228,266,473,1268
E01017947,443,263,240,438,1384
E01017948,291,105,197,697,1290
E01017949,255,267,600,222,1344
E01017950,257,352,453,70,1132
E01017951,329,353,278,286,1246
E01017952,240,242,197,524,1203
E01017953,312,356,306,389,1363
E01017954,305,337,193,352,1187
E01017955,304,528,408,22,1262
E01017956,331,380,262,59,1032
E01017957,234,293,446,24,997
E01017958,52,77,223,236,588
E01017959,462,473,392,94,1421
E01017960,321,165,152,399,1037
E01017961,270,186,241,302,999
E01017962,405,397,169,328,1299
E01017963,460,297,179,346,1282
E01017964,427,449,179,42,1097
E01017965,360,308,389,331,1388
E01017966,523,303,1000,294,2120
E01017967,329,258,392,451,1430
E01017968,356,453,388,154,1351
E01017969,383,253,325,257,1218
E01017971,259,182,268,590,1299
E01017972,323,338,242,414,1317
E01017973,184,164,271,738,1357
E01017974,321,227,366,516,1430
E01017975,301,200,175,568,1244
E01017976,470,288,405,232,1395
E01017977,423,141,300,467,1331
E01017978,283,169,239,538,1229
E01017979,313,105,221,585,1224
E01017980,366,237,186,146,935
E01017983,295,396,797,157,1645
E01017984,215,592,457,73,1337
E01017985,275,496,444,102,1317
E01017986,57,186,218,58,519
E01017987,301,346,621,107,1375
E01017988,274,265,696,78,1313
E01017989,406,275,842,244,1767
E01017990,263,218,541,55,1077
E01017991,175,187,379,262,1003
E01017992,474,337,349,339,1499
E01017993,399,575,355,354,1683
E01017994,421,355,202,347,1325
E01017995,383,627,122,66,1198
E01017996,331,423,311,7,1072
E01017997,570,381,662,331,1944
E01017998,381,229,845,70,1525
E01017999,348,232,551,355,1486
E01018000,401,233,801,106,1541
E01018001,370,291,747,107,1515
E01018002,350,272,465,229,1316
E01018003,421,393,226,222,1262
E01018005,195,308,559,260,1322
E01018006,388,379,593,82,1442
E01018007,455,594,222,31,1302
E01018008,405,364,419,133,1321
E01018009,313,293,651,299,1556
E01018010,329,445,564,136,1474
E01018011,769,764,290,195,2018
E01018012,362,393,121,211,1087
E01018013,663,624,96,54,1437
E01018014,661,480,156,102,1399
E01018015,562,398,97,31,1088
E01018016,434,293,58,319,1104
E01018017,303,295,226,243,1067
E01018019,308,340,180,23,851
E01018020,572,461,134,69,1236
E01018021,533,381,98,182,1194
E01018022,511,439,65,152,1167
E01018023,595,568,388,247,1798
E01018024,348,270,149,167,934
E01018025,253,211,527,172,1163
E01018026,401,469,308,40,1218
E01018027,525,529,273,47,1374
E01018029,1013,428,413,188,2042
E01018030,302,265,61,185,813
E01018032,784,741,319,154,1998
E01018033,468,535,249,380,1632
E01018034,526,488,185,62,1261
E01018035,650,453,340,365,1808
E01018036,569,420,136,207,1332
E01018037,533,474,58,62,1127
E01018038,570,502,130,29,1231
E01018039,488,404,76,92,1060
E01018040,458,421,127,21,1027
E01018041,361,241,93,177,872
E01018042,438,319,164,277,1198
E01018043,678,474,304,171,1627
E01018044,529,397,370,117,1413
E01018045,519,267,147,128,1061
E01018046,622,266,134,564,1586
E01018047,602,468,171,282,1523
E01018049,576,372,208,167,1323
E01018050,486,358,133,134,1111
E01018051,576,423,142,232,1373
E01018052,519,309,445,229,1502
E01018053,533,498,136,227,1394
E01018054,829,611,239,146,1825
E01018055,820,685,142,58,1705
E01018056,691,373,142,296,1502
E01018057,531,632,230,236,1629
E01018058,612,545,139,11,1307
E01018059,517,407,131,47,1102
E01018060,727,456,216,95,1494
E01018061,514,292,124,80,1010
E01018062,923,585,262,234,2004
E01018063,527,428,560,289,1804
E01018064,813,540,153,128,1634
E01018065,895,628,192,79,1794
E01018066,498,429,104,157,1188
E01018067,611,555,205,99,1470
E01018068,494,411,166,145,1216
E01018069,658,558,203,41,1460
E01018070,318,266,467,336,1387
E01018071,438,474,267,252,1431
E01018072,587,358,151,235,1331
E01018073,687,623,331,238,1879
E01018074,441,414,92,70,1017
E01018075,309,258,125,290,982
E01018076,825,564,200,83,1672
E01018077,417,428,477,144,1466
E01018078,346,350,213,443,1352
E01018079,456,619,216,176,1467
E01018080,854,604,305,106,1869
E01018081,534,374,166,105,1179
E01018082,708,597,204,87,1596
E01018083,579,390,330,169,1468
E01018084,640,731,224,86,1681
E01018085,549,609,152,17,1327
E01018086,517,498,238,131,1384
E01018087,574,587,312,222,1695
E01018088,517,606,127,55,1305
E01018090,557,600,126,152,1435
E01018091,493,366,158,152,1169
E01018092,559,526,184,128,1397
E01018093,709,625,362,235,1931
E01018094,493,619,132,215,1459
E01018095,514,595,118,76,1303
E01018096,524,637,175,37,1373
E01018097,495,521,101,100,1217
E01018098,447,464,120,36,1067
E01018099,526,422,101,10,1059
E01018100,352,252,271,85,960
E01018101,436,409,215,35,1095
E01018102,965,476,439,177,2057
E01018103,283,155,170,310,918
E01018104,418,404,108,115,1045
E01018105,424,260,153,116,953
E01018106,579,467,214,34,1294
E01018107,359,223,263,453,1298
E01018108,320,324,372,500,1516
E01018109,556,432,345,123,1456
E01018110,899,767,290,181,2137
E01018111,746,758,188,138,1830
E01018113,544,431,101,83,1159
E01018115,532,420,106,34,1092
E01018116,286,344,335,21,986
E01018117,459,530,171,221,1381
E01018118,792,425,289,38,1544
E01018119,515,506,162,71,1254
E01018120,586,495,157,164,1402
E01018121,594,422,64,23,1103
E01018122,425,381,68,76,950
E01018123,693,427,128,69,1317
E01018124,808,563,90,126,1587
E01018125,574,428,108,119,1229
E01018126,526,453,220,84,1283
E01018127,489,486,199,82,1256
E01018128,263,390,196,110,959
E01018129,516,440,189,123,1268
E01018130,642,514,133,89,1378
E01018131,540,292,113,278,1223
E01018132,441,471,350,149,1411
E01018133,663,350,95,196,1304
E01018134,765,359,195,114,1433
E01018135,1073,458,170,492,2193
E01018136,561,606,152,78,1397
E01018137,657,462,136,104,1359
E01018138,577,361,419,261,1618
E01018139,565,249,118,262,1194
E01018140,513,373,133,43,1062
E01018141,673,483,151,29,1336
E01018142,438,488,107,149,1182
E01018143,426,198,137,549,1310
E01018144,387,128,153,424,1092
E01018145,356,146,159,336,997
E01018146,642,223,331,403,1599
E01018147,458,138,228,439,1263
E01018148,1019,311,329,168,1827
E01018149,680,244,179,21,1124
E01018150,570,213,251,249,1283
E01018151,348,295,685,161,1489
E01018152,523,440,160,74,1197
E01018153,574,544,212,124,1454
E01018154,666,544,123,100,1433
E01018155,577,507,135,16,1235
E01018156,655,494,170,88,1407
E01018157,806,507,140,164,1617
E01018158,455,323,468,187,1433
E01018159,561,426,135,27,1149
E01018160,453,321,156,397,1327
E01018161,609,343,146,40,1138
E01018162,728,388,111,64,1291
E01018163,538,108,250,186,1082
E01018164,490,322,197,34,1043
E01018165,524,269,181,70,1044
E01018166,448,540,184,85,1257
E01018167,547,534,105,18,1204
E01018168,409,364,603,322,1698
E01018169,433,462,155,210,1260
E01018170,470,460,124,102,1156
E01018171,594,492,100,34,1220
E01018172,473,485,113,75,1146
E01018173,494,242,199,21,956
E01018174,641,420,175,63,1299
E01018175,586,434,90,15,1125
E01018176,508,493,37,4,1042
E01018177,546,536,108,78,1268
E01018178,535,428,124,105,1192
E01018179,487,156,161,308,1112
E01018180,375,129,111,437,1052
E01018181,1267,381,401,141,2190
E01018182,658,257,153,119,1187
E01018183,432,258,149,368,1207
E01018184,366,210,108,326,1010
E01018185,568,456,187,147,1358
E01018186,622,397,154,249,1422
E01018187,374,348,585,309,1616
E01018188,519,358,131,182,1190
E01018189,562,424,49,13,1048
E01018190,516,394,127,205,1242
E01018191,480,330,111,12,933
E01018192,560,395,122,65,1142
E01018193,508,358,109,8,983
E01018194,528,358,188,74,1148
E01018195,436,200,101,276,1013
E01018196,428,425,103,63,1019
E01018197,611,269,149,174,1203
E01018198,630,469,153,67,1319
E01018199,669,458,76,44,1247
E01018200,615,523,119,93,1350
E01018201,533,326,152,117,1128
E01018202,414,624,128,44,1210
E01018203,454,462,139,98,1153
E01018204,463,499,71,53,1086
E01018205,543,777,206,55,1581
E01018206,504,167,581,137,1389
E01018207,570,366,138,152,1226
E01018208,577,388,162,196,1323
E01018209,565,429,137,77,1208
E01018210,556,294,106,182,1138
E01018211,687,487,158,108,1440
E01018212,578,423,123,212,1336
E01018213,734,373,212,144,1463
E01018214,777,313,127,331,1548
E01018215,557,381,151,9,1098
E01018216,1064,524,208,111,1907
E01018217,572,533,104,172,1381
E01018218,548,618,155,106,1427
E01018219,437,346,111,221,1115
E01018220,519,415,131,161,1226
E01018221,726,390,237,32,1385
E01018222,591,579,102,11,1283
E01018223,650,538,203,139,1530
E01018224,398,410,143,173,1124
E01018225,260,363,141,149,913
E01018226,301,250,336,54,941
E01018227,644,396,135,309,1484
E01018228,607,497,108,135,1347
E01018231,916,689,208,135,1948
E01018232,728,794,159,174,1855
E01018233,521,537,182,57,1297
E01018234,579,536,204,14,1333
E01018235,612,430,136,134,1312
E01018236,472,366,73,320,1231
E01018237,493,453,134,143,1223
E01018238,448,346,125,229,1148
E01018239,416,426,96,136,1074
E01018240,371,442,56,123,992
E01018241,399,379,76,99,953
E01018242,368,390,86,223,1067
E01018243,432,368,332,216,1348
E01018244,459,611,160,68,1298
E01018245,568,593,163,64,1388
E01018246,568,419,134,233,1354
E01018247,509,418,187,197,1311
E01018248,615,513,257,80,1465
E01018249,279,399,86,91,855
E01018250,360,348,110,175,993
E01018251,554,302,83,35,974
E01018252,576,363,96,109,1144
E01018253,342,402,103,31,878
E01018254,405,389,95,183,1072
E01018255,373,384,57,95,909
E01018256,421,575,130,95,1221
E01018257,392,301,74,330,1097
E01018258,517,535,112,139,1303
E01018259,398,433,153,92,1076
E01018260,532,601,172,116,1421
E01018262,486,515,97,32,1130
E01018263,543,418,155,78,1194
E01018264,420,311,77,431,1239
E01018265,690,538,138,29,1395
E01018266,1062,571,298,168,2099
E01018267,773,830,155,155,1913
E01018268,637,535,129,203,1504
E01018269,450,259,85,316,1110
E01018270,345,362,59,153,919
E01018271,433,312,100,221,1066
E01018272,490,411,124,12,1037
E01018273,376,520,265,144,1305
E01018274,587,278,467,52,1384
E01018275,733,743,167,260,1903
E01018276,458,126,142,393,1119
E01018277,566,523,152,156,1397
E01018278,686,275,112,224,1297
E01018279,450,405,65,325,1245
E01018280,436,489,142,198,1265
E01018281,423,352,113,407,1295
E01018282,495,357,103,100,1055
E01018283,528,390,92,28,1038
E01018284,459,402,125,30,1016
E01018285,514,225,96,118,953
E01018286,443,295,251,271,1260
E01018287,344,206,455,70,1075
E01018288,387,355,73,140,955
E01018289,310,292,219,115,936
E01018290,785,774,180,214,1953
E01018291,312,427,111,123,973
E01018292,454,447,158,51,1110
E01018293,420,613,139,17,1189
E01018294,349,404,234,416,1403
E01018295,436,595,106,133,1270
E01018296,295,342,126,134,897
E01018297,483,440,270,198,1391
E01018298,230,140,507,117,994
E01018299,536,415,168,226,1345
E01018300,333,348,146,139,966
E01018301,401,450,186,70,1107
E01018302,572,352,164,121,1209
E01018303,368,352,78,173,971
E01018304,668,361,158,278,1465
E01018305,528,375,63,118,1084
E01018306,589,453,97,41,1180
E01018307,821,656,138,147,1762
E01018308,531,642,175,152,1500
E01018309,579,409,92,238,1318
E01018310,353,150,78,571,1152
E01018311,288,80,114,552,1034
E01018312,499,222,86,352,1159
E01018313,501,465,65,126,1157
E01018314,427,267,111,481,1286
E01018315,389,367,84,110,950
E01018316,316,160,78,524,1078
E01018317,279,109,98,650,1136
E01018319,674,395,495,174,1738
E01018320,525,578,90,9,1202
E01018321,396,408,126,60,990
E01018322,379,520,52,18,969
E01018323,460,405,127,78,1070
E01018324,462,491,110,6,1069
E01018325,562,530,46,61,1199
E01018326,309,392,832,317,1850
E01018327,358,209,646,612,1825
E01018328,207,180,940,66,1393
E01018329,313,225,1176,259,1973
E01018330,332,273,505,22,1132
E01018331,324,213,976,23,1536
E01018332,370,327,72,73,842
E01018333,413,671,161,9,1254
E01018334,547,637,76,28,1288
E01018335,551,535,558,82,1726
E01018336,583,381,46,21,1031
E01018337,531,396,111,57,1095
E01018338,782,453,151,51,1437
E01018339,650,706,171,133,1660
E01018340,404,478,149,168,1199
E01018341,289,508,108,44,949
E01018342,410,410,498,55,1373
E01018343,330,215,612,198,1355
E01018344,685,358,527,44,1614
E01018345,505,385,72,72,1034
E01018346,521,444,75,29,1069
E01018347,418,301,112,311,1142
E01018348,868,605,208,23,1704
E01018349,544,582,121,101,1348
E01018350,672,807,72,19,1570
E01018351,253,91,59,728,1131
E01018352,803,300,268,85,1456
E01018353,612,418,129,112,1271
E01018354,465,248,126,385,1224
E01018355,297,338,154,193,982
E01018356,526,419,208,63,1216
E01018357,377,510,170,35,1092
E01018358,435,385,94,46,960
E01018359,415,414,32,20,881
E01018360,521,584,384,72,1561
E01018361,456,326,383,48,1213
E01018362,599,498,117,26,1240
E01018363,387,441,58,6,892
E01018364,339,236,126,541,1242
E01018365,670,725,116,94,1605
E01018366,548,646,77,24,1295
E01018367,691,563,140,196,1590
E01018368,429,447,141,108,1125
E01018369,459,563,203,59,1284
E01018370,446,544,75,12,1077
E01018371,479,512,260,226,1477
E01018372,482,676,389,41,1588
E01018373,635,719,243,54,1651
E01018374,571,486,325,61,1443
E01018375,506,354,649,16,1525
E01018376,514,519,128,55,1216
E01018377,606,523,59,77,1265
E01018378,336,237,79,327,979
E01018379,381,587,62,96,1126
E01018380,389,436,62,89,976
E01018381,444,388,141,17,990
E01018382,545,322,227,228,1322
E01018383,579,498,108,31,1216
E01018384,493,585,113,17,1208
E01018385,626,873,164,39,1702
E01018386,381,535,135,86,1137
E01018387,571,845,45,9,1470
E01018388,387,269,169,435,1260
E01018389,605,537,119,57,1318
E01018390,556,716,105,35,1412
E01018391,665,411,196,226,1498
E01018392,755,703,98,22,1578
E01018393,612,818,167,99,1696
E01018394,745,725,146,74,1690
E01018395,580,593,132,52,1357
E01018396,434,396,62,286,1178
E01018397,749,487,141,25,1402
E01018398,409,338,212,259,1218
E01018399,490,400,205,127,1222
E01018400,515,289,154,675,1633
E01018401,477,314,60,356,1207
E01018402,513,406,407,238,1564
E01018403,638,831,104,50,1623
E01018404,545,615,64,7,1231
E01018405,630,399,104,5,1138
E01018406,505,568,109,7,1189
E01018407,570,575,78,6,1229
E01018408,690,699,73,47,1509
E01018409,597,665,110,167,1539
E01018410,518,721,53,19,1311
E01018411,844,945,74,32,1895
E01018412,361,658,111,153,1283
E01018413,512,395,71,16,994
E01018414,454,609,111,28,1202
E01018415,481,545,140,171,1337
E01018416,529,459,66,19,1073
E01018417,497,727,70,99,1393
E01018418,516,543,135,89,1283
E01018419,678,299,86,20,1083
E01018420,925,263,152,61,1401
E01018421,654,268,96,35,1053
E01018422,453,332,111,121,1017
E01018423,472,274,90,324,1160
E01018424,689,456,164,73,1382
E01018425,548,519,169,103,1339
E01018426,523,507,108,232,1370
E01018427,565,439,46,15,1065
E01018428,464,502,97,118,1181
E01018429,447,555,90,171,1263
E01018430,546,478,73,66,1163
E01018431,493,330,171,6,1000
E01018432,503,463,103,194,1263
E01018433,353,571,83,69,1076
E01018434,477,475,114,66,1132
E01018435,327,254,145,398,1124
E01018436,539,593,61,19,1212
E01018437,537,309,237,222,1305
E01018438,484,686,46,4,1220
E01018439,405,627,62,8,1102
E01018440,721,341,206,95,1363
E01018441,839,237,157,33,1266
E01018442,735,507,135,67,1444
E01018443,583,537,128,7,1255
E01018444,729,666,233,107,1735
E01018445,471,198,361,440,1470
E01018446,499,221,78,208,1006
E01018447,445,284,571,70,1370
E01018448,619,494,255,29,1397
E01018449,507,755,122,83,1467
E01018450,661,763,285,58,1767
E01018451,325,385,152,302,1164
E01018452,319,378,55,180,932
E01018454,422,248,252,332,1254
E01018455,402,562,63,74,1101
E01018456,401,643,51,12,1107
E01018457,457,428,298,47,1230
E01018458,725,680,188,151,1744
E01018459,285,200,97,413,995
E01018460,416,520,169,56,1161
E01018461,368,398,114,247,1127
E01018462,244,169,493,242,1148
E01018463,492,241,248,174,1155
E01018464,459,340,299,57,1155
E01018465,1012,832,398,86,2328
E01018466,457,293,443,622,1815
E01018467,491,275,796,187,1749
E01018468,692,517,91,12,1312
E01018469,534,511,106,108,1259
E01018470,605,525,67,19,1216
E01018471,585,542,105,3,1235
E01018472,612,376,139,43,1170
E01018473,897,258,108,25,1288
E01018474,1044,274,87,24,1429
E01018475,1033,258,73,13,1377
E01018476,256,159,85,450,950
E01018477,468,264,86,330,1148
E01018478,388,249,146,317,1100
E01018479,659,410,158,88,1315
E01018480,642,636,267,67,1612
E01018481,579,608,345,109,1641
E01018482,382,386,76,313,1157
E01018483,460,540,103,84,1187
E01018484,565,117,260,686,1628
E01018485,347,205,172,423,1147
E01018486,215,188,634,230,1267
E01018487,391,279,577,35,1282
E01018488,615,438,166,9,1228
E01018489,379,256,435,28,1098
E01018490,494,697,38,12,1241
E01018491,576,512,102,7,1197
E01018492,330,556,40,5,931
E01018493,377,595,79,47,1098
E01018494,497,526,116,5,1144
E01018495,478,493,82,7,1060
E01018496,615,397,201,114,1327
E01018497,339,240,347,30,956
E01018498,419,121,211,395,1146
E01018499,626,437,126,88,1277
E01018500,482,537,59,3,1081
E01018501,509,518,250,113,1390
E01018502,324,615,95,10,1044
E01018503,483,746,72,12,1313
E01018504,461,531,275,188,1455
E01018505,432,407,66,2,907
E01018506,692,460,33,2,1187
E01018507,560,610,30,2,1202
E01018508,460,459,54,9,982
E01018509,383,350,110,65,908
E01018510,730,397,70,74,1271
E01018511,482,278,95,326,1181
E01018512,545,429,127,244,1345
E01018513,612,580,96,18,1306
E01018514,616,709,186,130,1641
E01018515,887,666,220,63,1836
E01018516,518,575,73,33,1199
E01018518,487,722,91,13,1313
E01018519,417,254,366,106,1143
E01018520,314,143,241,128,826
E01018521,339,167,64,386,956
E01018522,412,256,72,346,1086
E01018523,322,242,60,428,1052
E01018524,242,83,64,654,1043
E01018525,316,132,97,400,945
E01018526,676,612,75,2,1365
E01018527,775,517,80,7,1379
E01018528,559,374,56,4,993
E01018529,612,628,57,5,1302
E01018530,729,350,68,20,1167
E01018531,646,534,123,4,1307
E01018532,586,482,167,317,1552
E01018533,547,679,54,8,1288
E01018534,622,370,300,737,2029
E01018535,406,468,120,252,1246
E01018536,555,644,167,36,1402
E01018537,567,925,125,60,1677
E01018538,282,198,61,363,904
E01018539,369,181,57,253,860
E01018540,586,421,93,83,1183
E01018541,531,367,119,102,1119
E01018542,204,78,71,578,931
E01018543,435,224,159,235,1053
E01018544,598,545,110,23,1276
E01018545,788,688,139,30,1645
E01018546,484,309,135,263,1191
E01018547,582,388,78,114,1162
E01018548,528,374,79,321,1302
E01018549,501,500,99,119,1219
E01018550,206,84,59,479,828
E01018551,374,100,81,635,1190
E01018552,508,262,128,319,1217
E01018553,508,237,135,346,1226
E01018554,1079,811,94,2,1986
E01018555,593,329,41,12,975
E01018556,511,556,79,66,1212
E01018557,480,315,64,338,1197
E01018558,622,328,74,15,1039
E01018559,507,428,28,9,972
E01018560,555,366,51,4,976
E01018561,560,404,36,0,1000
E01018562,784,240,72,2,1098
E01018563,477,108,248,807,1640
E01018564,700,312,440,377,1829
E01018565,585,553,55,52,1245
E01018566,509,607,49,0,1165
E01018567,617,531,50,18,1216
E01018568,846,212,102,8,1168
E01018569,380,618,43,43,1084
E01018570,420,413,132,36,1001
E01018571,442,503,118,72,1135
E01018572,524,682,126,24,1356
E01018573,537,570,152,11,1270
E01018574,558,516,349,204,1627
E01018575,392,310,160,15,877
E01018576,624,433,377,36,1470
E01018577,830,757,258,160,2005
E01018578,451,399,99,24,973
E01018579,334,232,68,256,890
E01018580,469,567,159,36,1231
E01018581,353,498,82,78,1011
E01018582,692,442,219,64,1417
E01018583,769,435,228,49,1481
E01018584,747,580,142,23,1492
E01018585,508,464,79,121,1172
E01018586,603,486,167,41,1297
E01018587,575,583,105,19,1282
E01018588,639,460,119,8,1226
E01018589,610,583,52,6,1251
E01018590,661,633,100,42,1436
E01018591,733,1015,157,123,2028
E01018592,593,519,113,133,1358
E01018593,594,579,147,86,1406
E01018594,487,248,116,544,1395
E01018595,516,388,167,202,1273
E01018596,457,141,189,712,1499
E01018597,671,870,362,118,2021
E01018598,557,490,218,32,1297
E01018599,354,464,105,39,962
E01018600,531,661,114,4,1310
E01018601,525,514,257,115,1411
E01018602,513,553,303,60,1429
E01018603,466,505,50,11,1032
E01018604,452,352,122,171,1097
E01018605,344,456,85,20,905
E01018606,374,420,304,163,1261
E01018607,447,515,83,7,1052
E01018608,458,546,78,20,1102
E01018609,492,631,119,161,1403
E01018610,639,406,212,295,1552
E01018611,414,164,177,566,1321
E01018612,420,309,87,161,977
E01018613,486,307,155,279,1227
E01018614,734,498,243,11,1486
E01018615,503,296,140,21,960
E01018616,488,361,85,61,995
E01018617,509,467,103,136,1215
E01018618,499,242,123,246,1110
E01018619,646,377,61,33,1117
E01018620,402,336,105,247,1090
E01018621,572,420,69,31,1092
E01018622,398,226,362,151,1137
E01018623,567,398,229,42,1236
E01018624,577,249,706,37,1569
E01018625,507,293,320,10,1130
E01018626,734,491,317,260,1802
E01018627,564,337,353,95,1349
E01018628,583,563,87,90,1323
E01018629,567,298,231,356,1452
E01018630,469,346,140,129,1084
E01018631,353,207,93,495,1148
E01018632,641,508,122,12,1283
E01018633,567,644,45,3,1259
E01018634,744,668,79,56,1547
E01018635,411,302,253,50,1016
E01018636,605,345,88,96,1134
E01018637,546,186,86,480,1298
E01018638,435,329,78,393,1235
E01018639,484,237,297,130,1148
E01018640,290,180,104,472,1046
E01018641,506,508,36,8,1058
E01018642,599,406,74,2,1081
E01018643,840,544,51,59,1494
E01018644,456,558,135,5,1154
E01018645,445,220,132,683,1480
E01018646,568,307,105,419,1399
E01018647,525,405,103,249,1282
E01018648,476,585,530,142,1733
E01018649,371,660,74,14,1119
E01018650,649,449,190,73,1361
E01018651,369,354,166,69,958
E01018652,599,510,109,16,1234
E01018653,701,778,134,9,1622
E01018654,609,792,274,80,1755
E01018655,463,648,151,29,1291
E01018656,488,647,90,5,1230
E01018657,377,217,45,239,878
E01018658,528,450,44,12,1034
E01018659,408,646,21,6,1081
E01018660,380,366,46,37,829
E01018661,476,516,65,8,1065
E01018662,504,380,40,23,947
E01018663,502,668,81,16,1267
E01018664,540,631,50,13,1234
E01018665,443,302,49,130,924
E01018666,587,767,86,9,1449
E01018667,437,693,126,76,1332
E01018668,509,683,130,16,1338
E01018669,909,982,198,61,2150
E01018670,695,920,166,154,1935
E01018671,508,476,51,11,1046
E01018672,498,292,124,351,1265
E01018673,480,392,58,54,984
E01018674,595,394,194,79,1262
E01018675,763,836,86,79,1764
E01018676,533,586,92,31,1242
E01018677,480,628,97,43,1248
E01018678,435,538,43,12,1028
E01018679,581,401,138,247,1367
E01018680,633,507,174,16,1330
E01018681,511,510,100,60,1181
E01018682,355,278,64,190,887
E01018683,551,529,98,22,1200
E01018684,738,954,117,48,1857
E01018685,319,178,59,450,1006
E01018686,573,279,169,75,1096
E01018687,440,650,31,35,1156
E01018688,472,622,205,1,1300
E01018689,439,518,142,69,1168
E01018690,727,850,115,30,1722
E01018691,537,538,125,84,1284
E01018692,721,720,148,23,1612
E01018693,654,564,75,3,1296
E01018694,581,626,71,7,1285
E01018695,648,500,194,40,1382
E01018696,476,643,106,17,1242
E01018697,699,462,111,158,1430
E01018698,682,832,92,46,1652
E01018699,684,339,101,139,1263
E01018700,1021,305,147,12,1485
E01018701,412,268,55,436,1171
E01018702,643,202,63,39,947
E01018703,782,440,248,19,1489
E01018704,335,474,60,134,1003
E01018705,649,499,75,29,1252
E01018706,454,325,106,139,1024
E01018707,517,699,138,115,1469
E01018708,713,805,172,92,1782
E01018709,541,309,265,83,1198
E01018710,436,261,118,336,1151
E01018711,616,386,211,60,1273
E01018712,550,335,268,167,1320
E01018713,1085,606,364,123,2178
E01018714,431,262,362,344,1399
E01018715,555,314,346,178,1393
E01018716,413,243,106,481,1243
E01018717,605,431,262,102,1400
E01018718,724,459,92,81,1356
E01018719,592,331,101,214,1238
E01018720,478,312,81,388,1259
E01018721,812,792,150,125,1879
E01018722,652,916,201,101,1870
E01018723,367,352,103,102,924
E01018724,509,588,131,24,1252
E01018725,356,472,171,78,1077
E01018726,476,352,83,264,1175
E01018727,558,712,122,39,1431
E01018728,575,394,81,189,1239
E01018729,507,308,102,441,1358
E01018730,453,390,63,301,1207
E01018731,544,377,249,81,1251
E01018732,541,310,135,70,1056
E01018733,478,578,77,64,1197
E01018734,408,298,104,218,1028
E01018735,580,327,140,28,1075
E01018736,701,344,174,84,1303
E01018737,672,330,87,11,1100
E01018738,124,77,43,749,993
E01018739,381,110,116,441,1048
E01018740,364,194,80,512,1150
E01018741,492,417,76,84,1069
E01018742,656,536,59,35,1286
E01018743,648,422,97,57,1224
E01018744,725,268,53,270,1316
E01018745,411,198,121,504,1234
E01018746,592,374,118,282,1366
E01018747,631,331,180,106,1248
E01018748,264,114,121,456,955
E01018749,1163,242,229,213,1847
E01018750,790,705,240,93,1828
E01018751,328,297,317,311,1253
E01018752,628,607,276,135,1646
E01018753,573,623,116,46,1358
E01018754,426,436,132,268,1262
E01018755,484,609,160,16,1269
E01018756,390,713,158,97,1358
E01018757,581,878,243,77,1779
E01018758,725,715,255,292,1987
E01018759,435,520,211,99,1265
E01018760,304,477,140,102,1023
E01018761,298,639,149,212,1298
E01018762,364,452,161,47,1024
E01018763,369,311,140,86,906
E01018764,454,558,165,37,1214
E01018765,403,605,126,153,1287
E01018766,337,705,295,239,1576
E01018767,305,206,169,496,1176
E01018768,690,381,240,197,1508
E01018769,455,571,329,150,1505
E01018770,290,243,121,348,1002
E01018771,298,278,457,97,1130
E01018772,542,635,128,30,1335
E01018773,381,542,182,191,1296
E01018774,313,414,201,253,1181
E01018775,432,634,125,13,1204
E01018776,308,441,244,30,1023
E01018777,616,761,219,116,1712
E01018778,405,579,273,170,1427
E01018779,707,800,212,132,1851
E01018780,606,688,242,321,1857
E01018781,450,708,272,152,1582
E01018782,505,440,152,107,1204
E01018783,500,604,146,54,1304
E01018784,399,600,151,79,1229
E01018785,525,605,310,167,1607
E01018786,480,448,110,46,1084
E01018787,645,368,184,23,1220
E01018788,360,357,114,382,1213
E01018789,555,482,126,47,1210
E01018790,347,296,100,217,960
E01018791,365,342,85,239,1031
E01018792,1146,704,267,127,2244
E01018793,527,424,260,200,1411
E01018794,521,386,95,148,1150
E01018795,426,511,79,16,1032
E01018796,498,292,153,13,956
E01018797,256,236,161,249,902
E01018798,480,520,155,95,1250
E01018799,304,239,129,289,961
E01018800,545,373,302,37,1257
E01018803,309,616,611,73,1609
E01018804,350,255,1023,52,1680
E01018805,327,683,226,42,1278
E01018806,381,369,508,70,1328
E01018807,287,470,302,82,1141
E01018808,424,453,211,107,1195
E01018809,346,329,640,390,1705
E01018810,456,414,234,14,1118
E01018811,554,513,120,31,1218
E01018812,429,291,141,247,1108
E01018813,534,444,165,12,1155
E01018814,532,479,133,45,1189
E01018815,676,532,294,121,1623
E01018816,445,845,135,24,1449
E01018817,554,760,380,37,1731
E01018818,447,718,106,123,1394
E01018819,449,384,271,121,1225
E01018820,524,487,338,123,1472
E01018821,400,385,165,47,997
E01018822,446,463,96,17,1022
E01018823,418,553,213,91,1275
E01018824,822,652,193,317,1984
E01018825,485,477,247,61,1270
E01018826,661,738,278,101,1778
E01018827,310,723,218,59,1310
E01018828,370,563,203,147,1283
E01018829,420,512,161,44,1137
E01018830,398,637,127,91,1253
E01018831,418,369,167,90,1044
E01018832,429,513,140,31,1113
E01018833,442,554,132,74,1202
E01018834,595,468,223,166,1452
E01018835,533,375,360,179,1447
E01018836,291,217,374,436,1318
E01018837,492,536,474,173,1675
E01018838,295,334,296,380,1305
E01018839,288,357,330,79,1054
E01018840,283,330,694,152,1459
E01018841,256,245,128,508,1137
E01018842,448,478,152,99,1177
E01018843,380,557,151,18,1106
E01018844,245,384,305,111,1045
E01018845,425,468,225,150,1268
E01018846,298,449,309,83,1139
E01018847,483,459,225,56,1223
E01018848,571,519,203,27,1320
E01018849,322,850,233,231,1636
E01018850,269,536,161,161,1127
E01018851,314,452,218,204,1188
E01018852,686,1001,329,48,2064
E01018853,704,558,353,365,1980
E01018854,246,248,175,418,1087
E01018855,674,556,443,179,1852
E01018856,347,386,194,285,1212
E01018857,240,269,105,355,969
E01018858,371,529,131,135,1166
E01018859,520,729,253,23,1525
E01018860,379,303,149,714,1545
E01018861,406,590,155,63,1214
E01018862,400,627,126,63,1216
E01018863,556,511,176,82,1325
E01018864,506,604,203,34,1347
E01018865,558,529,291,123,1501
E01018866,441,643,214,45,1343
E01018867,471,479,336,200,1486
E01018868,440,445,458,39,1382
E01018869,483,487,137,153,1260
E01018870,212,97,98,545,952
E01018871,565,584,221,21,1391
E01018872,373,437,149,64,1023
E01018873,403,317,97,167,984
E01018874,396,441,121,155,1113
E01018875,166,211,181,515,1073
E01018876,461,462,164,38,1125
E01018877,321,678,153,106,1258
E01018878,336,378,416,43,1173
E01018879,418,809,216,90,1533
E01018880,463,874,258,137,1732
E01018881,477,743,201,157,1578
E01018882,573,479,160,21,1233
E01018883,604,503,140,24,1271
E01018884,614,475,219,19,1327
E01018885,424,378,283,126,1211
E01018886,394,349,589,83,1415
E01018887,401,238,338,223,1200
E01018888,481,401,211,443,1536
E01018889,527,438,131,5,1101
E01018890,395,594,82,156,1227
E01018891,438,413,200,22,1073
E01018892,467,443,195,13,1118
E01018893,321,425,116,282,1144
E01018894,661,528,155,87,1431
E01018895,573,522,247,27,1369
E01018896,487,551,151,81,1270
E01018897,421,366,251,120,1158
E01018898,317,177,96,402,992
E01018899,416,527,184,105,1232
E01018900,477,568,141,78,1264
E01018901,444,637,213,74,1368
E01018902,268,435,182,106,991
E01018903,233,404,154,54,845
E01018904,496,854,213,204,1767
E01018905,346,509,171,88,1114
E01018906,347,464,175,42,1028
E01018907,301,372,116,238,1027
E01018908,494,591,173,128,1386
E01018909,622,369,244,30,1265
E01018910,206,127,221,843,1397
E01018911,397,352,334,280,1363
E01018912,495,553,150,10,1208
E01018913,590,328,430,56,1404
E01018914,600,565,260,118,1543
E01018915,667,575,335,34,1611
E01018916,381,415,125,159,1080
E01018917,439,550,144,9,1142
E01018918,511,562,206,171,1450
E01018919,436,538,126,55,1155
E01018920,426,853,249,193,1721
E01018921,627,716,240,165,1748
E01018922,846,839,217,38,1940
E01018923,292,488,152,91,1023
E01018924,260,410,215,50,935
E01018925,525,870,308,86,1789
E01018926,530,1082,250,147,2009
E01018927,483,381,173,205,1242
E01018928,419,259,326,360,1364
E01018929,369,391,171,72,1003
E01018930,242,122,141,661,1166
E01018931,406,390,91,84,971
E01018932,429,360,270,268,1327
E01018933,278,263,397,217,1155
E01018934,743,687,164,60,1654
E01018935,684,532,372,165,1753
E01018936,348,492,340,93,1273
E01018937,428,421,159,441,1449
E01018938,436,602,168,199,1405
E01018940,420,665,159,56,1300
E01018941,408,504,157,187,1256
E01018942,308,639,230,77,1254
E01018943,596,799,243,122,1760
E01018944,324,378,126,132,960
E01018945,322,566,141,45,1074
E01018946,365,522,177,179,1243
E01018947,883,495,547,291,2216
E01018948,439,449,338,96,1322
E01018949,362,143,121,384,1010
E01018950,378,391,532,92,1393
E01018951,520,939,284,122,1865
E01018952,327,456,172,25,980
E01018953,292,451,207,56,1006
E01018954,314,290,262,66,932
E01018955,331,593,173,194,1291
E01018956,232,448,166,77,923
E01018957,313,449,150,144,1056
E01018958,241,412,147,320,1120
E01018959,354,722,141,16,1233
E01018960,537,553,260,155,1505
E01018961,338,502,311,68,1219
E01018962,430,831,236,250,1747
E01018965,668,913,293,79,1953
E01018966,386,427,119,29,961
E01018967,376,490,137,62,1065
E01018968,668,1008,275,99,2050
E01018969,573,971,261,97,1902
E01018970,489,544,151,67,1251
E01018971,500,730,137,188,1555
E01018972,362,390,347,362,1461
E01018973,359,476,158,152,1145
E01018974,561,1034,280,178,2053
E01018975,576,668,169,150,1563
E01018976,571,825,297,81,1774
E01018977,316,269,126,400,1111
E01018978,465,404,121,230,1220
E01018979,401,415,127,136,1079
E01018980,363,514,146,63,1086
E01018981,657,769,198,89,1713
E01018982,610,586,331,167,1694
E01018983,470,655,153,29,1307
E01018984,424,384,199,621,1628
E01018985,649,882,297,37,1865
E01018986,382,650,214,41,1287
E01018987,600,881,274,10,1765
E01018988,437,548,203,87,1275
E01018989,404,507,279,225,1415
E01018990,306,608,307,257,1478
E01018991,419,508,171,166,1264
E01018992,424,697,222,15,1358
E01018993,430,494,220,215,1359
E01018994,368,633,146,229,1376
E01018995,339,439,314,593,1685
E01018996,353,428,300,165,1246
E01018997,181,146,72,680,1079
E01018998,396,344,369,37,1146
E01018999,297,311,397,219,1224
E01019000,298,613,121,174,1206
E01019001,319,507,494,121,1441
E01019002,290,658,220,43,1211
E01019003,475,725,226,22,1448
E01019004,311,401,263,327,1302
E01019005,481,672,303,234,1690
E01019006,365,669,244,52,1330
E01019007,614,710,339,121,1784
E01019008,314,300,123,419,1156
E01019009,340,338,139,363,1180
E01019010,467,475,116,73,1131
E01019011,366,613,176,31,1186
E01019012,377,649,448,105,1579
E01019013,562,639,254,314,1769
E01019014,435,545,91,94,1165
E01019015,530,497,128,13,1168
E01019016,795,331,200,70,1396
E01019017,664,1045,214,61,1984
E01019018,626,582,100,34,1342
E01019019,448,459,207,65,1179
E01019020,389,234,422,153,1198
E01019021,523,490,204,27,1244
E01019022,490,405,210,283,1388
E01019023,536,276,345,79,1236
E01019024,436,457,162,99,1154
E01019025,350,556,198,33,1137
E01019026,436,605,170,5,1216
E01019027,305,544,239,163,1251
E01019028,515,297,571,255,1638
E01019029,373,244,457,90,1164
E01019030,584,522,275,53,1434
E01019031,337,447,377,86,1247
E01019032,474,561,131,9,1175
E01019033,212,284,269,347,1112
E01019034,411,396,284,92,1183
E01019035,389,585,223,53,1250
E01019036,423,740,189,66,1418
E01019037,393,448,156,174,1171
E01019038,257,420,230,32,939
E01019039,287,578,253,24,1142
E01019040,306,457,191,75,1029
E01019041,366,298,315,309,1288
E01019042,456,395,350,183,1384
E01019043,450,580,187,79,1296
E01019044,409,669,176,52,1306
E01019045,740,640,247,69,1696
E01019046,409,219,115,380,1123
E01019047,275,338,178,103,894
E01019048,520,663,298,25,1506
E01019049,452,421,415,134,1422
E01019050,432,444,238,22,1136
E01019051,487,343,166,302,1298
E01019052,465,458,279,237,1439
E01019053,652,593,295,41,1581
E01019054,614,603,210,55,1482
E01019055,317,277,182,358,1134
E01019056,296,222,107,511,1136
E01019057,669,487,313,21,1490
E01019058,629,534,225,48,1436
E01019059,443,511,139,184,1277
E01019060,368,597,253,53,1271
E01019061,591,497,231,64,1383
E01019062,481,377,282,361,1501
E01019063,652,566,318,52,1588
E01019064,548,685,271,38,1542
E01019065,423,375,139,118,1055
E01019066,294,422,192,66,974
E01019067,277,424,202,28,931
E01019068,413,829,91,26,1359
E01019069,510,258,167,95,1030
E01019070,547,598,270,192,1607
E01019071,526,480,219,50,1275
E01019072,485,391,135,189,1200
E01019073,429,530,150,47,1156
E01019074,568,379,233,221,1401
E01019075,602,504,200,82,1388
E01019076,507,462,335,120,1424
E01019077,218,567,700,301,1786
E01019078,463,691,80,30,1264
E01019079,460,548,78,135,1221
E01019080,443,432,212,388,1475
E01019081,518,457,78,464,1517
E01019082,444,537,195,92,1268
E01019083,381,802,249,70,1502
E01019084,448,395,93,254,1190
E01019085,578,550,72,58,1258
E01019086,331,451,97,48,927
E01019087,569,632,85,46,1332
E01019088,432,466,328,215,1441
E01019089,467,400,103,352,1322
E01019090,335,700,269,28,1332
E01019091,511,800,183,37,1531
E01019092,344,654,156,103,1257
E01019093,525,514,116,119,1274
E01019094,488,628,70,208,1394
E01019095,255,271,137,527,1190
E01019096,790,830,100,205,1925
E01019097,251,221,86,814,1372
E01019098,488,485,67,290,1330
E01019099,440,454,105,410,1409
E01019100,647,560,110,49,1366
E01019101,488,664,48,17,1217
E01019102,451,608,229,136,1424
E01019103,304,362,76,253,995
E01019104,225,430,146,323,1124
E01019105,241,318,244,111,914
E01019106,271,739,99,131,1240
E01019107,484,715,119,26,1344
E01019108,339,237,50,551,1177
E01019109,504,480,61,381,1426
E01019110,336,301,61,683,1381
E01019111,354,324,103,443,1224
E01019112,292,326,80,654,1352
E01019113,258,199,96,768,1321
E01019114,465,533,154,51,1203
E01019115,429,412,198,282,1321
E01019116,418,278,216,127,1039
E01019117,504,503,55,51,1113
E01019118,530,355,228,19,1132
E01019119,512,670,47,24,1253
E01019120,653,538,189,105,1485
E01019121,475,497,316,388,1676
E01019122,315,277,101,433,1126
E01019123,418,408,52,390,1268
E01019124,917,705,54,37,1713
E01019125,524,618,90,55,1287
E01019126,423,453,196,273,1345
E01019127,400,815,89,38,1342
E01019128,466,631,148,115,1360
E01019129,625,670,81,4,1380
E01019130,479,690,160,71,1400
E01019131,474,880,207,39,1600
E01019132,552,738,147,73,1510
E01019133,477,597,137,78,1289
E01019134,446,610,66,164,1286
E01019135,428,358,81,403,1270
E01019136,564,500,94,107,1265
E01019137,302,271,185,111,869
E01019138,405,400,220,35,1060
E01019139,228,173,521,240,1162
E01019140,189,181,154,277,801
E01019141,221,203,393,189,1006
E01019142,404,306,373,28,1111
E01019143,357,291,385,153,1186
E01019144,557,505,84,38,1184
E01019145,880,618,113,0,1611
E01019146,504,494,93,27,1118
E01019147,650,410,187,10,1257
E01019148,534,577,63,10,1184
E01019149,620,443,142,28,1233
E01019150,594,384,151,136,1265
E01019151,494,464,65,135,1158
E01019152,396,447,75,11,929
E01019153,428,451,25,3,907
E01019154,349,734,41,11,1135
E01019155,307,841,68,0,1216
E01019156,277,195,229,477,1178
E01019157,329,312,429,93,1163
E01019158,324,230,293,81,928
E01019159,398,294,141,26,859
E01019160,513,194,52,335,1094
E01019161,696,437,44,159,1336
E01019162,590,568,61,3,1222
E01019163,504,491,66,4,1065
E01019164,252,127,79,599,1057
E01019165,515,312,120,235,1182
E01019166,480,298,139,221,1138
E01019167,627,422,158,20,1227
E01019168,549,463,100,56,1168
E01019169,571,364,75,7,1017
E01019170,610,311,87,3,1011
E01019171,527,301,236,9,1073
E01019172,497,342,259,35,1133
E01019173,420,298,225,79,1022
E01019174,403,208,100,205,916
E01019175,518,354,73,196,1141
E01019176,648,738,37,8,1431
E01019177,476,300,70,236,1082
E01019178,644,537,104,9,1294
E01019179,507,468,53,15,1043
E01019180,538,958,111,24,1631
E01019182,509,476,103,48,1136
E01019184,528,380,139,60,1107
E01019185,562,547,57,16,1182
E01019186,464,421,152,12,1049
E01019187,487,375,85,124,1071
E01019188,538,380,120,163,1201
E01019189,584,312,193,128,1217
E01019190,610,688,53,5,1356
E01019191,566,555,139,43,1303
E01019192,527,589,71,13,1200
E01019193,342,176,85,525,1128
E01019194,711,330,142,376,1559
E01019195,528,452,102,19,1101
E01019196,676,475,180,137,1468
E01019197,438,235,92,725,1490
E01019198,485,193,103,257,1038
E01019199,324,187,54,260,825
E01019200,378,579,228,120,1305
E01019201,354,348,161,268,1131
E01019202,530,310,194,262,1296
E01019203,702,866,143,65,1776
E01019204,239,176,471,208,1094
E01019205,387,274,411,253,1325
E01019206,309,272,597,84,1262
E01019207,425,249,250,204,1128
E01019208,489,295,83,295,1162
E01019209,574,274,170,151,1169
E01019210,398,314,75,297,1084
E01019211,648,339,469,28,1484
E01019212,354,603,232,22,1211
E01019213,1033,832,268,74,2207
E01019214,521,739,157,96,1513
E01019215,435,349,234,236,1254
E01019216,437,312,480,141,1370
E01019217,545,338,474,112,1469
E01019218,448,292,176,270,1186
E01019219,675,795,273,66,1809
E01019220,539,338,305,76,1258
E01019221,728,315,188,298,1529
E01019222,583,261,116,320,1280
E01019223,582,612,64,56,1314
E01019224,631,857,166,78,1732
E01019225,565,760,250,56,1631
E01019226,333,496,133,26,988
E01019227,399,334,139,295,1167
E01019228,422,544,290,36,1292
E01019229,533,848,218,44,1643
E01019230,498,382,85,341,1306
E01019231,419,295,54,489,1257
E01019232,525,467,113,152,1257
E01019233,438,515,65,120,1138
E01019234,269,278,510,352,1409
E01019235,580,418,234,22,1254
E01019236,384,263,613,80,1340
E01019237,462,368,276,62,1168
E01019238,491,490,94,21,1096
E01019239,486,607,142,31,1266
E01019240,680,573,123,25,1401
E01019241,527,669,45,76,1317
E01019242,411,349,241,123,1124
E01019243,549,483,133,10,1175
E01019244,520,575,110,7,1212
E01019245,352,141,116,565,1174
E01019246,392,280,66,296,1034
E01019247,472,461,111,164,1208
E01019248,304,140,65,341,850
E01019249,402,694,148,15,1259
E01019250,481,485,107,70,1143
E01019251,633,617,130,40,1420
E01019252,488,433,68,210,1199
E01019253,696,630,111,27,1464
E01019254,582,458,61,53,1154
E01019255,593,488,42,18,1141
E01019256,517,570,105,79,1271
E01019257,447,553,81,163,1244
E01019258,550,629,98,34,1311
E01019259,310,521,196,79,1106
E01019260,601,352,92,182,1227
E01019261,765,605,35,30,1435
E01019262,747,492,94,59,1392
E01019263,276,250,67,345,938
E01019264,674,457,72,166,1369
E01019265,387,370,133,191,1081
E01019266,529,463,128,107,1227
E01019267,243,281,62,468,1054
E01019268,381,444,83,48,956
E01019269,382,290,77,508,1257
E01019270,446,348,78,236,1108
E01019271,380,334,58,285,1057
E01019272,444,281,100,331,1156
E01019273,600,539,113,86,1338
E01019274,453,450,155,258,1316
E01019275,778,668,86,272,1804
E01019276,302,433,94,44,873
E01019277,302,269,65,343,979
E01019278,501,497,82,54,1134
E01019279,315,678,156,45,1194
E01019280,261,309,302,536,1408
E01019281,421,413,85,131,1050
E01019282,537,333,72,118,1060
E01019283,401,547,87,94,1129
E01019284,390,278,66,273,1007
E01019285,506,326,116,240,1188
E01019286,447,461,109,104,1121
E01019287,456,498,25,19,998
E01019288,669,454,38,12,1173
E01019289,393,430,63,245,1131
E01019290,371,322,122,72,887
E01019291,413,319,102,246,1080
E01019292,398,439,56,67,960
E01019293,390,588,145,34,1157
E01019294,525,375,61,250,1211
E01019295,365,219,48,492,1124
E01019296,508,319,55,253,1135
E01019297,531,387,89,127,1134
E01019298,444,592,116,115,1267
E01019299,556,532,251,240,1579
E01019300,636,565,152,49,1402
E01019301,196,175,101,620,1092
E01019302,349,312,72,130,863
E01019303,558,556,105,30,1249
E01019304,312,620,131,49,1112
E01019305,546,727,295,199,1767
E01019306,280,490,190,128,1088
E01019307,507,612,202,80,1401
E01019308,210,431,333,195,1169
E01019309,520,916,393,81,1910
E01019310,330,512,243,29,1114
E01019311,366,561,233,60,1220
E01019312,339,638,176,51,1204
E01019313,287,602,215,72,1176
E01019314,327,511,159,59,1056
E01019315,448,659,244,45,1396
E01019316,372,398,260,19,1049
E01019317,305,602,149,17,1073
E01019318,234,375,239,188,1036
E01019319,418,453,249,123,1243
E01019320,362,578,190,62,1192
E01019321,445,553,185,113,1296
E01019322,379,484,213,96,1172
E01019323,338,506,142,21,1007
E01019324,310,523,202,24,1059
E01019325,342,539,183,61,1125
E01019326,489,644,130,40,1303
E01019327,348,361,194,207,1110
E01019328,420,477,60,94,1051
E01019329,299,496,125,17,937
E01019330,349,499,245,87,1180
E01019331,516,491,134,123,1264
E01019332,331,297,140,343,1111
E01019333,271,224,207,200,902
E01019334,427,519,101,88,1135
E01019335,487,294,208,229,1218
E01019336,509,335,408,186,1438
E01019337,369,520,158,109,1156
E01019338,384,592,258,19,1253
E01019339,275,572,225,65,1137
E01019340,304,584,212,27,1127
E01019341,445,820,90,38,1393
E01019342,250,440,99,95,884
E01019343,400,638,167,55,1260
E01019344,223,494,119,60,896
E01019345,333,503,118,56,1010
E01019346,494,654,228,244,1620
E01019347,593,597,181,69,1440
E01019348,401,459,140,5,1005
E01019349,476,847,150,71,1544
E01019350,288,685,282,146,1401
E01019351,491,716,241,62,1510
E01019352,729,836,259,33,1857
E01019353,402,643,123,113,1281
E01019354,223,663,162,128,1176
E01019355,260,803,81,9,1153
E01019356,197,520,354,147,1218
E01019357,513,700,301,57,1571
E01019358,543,709,148,99,1499
E01019359,640,498,188,347,1673
E01019360,497,551,541,165,1754
E01019361,630,661,135,82,1508
E01019362,708,793,138,13,1652
E01019363,453,495,353,260,1561
E01019364,522,304,228,427,1481
E01019365,737,751,326,63,1877
E01019366,580,650,138,110,1478
E01019367,908,692,228,140,1968
E01019368,856,682,129,24,1691
E01019369,572,834,95,88,1589
E01019370,729,687,304,94,1814
E01019371,617,496,195,411,1719
E01019372,183,355,214,128,880
E01019373,299,446,238,38,1021
E01019374,272,343,310,323,1248
E01019375,234,579,208,158,1179
E01019376,154,407,265,253,1079
E01019377,440,809,186,49,1484
E01019378,618,563,81,73,1335
E01019379,398,624,113,53,1188
E01019380,325,511,64,13,913
E01019381,551,831,297,79,1758
E01019382,589,638,207,253,1687
E01019383,496,990,168,40,1694
E01019384,490,973,333,57,1853
E01019385,257,340,210,164,971
E01019386,387,680,336,60,1463
E01019387,494,879,258,118,1749
E01019388,522,536,142,255,1455
E01019389,756,496,209,359,1820
E01019390,622,687,260,97,1666
E01019391,582,675,66,101,1424
E01019392,512,505,371,185,1573
E01019393,508,1014,161,26,1709
E01019394,665,937,250,56,1908
E01019395,291,641,430,233,1595
E01019396,507,743,284,165,1699
E01019397,363,610,458,114,1545
E01019398,313,201,181,219,914
E01019399,323,273,95,174,865
E01019400,472,392,192,216,1272
E01019401,427,362,201,358,1348
E01019402,532,397,112,236,1277
E01019403,317,266,131,454,1168
E01019404,421,556,218,174,1369
E01019405,343,697,175,10,1225
E01019406,274,454,83,70,881
E01019407,663,508,446,100,1717
E01019408,538,477,136,77,1228
E01019409,568,717,76,94,1455
E01019410,647,411,150,7,1215
E01019411,533,424,114,159,1230
E01019412,799,345,60,8,1212
E01019413,685,237,120,19,1061
E01019414,476,786,102,26,1390
E01019415,586,497,231,114,1428
E01019416,471,620,91,43,1225
E01019417,566,434,213,363,1576
E01019418,675,430,150,133,1388
E01019419,709,631,238,37,1615
E01019420,403,403,190,99,1095
E01019421,673,650,99,216,1638
E01019422,490,685,77,47,1299
E01019423,352,519,130,31,1032
E01019424,327,369,93,188,977
E01019425,513,669,61,52,1295
E01019426,475,522,130,92,1219
E01019427,568,615,151,52,1386
E01019428,437,491,114,168,1210
E01019429,536,674,130,25,1365
E01019430,754,676,112,50,1592
E01019431,511,400,138,149,1198
E01019432,617,646,118,270,1651
E01019433,668,567,201,45,1481
E01019434,397,410,102,82,991
E01019435,703,331,147,110,1291
E01019436,449,419,149,58,1075
E01019437,393,337,113,369,1212
E01019438,610,416,197,98,1321
E01019439,547,418,82,24,1071
E01019440,551,430,136,130,1247
E01019441,392,278,258,268,1196
E01019442,527,495,145,125,1292
E01019443,459,644,123,95,1321
E01019444,196,154,92,559,1001
E01019445,520,389,205,63,1177
E01019446,440,445,71,70,1026
E01019447,460,587,114,76,1237
E01019448,635,541,80,127,1383
E01019449,780,487,162,29,1458
E01019450,435,331,102,289,1157
E01019451,737,508,213,121,1579
E01019452,362,275,103,562,1302
E01019453,569,319,337,195,1420
E01019454,444,596,54,132,1226
E01019455,535,370,198,21,1124
E01019456,673,417,210,129,1429
E01019457,473,500,97,34,1104
E01019458,552,342,311,81,1286
E01019459,378,326,89,322,1115
E01019460,631,482,131,80,1324
E01019461,444,539,94,125,1202
E01019462,378,590,68,17,1053
E01019463,332,245,83,526,1186
E01019464,790,681,89,34,1594
E01019465,336,385,74,177,972
E01019467,491,587,113,66,1257
E01019468,462,366,137,275,1240
E01019469,430,216,125,461,1232
E01019470,622,487,144,102,1355
E01019471,314,228,267,290,1099
E01019472,742,1018,390,94,2244
E01019473,554,507,47,11,1119
E01019474,523,395,92,7,1017
E01019475,433,333,116,106,988
E01019476,436,652,78,32,1198
E01019477,664,883,142,181,1870
E01019478,634,464,110,33,1241
E01019479,639,449,122,160,1370
E01019480,521,518,106,107,1252
E01019481,444,233,68,276,1021
E01019482,502,550,82,137,1271
E01019483,624,372,292,309,1597
E01019484,663,599,205,200,1667
E01019485,331,317,163,185,996
E01019486,438,343,63,38,882
E01019487,409,326,101,426,1262
E01019488,323,268,236,290,1117
E01019489,384,488,62,73,1007
E01019490,464,300,67,101,932
E01019491,827,545,341,85,1798
E01019492,533,419,149,341,1442
E01019493,598,568,101,45,1312
E01019494,572,696,216,214,1698
E01019495,470,430,135,317,1352
E01019496,431,264,179,221,1095
E01019497,319,392,231,251,1193
E01019498,377,245,396,337,1355
E01019499,445,343,187,116,1091
E01019500,442,301,86,325,1154
E01019501,464,519,162,98,1243
E01019502,474,478,94,226,1272
E01019503,741,757,245,179,1922
E01019504,391,452,142,123,1108
E01019505,384,354,262,187,1187
E01019506,348,364,166,234,1112
E01019507,372,324,295,387,1378
E01019508,428,537,187,453,1605
E01019509,170,160,97,471,898
E01019510,316,289,60,393,1058
E01019511,611,466,456,140,1673
E01019512,893,660,270,290,2113
E01019513,494,381,155,7,1037
E01019514,628,325,165,127,1245
E01019515,478,268,136,401,1283
E01019516,387,477,255,118,1237
E01019517,669,439,121,27,1256
E01019518,715,417,142,17,1291
E01019519,605,439,186,209,1439
E01019520,591,364,162,314,1431
E01019521,596,445,98,128,1267
E01019522,481,343,151,217,1192
E01019523,275,226,117,230,848
E01019524,467,463,103,106,1139
E01019525,540,396,97,205,1238
E01019526,478,366,144,149,1137
E01019527,275,255,87,521,1138
E01019528,579,520,70,149,1318
E01019529,543,357,188,115,1203
E01019530,437,283,225,234,1179
E01019531,409,264,251,215,1139
E01019532,419,366,98,137,1020
E01019533,563,541,65,28,1197
E01019534,461,495,70,136,1162
E01019535,489,585,72,85,1231
E01019536,488,255,139,478,1360
E01019537,492,556,49,127,1224
E01019538,460,394,474,61,1389
E01019539,542,588,159,70,1359
E01019540,568,499,115,9,1191
E01019541,426,388,59,372,1245
E01019542,359,258,175,548,1340
E01019543,296,265,79,627,1267
E01019544,388,417,90,398,1293
E01019545,415,581,125,56,1177
E01019546,473,522,136,85,1216
E01019547,302,214,157,424,1097
E01019548,843,693,222,76,1834
E01019549,301,297,86,363,1047
E01019550,475,407,82,348,1312
E01019551,514,717,61,90,1382
E01019552,500,258,71,196,1025
E01019553,764,387,169,52,1372
E01019554,365,271,435,92,1163
E01019555,399,315,188,370,1272
E01019556,266,225,307,410,1208
E01019557,577,326,43,234,1180
E01019558,621,518,61,23,1223
E01019559,483,407,44,56,990
E01019560,406,352,50,321,1129
E01019561,219,139,53,674,1085
E01019562,345,306,59,327,1037
E01019563,405,199,123,533,1260
E01019564,502,546,111,86,1245
E01019565,320,263,85,488,1156
E01019566,340,243,110,583,1276
E01019567,420,343,130,462,1355
E01019568,239,124,48,693,1104
E01019569,479,389,343,182,1393
E01019570,384,476,57,165,1082
E01019571,314,245,104,475,1138
E01019572,249,200,88,545,1082
E01019573,465,372,204,178,1219
E01019574,321,478,101,222,1122
E01019575,278,189,124,680,1271
E01019576,322,413,70,504,1309
E01019577,438,465,135,291,1329
E01019578,140,147,80,892,1259
E01019579,380,252,476,219,1327
E01019580,356,286,108,422,1172
E01019581,345,202,174,404,1125
E01019582,467,473,116,143,1199
E01019583,564,449,138,13,1164
E01019585,717,590,481,40,1828
E01019586,497,543,84,34,1158
E01019587,611,506,103,11,1231
E01019588,487,684,59,7,1237
E01019589,493,598,59,2,1152
E01019590,560,864,119,41,1584
E01019591,560,468,125,68,1221
E01019592,523,726,78,8,1335
E01019593,362,539,37,1,939
E01019594,439,415,107,451,1412
E01019595,598,665,335,90,1688
E01019596,525,432,150,161,1268
E01019597,567,435,78,102,1182
E01019598,458,275,218,355,1306
E01019599,384,628,129,86,1227
E01019600,335,639,322,89,1385
E01019601,329,488,105,360,1282
E01019602,481,680,229,167,1557
E01019603,451,639,205,41,1336
E01019604,502,748,175,104,1529
E01019605,566,698,194,66,1524
E01019606,293,530,474,100,1397
E01019607,424,718,343,26,1511
E01019608,368,520,129,352,1369
E01019609,717,772,215,67,1771
E01019610,496,658,132,13,1299
E01019611,368,668,272,127,1435
E01019612,561,610,335,66,1572
E01019613,431,693,188,82,1394
E01019614,521,705,118,49,1393
E01019615,525,737,210,293,1765
E01019616,522,747,146,65,1480
E01019617,287,639,237,165,1328
E01019618,415,735,198,49,1397
E01019619,375,616,118,151,1260
E01019620,491,556,178,75,1300
E01019621,444,488,80,44,1056
E01019622,536,548,171,31,1286
E01019623,350,331,205,208,1094
E01019624,370,531,69,56,1026
E01019625,255,237,58,678,1228
E01019626,434,586,163,72,1255
E01019627,322,486,130,81,1019
E01019628,309,439,67,115,930
E01019629,519,620,183,49,1371
E01019630,546,586,266,121,1519
E01019631,504,644,187,154,1489
E01019632,446,744,112,122,1424
E01019633,428,460,53,312,1253
E01019634,463,535,99,142,1239
E01019635,347,600,87,10,1044
E01019636,425,488,230,134,1277
E01019638,567,391,78,24,1060
E01019639,392,261,69,136,858
E01019640,793,244,107,4,1148
E01019641,493,639,90,2,1224
E01019642,423,538,82,148,1191
E01019643,510,648,114,69,1341
E01019644,464,315,182,259,1220
E01019645,616,453,176,61,1306
E01019646,418,214,194,337,1163
E01019647,564,286,465,216,1531
E01019648,586,394,154,115,1249
E01019649,700,286,327,97,1410
E01019650,396,247,123,533,1299
E01019651,525,447,95,120,1187
E01019652,593,460,162,28,1243
E01019653,550,544,81,9,1184
E01019654,531,448,137,179,1295
E01019655,581,299,228,133,1241
E01019656,405,423,102,40,970
E01019657,529,355,262,268,1414
E01019658,768,360,175,131,1434
E01019659,777,500,119,13,1409
E01019660,651,561,295,73,1580
E01019661,452,360,246,41,1099
E01019662,417,275,312,253,1257
E01019663,183,85,96,756,1120
E01019664,303,204,99,333,939
E01019665,388,520,164,81,1153
E01019666,454,375,72,263,1164
E01019667,525,411,91,269,1296
E01019668,333,257,62,502,1154
E01019669,542,584,102,137,1365
E01019670,620,636,112,97,1465
E01019671,565,688,151,102,1506
E01019672,525,410,329,35,1299
E01019673,468,508,55,21,1052
E01019674,429,453,119,14,1015
E01019675,519,242,281,226,1268
E01019676,549,341,175,127,1192
E01019677,518,506,170,24,1218
E01019678,769,312,182,12,1275
E01019679,683,335,268,85,1371
E01019680,617,398,158,33,1206
E01019681,532,628,106,30,1296
E01019682,444,217,341,248,1250
E01019683,502,418,107,67,1094
E01019684,703,443,146,47,1339
E01019685,519,558,139,32,1248
E01019686,408,550,131,62,1151
E01019687,426,308,97,378,1209
E01019688,412,313,261,204,1190
E01019689,508,463,117,132,1220
E01019690,460,292,199,29,980
E01019691,635,442,95,116,1288
E01019692,402,267,112,388,1169
E01019693,570,352,330,214,1466
E01019694,514,445,32,31,1022
E01019695,610,347,180,13,1150
E01019696,486,533,77,30,1126
E01019697,550,457,77,109,1193
E01019698,576,407,154,8,1145
E01019699,372,181,96,565,1214
E01019700,855,652,199,186,1892
E01019701,684,668,134,277,1763
E01019702,779,689,63,10,1541
E01019703,659,490,118,24,1291
E01019704,537,606,83,22,1248
E01019705,757,410,190,87,1444
E01019706,557,379,58,23,1017
E01019707,710,333,141,29,1213
E01019708,735,500,74,8,1317
E01019709,423,225,89,249,986
E01019710,545,502,406,155,1608
E01019711,461,382,116,149,1108
E01019712,568,527,97,21,1213
E01019713,320,495,61,9,885
E01019714,982,765,196,51,1994
E01019715,395,271,517,61,1244
E01019716,411,427,168,29,1035
E01019717,173,241,437,157,1008
E01019718,768,649,223,187,1827
E01019719,518,375,194,149,1236
E01019720,530,552,114,56,1252
E01019721,468,403,50,12,933
E01019722,661,529,276,18,1484
E01019723,350,670,262,215,1497
E01019724,328,245,144,241,958
E01019725,544,437,109,53,1143
E01019726,503,372,91,81,1047
E01019727,601,801,52,26,1480
E01019728,187,69,51,575,882
E01019729,315,100,49,513,977
E01019730,597,339,203,379,1518
E01019731,610,346,46,31,1033
E01019732,580,406,90,153,1229
E01019733,529,408,132,151,1220
E01019734,681,653,145,205,1684
E01019735,463,555,125,138,1281
E01019736,341,455,143,47,986
E01019737,312,427,119,134,992
E01019738,500,342,236,22,1100
E01019739,406,334,459,166,1365
E01019740,485,291,185,2,963
E01019741,394,361,66,92,913
E01019742,366,325,137,74,902
E01019743,408,214,87,375,1084
E01019744,509,459,113,130,1211
E01019745,347,202,98,231,878
E01019746,591,466,218,36,1311
E01019747,432,455,104,1,992
E01019748,597,396,231,6,1230
E01019749,604,383,42,0,1029
E01019750,404,271,131,246,1052
E01019751,965,543,180,27,1715
E01019752,472,172,179,195,1018
E01019753,617,358,200,31,1206
E01019754,647,639,180,47,1513
E01019755,809,700,137,13,1659
E01019756,939,355,83,5,1382
E01019757,559,420,75,39,1093
E01019758,734,431,68,2,1235
E01019759,435,300,142,349,1226
E01019760,519,414,116,145,1194
E01019761,271,163,127,544,1105
E01019762,542,790,143,23,1498
E01019763,794,507,200,200,1701
E01019764,508,499,90,189,1286
E01019765,666,498,305,19,1488
E01019766,519,452,127,108,1206
E01019767,565,550,100,86,1301
E01019768,575,403,258,566,1802
E01019769,486,843,146,136,1611
E01019770,476,769,127,232,1604
E01019771,566,845,165,206,1782
E01019772,513,647,83,38,1281
E01019773,737,455,285,472,1949
E01019774,353,910,77,61,1401
E01019775,419,311,117,581,1428
E01019776,350,473,109,228,1160
E01019777,597,371,122,820,1910
E01019778,545,772,41,92,1450
E01019779,410,872,100,12,1394
E01019780,378,277,60,408,1123
E01019781,513,497,81,71,1162
E01019782,364,215,82,382,1043
E01019783,489,513,33,11,1046
E01019784,502,445,46,12,1005
E01019785,536,509,18,4,1067
E01019786,458,410,168,231,1267
E01019787,626,688,85,75,1474
E01019788,625,697,37,17,1376
E01019790,856,628,147,39,1670
E01019791,506,378,146,390,1420
E01019792,549,306,83,675,1613
E01019793,532,656,42,24,1254
E01019794,421,744,31,17,1213
E01019795,922,642,91,166,1821
E01019796,146,130,47,566,889
E01019797,358,378,105,266,1107
E01019798,547,523,80,60,1210
E01019799,288,327,162,770,1547
E01019800,570,398,128,312,1408
E01019801,436,337,103,60,936
E01019802,552,380,100,73,1105
E01019803,364,249,58,334,1005
E01019804,659,379,56,21,1115
E01019805,595,392,64,47,1098
E01019806,681,328,86,195,1290
E01019807,277,244,57,616,1194
E01019808,295,230,71,658,1254
E01019809,304,450,80,162,996
E01019810,463,322,128,301,1214
E01019811,617,543,129,13,1302
E01019812,740,587,141,32,1500
E01019813,487,341,101,417,1346
E01019814,512,657,119,133,1421
E01019815,900,471,190,544,2105
E01019816,513,643,101,233,1490
E01019817,236,184,46,501,967
E01019818,314,290,75,527,1206
E01019819,393,506,149,173,1221
E01019820,489,567,53,97,1206
E01019821,398,638,102,37,1175
E01019822,477,536,104,202,1319
E01019823,286,282,61,297,926
E01019824,336,418,61,188,1003
E01019825,563,420,58,76,1117
E01019826,319,267,62,494,1142
E01019827,467,569,107,413,1556
E01019828,395,831,56,6,1288
E01019829,475,575,86,75,1211
E01019830,412,597,55,1,1065
E01019831,525,493,83,23,1124
E01019832,646,601,118,87,1452
E01019833,648,658,114,34,1454
E01019834,505,573,106,52,1236
E01019835,820,350,78,37,1285
E01019837,766,361,238,110,1475
E01019838,521,308,253,234,1316
E01019839,700,462,232,8,1402
E01019840,514,484,102,155,1255
E01019841,489,630,103,24,1246
E01019842,423,297,75,492,1287
E01019843,467,475,207,105,1254
E01019844,402,572,64,236,1274
E01019845,523,393,133,9,1058
E01019846,433,305,109,177,1024
E01019847,495,426,77,117,1115
E01019848,1099,245,138,98,1580
E01019850,581,612,87,51,1331
E01019851,545,406,111,252,1314
E01019852,722,458,184,87,1451
E01019853,437,551,138,114,1240
E01019854,461,473,314,202,1450
E01019855,559,482,164,44,1249
E01019856,394,347,101,344,1186
E01019857,659,255,53,16,983
E01019858,323,306,164,430,1223
E01019859,585,659,93,68,1405
E01019860,571,425,66,13,1075
E01019861,675,492,188,104,1459
E01019862,462,478,213,76,1229
E01019863,354,275,182,437,1248
E01019864,554,279,154,201,1188
E01019865,514,316,109,84,1023
E01019866,687,821,289,21,1818
E01019867,456,614,124,17,1211
E01019868,540,490,152,110,1292
E01019869,317,442,259,4,1022
E01019870,414,427,213,202,1256
E01019871,609,527,142,149,1427
E01019872,721,627,152,50,1550
E01019873,602,274,209,21,1106
E01019874,553,529,112,16,1210
E01019875,657,352,91,18,1118
E01019876,683,514,136,218,1551
E01019877,435,345,274,244,1298
E01019878,549,454,137,119,1259
E01019879,829,552,127,59,1567
E01019880,639,547,108,3,1297
E01019881,492,555,83,16,1146
E01019882,530,511,112,138,1291
E01019883,1103,377,424,242,2146
E01019885,766,396,155,67,1384
E01019886,669,804,201,447,2121
E01019887,325,389,174,258,1146
E01019888,332,606,353,52,1343
E01019889,421,640,134,50,1245
E01019890,413,729,238,198,1578
E01019891,378,384,300,128,1190
E01019892,552,367,152,148,1219
E01019893,558,577,199,112,1446
E01019894,255,839,150,45,1289
E01019895,289,691,166,47,1193
E01019896,312,823,163,39,1337
E01019897,406,407,173,243,1229
E01019898,684,1025,259,37,2005
E01019899,327,479,101,213,1120
E01019900,388,955,134,72,1549
E01019901,324,620,116,57,1117
E01019902,629,792,174,78,1673
E01019903,575,738,258,134,1705
E01019904,458,334,90,214,1096
E01019905,826,643,107,19,1595
E01019906,578,512,117,12,1219
E01019907,487,604,112,59,1262
E01019908,652,302,211,176,1341
E01019909,577,806,116,34,1533
E01019910,599,526,140,65,1330
E01019911,387,802,154,41,1384
E01019912,385,601,312,120,1418
E01019913,287,841,169,21,1318
E01019914,432,477,254,586,1749
E01019915,436,740,130,57,1363
E01019916,443,279,763,66,1551
E01019917,500,415,290,22,1227
E01019918,395,481,646,43,1565
E01019919,545,337,436,83,1401
E01019920,523,360,134,154,1171
E01019921,553,537,97,69,1256
E01019922,402,238,91,444,1175
E01019923,344,361,107,186,998
E01019924,539,246,155,248,1188
E01019925,547,353,96,45,1041
E01019927,263,273,228,273,1037
E01019928,441,378,114,207,1140
E01019929,507,383,195,82,1167
E01019930,418,579,162,24,1183
E01019931,465,474,84,28,1051
E01019932,370,381,314,343,1408
E01019933,362,377,186,102,1027
E01019934,482,862,136,96,1576
E01019935,276,621,114,79,1090
E01019936,266,460,114,101,941
E01019937,539,843,237,153,1772
E01019938,550,999,215,93,1857
E01019939,412,644,119,59,1234
E01019940,386,781,88,40,1295
E01019942,504,528,162,237,1431
E01019943,525,612,80,57,1274
E01019944,484,447,261,40,1232
E01019945,474,677,372,123,1646
E01019946,315,730,97,44,1186
E01019947,352,658,507,16,1533
E01019948,289,673,75,79,1116
E01019949,334,747,131,10,1222
E01019950,247,452,82,264,1045
E01019951,434,1127,186,112,1859
E01019952,437,791,127,121,1476
E01019953,329,770,58,199,1356
E01019954,405,460,89,265,1219
E01019955,386,604,174,222,1386
E01019956,265,708,350,69,1392
E01019957,199,1151,125,38,1513
E01019958,452,838,129,73,1492
E01019959,270,419,174,78,941
E01019960,399,482,167,46,1094
E01019961,634,1100,261,103,2098
E01019962,789,782,230,155,1956
E01019963,541,476,154,106,1277
E01019964,312,403,123,13,851
E01019965,441,533,299,133,1406
E01019966,265,496,62,79,902
E01019967,303,527,216,32,1078
E01019968,413,562,220,95,1290
E01019969,476,384,162,72,1094
E01019970,475,313,173,44,1005
E01019971,358,220,597,174,1349
E01019972,447,249,266,148,1110
E01019973,512,457,87,126,1182
E01019974,447,503,122,134,1206
E01019975,413,211,120,276,1020
E01019976,421,503,95,47,1066
E01019977,544,463,69,117,1193
E01019980,527,188,304,295,1314
E01019981,458,325,97,247,1127
E01019982,567,164,357,205,1293
E01019983,479,465,100,158,1202
E01019984,603,356,117,38,1114
E01019985,347,135,96,469,1047
E01019986,537,481,181,25,1224
E01019987,360,280,421,104,1165
E01019988,511,442,147,76,1176
E01019989,434,270,228,11,943
E01019990,357,165,79,443,1044
E01019991,349,244,147,395,1135
E01019992,500,388,112,209,1209
E01019993,518,374,99,21,1012
E01019994,266,205,583,218,1272
E01019995,200,146,370,524,1240
E01019996,224,148,493,94,959
E01019997,246,206,927,26,1405
E01019998,488,377,226,76,1167
E01019999,355,415,307,34,1111
E01020000,328,217,185,352,1082
E01020001,470,483,167,23,1143
E01020002,426,399,105,249,1179
E01020003,490,677,93,78,1338
E01020004,540,516,141,21,1218
E01020005,424,371,119,477,1391
E01020006,534,297,484,366,1681
E01020007,209,172,938,39,1358
E01020008,284,187,1084,38,1593
E01020009,485,339,365,25,1214
E01020010,423,290,201,450,1364
E01020011,377,444,111,107,1039
E01020012,456,280,103,330,1169
E01020013,349,271,264,163,1047
E01020014,376,136,123,586,1221
E01020015,340,106,143,758,1347
E01020016,191,193,773,562,1719
E01020017,352,225,956,218,1751
E01020018,240,261,850,414,1765
E01020019,178,220,1206,38,1642
E01020020,172,189,983,36,1380
E01020021,242,289,698,25,1254
E01020022,151,86,1014,232,1483
E01020023,683,637,357,124,1801
E01020024,386,505,251,50,1192
E01020025,358,296,490,89,1233
E01020026,631,650,168,14,1463
E01020027,634,445,147,89,1315
E01020029,625,354,241,90,1310
E01020030,568,302,452,189,1511
E01020031,599,365,241,67,1272
E01020032,491,356,312,43,1202
E01020033,374,735,112,111,1332
E01020035,651,375,151,81,1258
E01020036,424,437,77,253,1191
E01020037,304,284,71,408,1067
E01020038,558,456,125,69,1208
E01020039,392,189,135,766,1482
E01020040,412,387,78,209,1086
E01020041,671,386,271,380,1708
E01020042,595,599,172,17,1383
E01020043,559,500,269,220,1548
E01020044,448,576,189,97,1310
E01020045,509,594,148,86,1337
E01020046,464,518,230,58,1270
E01020047,610,747,349,35,1741
E01020048,437,442,632,169,1680
E01020049,360,572,150,32,1114
E01020050,481,794,313,170,1758
E01020051,540,812,177,37,1566
E01020052,437,340,333,323,1433
E01020053,363,323,145,302,1133
E01020054,784,527,203,154,1668
E01020055,547,400,270,269,1486
E01020056,584,685,277,85,1631
E01020057,500,328,226,339,1393
E01020058,700,564,236,71,1571
E01020059,569,707,231,142,1649
E01020060,387,433,383,225,1428
E01020061,653,635,222,130,1640
E01020062,629,529,114,21,1293
E01020063,718,645,238,379,1980
E01020064,643,298,228,236,1405
E01020065,515,307,295,272,1389
E01020066,970,604,537,55,2166
E01020067,466,170,210,592,1438
E01020068,398,518,217,124,1257
E01020069,407,538,177,103,1225
E01020070,524,744,201,74,1543
E01020071,585,639,179,139,1542
E01020072,514,616,147,84,1361
E01020073,470,639,152,122,1383
E01020074,664,726,256,91,1737
E01020075,555,633,199,153,1540
E01020076,544,523,222,81,1370
E01020077,496,595,154,59,1304
E01020078,311,147,362,288,1108
E01020079,378,288,74,321,1061
E01020080,340,567,146,16,1069
E01020081,314,329,130,240,1013
E01020082,324,452,123,58,957
E01020083,868,586,269,110,1833
E01020084,385,456,189,186,1216
E01020085,535,295,284,65,1179
E01020086,497,615,123,24,1259
E01020087,474,816,192,124,1606
E01020088,532,740,260,131,1663
E01020089,723,675,337,118,1853
E01020090,521,713,141,17,1392
E01020091,430,498,159,3,1090
E01020092,375,699,123,29,1226
E01020093,383,403,195,192,1173
E01020094,254,202,558,482,1496
E01020095,451,202,311,224,1188
E01020096,372,449,409,163,1393
E01020097,608,826,356,76,1866
E01020098,534,848,243,132,1757
E01020099,348,574,239,7,1168
E01020100,261,501,98,51,911
E01020101,374,577,217,50,1218
E01020102,701,309,252,45,1307
E01020103,360,184,96,459,1099
E01020104,318,171,284,273,1046
E01020105,533,443,96,145,1217
E01020106,379,572,54,4,1009
E01020107,522,722,94,47,1385
E01020108,599,859,346,64,1868
E01020109,423,534,182,49,1188
E01020110,379,465,547,213,1604
E01020111,285,238,336,272,1131
E01020112,294,217,658,81,1250
E01020113,263,325,444,31,1063
E01020114,362,304,271,25,962
E01020115,401,407,179,9,996
E01020116,566,430,229,96,1321
E01020117,522,585,114,59,1280
E01020118,386,267,147,231,1031
E01020119,363,594,280,48,1285
E01020120,622,684,180,20,1506
E01020121,706,552,180,134,1572
E01020122,486,636,263,53,1438
E01020123,361,502,109,226,1198
E01020124,443,528,169,9,1149
E01020125,368,610,148,7,1133
E01020126,399,517,242,107,1265
E01020127,551,755,202,42,1550
E01020128,423,503,92,31,1049
E01020129,343,254,113,246,956
E01020130,547,246,321,107,1221
E01020131,476,700,425,132,1733
E01020132,631,583,209,81,1504
E01020133,454,497,205,40,1196
E01020134,286,176,147,288,897
E01020135,444,351,226,242,1263
E01020136,471,606,218,134,1429
E01020137,382,425,345,104,1256
E01020138,643,849,230,169,1891
E01020139,432,307,202,223,1164
E01020140,341,444,147,81,1013
E01020141,490,186,264,375,1315
E01020142,683,724,309,128,1844
E01020143,535,845,355,117,1852
E01020144,748,266,173,17,1204
E01020145,677,561,219,70,1527
E01020146,486,216,219,10,931
E01020147,450,846,213,178,1687
E01020148,335,377,131,76,919
E01020149,366,327,187,118,998
E01020150,432,632,168,171,1403
E01020151,401,726,221,62,1410
E01020152,277,512,347,193,1329
E01020153,325,572,176,21,1094
E01020154,340,215,164,286,1005
E01020155,216,173,82,369,840
E01020156,438,813,283,45,1579
E01020157,576,886,301,102,1865
E01020158,468,573,219,132,1392
E01020159,368,456,266,68,1158
E01020160,625,561,211,115,1512
E01020161,780,642,235,279,1936
E01020162,732,419,132,32,1315
E01020163,795,407,115,78,1395
E01020164,574,341,135,183,1233
E01020165,664,307,182,38,1191
E01020166,595,484,78,7,1164
E01020167,579,386,91,15,1071
E01020168,480,820,208,200,1708
E01020169,618,623,478,177,1896
E01020170,748,867,123,67,1805
E01020171,456,834,210,89,1589
E01020172,425,763,201,128,1517
E01020173,315,684,168,177,1344
E01020174,325,686,192,124,1327
E01020175,412,961,210,109,1692
E01020176,315,422,164,46,947
E01020177,352,424,83,265,1124
E01020178,458,903,202,94,1657
E01020179,451,826,193,146,1616
E01020180,379,503,218,421,1521
E01020181,431,529,127,317,1404
E01020182,441,339,170,222,1172
E01020183,245,470,419,62,1196
E01020184,339,468,305,272,1384
E01020185,383,626,73,49,1131
E01020186,418,752,102,9,1281
E01020187,552,451,156,213,1372
E01020188,493,810,242,92,1637
E01020189,460,473,257,506,1696
E01020190,543,745,213,173,1674
E01020191,295,374,134,17,820
E01020192,555,572,96,55,1278
E01020193,439,509,142,61,1151
E01020194,600,456,124,12,1192
E01020195,539,542,187,151,1419
E01020196,426,409,263,279,1377
E01020197,329,511,152,68,1060
E01020198,359,244,225,268,1096
E01020199,473,387,262,150,1272
E01020200,369,475,110,17,971
E01020201,369,744,76,47,1236
E01020202,365,757,92,105,1319
E01020203,449,778,150,30,1407
E01020204,586,185,236,181,1188
E01020205,388,671,101,21,1181
E01020206,468,413,213,149,1243
E01020207,396,298,161,3,858
E01020208,424,232,96,236,988
E01020209,534,384,205,42,1165
E01020210,437,509,64,16,1026
E01020211,428,177,145,448,1198
E01020212,369,237,90,271,967
E01020213,448,448,148,147,1191
E01020214,549,584,124,67,1324
E01020215,540,589,50,16,1195
E01020216,503,256,166,318,1243
E01020217,477,399,462,56,1394
E01020218,444,217,391,190,1242
E01020219,797,478,210,148,1633
E01020220,430,314,122,209,1075
E01020221,609,431,249,113,1402
E01020222,473,383,136,7,999
E01020223,599,547,185,106,1437
E01020224,472,169,304,26,971
E01020225,409,202,245,156,1012
E01020226,387,428,94,45,954
E01020227,436,466,175,78,1155
E01020228,325,463,502,164,1454
E01020229,435,692,230,44,1401
E01020230,559,609,214,38,1420
E01020231,479,519,178,27,1203
E01020232,582,373,184,109,1248
E01020233,504,821,170,16,1511
E01020234,376,367,130,297,1170
E01020235,399,551,389,128,1467
E01020236,500,502,68,15,1085
E01020237,514,569,138,64,1285
E01020238,383,402,109,95,989
E01020239,391,538,103,20,1052
E01020240,492,415,187,161,1255
E01020241,522,517,328,42,1409
E01020242,562,438,107,20,1127
E01020243,365,406,150,75,996
E01020244,441,356,178,172,1147
E01020245,488,586,227,58,1359
E01020246,439,352,98,29,918
E01020247,488,459,147,220,1314
E01020248,610,614,127,16,1367
E01020249,508,552,96,5,1161
E01020250,644,554,105,41,1344
E01020251,579,435,145,14,1173
E01020252,398,316,160,221,1095
E01020253,632,284,182,48,1146
E01020254,461,250,135,230,1076
E01020255,422,427,160,66,1075
E01020256,447,432,184,19,1082
E01020257,483,425,95,11,1014
E01020258,513,542,207,144,1406
E01020259,243,468,204,31,946
E01020260,285,597,177,20,1079
E01020261,379,481,119,18,997
E01020262,295,572,129,37,1033
E01020263,314,800,122,48,1284
E01020264,343,417,261,115,1136
E01020265,614,670,144,25,1453
E01020266,602,548,165,30,1345
E01020267,479,553,177,2,1211
E01020268,394,666,98,51,1209
E01020269,290,542,708,139,1679
E01020270,626,566,130,13,1335
E01020271,480,303,227,200,1210
E01020272,542,330,166,391,1429
E01020273,374,534,103,127,1138
E01020274,329,556,158,20,1063
E01020275,349,451,229,98,1127
E01020276,450,617,123,84,1274
E01020277,408,350,231,538,1527
E01020278,553,533,181,68,1335
E01020279,795,553,260,231,1839
E01020280,514,399,764,115,1792
E01020281,662,691,194,14,1561
E01020282,363,458,250,275,1346
E01020283,487,541,88,65,1181
E01020284,628,429,253,219,1529
E01020285,586,357,232,380,1555
E01020286,425,629,249,45,1348
E01020287,399,643,230,30,1302
E01020288,401,513,403,54,1371
E01020289,419,731,148,42,1340
E01020290,477,717,176,44,1414
E01020291,441,586,206,66,1299
E01020292,332,494,280,118,1224
E01020293,564,802,344,94,1804
E01020294,387,550,221,210,1368
E01020295,445,665,184,58,1352
E01020296,494,529,172,41,1236
E01020297,357,392,222,304,1275
E01020298,539,925,156,56,1676
E01020299,524,767,269,21,1581
E01020300,501,756,165,7,1429
E01020301,579,759,200,78,1616
E01020302,492,663,195,61,1411
E01020303,443,737,181,51,1412
E01020304,515,469,242,158,1384
E01020305,255,297,267,65,884
E01020306,430,432,102,37,1001
E01020307,429,352,180,277,1238
E01020308,528,714,165,34,1441
E01020309,484,699,179,61,1423
E01020310,449,928,430,22,1829
E01020311,547,811,251,135,1744
E01020312,461,705,142,43,1351
E01020313,420,362,144,216,1142
E01020314,365,670,227,55,1317
E01020315,386,485,153,153,1177
E01020316,569,714,185,43,1511
E01020317,411,633,144,39,1227
E01020318,287,576,264,98,1225
E01020319,407,645,213,76,1341
E01020320,430,754,202,41,1427
E01020321,587,721,296,152,1756
E01020322,540,867,191,85,1683
E01020323,398,472,243,166,1279
E01020324,435,695,99,65,1294
E01020325,496,516,291,27,1330
E01020326,573,698,265,120,1656
E01020327,569,585,206,124,1484
E01020328,696,440,405,200,1741
E01020329,418,587,161,131,1297
E01020330,374,531,352,211,1468
E01020331,430,561,176,79,1246
E01020332,477,487,473,104,1541
E01020333,618,686,177,87,1568
E01020334,563,480,257,213,1513
E01020335,412,663,77,110,1262
E01020336,392,686,88,13,1179
E01020337,308,354,130,197,989
E01020338,711,586,288,261,1846
E01020339,485,556,224,126,1391
E01020340,489,627,203,88,1407
E01020341,492,700,114,26,1332
E01020342,442,399,115,256,1212
E01020343,489,563,117,133,1302
E01020344,631,304,108,89,1132
E01020345,448,342,113,132,1035
E01020346,442,355,114,390,1301
E01020347,312,258,96,633,1299
E01020348,369,222,80,611,1282
E01020349,255,861,298,174,1588
E01020350,320,1089,152,10,1571
E01020351,452,456,97,45,1050
E01020352,512,394,77,70,1053
E01020353,463,398,112,330,1303
E01020354,422,517,186,140,1265
E01020355,445,1114,106,14,1679
E01020356,372,772,186,49,1379
E01020357,712,660,164,217,1753
E01020358,419,785,82,23,1309
E01020359,462,253,80,199,994
E01020360,536,366,195,117,1214
E01020361,549,381,250,57,1237
E01020362,413,722,106,30,1271
E01020363,360,191,91,299,941
E01020364,360,479,242,260,1341
E01020365,466,673,145,74,1358
E01020366,692,965,99,21,1777
E01020367,504,727,328,47,1606
E01020368,603,561,397,428,1989
E01020369,369,625,131,6,1131
E01020370,594,480,125,30,1229
E01020371,433,896,50,8,1387
E01020372,340,624,94,21,1079
E01020373,511,274,99,107,991
E01020374,551,654,54,23,1282
E01020375,530,482,83,100,1195
E01020376,417,477,49,20,963
E01020377,690,570,62,11,1333
E01020378,589,521,116,47,1273
E01020379,461,499,46,217,1223
E01020380,371,449,73,19,912
E01020381,419,564,44,5,1032
E01020382,606,481,141,25,1253
E01020383,643,734,81,36,1494
E01020384,724,417,133,72,1346
E01020385,420,347,101,121,989
E01020386,488,425,45,28,986
E01020387,376,538,32,7,953
E01020388,511,383,126,177,1197
E01020389,456,536,544,225,1761
E01020390,300,763,83,102,1248
E01020391,404,746,108,30,1288
E01020392,313,752,206,57,1328
E01020393,467,183,156,336,1142
E01020394,367,699,85,331,1482
E01020395,475,968,139,43,1625
E01020396,223,267,346,59,895
E01020397,451,378,192,173,1194
E01020398,634,950,232,101,1917
E01020399,963,813,201,39,2016
E01020400,556,726,95,14,1391
E01020401,412,851,82,10,1355
E01020402,584,646,57,12,1299
E01020403,462,742,67,6,1277
E01020404,494,697,81,77,1349
E01020405,405,774,121,16,1316
E01020406,630,1320,103,6,2059
E01020407,447,482,78,9,1016
E01020408,397,434,69,59,959
E01020409,464,393,126,32,1015
E01020410,257,242,321,245,1065
E01020411,294,333,42,191,860
E01020412,454,222,98,349,1123
E01020413,614,456,62,27,1159
E01020414,682,588,145,163,1578
E01020415,569,603,53,44,1269
E01020416,677,314,174,11,1176
E01020417,419,365,89,13,886
E01020418,477,733,63,11,1284
E01020419,766,661,101,6,1534
E01020420,509,443,70,36,1058
E01020421,355,480,159,86,1080
E01020422,330,756,152,214,1452
E01020423,439,693,54,72,1258
E01020424,502,571,46,103,1222
E01020425,382,914,85,77,1458
E01020426,461,729,208,66,1464
E01020427,333,353,95,520,1301
E01020428,358,615,397,313,1683
E01020429,485,416,272,191,1364
E01020430,381,578,122,119,1200
E01020431,234,350,152,109,845
E01020432,343,353,211,133,1040
E01020433,503,647,219,107,1476
E01020434,450,631,120,264,1465
E01020435,730,450,206,113,1499
E01020436,819,439,165,195,1618
E01020437,634,544,102,265,1545
E01020438,424,480,434,334,1672
E01020439,722,434,249,401,1806
E01020440,549,787,169,139,1644
E01020441,527,638,164,216,1545
E01020442,520,715,354,110,1699
E01020443,683,478,468,366,1995
E01020444,421,515,184,325,1445
E01020445,278,440,139,75,932
E01020446,430,598,105,95,1228
E01020447,495,641,104,268,1508
E01020448,505,754,154,216,1629
E01020449,492,889,126,196,1703
E01020450,870,620,256,89,1835
E01020452,492,388,326,361,1567
E01020453,545,596,170,106,1417
E01020454,518,504,287,378,1687
E01020455,692,459,178,154,1483
E01020456,603,407,237,172,1419
E01020457,384,649,136,86,1255
E01020458,635,810,293,64,1802
E01020459,655,626,307,504,2092
E01020460,514,793,173,187,1667
E01020462,498,745,141,119,1503
E01020463,614,586,135,50,1385
E01020464,474,554,142,77,1247
E01020465,525,524,346,256,1651
E01020466,295,616,381,223,1515
E01020467,423,729,241,94,1487
E01020468,361,695,127,92,1275
E01020469,538,474,247,290,1549
E01020470,649,740,106,21,1516
E01020471,508,194,159,185,1046
E01020472,499,329,168,137,1133
E01020473,523,521,168,18,1230
E01020474,545,670,190,46,1451
E01020475,727,689,159,100,1675
E01020476,333,534,162,41,1070
E01020477,500,407,81,252,1240
E01020478,303,469,101,22,895
E01020479,164,557,222,82,1025
E01020480,294,769,141,102,1306
E01020481,363,662,238,61,1324
E01020482,439,491,327,113,1370
E01020483,363,314,91,257,1025
E01020484,303,514,104,269,1190
E01020485,192,434,315,322,1263
E01020486,289,547,177,129,1142
E01020487,440,485,94,43,1062
E01020488,424,481,129,186,1220
E01020489,232,368,417,127,1144
E01020490,405,526,317,114,1362
E01020491,447,495,161,183,1286
E01020492,300,400,123,173,996
E01020493,438,201,598,387,1624
E01020494,290,435,151,66,942
E01020495,314,595,178,102,1189
E01020496,237,582,157,358,1334
E01020497,532,720,209,131,1592
E01020498,563,827,135,172,1697
E01020499,297,220,119,466,1102
E01020500,361,583,284,183,1411
E01020501,392,596,79,72,1139
E01020502,316,391,166,503,1376
E01020503,349,591,359,203,1502
E01020504,507,1221,189,71,1988
E01020505,622,693,141,129,1585
E01020506,366,775,174,149,1464
E01020507,355,981,207,130,1673
E01020508,435,836,269,97,1637
E01020509,773,996,331,135,2235
E01020510,555,537,209,320,1621
E01020511,327,756,129,206,1418
E01020512,449,749,458,128,1784
E01020513,445,444,134,220,1243
E01020514,421,394,155,57,1027
E01020515,405,345,132,70,952
E01020516,481,594,83,125,1283
E01020517,363,895,209,57,1524
E01020518,352,314,159,435,1260
E01020519,466,515,249,185,1415
E01020520,481,442,163,114,1200
E01020523,472,382,141,34,1029
E01020524,457,588,77,103,1225
E01020525,421,570,54,34,1079
E01020526,426,352,96,157,1031
E01020527,456,279,178,219,1132
E01020528,472,457,241,405,1575
E01020529,555,817,321,150,1843
E01020530,379,709,361,100,1549
E01020531,393,718,226,91,1428
E01020532,331,817,197,45,1390
E01020533,428,646,155,434,1663
E01020534,548,615,351,187,1701
E01020535,368,793,195,95,1451
E01020536,483,776,234,192,1685
E01020537,519,714,226,86,1545
E01020538,596,580,135,234,1545
E01020539,545,663,299,154,1661
E01020540,727,754,332,201,2014
E01020541,409,693,394,182,1678
E01020542,261,528,178,171,1138
E01020543,308,351,116,339,1114
E01020544,275,565,311,109,1260
E01020546,126,242,380,136,884
E01020547,286,282,80,275,923
E01020549,546,676,354,120,1696
E01020550,424,661,127,140,1352
E01020551,648,318,274,238,1478
E01020552,354,140,118,739,1351
E01020553,246,224,396,162,1028
E01020554,212,275,914,113,1514
E01020555,313,267,497,77,1154
E01020556,243,438,452,69,1202
E01020557,434,815,115,6,1370
E01020558,504,818,158,10,1490
E01020559,376,969,74,8,1427
E01020560,626,821,166,23,1636
E01020561,576,374,319,132,1401
E01020562,743,584,276,49,1652
E01020563,419,340,131,77,967
E01020564,539,283,172,233,1227
E01020565,499,464,165,83,1211
E01020566,803,721,186,40,1750
E01020569,193,187,188,556,1124
E01020570,515,632,173,32,1352
E01020571,695,374,220,333,1622
E01020572,734,431,385,48,1598
E01020573,486,437,321,274,1518
E01020574,546,555,156,268,1525
E01020575,425,191,137,555,1308
E01020576,539,747,114,72,1472
E01020577,576,396,146,162,1280
E01020578,619,496,159,434,1708
E01020579,642,729,220,33,1624
E01020580,494,554,92,49,1189
E01020581,419,753,480,67,1719
E01020582,290,336,316,336,1278
E01020583,600,684,233,73,1590
E01020584,573,411,198,191,1373
E01020585,474,340,63,325,1202
E01020586,426,435,88,112,1061
E01020587,421,358,191,189,1159
E01020588,464,468,129,18,1079
E01020589,451,413,130,212,1206
E01020590,474,451,183,10,1118
E01020591,394,282,161,335,1172
E01020592,272,102,130,636,1140
E01020593,359,267,216,219,1061
E01020594,603,465,303,13,1384
E01020595,579,659,146,34,1418
E01020596,535,272,122,402,1331
E01020597,541,633,75,29,1278
E01020598,601,581,228,84,1494
E01020599,505,253,108,543,1409
E01020600,575,650,58,3,1286
E01020601,692,323,73,183,1271
E01020602,532,266,93,586,1477
E01020603,919,528,37,2,1486
E01020604,537,350,100,209,1196
E01020605,852,487,110,3,1452
E01020606,449,377,265,163,1254
E01020607,538,362,112,290,1302
E01020608,720,307,96,269,1392
E01020609,407,503,63,189,1162
E01020610,649,409,78,88,1224
E01020611,533,537,66,15,1151
E01020612,577,706,78,16,1377
E01020613,631,443,40,25,1139
E01020614,446,484,81,177,1188
E01020615,549,218,115,503,1385
E01020616,612,235,154,328,1329
E01020617,774,521,151,114,1560
E01020618,553,231,97,408,1289
E01020619,645,403,97,132,1277
E01020620,576,360,101,213,1250
E01020621,583,363,102,491,1539
E01020622,821,430,92,49,1392
E01020623,795,327,109,8,1239
E01020624,551,379,281,58,1269
E01020625,575,413,183,101,1272
E01020626,390,353,149,399,1291
E01020627,602,481,138,67,1288
E01020628,561,629,154,25,1369
E01020629,502,381,79,228,1190
E01020630,373,363,83,285,1104
E01020631,509,313,154,371,1347
E01020632,737,456,220,53,1466
E01020633,505,406,130,269,1310
E01020634,652,479,69,69,1269
E01020635,622,448,80,34,1184
E01020636,614,344,119,328,1405
E01020637,617,543,152,80,1392
E01020638,546,451,134,184,1315
E01020639,427,227,145,366,1165
E01020640,975,517,315,76,1883
E01020641,698,498,333,201,1730
E01020642,522,429,128,63,1142
E01020643,803,379,376,229,1787
E01020644,900,291,281,437,1909
E01020645,385,272,118,354,1129
E01020646,531,451,94,216,1292
E01020647,567,222,111,667,1567
E01020648,502,254,187,483,1426
E01020649,471,339,172,245,1227
E01020650,903,428,212,179,1722
E01020651,586,557,152,140,1435
E01020652,746,364,202,256,1568
E01020653,476,317,138,320,1251
E01020654,724,467,124,110,1425
E01020655,737,596,108,154,1595
E01020656,444,425,105,222,1196
E01020657,679,407,103,47,1236
E01020658,515,351,201,317,1384
E01020659,708,411,153,20,1292
E01020660,486,497,123,201,1307
E01020661,656,319,289,170,1434
E01020662,657,358,146,306,1467
E01020663,721,562,184,86,1553
E01020664,440,638,146,6,1230
E01020665,455,401,63,219,1138
E01020666,508,621,57,51,1237
E01020667,532,487,196,124,1339
E01020668,496,345,192,180,1213
E01020669,489,357,95,248,1189
E01020670,472,442,183,213,1310
E01020671,328,314,342,84,1068
E01020672,558,420,254,164,1396
E01020673,368,327,160,464,1319
E01020674,449,403,103,335,1290
E01020675,510,295,152,411,1368
E01020676,590,451,154,92,1287
E01020677,479,349,119,314,1261
E01020678,506,411,70,143,1130
E01020679,497,278,127,361,1263
E01020680,646,527,149,22,1344
E01020681,529,258,89,344,1220
E01020682,646,935,57,12,1650
E01020683,590,576,144,6,1316
E01020684,849,548,414,53,1864
E01020685,603,443,102,223,1371
E01020686,313,230,128,614,1285
E01020687,512,385,80,262,1239
E01020688,517,310,102,286,1215
E01020689,322,228,97,485,1132
E01020690,390,629,119,14,1152
E01020691,461,319,149,188,1117
E01020692,441,712,107,1,1261
E01020693,311,311,272,240,1134
E01020694,458,271,90,397,1216
E01020695,640,430,108,287,1465
E01020696,403,332,158,194,1087
E01020697,584,372,220,35,1211
E01020698,722,415,111,23,1271
E01020699,310,203,86,331,930
E01020700,444,423,68,350,1285
E01020701,484,362,139,133,1118
E01020702,548,602,548,25,1723
E01020703,126,164,1430,176,1896
E01020704,304,403,851,23,1581
E01020705,451,248,104,430,1233
E01020706,633,661,180,93,1567
E01020708,370,412,192,10,984
E01020709,601,379,104,66,1150
E01020710,604,341,231,159,1335
E01020711,510,313,129,456,1408
E01020712,482,506,367,15,1370
E01020713,615,643,379,8,1645
E01020714,612,557,121,54,1344
E01020715,872,482,286,298,1938
E01020716,416,165,142,612,1335
E01020717,577,772,75,19,1443
E01020718,468,513,112,46,1139
E01020719,497,408,118,1,1024
E01020720,442,313,115,297,1167
E01020721,521,396,71,6,994
E01020722,348,327,399,621,1695
E01020723,235,293,674,342,1544
E01020724,178,166,160,715,1219
E01020725,591,437,65,138,1231
E01020726,469,376,99,71,1015
E01020727,301,178,41,362,882
E01020729,738,441,155,353,1687
E01020730,572,340,96,400,1408
E01020731,543,419,74,168,1204
E01020732,599,591,110,115,1415
E01020733,456,206,119,202,983
E01020734,390,193,104,270,957
E01020735,623,329,73,131,1156
E01020736,365,281,46,277,969
E01020737,500,477,132,35,1144
E01020738,355,414,67,58,894
E01020739,275,289,217,321,1102
E01020740,550,408,111,67,1136
E01020741,369,326,301,23,1019
E01020742,592,375,264,102,1333
E01020743,374,116,110,423,1023
E01020744,371,355,50,79,855
E01020745,344,210,129,368,1051
E01020746,476,305,45,108,934
E01020747,191,158,73,496,918
E01020748,377,213,121,303,1014
E01020749,315,385,122,428,1250
E01020750,511,475,78,30,1094
E01020751,665,485,245,112,1507
E01020752,212,266,282,193,953
E01020753,606,354,136,427,1523
E01020754,431,375,100,218,1124
E01020756,558,478,75,6,1117
E01020757,315,167,96,276,854
E01020758,355,188,151,402,1096
E01020759,271,143,101,324,839
E01020760,576,469,90,206,1341
E01020761,398,302,134,199,1033
E01020762,299,270,103,413,1085
E01020763,611,428,157,298,1494
E01020764,268,355,273,247,1143
E01020765,552,303,103,385,1343
E01020766,477,416,118,226,1237
E01020767,457,337,298,434,1526
E01020768,553,475,147,89,1264
E01020769,485,273,91,136,985
E01020770,459,240,107,169,975
E01020771,334,187,86,237,844
E01020772,745,607,139,161,1652
E01020773,391,312,82,400,1185
E01020775,332,238,131,674,1375
E01020776,659,620,79,197,1555
E01020777,438,198,143,413,1192
E01020778,479,453,58,43,1033
E01020779,853,501,34,21,1409
E01020780,354,275,75,238,942
E01020781,404,277,66,168,915
E01020782,425,340,78,120,963
E01020783,458,409,152,101,1120
E01020784,367,299,225,339,1230
E01020786,663,635,69,25,1392
E01020787,633,330,169,353,1485
E01020788,430,441,157,219,1247
E01020789,444,375,113,230,1162
E01020790,320,279,102,348,1049
E01020791,430,307,103,249,1089
E01020792,540,295,126,198,1159
E01020793,463,406,115,396,1380
E01020794,776,473,103,103,1455
E01020795,566,411,219,198,1394
E01020796,477,410,66,114,1067
E01020797,675,545,309,546,2075
E01020798,376,192,103,584,1255
E01020799,533,340,118,233,1224
E01020801,550,474,161,112,1297
E01020802,668,345,311,282,1606
E01020803,745,601,222,40,1608
E01020805,534,304,135,608,1581
E01020806,411,342,102,291,1146
E01020807,292,248,320,235,1095
E01020808,445,441,148,161,1195
E01020809,424,226,102,407,1159
E01020810,543,316,117,99,1075
E01020811,427,244,103,241,1015
E01020812,594,391,84,204,1273
E01020813,539,412,48,12,1011
E01020814,703,190,96,157,1146
E01020815,520,332,67,86,1005
E01020816,277,148,181,443,1049
E01020817,543,515,47,7,1112
E01020818,467,416,102,231,1216
E01020819,198,218,58,414,888
E01020820,361,181,153,537,1232
E01020821,716,497,128,142,1483
E01020822,733,604,156,71,1564
E01020823,389,364,179,531,1463
E01020824,481,320,164,335,1300
E01020825,563,304,102,335,1304
E01020826,469,363,102,328,1262
E01020827,642,484,154,195,1475
E01020828,479,727,131,20,1357
E01020829,871,823,215,29,1938
E01020830,461,425,116,293,1295
E01020831,436,285,98,319,1138
E01020832,448,439,113,195,1195
E01020833,453,309,74,141,977
E01020834,417,197,87,334,1035
E01020835,590,431,206,82,1309
E01020836,633,373,157,433,1596
E01020837,677,693,69,35,1474
E01020838,487,536,286,136,1445
E01020839,403,377,191,400,1371
E01020840,371,373,164,363,1271
E01020841,391,181,204,603,1379
E01020842,468,386,177,558,1589
E01020843,646,494,94,120,1354
E01020844,337,147,146,557,1187
E01020845,427,242,114,356,1139
E01020846,407,412,88,161,1068
E01020847,350,123,225,422,1120
E01020848,429,287,96,98,910
E01020849,328,105,138,364,935
E01020850,932,384,107,70,1493
E01020851,638,478,94,12,1222
E01020852,306,454,214,340,1314
E01020853,410,485,139,173,1207
E01020854,612,675,317,190,1794
E01020855,331,543,97,61,1032
E01020856,433,491,168,198,1290
E01020857,338,577,215,102,1232
E01020858,333,311,66,137,847
E01020859,437,458,106,21,1022
E01020860,245,247,97,235,824
E01020861,327,474,139,67,1007
E01020862,648,875,336,177,2036
E01020863,346,495,327,15,1183
E01020864,632,797,222,105,1756
E01020865,252,572,259,56,1139
E01020866,160,287,352,70,869
E01020867,437,692,440,206,1775
E01020868,640,431,314,127,1512
E01020869,438,370,277,40,1125
E01020870,446,715,36,1,1198
E01020871,473,479,176,10,1138
E01020872,553,530,223,96,1402
E01020873,289,208,119,544,1160
E01020874,430,349,230,171,1180
E01020875,421,392,113,163,1089
E01020876,629,414,106,246,1395
E01020877,456,546,233,58,1293
E01020878,498,264,102,479,1343
E01020879,871,653,172,88,1784
E01020880,379,320,471,87,1257
E01020881,518,390,105,61,1074
E01020882,555,438,138,88,1219
E01020883,807,526,74,6,1413
E01020884,443,396,127,174,1140
E01020885,322,147,55,431,955
E01020886,429,339,163,70,1001
E01020887,661,556,194,153,1564
E01020888,784,554,170,93,1601
E01020889,469,607,164,44,1284
E01020890,484,560,255,158,1457
E01020891,466,596,175,167,1404
E01020892,284,382,99,146,911
E01020893,547,495,179,130,1351
E01020894,272,254,135,279,940
E01020895,414,301,188,283,1186
E01020896,387,528,108,114,1137
E01020897,878,379,275,367,1899
E01020898,293,171,109,629,1202
E01020899,433,404,139,152,1128
E01020900,533,359,69,166,1127
E01020901,327,297,145,316,1085
E01020902,280,217,109,538,1144
E01020903,434,336,128,50,948
E01020904,645,467,227,72,1411
E01020905,442,484,149,203,1278
E01020906,517,631,174,61,1383
E01020907,474,322,170,326,1292
E01020908,512,238,67,302,1119
E01020909,207,169,123,713,1212
E01020910,348,209,649,199,1405
E01020911,282,199,1145,85,1711
E01020912,248,120,1187,214,1769
E01020913,524,436,337,374,1671
E01020914,625,318,520,81,1544
E01020915,410,417,432,118,1377
E01020916,414,280,639,40,1373
E01020917,334,131,131,504,1100
E01020918,534,304,200,170,1208
E01020919,457,293,205,223,1178
E01020920,284,198,262,451,1195
E01020921,445,355,98,260,1158
E01020922,367,214,231,311,1123
E01020923,266,96,162,534,1058
E01020924,524,296,100,215,1135
E01020925,379,175,155,464,1173
E01020926,594,432,72,223,1321
E01020927,495,237,157,252,1141
E01020928,462,541,207,139,1349
E01020929,352,279,165,461,1257
E01020930,423,92,81,500,1096
E01020931,284,650,291,57,1282
E01020932,189,800,202,64,1255
E01020933,225,426,111,19,781
E01020934,204,532,357,12,1105
E01020935,300,338,961,65,1664
E01020936,186,745,602,17,1550
E01020937,207,264,618,51,1140
E01020938,551,343,154,174,1222
E01020939,588,408,204,25,1225
E01020940,477,570,121,43,1211
E01020941,405,279,103,477,1264
E01020942,628,496,83,39,1246
E01020943,505,390,293,103,1291
E01020944,496,587,101,56,1240
E01020945,629,791,123,35,1578
E01020946,533,750,126,34,1443
E01020947,482,431,110,228,1251
E01020948,317,604,253,104,1278
E01020949,517,579,127,102,1325
E01020950,435,724,94,148,1401
E01020951,546,283,199,182,1210
E01020952,569,325,241,256,1391
E01020953,688,395,99,18,1200
E01020954,678,477,145,57,1357
E01020955,394,307,160,341,1202
E01020956,438,836,97,51,1422
E01020957,465,409,138,193,1205
E01020959,535,357,148,104,1144
E01020960,751,557,684,37,2029
E01020961,421,718,100,9,1248
E01020962,557,656,421,73,1707
E01020963,615,361,265,26,1267
E01020964,398,536,389,76,1399
E01020965,380,316,840,48,1584
E01020966,373,432,435,102,1342
E01020967,374,624,310,226,1534
E01020968,272,371,714,48,1405
E01020969,545,522,88,100,1255
E01020970,1223,704,189,22,2138
E01020971,723,384,195,320,1622
E01020972,186,89,109,741,1125
E01020973,548,409,156,246,1359
E01020974,477,584,92,58,1211
E01020975,531,318,409,167,1425
E01020976,572,546,452,22,1592
E01020977,405,215,535,74,1229
E01020978,248,257,1044,84,1633
E01020979,211,218,983,171,1583
E01020980,317,179,652,138,1286
E01020981,462,314,428,49,1253
E01020982,187,113,950,167,1417
E01020983,110,145,709,440,1404
E01020984,258,287,1082,75,1702
E01020985,280,317,868,77,1542
E01020986,495,544,121,8,1168
E01020987,728,296,341,34,1399
E01020988,591,758,81,15,1445
E01020989,268,187,774,130,1359
E01020990,375,235,581,55,1246
E01020991,355,313,411,12,1091
E01020992,346,259,694,174,1473
E01020993,265,136,117,536,1054
E01020994,309,156,166,477,1108
E01020995,303,152,123,519,1097
E01020996,540,278,111,393,1322
E01020997,544,327,157,185,1213
E01020998,421,312,655,52,1440
E01020999,582,559,198,21,1360
E01021000,558,339,217,49,1163
E01021001,453,318,179,15,965
E01021002,406,409,234,105,1154
E01021003,315,429,516,173,1433
E01021004,590,555,211,71,1427
E01021005,319,208,122,580,1229
E01021006,534,398,453,69,1454
E01021007,501,705,67,6,1279
E01021008,447,471,170,253,1341
E01021009,655,808,101,14,1578
E01021010,634,500,145,15,1294
E01021011,529,306,308,70,1213
E01021012,476,333,300,244,1353
E01021013,642,376,308,61,1387
E01021014,441,300,509,157,1407
E01021015,182,93,191,668,1134
E01021016,427,368,390,114,1299
E01021017,706,346,203,53,1308
E01021018,842,478,158,94,1572
E01021019,360,179,151,651,1341
E01021020,523,324,118,426,1391
E01021021,631,480,339,82,1532
E01021022,606,561,234,251,1652
E01021023,745,594,127,110,1576
E01021024,417,260,70,221,968
E01021025,641,548,151,74,1414
E01021026,594,929,198,137,1858
E01021027,617,543,111,4,1275
E01021028,744,340,136,59,1279
E01021029,661,468,108,15,1252
E01021030,423,454,124,11,1012
E01021031,498,351,243,143,1235
E01021032,545,749,287,99,1680
E01021033,529,468,202,230,1429
E01021034,457,249,151,202,1059
E01021035,420,429,482,160,1491
E01021036,463,432,108,160,1163
E01021037,382,196,94,554,1226
E01021038,427,496,341,152,1416
E01021039,354,462,218,89,1123
E01021040,382,465,207,98,1152
E01021041,469,540,69,158,1236
E01021042,461,412,82,81,1036
E01021043,480,336,102,264,1182
E01021044,582,236,169,417,1404
E01021045,519,678,188,139,1524
E01021046,608,448,127,15,1198
E01021047,482,448,164,87,1181
E01021048,441,369,434,50,1294
E01021049,416,191,441,101,1149
E01021050,485,209,99,250,1043
E01021051,493,274,138,84,989
E01021052,505,446,63,13,1027
E01021053,339,328,115,180,962
E01021054,374,363,340,140,1217
E01021055,454,591,148,237,1430
E01021056,485,711,154,27,1377
E01021057,311,234,392,314,1251
E01021058,646,543,268,36,1493
E01021059,512,527,181,84,1304
E01021060,508,457,107,266,1338
E01021061,693,372,166,16,1247
E01021062,413,281,129,331,1154
E01021063,673,573,109,39,1394
E01021064,508,613,277,22,1420
E01021065,354,256,272,132,1014
E01021066,557,542,133,64,1296
E01021067,400,371,96,80,947
E01021068,319,354,158,38,869
E01021069,458,652,161,11,1282
E01021070,439,453,359,62,1313
E01021071,333,449,638,72,1492
E01021072,378,927,57,21,1383
E01021073,483,626,86,34,1229
E01021074,509,543,77,244,1373
E01021075,621,657,95,72,1445
E01021076,593,405,122,382,1502
E01021077,465,624,79,75,1243
E01021078,349,648,82,19,1098
E01021079,379,470,261,169,1279
E01021080,504,439,125,88,1156
E01021081,458,674,187,31,1350
E01021082,494,792,134,17,1437
E01021083,471,646,53,11,1181
E01021084,408,479,311,300,1498
E01021085,585,547,184,49,1365
E01021086,505,626,98,138,1367
E01021087,515,694,135,33,1377
E01021088,434,686,115,89,1324
E01021089,481,493,92,193,1259
E01021090,405,271,614,23,1313
E01021091,383,491,724,20,1618
E01021092,317,577,626,190,1710
E01021093,451,776,68,16,1311
E01021094,376,778,169,66,1389
E01021095,354,769,47,5,1175
E01021096,344,383,216,61,1004
E01021097,478,455,77,70,1080
E01021098,517,537,149,171,1374
E01021099,499,641,166,26,1332
E01021100,639,475,164,117,1395
E01021101,475,663,149,199,1486
E01021102,420,551,245,139,1355
E01021103,368,545,211,134,1258
E01021104,426,510,110,84,1130
E01021105,293,447,109,155,1004
E01021106,323,941,158,85,1507
E01021107,381,876,85,29,1371
E01021108,483,482,144,79,1188
E01021109,497,702,101,70,1370
E01021110,599,1241,147,58,2045
E01021111,236,325,111,137,809
E01021112,429,580,136,33,1178
E01021113,484,319,169,121,1093
E01021114,385,524,117,257,1283
E01021115,488,697,141,38,1364
E01021116,409,496,133,219,1257
E01021117,375,596,268,121,1360
E01021118,447,563,247,85,1342
E01021119,195,166,56,454,871
E01021120,245,705,170,31,1151
E01021121,400,581,347,44,1372
E01021122,275,450,441,32,1198
E01021123,424,840,79,13,1356
E01021124,449,910,127,12,1498
E01021125,354,620,70,13,1057
E01021126,433,428,215,47,1123
E01021127,404,476,148,253,1281
E01021128,589,697,202,59,1547
E01021129,598,812,111,25,1546
E01021130,468,557,151,40,1216
E01021131,484,274,193,299,1250
E01021132,411,439,61,62,973
E01021133,483,447,183,208,1321
E01021134,570,386,126,101,1183
E01021135,397,222,308,377,1304
E01021136,204,169,82,520,975
E01021137,436,292,107,320,1155
E01021138,328,443,55,78,904
E01021139,380,301,85,235,1001
E01021140,684,543,145,31,1403
E01021141,562,458,113,64,1197
E01021142,175,758,96,6,1035
E01021143,290,461,165,86,1002
E01021144,674,639,101,15,1429
E01021145,629,678,162,147,1616
E01021146,531,588,108,191,1418
E01021147,568,549,181,48,1346
E01021148,543,422,145,96,1206
E01021149,419,402,111,93,1025
E01021150,440,420,68,12,940
E01021151,770,466,103,69,1408
E01021152,357,207,88,342,994
E01021153,738,445,280,114,1577
E01021154,503,322,96,254,1175
E01021155,510,252,121,43,926
E01021156,600,524,186,110,1420
E01021157,647,689,135,37,1508
E01021158,862,642,106,107,1717
E01021159,811,957,114,45,1927
E01021160,464,533,212,80,1289
E01021161,658,472,133,14,1277
E01021162,589,610,107,8,1314
E01021163,712,814,164,10,1700
E01021164,568,536,212,110,1426
E01021165,405,375,130,54,964
E01021166,593,1046,268,51,1958
E01021167,649,566,306,232,1753
E01021168,512,541,283,29,1365
E01021169,440,394,188,22,1044
E01021170,956,970,236,85,2247
E01021171,677,636,199,112,1624
E01021172,562,563,161,128,1414
E01021173,472,412,201,28,1113
E01021174,689,465,139,22,1315
E01021175,527,546,110,12,1195
E01021176,495,549,149,5,1198
E01021177,341,283,218,103,945
E01021178,238,340,101,364,1043
E01021179,335,235,104,472,1146
E01021180,510,406,81,28,1025
E01021181,493,432,99,17,1041
E01021182,537,542,103,122,1304
E01021183,302,138,99,442,981
E01021184,500,563,108,40,1211
E01021185,410,284,128,306,1128
E01021186,386,400,128,76,990
E01021187,417,574,147,41,1179
E01021188,343,469,114,19,945
E01021189,510,453,90,35,1088
E01021190,571,572,109,26,1278
E01021191,442,616,338,27,1423
E01021192,655,486,133,22,1296
E01021193,588,309,175,319,1391
E01021194,650,407,153,8,1218
E01021195,694,663,142,32,1531
E01021196,767,650,147,29,1593
E01021197,727,530,139,41,1437
E01021198,531,408,135,136,1210
E01021199,369,618,111,21,1119
E01021200,344,295,125,154,918
E01021201,516,566,110,14,1206
E01021202,273,360,198,58,889
E01021203,523,575,93,43,1234
E01021204,411,389,83,82,965
E01021205,384,500,100,32,1016
E01021206,491,481,145,108,1225
E01021207,496,539,123,11,1169
E01021208,721,484,226,62,1493
E01021209,533,642,97,75,1347
E01021210,779,322,73,12,1186
E01021211,408,687,258,7,1360
E01021212,661,757,130,38,1586
E01021213,608,400,302,89,1399
E01021214,435,691,174,37,1337
E01021215,368,519,117,94,1098
E01021216,365,402,73,117,957
E01021217,459,417,90,92,1058
E01021218,433,438,67,15,953
E01021219,574,491,47,2,1114
E01021220,410,566,252,148,1376
E01021221,478,260,179,107,1024
E01021222,557,308,215,146,1226
E01021223,461,297,113,53,924
E01021224,433,254,80,408,1175
E01021225,606,461,165,22,1254
E01021226,614,238,137,57,1046
E01021227,735,373,116,56,1280
E01021228,770,344,68,14,1196
E01021229,551,566,191,31,1339
E01021230,590,596,160,23,1369
E01021231,479,477,154,292,1402
E01021232,498,720,201,10,1429
E01021233,551,577,69,8,1205
E01021234,523,629,82,11,1245
E01021235,478,642,67,7,1194
E01021236,499,607,90,92,1288
E01021237,506,545,36,9,1096
E01021238,576,472,51,14,1113
E01021239,556,540,33,16,1145
E01021240,513,373,229,231,1346
E01021241,558,320,109,248,1235
E01021242,531,423,52,4,1010
E01021243,777,474,97,19,1367
E01021244,453,590,132,7,1182
E01021245,389,205,100,427,1121
E01021246,595,513,91,21,1220
E01021247,478,562,107,81,1228
E01021248,594,396,143,18,1151
E01021249,583,549,90,16,1238
E01021250,629,537,68,14,1248
E01021251,670,527,60,8,1265
E01021252,646,369,130,23,1168
E01021253,593,691,77,9,1370
E01021254,545,557,77,17,1196
E01021255,454,584,63,72,1173
E01021256,526,627,39,20,1212
E01021257,584,572,78,15,1249
E01021258,505,454,90,289,1338
E01021259,634,432,94,89,1249
E01021260,740,937,139,6,1822
E01021261,681,381,162,123,1347
E01021262,549,248,170,321,1288
E01021263,730,312,227,162,1431
E01021264,616,507,23,35,1181
E01021265,525,327,105,283,1240
E01021266,531,354,128,309,1322
E01021267,533,332,130,382,1377
E01021268,314,189,82,486,1071
E01021269,600,317,92,275,1284
E01021270,517,206,118,319,1160
E01021271,372,116,176,602,1266
E01021272,512,264,145,303,1224
E01021273,444,324,107,499,1374
E01021274,598,360,168,340,1466
E01021275,592,565,78,164,1399
E01021276,435,287,129,358,1209
E01021277,458,378,104,225,1165
E01021278,480,146,116,581,1323
E01021279,412,209,97,511,1229
E01021280,719,222,150,85,1176
E01021281,582,469,127,43,1221
E01021282,569,611,58,42,1280
E01021283,516,231,114,405,1266
E01021284,769,275,101,24,1169
E01021285,656,269,105,31,1061
E01021286,492,168,246,423,1329
E01021287,596,343,86,165,1190
E01021288,151,76,90,776,1093
E01021289,428,196,139,600,1363
E01021290,153,58,85,945,1241
E01021291,428,309,229,369,1335
E01021292,466,347,102,290,1205
E01021293,529,319,168,324,1340
E01021294,646,442,87,156,1331
E01021295,550,339,162,274,1325
E01021296,525,350,202,329,1406
E01021297,506,275,223,301,1305
E01021298,550,366,127,230,1273
E01021299,578,649,44,41,1312
E01021300,666,273,188,499,1626
E01021301,435,138,130,436,1139
E01021302,238,64,100,663,1065
E01021303,541,154,119,266,1080
E01021304,375,139,111,497,1122
E01021305,364,231,120,452,1167
E01021306,446,196,134,394,1170
E01021307,496,144,169,246,1055
E01021308,773,138,105,17,1033
E01021309,611,182,206,68,1067
E01021310,505,332,293,49,1179
E01021311,403,242,115,349,1109
E01021312,630,483,114,17,1244
E01021313,631,496,83,53,1263
E01021314,367,132,89,462,1050
E01021315,380,205,77,532,1194
E01021316,334,221,119,535,1209
E01021317,455,215,149,425,1244
E01021318,429,341,320,546,1636
E01021319,455,258,188,384,1285
E01021320,490,253,169,339,1251
E01021321,507,261,117,354,1239
E01021322,416,210,158,392,1176
E01021323,322,132,119,693,1266
E01021324,293,142,61,726,1222
E01021325,288,119,150,562,1119
E01021326,600,254,180,363,1397
E01021327,401,177,118,643,1339
E01021328,537,260,147,286,1230
E01021329,476,488,142,130,1236
E01021330,637,587,99,9,1332
E01021331,662,407,147,52,1268
E01021332,551,602,42,8,1203
E01021333,636,641,50,5,1332
E01021334,536,583,151,67,1337
E01021335,707,339,43,45,1134
E01021336,611,522,150,87,1370
E01021337,558,581,64,4,1207
E01021338,524,374,89,182,1169
E01021339,373,289,118,324,1104
E01021340,681,490,121,23,1315
E01021341,704,500,76,13,1293
E01021342,547,290,113,328,1278
E01021343,750,178,194,181,1303
E01021344,1032,380,200,69,1681
E01021345,1051,258,133,13,1455
E01021346,892,440,219,19,1570
E01021347,1028,544,162,118,1852
E01021348,405,403,334,155,1297
E01021349,722,270,107,22,1121
E01021350,624,534,165,55,1378
E01021351,831,274,87,8,1200
E01021352,708,382,117,36,1243
E01021353,648,402,249,170,1469
E01021354,317,210,84,388,999
E01021355,665,424,220,198,1507
E01021356,451,436,75,149,1111
E01021357,516,335,135,241,1227
E01021358,556,276,271,547,1650
E01021359,535,314,113,636,1598
E01021360,546,318,100,539,1503
E01021361,635,400,123,128,1286
E01021362,573,414,94,113,1194
E01021364,717,408,151,41,1317
E01021365,622,424,553,278,1877
E01021366,594,567,80,18,1259
E01021367,400,223,74,459,1156
E01021368,514,311,192,221,1238
E01021369,1043,316,329,403,2091
E01021370,393,143,153,532,1221
E01021371,661,441,163,86,1351
E01021372,755,372,199,129,1455
E01021373,916,472,334,200,1922
E01021374,443,197,80,465,1185
E01021375,396,334,85,112,927
E01021376,581,419,92,64,1156
E01021377,573,481,179,148,1381
E01021378,432,384,177,347,1340
E01021379,691,565,122,70,1448
E01021380,738,623,187,327,1875
E01021381,365,522,52,48,987
E01021382,435,398,153,65,1051
E01021383,871,414,126,116,1527
E01021384,1044,467,164,46,1721
E01021385,548,179,120,121,968
E01021386,717,413,57,30,1217
E01021387,616,406,415,206,1643
E01021388,502,358,171,284,1315
E01021389,693,472,102,117,1384
E01021390,578,482,141,49,1250
E01021391,350,243,96,559,1248
E01021392,563,378,173,206,1320
E01021393,507,358,127,201,1193
E01021394,452,354,147,254,1207
E01021395,445,525,54,173,1197
E01021396,447,481,171,52,1151
E01021397,624,452,291,50,1417
E01021398,481,530,151,104,1266
E01021399,514,457,96,253,1320
E01021400,567,479,152,183,1381
E01021401,363,404,147,297,1211
E01021402,775,479,226,117,1597
E01021403,621,478,119,32,1250
E01021404,711,700,160,185,1756
E01021405,890,668,171,114,1843
E01021406,668,747,277,140,1832
E01021407,623,818,187,137,1765
E01021408,558,633,130,79,1400
E01021409,747,445,158,71,1421
E01021410,427,301,188,354,1270
E01021411,428,325,124,147,1024
E01021412,432,331,277,124,1164
E01021413,464,398,117,83,1062
E01021414,776,677,151,198,1802
E01021415,343,371,175,305,1194
E01021416,483,449,344,56,1332
E01021417,458,321,142,308,1229
E01021418,437,150,132,377,1096
E01021419,627,382,94,252,1355
E01021420,598,346,179,241,1364
E01021422,460,373,153,382,1368
E01021423,462,183,151,348,1144
E01021424,855,407,185,139,1586
E01021425,501,153,121,371,1146
E01021426,462,277,67,248,1054
E01021427,475,123,126,349,1073
E01021428,542,572,85,35,1234
E01021429,511,200,89,250,1050
E01021430,759,502,153,282,1696
E01021431,591,423,153,43,1210
E01021432,527,270,92,412,1301
E01021433,638,480,396,90,1604
E01021434,453,272,109,122,956
E01021435,587,479,97,321,1484
E01021436,671,424,558,159,1812
E01021437,495,183,145,504,1327
E01021438,844,631,138,7,1620
E01021439,795,333,471,325,1924
E01021441,572,480,43,140,1235
E01021442,569,510,23,7,1109
E01021443,499,450,112,89,1150
E01021444,572,545,70,144,1331
E01021445,814,747,133,45,1739
E01021446,504,652,124,26,1306
E01021447,854,983,129,29,1995
E01021448,415,341,84,313,1153
E01021449,551,361,106,227,1245
E01021450,886,683,72,31,1672
E01021451,384,203,113,456,1156
E01021452,526,592,74,32,1224
E01021453,396,424,117,44,981
E01021454,508,374,116,24,1022
E01021455,388,691,37,0,1116
E01021456,481,412,110,14,1017
E01021457,394,452,108,231,1185
E01021458,417,623,251,76,1367
E01021459,439,589,61,10,1099
E01021460,508,481,160,182,1331
E01021461,387,262,75,436,1160
E01021462,557,495,73,31,1156
E01021463,518,547,86,143,1294
E01021464,509,418,102,201,1230
E01021465,584,657,258,18,1517
E01021466,571,791,82,2,1446
E01021467,713,599,60,7,1379
E01021468,718,587,190,39,1534
E01021469,409,427,51,62,949
E01021470,366,348,30,133,877
E01021471,616,617,30,48,1311
E01021472,440,263,240,256,1199
E01021473,422,416,127,63,1028
E01021474,638,534,72,25,1269
E01021475,556,295,278,55,1184
E01021476,833,531,107,107,1578
E01021477,614,613,68,2,1297
E01021478,678,641,97,7,1423
E01021479,613,498,102,22,1235
E01021480,738,556,182,6,1482
E01021481,664,488,69,9,1230
E01021482,583,514,138,36,1271
E01021483,658,675,103,4,1440
E01021484,448,529,153,42,1172
E01021485,384,254,100,262,1000
E01021486,387,180,162,177,906
E01021487,568,490,75,27,1160
E01021488,418,356,118,270,1162
E01021489,594,502,107,5,1208
E01021490,557,445,138,118,1258
E01021491,672,537,120,34,1363
E01021492,619,598,182,33,1432
E01021493,577,559,134,56,1326
E01021494,671,388,111,62,1232
E01021495,391,1321,142,5,1859
E01021496,497,466,154,45,1162
E01021497,591,494,156,16,1257
E01021498,639,499,122,5,1265
E01021499,683,627,82,34,1426
E01021500,628,427,263,76,1394
E01021501,540,504,119,46,1209
E01021502,777,569,448,16,1810
E01021503,546,318,129,114,1107
E01021504,768,307,71,52,1198
E01021505,680,351,61,54,1146
E01021506,558,267,180,33,1038
E01021507,442,186,167,432,1227
E01021508,546,221,130,98,995
E01021509,502,539,79,61,1181
E01021510,477,662,94,10,1243
E01021511,488,498,78,19,1083
E01021512,592,577,120,12,1301
E01021513,655,581,98,32,1366
E01021514,648,433,87,65,1233
E01021515,561,445,43,24,1073
E01021516,527,515,85,5,1132
E01021517,563,687,115,16,1381
E01021518,566,553,390,109,1618
E01021519,481,695,84,23,1283
E01021520,547,533,175,21,1276
E01021521,599,499,83,7,1188
E01021522,648,398,192,108,1346
E01021523,520,587,58,21,1186
E01021524,632,554,77,33,1296
E01021525,597,407,227,23,1254
E01021526,662,578,92,10,1342
E01021527,663,658,65,7,1393
E01021528,593,576,64,10,1243
E01021529,498,310,123,294,1225
E01021530,512,590,83,18,1203
E01021531,567,416,132,27,1142
E01021532,561,646,51,5,1263
E01021533,978,655,122,84,1839
E01021535,653,497,119,150,1419
E01021536,519,279,154,356,1308
E01021537,737,601,127,63,1528
E01021538,1040,572,220,237,2069
E01021539,428,347,107,165,1047
E01021540,530,517,156,74,1277
E01021541,426,380,94,300,1200
E01021542,626,521,206,242,1595
E01021543,678,509,93,24,1304
E01021544,605,243,198,15,1061
E01021545,805,295,92,30,1222
E01021546,616,189,157,198,1160
E01021547,715,241,225,108,1289
E01021548,574,331,117,71,1093
E01021550,452,456,176,74,1158
E01021551,384,478,132,126,1120
E01021552,481,560,73,193,1307
E01021553,506,403,64,153,1126
E01021554,408,378,88,283,1157
E01021555,473,493,88,60,1114
E01021556,616,455,152,89,1312
E01021557,543,425,43,10,1021
E01021558,532,459,43,17,1051
E01021559,582,551,63,43,1239
E01021560,518,623,177,71,1389
E01021561,657,680,101,29,1467
E01021562,528,388,123,399,1438
E01021563,470,249,223,428,1370
E01021564,517,585,93,64,1259
E01021565,346,174,61,653,1234
E01021566,660,510,79,140,1389
E01021568,478,673,91,57,1299
E01021569,597,619,75,25,1316
E01021570,570,819,112,66,1567
E01021571,589,489,91,96,1265
E01021572,463,323,85,341,1212
E01021573,576,385,226,191,1378
E01021574,467,211,983,119,1780
E01021575,461,234,309,294,1298
E01021576,247,76,112,722,1157
E01021577,597,408,144,18,1167
E01021578,564,280,489,93,1426
E01021579,585,352,210,29,1176
E01021580,604,395,67,21,1087
E01021582,587,345,569,111,1612
E01021583,633,363,114,107,1217
E01021584,456,523,20,10,1009
E01021585,571,411,51,10,1043
E01021586,569,561,98,28,1256
E01021587,500,602,90,36,1228
E01021588,306,303,106,420,1135
E01021589,433,286,232,246,1197
E01021590,599,479,102,17,1197
E01021591,563,500,163,24,1250
E01021592,273,162,130,637,1202
E01021593,572,650,68,29,1319
E01021594,521,592,147,120,1380
E01021595,629,689,102,31,1451
E01021596,343,157,102,598,1200
E01021597,471,306,122,250,1149
E01021598,425,347,84,322,1178
E01021599,722,502,152,95,1471
E01021600,455,410,63,56,984
E01021601,414,240,127,439,1220
E01021602,509,508,170,230,1417
E01021604,895,707,108,72,1782
E01021605,613,346,72,6,1037
E01021606,783,335,47,145,1310
E01021607,722,213,162,105,1202
E01021608,465,195,193,81,934
E01021609,656,413,61,7,1137
E01021610,569,298,194,20,1081
E01021611,706,362,92,14,1174
E01021612,658,511,61,10,1240
E01021613,751,401,286,61,1499
E01021614,793,493,113,28,1427
E01021615,633,436,104,20,1193
E01021616,696,421,48,17,1182
E01021617,572,260,59,234,1125
E01021618,670,309,145,45,1169
E01021619,727,333,106,54,1220
E01021620,587,320,210,16,1133
E01021621,765,231,175,21,1192
E01021622,484,627,100,43,1254
E01021623,523,370,116,9,1018
E01021624,453,532,53,2,1040
E01021625,530,548,90,29,1197
E01021626,580,438,132,6,1156
E01021627,392,329,257,113,1091
E01021628,583,356,226,161,1326
E01021629,532,276,243,267,1318
E01021631,439,242,167,611,1459
E01021632,425,681,49,75,1230
E01021633,350,436,122,31,939
E01021634,518,568,147,33,1266
E01021635,423,546,105,119,1193
E01021636,248,255,57,368,928
E01021637,402,308,90,153,953
E01021638,381,198,100,300,979
E01021639,598,218,295,248,1359
E01021640,466,242,100,148,956
E01021641,454,329,133,218,1134
E01021642,661,256,333,324,1574
E01021643,994,739,169,35,1937
E01021644,529,502,191,128,1350
E01021645,545,565,72,44,1226
E01021646,439,376,757,129,1701
E01021647,552,526,331,71,1480
E01021648,619,434,721,184,1958
E01021649,314,202,723,354,1593
E01021650,480,245,819,83,1627
E01021651,518,280,388,68,1254
E01021652,447,491,214,52,1204
E01021653,555,373,98,7,1033
E01021654,761,484,153,66,1464
E01021655,439,541,84,50,1114
E01021656,448,608,104,145,1305
E01021657,588,386,204,108,1286
E01021658,385,209,67,181,842
E01021659,742,640,149,143,1674
E01021660,463,482,131,101,1177
E01021661,711,489,107,66,1373
E01021662,537,578,103,65,1283
E01021663,398,390,69,55,912
E01021664,602,439,397,186,1624
E01021665,316,167,139,467,1089
E01021666,521,252,260,81,1114
E01021667,375,301,135,316,1127
E01021668,621,178,427,90,1316
E01021669,464,105,279,323,1171
E01021670,427,282,194,261,1164
E01021671,498,472,108,82,1160
E01021673,409,665,105,1,1180
E01021674,476,190,114,258,1038
E01021675,481,394,118,43,1036
E01021676,374,562,162,74,1172
E01021677,527,403,59,27,1016
E01021678,462,348,177,85,1072
E01021679,807,343,563,120,1833
E01021680,991,436,461,213,2101
E01021681,939,513,600,105,2157
E01021682,977,453,497,169,2096
E01021683,240,137,385,112,874
E01021684,557,246,285,128,1216
E01021685,396,107,623,398,1524
E01021686,361,148,670,337,1516
E01021687,501,229,508,78,1316
E01021688,467,273,322,52,1114
E01021689,468,451,106,171,1196
E01021690,543,377,92,33,1045
E01021691,453,615,76,100,1244
E01021692,556,601,81,8,1246
E01021693,459,769,118,35,1381
E01021694,523,503,92,70,1188
E01021695,429,401,49,40,919
E01021696,216,144,244,642,1246
E01021697,372,227,259,480,1338
E01021698,287,175,305,273,1040
E01021699,241,186,340,453,1220
E01021700,165,77,364,534,1140
E01021702,416,400,220,64,1100
E01021703,300,98,84,438,920
E01021704,472,279,200,231,1182
E01021705,840,543,152,148,1683
E01021706,359,218,363,112,1052
E01021707,426,441,98,166,1131
E01021708,506,545,73,96,1220
E01021709,457,683,72,19,1231
E01021710,701,782,111,33,1627
E01021711,320,207,86,393,1006
E01021713,314,300,66,296,976
E01021714,544,166,438,149,1297
E01021715,515,251,134,240,1140
E01021717,529,339,405,106,1379
E01021718,652,371,183,26,1232
E01021719,546,546,130,55,1277
E01021720,443,353,134,288,1218
E01021721,777,619,135,61,1592
E01021722,571,457,124,195,1347
E01021723,540,638,138,78,1394
E01021724,588,638,146,26,1398
E01021725,461,498,142,12,1113
E01021726,452,368,114,304,1238
E01021727,571,567,95,10,1243
E01021728,631,634,56,22,1343
E01021729,591,452,152,162,1357
E01021730,581,536,88,169,1374
E01021731,415,661,120,19,1215
E01021732,501,374,165,200,1240
E01021733,467,659,84,47,1257
E01021734,437,637,107,23,1204
E01021735,354,700,118,14,1186
E01021736,335,322,341,55,1053
E01021737,377,394,228,31,1030
E01021738,649,647,423,32,1751
E01021739,506,598,184,16,1304
E01021740,498,575,221,147,1441
E01021741,769,605,145,121,1640
E01021742,503,287,59,195,1044
E01021743,530,376,224,224,1354
E01021744,595,426,155,82,1258
E01021745,588,440,176,38,1242
E01021746,619,547,254,31,1451
E01021747,587,582,133,29,1331
E01021748,593,471,286,43,1393
E01021749,792,787,183,100,1862
E01021750,407,425,180,36,1048
E01021751,561,485,61,13,1120
E01021752,649,351,149,65,1214
E01021753,447,325,184,207,1163
E01021754,541,639,76,17,1273
E01021755,383,464,72,18,937
E01021756,541,469,113,95,1218
E01021757,463,616,292,27,1398
E01021758,351,320,282,363,1316
E01021759,509,340,111,211,1171
E01021760,511,475,128,153,1267
E01021761,624,429,167,207,1427
E01021762,362,348,96,325,1131
E01021763,593,403,60,159,1215
E01021764,319,180,174,582,1255
E01021765,605,479,204,34,1322
E01021766,581,471,102,26,1180
E01021767,662,555,122,44,1383
E01021768,783,584,173,193,1733
E01021769,752,599,203,265,1819
E01021770,615,611,151,278,1655
E01021771,374,205,113,491,1183
E01021772,463,447,101,208,1219
E01021773,565,252,160,225,1202
E01021774,421,219,157,312,1109
E01021775,428,227,95,377,1127
E01021776,351,190,172,456,1169
E01021777,503,270,83,257,1113
E01021778,531,255,128,254,1168
E01021779,480,198,194,348,1220
E01021780,591,451,91,12,1145
E01021781,575,478,140,22,1215
E01021782,505,478,179,19,1181
E01021783,630,464,95,74,1263
E01021784,623,445,132,27,1227
E01021785,511,298,111,330,1250
E01021786,459,382,147,5,993
E01021787,671,483,124,9,1287
E01021788,553,559,119,58,1289
E01021789,594,564,51,24,1233
E01021790,537,229,89,252,1107
E01021791,550,419,278,16,1263
E01021792,470,500,40,19,1029
E01021793,619,628,45,19,1311
E01021794,405,324,64,165,958
E01021795,812,429,402,36,1679
E01021796,719,697,173,155,1744
E01021797,541,392,82,77,1092
E01021798,533,515,60,161,1269
E01021799,552,277,110,347,1286
E01021800,760,723,246,108,1837
E01021801,840,733,89,166,1828
E01021802,683,390,118,545,1736
E01021803,477,384,44,188,1093
E01021804,474,463,157,39,1133
E01021805,516,471,18,16,1021
E01021806,625,954,200,30,1809
E01021807,579,409,94,88,1170
E01021808,469,281,69,352,1171
E01021809,523,345,71,222,1161
E01021810,764,243,280,112,1399
E01021811,422,220,75,382,1099
E01021812,380,564,75,49,1068
E01021813,532,478,98,70,1178
E01021814,497,367,71,246,1181
E01021815,536,273,58,338,1205
E01021816,299,190,63,486,1038
E01021817,873,394,192,475,1934
E01021818,513,321,375,251,1460
E01021819,426,312,76,418,1232
E01021820,444,285,76,386,1191
E01021821,338,179,96,475,1088
E01021822,465,256,109,372,1202
E01021823,418,218,128,552,1316
E01021824,834,282,119,6,1241
E01021825,771,225,188,7,1191
E01021826,734,289,93,114,1230
E01021827,708,258,184,117,1267
E01021828,1217,262,165,12,1656
E01021829,526,231,94,332,1183
E01021830,404,426,78,94,1002
E01021831,392,280,139,341,1152
E01021832,593,297,61,60,1011
E01021833,392,257,100,263,1012
E01021834,417,245,102,420,1184
E01021835,456,285,60,361,1162
E01021836,351,175,110,491,1127
E01021837,467,306,70,335,1178
E01021838,546,354,62,269,1231
E01021839,411,297,179,345,1232
E01021840,410,174,139,433,1156
E01021841,371,252,91,356,1070
E01021842,350,161,223,451,1185
E01021843,625,230,286,518,1659
E01021844,410,233,75,376,1094
E01021845,298,188,142,501,1129
E01021846,328,159,145,425,1057
E01021847,411,219,92,400,1122
E01021848,435,262,175,404,1276
E01021849,498,260,121,422,1301
E01021850,353,137,148,488,1126
E01021851,317,141,287,443,1188
E01021852,422,219,107,453,1201
E01021853,379,250,159,329,1117
E01021854,546,363,152,316,1377
E01021855,406,283,122,299,1110
E01021856,488,319,122,250,1179
E01021857,931,437,288,359,2015
E01021858,391,207,120,465,1183
E01021859,417,137,152,417,1123
E01021860,424,215,146,373,1158
E01021861,389,201,46,367,1003
E01021862,450,196,146,335,1127
E01021863,463,257,143,363,1226
E01021864,377,191,145,391,1104
E01021865,506,197,91,269,1063
E01021866,552,123,137,268,1080
E01021867,642,394,75,88,1199
E01021868,519,280,121,360,1280
E01021869,438,335,106,215,1094
E01021870,423,232,108,297,1060
E01021871,353,196,117,437,1103
E01021872,286,134,429,573,1422
E01021873,619,443,62,7,1131
E01021874,515,315,90,174,1094
E01021875,457,631,98,19,1205
E01021878,482,511,116,95,1204
E01021879,479,410,129,104,1122
E01021880,371,457,242,185,1255
E01021881,416,394,153,10,973
E01021882,642,837,148,64,1691
E01021883,614,462,116,114,1306
E01021884,649,299,154,52,1154
E01021885,452,405,68,17,942
E01021886,628,433,70,80,1211
E01021887,961,474,115,114,1664
E01021888,542,366,146,415,1469
E01021889,551,391,245,537,1724
E01021890,428,517,385,158,1488
E01021891,386,626,176,62,1250
E01021892,256,275,87,226,844
E01021893,658,485,40,12,1195
E01021894,393,302,55,205,955
E01021895,469,357,100,56,982
E01021896,561,451,59,13,1084
E01021897,460,367,75,69,971
E01021898,390,493,42,160,1085
E01021899,652,375,57,20,1104
E01021900,509,239,85,41,874
E01021901,779,605,117,61,1562
E01021902,748,594,98,42,1482
E01021903,552,580,82,118,1332
E01021904,622,347,88,72,1129
E01021905,441,329,90,149,1009
E01021906,535,358,183,121,1197
E01021907,794,632,235,149,1810
E01021908,734,710,150,52,1646
E01021909,476,410,85,119,1090
E01021910,488,452,119,163,1222
E01021911,474,431,60,45,1010
E01021912,577,904,101,90,1672
E01021913,507,566,97,69,1239
E01021914,869,695,119,18,1701
E01021915,413,324,169,133,1039
E01021916,388,309,49,81,827
E01021917,703,530,163,65,1461
E01021918,680,447,68,5,1200
E01021919,555,481,28,22,1086
E01021920,912,462,115,86,1575
E01021921,526,316,230,146,1218
E01021922,506,375,92,294,1267
E01021923,574,417,65,49,1105
E01021924,594,364,87,6,1051
E01021925,664,520,148,14,1346
E01021926,876,448,200,88,1612
E01021927,560,479,59,7,1105
E01021928,618,534,108,58,1318
E01021929,774,446,62,2,1284
E01021930,480,311,265,94,1150
E01021931,525,529,85,1,1140
E01021932,566,525,142,20,1253
E01021933,581,438,51,33,1103
E01021934,579,521,43,5,1148
E01021935,549,513,63,1,1126
E01021936,589,542,136,182,1449
E01021937,648,485,181,16,1330
E01021938,577,634,49,4,1264
E01021939,755,599,49,7,1410
E01021940,811,739,72,87,1709
E01021941,886,760,55,4,1705
E01021942,346,929,111,32,1418
E01021943,704,651,78,68,1501
E01021944,658,633,76,3,1370
E01021945,628,643,53,19,1343
E01021946,647,584,58,3,1292
E01021947,465,478,37,32,1012
E01021948,567,395,93,16,1071
E01021949,594,618,53,6,1271
E01021950,514,461,63,174,1212
E01021951,525,398,44,63,1030
E01021952,526,454,133,39,1152
E01021953,258,150,80,614,1102
E01021954,586,364,180,75,1205
E01021955,449,251,302,463,1465
E01021956,544,414,114,133,1205
E01021957,526,275,80,299,1180
E01021958,593,263,111,19,986
E01021959,741,347,87,115,1290
E01021960,792,759,53,11,1615
E01021961,591,556,59,49,1255
E01021962,360,315,158,160,993
E01021963,503,481,94,11,1089
E01021964,578,571,121,40,1310
E01021965,877,934,101,0,1912
E01021966,509,539,192,221,1461
E01021967,694,747,142,85,1668
E01021968,519,371,345,134,1369
E01021969,428,352,234,80,1094
E01021970,412,238,386,275,1311
E01021971,366,405,94,10,875
E01021972,430,370,93,121,1014
E01021973,423,446,49,18,936
E01021974,359,364,145,93,961
E01021975,439,429,168,160,1196
E01021976,488,545,126,7,1166
E01021977,559,588,159,52,1358
E01021978,768,778,190,102,1838
E01021979,461,440,110,196,1207
E01021980,606,621,153,69,1449
E01021981,556,586,204,48,1394
E01021982,551,415,411,45,1422
E01021983,427,624,107,8,1166
E01021984,608,1020,143,31,1802
E01021985,291,681,171,9,1152
E01021986,285,664,270,9,1228
E01021987,268,617,137,43,1065
E01021988,214,515,699,61,1489
E01021989,333,873,115,14,1335
E01021990,378,783,242,13,1416
E01021991,332,401,92,27,852
E01021992,438,344,69,97,948
E01021993,764,791,162,110,1827
E01021994,256,630,91,50,1027
E01021995,398,674,105,6,1183
E01021996,340,519,152,70,1081
E01021997,270,228,301,290,1089
E01021998,384,367,285,65,1101
E01021999,479,450,235,169,1333
E01022000,514,512,153,83,1262
E01022001,352,334,547,97,1330
E01022002,710,640,122,60,1532
E01022004,541,639,136,64,1380
E01022005,602,677,125,19,1423
E01022006,421,330,212,325,1288
E01022007,541,332,161,268,1302
E01022008,505,1096,152,45,1798
E01022009,433,618,122,14,1187
E01022010,489,676,150,8,1323
E01022011,599,596,162,106,1463
E01022012,377,1002,178,121,1678
E01022013,537,602,130,43,1312
E01022014,409,411,86,226,1132
E01022015,605,324,166,42,1137
E01022016,465,886,140,15,1506
E01022017,538,491,108,22,1159
E01022018,457,500,81,124,1162
E01022019,501,443,134,59,1137
E01022020,506,477,345,141,1469
E01022021,434,316,135,229,1114
E01022022,510,392,196,53,1151
E01022023,479,406,221,69,1175
E01022024,529,327,156,161,1173
E01022025,189,351,564,57,1161
E01022026,422,208,449,63,1142
E01022027,360,389,525,25,1299
E01022028,445,393,85,156,1079
E01022030,316,493,132,407,1348
E01022031,222,126,169,468,985
E01022032,403,464,201,286,1354
E01022033,373,827,102,7,1309
E01022034,377,777,174,15,1343
E01022035,386,792,105,15,1298
E01022036,383,517,146,9,1055
E01022037,344,602,175,15,1136
E01022038,396,514,128,182,1220
E01022039,412,402,155,234,1203
E01022040,507,819,109,62,1497
E01022041,414,697,141,23,1275
E01022042,372,376,269,156,1173
E01022043,574,331,417,102,1424
E01022044,433,672,127,155,1387
E01022045,344,431,146,260,1181
E01022046,494,676,162,4,1336
E01022047,393,527,129,23,1072
E01022048,348,669,207,13,1237
E01022049,419,551,185,20,1175
E01022050,388,711,253,101,1453
E01022051,494,491,126,51,1162
E01022052,472,483,121,96,1172
E01022053,610,667,102,47,1426
E01022054,338,493,246,78,1155
E01022055,192,526,146,226,1090
E01022056,412,382,450,69,1313
E01022057,625,478,137,139,1379
E01022058,596,503,147,122,1368
E01022059,551,436,210,93,1290
E01022060,818,485,142,115,1560
E01022061,430,559,88,105,1182
E01022062,799,658,156,53,1666
E01022063,628,389,105,168,1290
E01022064,581,649,145,38,1413
E01022067,548,353,394,204,1499
E01022068,588,366,109,179,1242
E01022069,502,472,192,81,1247
E01022070,636,493,148,195,1472
E01022071,489,496,235,116,1336
E01022072,662,554,166,103,1485
E01022073,523,454,89,211,1277
E01022074,388,322,85,383,1178
E01022075,601,597,199,16,1413
E01022076,352,541,338,238,1469
E01022077,532,477,164,94,1267
E01022078,350,250,136,459,1195
E01022079,499,465,220,191,1375
E01022080,681,304,210,96,1291
E01022081,735,587,202,247,1771
E01022082,616,469,174,132,1391
E01022083,636,507,148,68,1359
E01022084,608,559,114,13,1294
E01022085,625,328,268,79,1300
E01022086,393,192,137,337,1059
E01022087,727,341,186,164,1418
E01022088,505,543,133,114,1295
E01022089,506,405,189,125,1225
E01022090,854,408,380,193,1835
E01022091,806,659,254,140,1859
E01022092,540,567,259,48,1414
E01022093,546,400,109,314,1369
E01022094,585,475,156,114,1330
E01022095,486,421,232,116,1255
E01022096,690,466,163,150,1469
E01022097,576,605,172,144,1497
E01022098,513,481,124,116,1234
E01022099,535,515,432,142,1624
E01022100,589,442,390,37,1458
E01022101,620,369,446,105,1540
E01022102,373,157,1024,78,1632
E01022103,895,598,325,87,1905
E01022104,604,398,246,56,1304
E01022105,486,532,103,13,1134
E01022106,648,615,160,18,1441
E01022107,569,520,155,11,1255
E01022108,645,614,106,106,1471
E01022109,510,576,82,21,1189
E01022110,526,258,123,154,1061
E01022111,466,418,148,44,1076
E01022112,493,385,67,14,959
E01022113,526,711,67,45,1349
E01022114,510,618,87,9,1224
E01022115,513,550,260,47,1370
E01022116,219,248,409,38,914
E01022117,255,327,872,59,1513
E01022118,490,433,142,34,1099
E01022119,446,277,338,14,1075
E01022120,329,183,91,583,1186
E01022121,372,165,247,512,1296
E01022122,245,86,113,519,963
E01022123,831,470,448,86,1835
E01022124,189,207,477,204,1077
E01022125,315,346,377,9,1047
E01022126,221,254,800,91,1366
E01022127,184,156,724,45,1109
E01022128,540,621,113,1,1275
E01022129,703,710,111,90,1614
E01022130,529,488,249,6,1272
E01022131,323,245,99,333,1000
E01022132,404,236,109,370,1119
E01022133,354,135,114,479,1082
E01022134,410,377,245,286,1318
E01022135,406,481,193,46,1126
E01022136,360,448,306,80,1194
E01022137,468,409,573,21,1471
E01022138,465,519,337,15,1336
E01022139,351,486,105,45,987
E01022140,422,394,163,10,989
E01022141,343,322,563,31,1259
E01022142,374,167,634,156,1331
E01022143,462,653,124,15,1254
E01022144,339,431,105,106,981
E01022145,469,430,74,20,993
E01022146,413,633,82,15,1143
E01022147,258,175,120,707,1260
E01022148,555,361,178,146,1240
E01022149,533,244,120,216,1113
E01022150,499,318,247,160,1224
E01022151,297,205,740,172,1414
E01022152,110,88,290,357,845
E01022153,211,101,898,216,1426
E01022154,273,164,1192,99,1728
E01022155,470,413,298,76,1257
E01022156,448,191,406,182,1227
E01022157,400,252,143,384,1179
E01022158,480,270,1133,84,1967
E01022159,464,253,115,310,1142
E01022160,537,153,272,604,1566
E01022161,512,243,225,155,1135
E01022162,565,502,133,104,1304
E01022163,627,402,154,55,1238
E01022164,333,188,257,338,1116
E01022165,528,495,224,25,1272
E01022166,476,483,117,19,1095
E01022167,413,532,47,3,995
E01022168,371,405,103,26,905
E01022169,610,324,159,112,1205
E01022170,595,410,131,32,1168
E01022171,609,272,159,20,1060
E01022172,488,649,93,10,1240
E01022173,425,340,143,189,1097
E01022174,481,516,109,18,1124
E01022175,452,602,366,170,1590
E01022176,469,539,383,196,1587
E01022177,446,731,210,327,1714
E01022178,371,411,231,82,1095
E01022179,568,650,191,249,1658
E01022180,552,503,197,441,1693
E01022181,394,746,219,34,1393
E01022182,356,597,188,142,1283
E01022183,359,534,157,195,1245
E01022184,363,531,205,148,1247
E01022185,412,467,123,172,1174
E01022186,450,510,349,83,1392
E01022187,407,553,394,106,1460
E01022188,355,263,95,377,1090
E01022189,541,394,72,86,1093
E01022190,546,302,113,153,1114
E01022191,416,228,318,181,1143
E01022192,312,202,164,377,1055
E01022193,347,389,73,51,860
E01022194,240,497,505,244,1486
E01022195,300,404,283,123,1110
E01022196,581,508,149,161,1399
E01022197,670,658,170,40,1538
E01022198,386,285,207,204,1082
E01022199,456,447,342,239,1484
E01022200,220,135,108,504,967
E01022201,486,562,358,92,1498
E01022202,317,343,126,80,866
E01022203,377,561,190,66,1194
E01022204,472,315,136,253,1176
E01022205,405,525,408,180,1518
E01022206,437,590,421,97,1545
E01022207,535,559,244,141,1479
E01022208,536,601,139,18,1294
E01022209,392,297,85,141,915
E01022210,234,441,142,294,1111
E01022211,428,515,243,340,1526
E01022212,505,509,209,150,1373
E01022213,531,509,244,186,1470
E01022214,771,510,243,129,1653
E01022215,322,482,515,178,1497
E01022216,501,557,349,97,1504
E01022217,453,342,87,176,1058
E01022218,274,226,80,455,1035
E01022219,445,433,67,66,1011
E01022220,433,557,253,111,1354
E01022221,522,497,318,217,1554
E01022222,412,631,422,155,1620
E01022223,877,570,217,271,1935
E01022224,470,597,196,59,1322
E01022225,267,430,310,209,1216
E01022226,458,404,202,179,1243
E01022227,496,504,218,92,1310
E01022228,565,526,186,117,1394
E01022229,576,475,88,205,1344
E01022230,561,650,130,45,1386
E01022231,504,429,96,290,1319
E01022232,540,507,138,51,1236
E01022233,618,654,185,128,1585
E01022234,492,661,87,49,1289
E01022235,478,753,156,72,1459
E01022236,711,632,238,117,1698
E01022237,394,291,157,353,1195
E01022238,266,248,83,418,1015
E01022239,590,525,136,88,1339
E01022240,619,524,399,124,1666
E01022241,463,504,277,132,1376
E01022242,430,379,111,231,1151
E01022243,354,343,63,225,985
E01022244,465,358,81,276,1180
E01022245,399,275,191,224,1089
E01022246,472,468,95,18,1053
E01022247,499,667,175,44,1385
E01022248,521,738,92,88,1439
E01022249,659,780,101,87,1627
E01022250,493,512,123,322,1450
E01022251,447,375,98,253,1173
E01022252,644,673,67,53,1437
E01022253,604,565,96,80,1345
E01022254,541,416,135,372,1464
E01022255,611,447,143,51,1252
E01022256,411,365,165,364,1305
E01022257,658,758,104,16,1536
E01022258,322,271,106,186,885
E01022259,626,579,80,39,1324
E01022260,570,552,115,223,1460
E01022261,575,553,196,219,1543
E01022262,506,439,342,240,1527
E01022263,587,692,176,76,1531
E01022264,437,554,139,99,1229
E01022265,484,576,191,81,1332
E01022266,386,493,180,59,1118
E01022267,419,696,164,41,1320
E01022268,533,515,68,213,1329
E01022269,688,695,103,113,1599
E01022270,625,637,151,99,1512
E01022271,458,735,163,56,1412
E01022272,399,303,129,228,1059
E01022273,259,280,335,39,913
E01022274,415,460,107,9,991
E01022275,477,589,173,30,1269
E01022276,692,550,114,9,1365
E01022277,555,505,114,61,1235
E01022278,647,452,89,92,1280
E01022279,649,366,128,22,1165
E01022280,716,201,286,41,1244
E01022281,845,417,101,52,1415
E01022282,1354,444,194,104,2096
E01022283,491,608,96,61,1256
E01022284,445,234,144,185,1008
E01022285,421,250,61,310,1042
E01022286,542,278,142,266,1228
E01022287,616,467,163,108,1354
E01022288,480,243,419,127,1269
E01022289,283,346,372,208,1209
E01022290,331,268,231,173,1003
E01022291,329,332,491,104,1256
E01022292,341,364,333,48,1086
E01022293,431,306,431,77,1245
E01022294,521,289,347,35,1192
E01022295,556,509,64,34,1163
E01022296,506,306,150,152,1114
E01022297,525,478,36,4,1043
E01022298,677,369,137,53,1236
E01022299,514,552,94,21,1181
E01022300,448,607,120,5,1180
E01022301,573,316,172,141,1202
E01022302,572,527,132,34,1265
E01022303,419,467,119,152,1157
E01022304,513,675,136,10,1334
E01022305,545,521,73,24,1163
E01022306,654,332,126,5,1117
E01022307,798,294,165,6,1263
E01022308,492,600,117,9,1218
E01022309,469,401,256,75,1201
E01022310,428,411,430,165,1434
E01022311,290,188,644,379,1501
E01022312,445,317,859,113,1734
E01022313,671,482,169,29,1351
E01022314,505,637,91,14,1247
E01022315,585,537,127,5,1254
E01022316,655,423,178,33,1289
E01022317,642,509,82,25,1258
E01022318,610,629,61,9,1309
E01022319,221,129,82,645,1077
E01022320,539,319,85,226,1169
E01022321,569,356,144,128,1197
E01022322,350,264,92,360,1066
E01022323,368,124,106,682,1280
E01022324,384,264,123,412,1183
E01022325,470,363,104,185,1122
E01022326,514,191,278,26,1009
E01022327,586,333,241,79,1239
E01022328,456,164,144,275,1039
E01022329,425,177,221,319,1142
E01022330,569,257,250,39,1115
E01022331,526,268,105,169,1068
E01022332,417,251,509,117,1294
E01022333,212,135,99,654,1100
E01022334,563,428,133,182,1306
E01022335,639,360,154,65,1218
E01022336,489,346,108,10,953
E01022338,539,153,335,20,1047
E01022339,834,320,125,24,1303
E01022340,679,175,275,19,1148
E01022341,876,300,310,160,1646
E01022342,890,194,203,7,1294
E01022343,413,438,79,90,1020
E01022344,526,455,80,181,1242
E01022345,566,468,86,118,1238
E01022346,327,172,89,578,1166
E01022347,221,172,934,147,1474
E01022348,764,549,586,191,2090
E01022350,622,874,143,103,1742
E01022351,454,365,151,204,1174
E01022352,389,517,146,43,1095
E01022353,417,375,220,167,1179
E01022354,639,915,169,95,1818
E01022355,551,461,117,186,1315
E01022356,739,455,408,189,1791
E01022357,617,560,149,136,1462
E01022358,393,336,99,431,1259
E01022359,602,499,83,53,1237
E01022360,514,514,68,70,1166
E01022361,365,347,79,257,1048
E01022362,400,442,59,82,983
E01022363,651,588,99,112,1450
E01022364,282,167,62,395,906
E01022365,635,521,417,168,1741
E01022366,710,507,124,11,1352
E01022367,600,563,93,68,1324
E01022368,527,547,64,30,1168
E01022369,649,270,288,81,1288
E01022370,380,400,99,146,1025
E01022371,334,446,61,54,895
E01022372,610,526,208,61,1405
E01022373,576,434,138,225,1373
E01022374,623,486,206,263,1578
E01022375,272,158,83,420,933
E01022376,553,572,179,152,1456
E01022377,606,613,164,378,1761
E01022378,864,382,204,15,1465
E01022379,557,220,273,122,1172
E01022380,550,497,155,32,1234
E01022381,706,648,149,86,1589
E01022382,469,697,83,29,1278
E01022383,286,366,73,351,1076
E01022384,393,565,144,63,1165
E01022385,488,547,130,136,1301
E01022386,488,502,228,119,1337
E01022387,536,394,197,180,1307
E01022388,554,414,142,251,1361
E01022389,592,652,104,91,1439
E01022390,237,474,177,114,1002
E01022391,376,691,145,11,1223
E01022392,415,646,202,31,1294
E01022393,542,566,60,32,1200
E01022394,547,332,251,111,1241
E01022395,599,532,107,32,1270
E01022396,593,483,211,77,1364
E01022397,662,519,136,180,1497
E01022398,375,401,83,72,931
E01022399,653,445,228,372,1698
E01022400,571,516,249,159,1495
E01022401,538,223,104,280,1145
E01022402,635,343,186,122,1286
E01022403,354,256,73,441,1124
E01022404,450,397,177,46,1070
E01022405,387,413,76,278,1154
E01022406,461,462,79,21,1023
E01022407,398,515,100,98,1111
E01022408,428,364,53,26,871
E01022409,485,354,99,69,1007
E01022410,582,579,277,287,1725
E01022411,757,545,230,257,1789
E01022412,982,847,337,136,2302
E01022413,599,598,231,83,1511
E01022414,769,534,365,326,1994
E01022415,463,632,139,38,1272
E01022416,416,344,75,304,1139
E01022417,599,617,123,81,1420
E01022418,519,448,239,213,1419
E01022420,565,938,168,106,1777
E01022421,482,376,134,365,1357
E01022422,684,398,156,75,1313
E01022423,708,652,101,147,1608
E01022424,351,374,127,415,1267
E01022425,480,380,71,68,999
E01022426,383,773,73,11,1240
E01022427,436,459,215,61,1171
E01022428,523,291,197,407,1418
E01022429,638,479,135,31,1283
E01022430,590,534,62,38,1224
E01022431,926,414,299,25,1664
E01022432,641,771,188,96,1696
E01022433,687,802,96,89,1674
E01022434,674,910,95,22,1701
E01022435,606,576,115,557,1854
E01022436,613,674,169,148,1604
E01022437,501,307,127,161,1096
E01022438,601,322,151,21,1095
E01022439,631,314,242,28,1215
E01022440,496,418,305,94,1313
E01022441,496,479,227,80,1282
E01022442,479,609,128,81,1297
E01022443,467,525,80,44,1116
E01022444,476,620,89,14,1199
E01022445,375,465,202,109,1151
E01022446,686,414,178,91,1369
E01022447,209,58,507,152,926
E01022448,344,458,143,158,1103
E01022449,588,736,253,64,1641
E01022450,637,229,257,481,1604
E01022451,679,342,115,85,1221
E01022452,676,327,100,28,1131
E01022453,500,715,109,22,1346
E01022454,485,665,99,341,1590
E01022455,823,712,97,47,1679
E01022456,484,367,122,87,1060
E01022457,374,280,75,393,1122
E01022458,256,156,83,600,1095
E01022459,306,384,512,137,1339
E01022460,607,407,190,249,1453
E01022461,437,616,71,49,1173
E01022462,500,727,91,79,1397
E01022463,366,529,266,122,1283
E01022464,316,526,113,353,1308
E01022465,495,616,91,51,1253
E01022466,522,614,227,44,1407
E01022467,618,635,76,47,1376
E01022468,556,566,176,84,1382
E01022469,536,466,71,197,1270
E01022470,899,412,193,18,1522
E01022471,681,399,123,26,1229
E01022472,401,454,125,35,1015
E01022473,542,359,83,38,1022
E01022474,426,212,160,358,1156
E01022475,773,295,193,76,1337
E01022476,895,363,129,42,1429
E01022477,556,193,142,200,1091
E01022478,433,113,108,471,1125
E01022479,399,151,116,434,1100
E01022480,489,139,79,308,1015
E01022481,617,452,238,184,1491
E01022482,404,314,248,271,1237
E01022484,294,110,87,479,970
E01022485,343,145,70,332,890
E01022486,755,218,145,408,1526
E01022487,378,128,89,361,956
E01022488,234,227,149,293,903
E01022489,403,432,163,123,1121
E01022490,786,349,71,189,1395
E01022491,669,279,111,355,1414
E01022492,459,434,302,93,1288
E01022493,448,388,136,95,1067
E01022494,980,341,294,274,1889
E01022495,651,212,259,35,1157
E01022496,1250,318,134,163,1865
E01022497,562,291,235,14,1102
E01022498,647,339,194,47,1227
E01022499,558,473,71,53,1155
E01022500,458,344,178,110,1090
E01022502,563,366,281,70,1280
E01022503,513,275,311,68,1167
E01022504,528,545,84,96,1253
E01022505,638,464,125,31,1258
E01022506,496,264,176,116,1052
E01022507,521,299,154,308,1282
E01022509,692,238,126,43,1099
E01022510,894,226,75,57,1252
E01022511,621,250,86,11,968
E01022512,749,207,72,13,1041
E01022513,489,466,137,162,1254
E01022514,441,434,209,150,1234
E01022515,388,774,34,13,1209
E01022516,582,592,24,52,1250
E01022517,499,496,39,2,1036
E01022518,887,510,58,91,1546
E01022519,513,491,18,22,1044
E01022520,458,340,212,351,1361
E01022521,637,553,132,69,1391
E01022522,551,449,165,104,1269
E01022523,512,195,256,610,1573
E01022524,515,153,148,630,1446
E01022525,598,424,156,122,1300
E01022526,525,262,217,313,1317
E01022527,351,248,204,487,1290
E01022528,506,457,55,20,1038
E01022529,441,385,137,244,1207
E01022530,437,571,45,22,1075
E01022531,482,565,163,29,1239
E01022532,449,394,150,87,1080
E01022533,512,477,219,208,1416
E01022534,527,496,125,206,1354
E01022535,435,432,166,203,1236
E01022536,463,508,67,77,1115
E01022537,518,505,68,12,1103
E01022539,425,192,99,222,938
E01022540,587,172,142,532,1433
E01022542,350,171,143,274,938
E01022543,480,197,188,364,1229
E01022546,504,364,143,65,1076
E01022547,604,521,151,112,1388
E01022548,371,378,114,274,1137
E01022549,418,207,106,583,1314
E01022550,331,284,101,631,1347
E01022551,519,335,139,272,1265
E01022552,412,169,83,518,1182
E01022553,602,459,91,48,1200
E01022554,668,460,92,120,1340
E01022555,575,389,118,121,1203
E01022556,432,291,81,431,1235
E01022557,568,404,142,87,1201
E01022558,568,203,170,67,1008
E01022559,537,390,87,45,1059
E01022560,528,279,79,70,956
E01022561,323,343,419,100,1185
E01022562,356,451,170,101,1078
E01022563,666,525,173,55,1419
E01022564,556,416,220,245,1437
E01022565,516,347,160,304,1327
E01022566,516,332,50,141,1039
E01022567,362,175,67,369,973
E01022568,456,246,106,320,1128
E01022569,427,374,86,115,1002
E01022570,633,510,65,90,1298
E01022571,458,339,151,29,977
E01022572,452,412,91,70,1025
E01022573,925,715,309,99,2048
E01022574,393,293,181,212,1079
E01022575,264,125,105,633,1127
E01022576,280,242,322,420,1264
E01022577,478,508,219,41,1246
E01022578,1020,935,142,287,2384
E01022579,233,203,80,384,900
E01022580,498,369,107,6,980
E01022581,433,382,218,82,1115
E01022582,509,484,137,26,1156
E01022583,546,507,135,177,1365
E01022584,482,371,175,337,1365
E01022585,614,563,109,41,1327
E01022586,663,506,133,21,1323
E01022587,621,449,199,106,1375
E01022588,715,531,66,20,1332
E01022589,665,445,178,133,1421
E01022590,534,611,46,49,1240
E01022591,750,852,216,157,1975
E01022592,616,590,289,335,1830
E01022593,491,474,41,9,1015
E01022594,508,423,103,120,1154
E01022595,836,520,63,99,1518
E01022596,503,552,84,12,1151
E01022597,634,678,493,178,1983
E01022599,379,367,193,107,1046
E01022600,547,611,86,5,1249
E01022601,469,489,111,126,1195
E01022602,511,532,41,2,1086
E01022603,425,204,136,323,1088
E01022604,306,412,153,87,958
E01022605,549,451,151,30,1181
E01022606,1038,764,131,53,1986
E01022607,477,320,92,105,994
E01022608,596,417,60,15,1088
E01022610,551,405,124,11,1091
E01022611,589,400,99,144,1232
E01022613,541,367,79,115,1102
E01022614,324,322,66,198,910
E01022615,1108,666,193,251,2218
E01022616,414,343,197,377,1331
E01022617,492,524,157,75,1248
E01022618,520,673,110,25,1328
E01022619,445,396,163,22,1026
E01022620,369,234,132,186,921
E01022621,301,234,79,471,1085
E01022622,373,474,108,115,1070
E01022623,690,592,232,271,1785
E01022624,820,909,179,25,1933
E01022625,884,802,204,203,2093
E01022627,644,710,306,149,1809
E01022628,413,327,140,81,961
E01022629,393,624,92,77,1186
E01022630,721,700,280,173,1874
E01022631,439,397,103,82,1021
E01022632,392,362,75,71,900
E01022633,604,287,165,31,1087
E01022634,429,176,151,131,887
E01022635,385,214,49,458,1106
E01022636,580,254,96,123,1053
E01022639,370,103,480,175,1128
E01022640,455,109,195,328,1087
E01022641,552,223,151,74,1000
E01022642,406,325,102,34,867
E01022643,693,457,91,82,1323
E01022644,518,309,84,111,1022
E01022645,435,530,43,6,1014
E01022646,649,410,126,65,1250
E01022647,594,516,107,28,1245
E01022648,476,346,129,153,1104
E01022649,306,172,71,663,1212
E01022650,457,327,85,69,938
E01022651,852,473,168,7,1500
E01022652,552,502,100,286,1440
E01022653,564,507,99,58,1228
E01022654,639,232,142,77,1090
E01022655,182,72,53,765,1072
E01022656,501,411,122,172,1206
E01022657,627,372,234,117,1350
E01022658,542,623,152,77,1394
E01022659,699,423,160,13,1295
E01022660,533,429,126,160,1248
E01022661,548,670,199,13,1430
E01022662,569,486,57,21,1133
E01022663,685,463,139,33,1320
E01022664,613,491,120,15,1239
E01022665,509,389,210,164,1272
E01022666,672,373,581,110,1736
E01022667,648,337,141,104,1230
E01022668,790,293,504,430,2017
E01022669,607,265,392,167,1431
E01022670,349,171,188,492,1200
E01022671,493,197,265,279,1234
E01022672,559,383,115,227,1284
E01022673,673,338,303,353,1667
E01022674,694,364,173,125,1356
E01022675,620,483,80,12,1195
E01022676,631,514,89,64,1298
E01022677,615,263,168,547,1593
E01022678,637,325,108,339,1409
E01022679,669,311,280,177,1437
E01022680,394,275,75,571,1315
E01022681,427,247,108,469,1251
E01022682,609,455,32,22,1118
E01022683,659,321,75,40,1095
E01022684,601,530,81,4,1216
E01022685,434,364,123,89,1010
E01022686,685,406,143,46,1280
E01022687,871,336,140,2,1349
E01022688,754,603,409,92,1858
E01022689,580,514,147,39,1280
E01022690,589,297,308,342,1536
E01022691,782,207,163,31,1183
E01022692,1227,202,290,316,2035
E01022693,747,240,132,10,1129
E01022694,786,265,206,65,1322
E01022695,519,356,114,107,1096
E01022696,576,649,62,4,1291
E01022697,602,532,76,42,1252
E01022698,620,615,62,12,1309
E01022699,667,444,98,15,1224
E01022700,542,301,149,249,1241
E01022701,373,337,30,101,841
E01022702,599,279,145,10,1033
E01022703,548,410,140,116,1214
E01022704,694,643,110,13,1460
E01022705,479,720,55,20,1274
E01022706,594,726,43,4,1367
E01022707,776,652,115,23,1566
E01022708,653,544,202,11,1410
E01022709,556,645,127,6,1334
E01022710,560,555,329,237,1681
E01022711,485,242,125,525,1377
E01022712,678,373,190,56,1297
E01022713,586,509,140,99,1334
E01022714,639,659,79,49,1426
E01022715,602,402,215,113,1332
E01022716,563,300,261,161,1285
E01022717,620,254,114,19,1007
E01022718,593,430,85,102,1210
E01022719,607,535,102,67,1311
E01022720,574,502,80,2,1158
E01022721,552,432,157,22,1163
E01022722,569,473,179,84,1305
E01022723,420,353,322,138,1233
E01022724,615,315,118,91,1139
E01022725,415,577,40,6,1038
E01022726,514,589,49,54,1206
E01022727,579,587,93,46,1305
E01022728,501,358,398,154,1411
E01022729,497,302,97,28,924
E01022730,595,506,77,63,1241
E01022731,663,295,67,58,1083
E01022732,401,167,97,518,1183
E01022733,529,540,84,249,1402
E01022734,455,243,102,243,1043
E01022735,565,314,189,102,1170
E01022736,620,399,113,149,1281
E01022737,589,429,189,80,1287
E01022738,331,159,75,270,835
E01022739,427,157,125,511,1220
E01022740,678,691,71,10,1450
E01022741,359,343,251,20,973
E01022742,608,870,102,7,1587
E01022743,683,671,128,83,1565
E01022744,492,608,62,6,1168
E01022745,503,660,97,8,1268
E01022746,398,627,285,27,1337
E01022747,443,429,105,69,1046
E01022748,603,462,129,6,1200
E01022749,554,475,52,35,1116
E01022750,609,520,94,10,1233
E01022751,559,540,97,95,1291
E01022752,678,432,51,5,1166
E01022753,522,298,89,101,1010
E01022754,675,322,231,152,1380
E01022755,559,456,87,121,1223
E01022756,634,332,92,10,1068
E01022757,737,237,260,27,1261
E01022758,621,330,65,159,1175
E01022759,642,531,90,30,1293
E01022760,637,405,115,121,1278
E01022761,450,476,111,223,1260
E01022762,696,430,104,29,1259
E01022763,611,687,51,13,1362
E01022764,523,564,110,175,1372
E01022765,682,631,106,16,1435
E01022766,533,510,70,5,1118
E01022767,459,456,56,55,1026
E01022768,555,410,80,125,1170
E01022769,510,317,137,45,1009
E01022770,702,654,70,21,1447
E01022771,807,213,156,14,1190
E01022772,1113,308,160,47,1628
E01022773,641,503,110,42,1296
E01022774,836,551,124,15,1526
E01022776,626,529,103,47,1305
E01022777,488,620,85,207,1400
E01022778,584,489,103,19,1195
E01022780,605,265,194,105,1169
E01022781,368,300,206,202,1076
E01022782,456,527,170,55,1208
E01022783,573,591,98,7,1269
E01022784,605,398,67,10,1080
E01022785,666,417,60,77,1220
E01022786,630,479,77,121,1307
E01022787,551,295,120,103,1069
E01022788,483,268,149,94,994
E01022789,646,346,174,25,1191
E01022790,790,487,169,5,1451
E01022791,622,653,230,64,1569
E01022792,515,459,142,115,1231
E01022793,768,524,120,9,1421
E01022794,428,549,179,10,1166
E01022795,487,554,220,12,1273
E01022796,375,478,37,53,943
E01022797,411,370,86,25,892
E01022798,399,334,86,109,928
E01022799,496,427,138,40,1101
E01022800,615,316,93,297,1321
E01022801,515,217,84,386,1202
E01022802,589,487,80,81,1237
E01022803,565,215,104,397,1281
E01022804,596,436,102,199,1333
E01022805,481,254,141,334,1210
E01022806,590,318,190,61,1159
E01022807,514,237,349,194,1294
E01022810,447,348,383,131,1309
E01022811,700,297,573,232,1802
E01022812,553,299,144,20,1016
E01022813,634,372,106,10,1122
E01022814,588,367,243,182,1380
E01022815,662,427,138,36,1263
E01022816,609,241,138,193,1181
E01022817,666,274,170,281,1391
E01022818,407,178,128,416,1129
E01022819,540,198,355,60,1153
E01022820,310,40,353,456,1159
E01022823,637,454,151,30,1272
E01022824,1064,369,544,187,2164
E01022825,656,328,132,40,1156
E01022826,703,472,112,12,1299
E01022828,296,631,240,29,1196
E01022829,410,693,404,77,1584
E01022830,483,606,112,9,1210
E01022831,614,369,144,49,1176
E01022832,702,304,229,41,1276
E01022833,421,159,255,574,1409
E01022834,410,411,81,234,1136
E01022835,536,328,165,157,1186
E01022836,518,619,68,45,1250
E01022837,602,589,110,31,1332
E01022838,522,480,60,1,1063
E01022839,391,213,162,360,1126
E01022840,502,224,129,414,1269
E01022841,303,165,304,330,1102
E01022842,261,201,489,229,1180
E01022843,313,170,128,563,1174
E01022845,517,322,239,106,1184
E01022846,438,322,132,26,918
E01022847,707,466,210,40,1423
E01022848,635,544,94,27,1300
E01022849,648,485,96,110,1339
E01022850,624,401,144,12,1181
E01022851,713,497,95,14,1319
E01022852,804,265,276,57,1402
E01022853,739,534,72,18,1363
E01022854,737,419,105,44,1305
E01022855,386,348,77,167,978
E01022856,445,517,114,124,1200
E01022857,233,161,526,41,961
E01022858,304,338,154,74,870
E01022859,626,452,118,93,1289
E01022860,557,718,258,75,1608
E01022861,687,600,83,7,1377
E01022862,672,402,486,58,1618
E01022863,552,620,79,21,1272
E01022864,395,506,53,231,1185
E01022865,627,644,51,4,1326
E01022867,623,262,249,68,1202
E01022868,639,639,59,54,1391
E01022869,538,472,90,74,1174
E01022870,539,490,92,55,1176
E01022871,532,211,120,234,1097
E01022872,650,561,161,55,1427
E01022873,612,633,42,86,1373
E01022874,593,349,85,66,1093
E01022875,569,221,68,238,1096
E01022876,568,405,101,8,1082
E01022877,601,451,72,51,1175
E01022878,604,701,97,22,1424
E01022879,457,471,288,199,1415
E01022880,471,317,129,316,1233
E01022881,909,445,178,277,1809
E01022882,596,394,147,16,1153
E01022883,559,382,91,45,1077
E01022884,576,428,133,127,1264
E01022885,657,335,124,31,1147
E01022887,506,446,168,38,1158
E01022888,447,637,236,71,1391
E01022889,411,358,113,312,1194
E01022890,449,344,88,323,1204
E01022891,711,477,167,51,1406
E01022892,706,714,119,40,1579
E01022893,704,432,70,65,1271
E01022894,557,395,89,160,1201
E01022895,850,482,122,29,1483
E01022896,773,479,67,14,1333
E01022897,856,415,87,8,1366
E01022898,718,475,33,4,1230
E01022899,482,247,70,293,1092
E01022900,506,295,135,500,1436
E01022901,506,256,120,368,1250
E01022902,494,236,98,347,1175
E01022903,415,211,112,626,1364
E01022904,654,401,126,397,1578
E01022905,297,172,167,728,1364
E01022906,386,171,84,458,1099
E01022907,516,497,85,165,1263
E01022908,495,240,109,315,1159
E01022909,628,547,81,54,1310
E01022910,486,359,207,136,1188
E01022911,529,509,93,122,1253
E01022913,345,188,65,434,1032
E01022914,370,228,71,353,1022
E01022915,309,160,107,543,1119
E01022916,552,227,96,345,1220
E01022917,324,167,88,405,984
E01022918,515,511,86,168,1280
E01022919,639,410,126,147,1322
E01022920,640,538,103,19,1300
E01022921,639,554,87,22,1302
E01022922,695,248,261,11,1215
E01022924,493,562,172,114,1341
E01022925,453,475,95,118,1141
E01022926,420,613,135,74,1242
E01022927,404,497,93,316,1310
E01022928,408,884,152,28,1472
E01022929,317,664,327,81,1389
E01022930,696,687,67,26,1476
E01022931,705,590,58,13,1366
E01022933,343,137,60,690,1230
E01022934,428,251,115,617,1411
E01022935,522,556,74,100,1252
E01022936,406,581,281,57,1325
E01022937,459,400,80,216,1155
E01022938,387,599,161,22,1169
E01022939,579,529,109,122,1339
E01022940,456,533,171,164,1324
E01022941,516,648,151,11,1326
E01022942,273,415,340,270,1298
E01022943,391,751,81,8,1231
E01022944,517,521,56,14,1108
E01022945,653,940,265,55,1913
E01022946,605,659,142,58,1464
E01022947,768,488,100,10,1366
E01022948,725,429,124,56,1334
E01022949,462,152,125,520,1259
E01022950,625,517,52,18,1212
E01022951,642,433,47,42,1164
E01022952,594,502,111,34,1241
E01022953,487,481,444,274,1686
E01022954,468,711,122,11,1312
E01022955,442,567,100,39,1148
E01022956,478,181,91,180,930
E01022957,398,350,72,201,1021
E01022958,565,578,73,7,1223
E01022959,385,172,67,474,1098
E01022960,518,192,142,223,1075
E01022961,538,221,103,180,1042
E01022962,605,425,69,103,1202
E01022963,504,430,96,191,1221
E01022964,326,174,150,444,1094
E01022965,364,197,63,510,1134
E01022966,309,185,80,427,1001
E01022967,189,109,58,536,892
E01022968,250,136,69,592,1047
E01022969,377,177,134,559,1247
E01022970,456,187,156,553,1352
E01022971,604,512,180,11,1307
E01022972,628,581,102,3,1314
E01022973,518,479,190,345,1532
E01022974,586,493,129,7,1215
E01022975,548,666,84,50,1348
E01022976,504,344,68,311,1227
E01022977,525,604,71,18,1218
E01022978,477,669,106,36,1288
E01022979,379,505,55,70,1009
E01022980,446,579,110,26,1161
E01022981,531,1071,99,2,1703
E01022982,419,940,222,74,1655
E01022983,451,912,97,8,1468
E01022984,423,763,113,13,1312
E01022985,473,419,122,10,1024
E01022986,485,645,83,24,1237
E01022987,437,1062,146,9,1654
E01022988,395,333,166,315,1209
E01022989,432,691,113,160,1396
E01022990,297,625,190,138,1250
E01022991,577,977,175,24,1753
E01022992,397,526,76,8,1007
E01022993,307,539,164,79,1089
E01022994,495,663,103,68,1329
E01022995,563,502,92,21,1178
E01022996,328,443,143,101,1015
E01022997,356,480,163,122,1121
E01022998,473,788,105,26,1392
E01022999,415,668,527,168,1778
E01023000,387,656,203,185,1431
E01023001,573,501,342,62,1478
E01023002,416,369,200,387,1372
E01023003,520,739,86,151,1496
E01023004,694,584,85,121,1484
E01023005,571,616,41,31,1259
E01023006,338,177,66,469,1050
E01023007,347,484,66,68,965
E01023008,348,699,217,119,1383
E01023009,653,372,156,43,1224
E01023010,493,202,195,292,1182
E01023011,348,447,253,162,1210
E01023012,313,512,268,80,1173
E01023013,554,479,94,112,1239
E01023014,529,663,128,91,1411
E01023015,446,418,205,110,1179
E01023016,457,691,59,4,1211
E01023017,536,550,113,353,1552
E01023018,255,421,126,345,1147
E01023019,485,216,220,242,1163
E01023020,432,697,81,15,1225
E01023021,487,597,117,26,1227
E01023022,407,452,380,240,1479
E01023023,447,543,146,307,1443
E01023024,571,554,106,17,1248
E01023025,338,728,106,3,1175
E01023026,336,421,157,20,934
E01023027,443,417,106,206,1172
E01023028,578,563,237,239,1617
E01023029,222,106,46,802,1176
E01023030,569,289,125,59,1042
E01023031,474,434,151,22,1081
E01023032,469,482,61,86,1098
E01023033,374,323,85,241,1023
E01023034,565,675,99,111,1450
E01023035,594,673,108,73,1448
E01023036,569,1020,96,53,1738
E01023037,480,430,186,463,1559
E01023038,564,593,82,15,1254
E01023039,428,517,144,129,1218
E01023040,464,690,98,6,1258
E01023041,313,717,187,111,1328
E01023042,203,518,450,143,1314
E01023043,420,680,313,42,1455
E01023044,197,646,102,10,955
E01023045,476,651,150,26,1303
E01023046,282,424,260,210,1176
E01023047,604,282,154,35,1075
E01023048,486,395,66,153,1100
E01023049,563,261,309,94,1227
E01023050,633,260,358,107,1358
E01023051,379,648,170,101,1298
E01023052,351,997,149,7,1504
E01023053,391,843,214,17,1465
E01023054,401,776,266,60,1503
E01023055,284,190,86,407,967
E01023056,296,662,221,109,1288
E01023057,310,699,388,84,1481
E01023058,283,232,68,567,1150
E01023059,421,767,165,49,1402
E01023060,518,531,79,44,1172
E01023061,358,328,159,369,1214
E01023062,548,531,81,39,1199
E01023063,355,346,219,59,979
E01023064,516,374,118,63,1071
E01023065,458,504,112,261,1335
E01023066,514,640,94,99,1347
E01023067,532,550,108,9,1199
E01023068,348,284,117,311,1060
E01023069,533,473,185,82,1273
E01023070,325,449,453,192,1419
E01023071,442,295,338,58,1133
E01023072,627,268,149,18,1062
E01023073,706,308,79,12,1105
E01023074,493,525,148,37,1203
E01023075,419,348,79,121,967
E01023076,497,631,58,58,1244
E01023077,428,275,260,236,1199
E01023078,476,600,88,48,1212
E01023079,648,409,144,187,1388
E01023080,508,365,121,55,1049
E01023081,800,382,111,201,1494
E01023082,552,363,141,122,1178
E01023083,488,234,158,334,1214
E01023084,633,517,91,32,1273
E01023085,502,294,123,286,1205
E01023086,451,524,67,209,1251
E01023087,731,204,220,22,1177
E01023088,497,321,95,372,1285
E01023089,613,466,186,43,1308
E01023090,813,317,241,128,1499
E01023091,449,129,191,507,1276
E01023092,771,252,97,11,1131
E01023093,681,346,76,16,1119
E01023094,582,373,111,39,1105
E01023095,654,245,267,236,1402
E01023096,798,555,285,91,1729
E01023097,576,468,143,9,1196
E01023098,576,384,256,87,1303
E01023099,461,311,107,351,1230
E01023100,626,146,101,90,963
E01023101,611,380,65,13,1069
E01023102,629,418,72,8,1127
E01023103,709,405,163,46,1323
E01023104,625,216,150,326,1317
E01023105,542,129,122,463,1256
E01023106,449,208,180,341,1178
E01023107,391,200,71,492,1154
E01023108,294,134,58,587,1073
E01023109,674,376,180,8,1238
E01023110,599,258,148,404,1409
E01023111,714,504,129,110,1457
E01023112,659,260,57,8,984
E01023113,561,366,227,112,1266
E01023114,606,243,157,92,1098
E01023115,632,306,92,15,1045
E01023116,785,291,339,67,1482
E01023117,827,481,113,26,1447
E01023118,733,195,336,144,1408
E01023119,258,60,120,530,968
E01023120,600,135,231,412,1378
E01023121,807,372,99,341,1619
E01023122,504,144,236,289,1173
E01023123,671,263,172,75,1181
E01023124,594,203,175,53,1025
E01023125,1009,373,221,249,1852
E01023128,528,285,120,197,1130
E01023129,514,187,290,57,1048
E01023130,582,445,74,51,1152
E01023131,461,352,172,134,1119
E01023132,611,362,112,176,1261
E01023133,669,220,141,33,1063
E01023134,921,289,198,46,1454
E01023135,865,394,267,281,1807
E01023136,498,163,543,138,1342
E01023137,466,246,261,55,1028
E01023138,430,218,316,127,1091
E01023139,455,166,149,192,962
E01023140,132,50,677,286,1145
E01023141,91,25,964,165,1245
E01023142,286,31,931,275,1523
E01023143,192,53,841,238,1324
E01023144,455,164,641,135,1395
E01023145,556,228,710,176,1670
E01023146,447,169,137,326,1079
E01023147,670,409,93,43,1215
E01023148,586,392,138,73,1189
E01023149,545,442,71,47,1105
E01023150,388,478,228,191,1285
E01023151,192,397,282,360,1231
E01023152,364,630,218,218,1430
E01023153,532,174,192,402,1300
E01023154,446,100,80,644,1270
E01023155,784,378,276,672,2110
E01023156,303,59,95,535,992
E01023157,398,151,106,411,1066
E01023158,739,868,202,60,1869
E01023159,625,765,255,168,1813
E01023160,463,519,163,60,1205
E01023162,526,619,165,72,1382
E01023163,547,745,97,9,1398
E01023164,467,549,137,150,1303
E01023165,592,564,368,169,1693
E01023166,415,474,195,140,1224
E01023167,339,545,286,142,1312
E01023168,411,511,251,85,1258
E01023169,765,693,129,74,1661
E01023170,628,365,247,148,1388
E01023171,570,582,149,39,1340
E01023172,604,603,60,10,1277
E01023173,574,598,72,12,1256
E01023174,678,527,155,54,1414
E01023175,536,675,101,26,1338
E01023176,435,507,141,199,1282
E01023177,536,644,308,267,1755
E01023178,630,514,483,185,1812
E01023179,632,282,170,327,1411
E01023180,472,557,217,103,1349
E01023181,667,205,121,88,1081
E01023182,733,233,149,129,1244
E01023183,487,286,91,252,1116
E01023184,402,396,241,51,1090
E01023185,333,390,66,200,989
E01023186,635,386,152,180,1353
E01023187,611,363,217,32,1223
E01023188,628,280,114,43,1065
E01023189,499,335,367,64,1265
E01023190,386,315,178,136,1015
E01023191,711,520,172,72,1475
E01023192,507,360,131,432,1430
E01023193,590,620,77,59,1346
E01023194,511,719,79,24,1333
E01023195,428,330,540,183,1481
E01023196,522,463,204,164,1353
E01023197,461,271,304,124,1160
E01023198,486,430,159,123,1198
E01023199,433,410,273,166,1282
E01023200,630,450,104,30,1214
E01023201,511,367,137,259,1274
E01023202,290,219,451,525,1485
E01023203,571,443,146,141,1301
E01023204,444,236,360,288,1328
E01023205,398,119,65,373,955
E01023206,271,391,74,216,952
E01023207,538,643,74,19,1274
E01023208,377,296,94,177,944
E01023209,562,448,111,9,1130
E01023210,740,335,87,4,1166
E01023211,845,216,163,113,1337
E01023212,703,442,66,12,1223
E01023213,542,356,91,63,1052
E01023214,620,358,94,5,1077
E01023215,562,412,142,169,1285
E01023216,505,370,357,241,1473
E01023217,622,488,173,16,1299
E01023218,592,526,115,20,1253
E01023219,514,324,84,264,1186
E01023220,853,510,181,61,1605
E01023221,444,510,192,277,1423
E01023222,511,577,138,12,1238
E01023223,423,348,54,350,1175
E01023224,243,223,474,94,1034
E01023225,482,634,420,156,1692
E01023226,462,448,190,129,1229
E01023227,616,424,117,335,1492
E01023228,673,842,98,42,1655
E01023229,608,546,245,168,1567
E01023230,808,607,173,31,1619
E01023231,712,588,102,32,1434
E01023232,698,632,145,66,1541
E01023233,632,408,113,22,1175
E01023234,578,326,111,250,1265
E01023235,577,693,217,159,1646
E01023236,481,658,289,112,1540
E01023237,300,227,59,421,1007
E01023238,614,396,104,40,1154
E01023239,622,473,162,46,1303
E01023240,625,737,297,111,1770
E01023241,369,519,78,64,1030
E01023242,472,342,162,6,982
E01023243,476,272,324,14,1086
E01023244,468,745,61,38,1312
E01023245,795,803,172,99,1869
E01023246,457,486,155,97,1195
E01023247,420,513,117,162,1212
E01023248,618,652,87,26,1383
E01023249,374,312,98,223,1007
E01023250,366,308,140,487,1301
E01023251,177,123,297,411,1008
E01023252,260,306,667,308,1541
E01023253,422,512,148,176,1258
E01023254,534,366,312,195,1407
E01023255,338,225,214,468,1245
E01023256,164,150,183,634,1131
E01023257,378,284,245,364,1271
E01023258,270,191,197,388,1046
E01023259,353,420,229,201,1203
E01023260,120,51,287,584,1042
E01023261,191,118,466,583,1358
E01023262,181,149,506,460,1296
E01023263,271,445,285,73,1074
E01023264,178,269,521,148,1116
E01023265,417,456,352,214,1439
E01023266,271,339,315,229,1154
E01023267,402,202,303,81,988
E01023268,419,352,186,28,985
E01023269,482,450,363,70,1365
E01023270,334,250,151,173,908
E01023271,368,387,76,103,934
E01023272,548,358,93,19,1018
E01023273,553,521,84,29,1187
E01023274,408,490,204,134,1236
E01023275,448,469,109,144,1170
E01023276,551,562,74,59,1246
E01023277,457,490,76,22,1045
E01023278,515,564,123,121,1323
E01023279,542,537,105,27,1211
E01023280,379,476,225,127,1207
E01023281,420,529,205,304,1458
E01023282,495,638,241,153,1527
E01023284,931,511,464,214,2120
E01023285,379,399,140,348,1266
E01023286,398,314,239,194,1145
E01023287,921,761,499,60,2241
E01023288,452,342,201,107,1102
E01023289,628,523,28,15,1194
E01023290,562,634,70,69,1335
E01023291,570,577,117,14,1278
E01023292,552,567,111,14,1244
E01023293,647,507,62,134,1350
E01023294,436,276,94,410,1216
E01023295,529,374,74,192,1169
E01023296,641,312,58,316,1327
E01023297,635,362,70,17,1084
E01023298,549,604,79,47,1279
E01023299,656,495,162,41,1354
E01023300,439,199,193,285,1116
E01023301,521,293,294,155,1263
E01023302,427,403,87,325,1242
E01023303,593,283,130,224,1230
E01023304,578,420,85,177,1260
E01023305,614,317,97,35,1063
E01023306,640,422,75,95,1232
E01023307,711,415,55,59,1240
E01023308,754,564,55,29,1402
E01023309,790,570,58,4,1422
E01023310,635,248,269,462,1614
E01023311,649,546,123,77,1395
E01023312,854,384,65,41,1344
E01023313,649,660,36,25,1370
E01023314,574,379,50,92,1095
E01023315,917,293,90,69,1369
E01023316,627,472,40,27,1166
E01023317,963,561,202,137,1863
E01023318,681,523,75,24,1303
E01023319,511,680,62,84,1337
E01023320,582,469,426,137,1614
E01023321,707,703,153,71,1634
E01023322,713,315,200,169,1397
E01023323,384,237,224,476,1321
E01023324,639,287,37,130,1093
E01023325,647,344,73,90,1154
E01023326,503,333,106,334,1276
E01023327,528,330,119,118,1095
E01023328,626,238,83,130,1077
E01023329,478,401,37,125,1041
E01023330,539,254,157,186,1136
E01023331,584,314,83,228,1209
E01023332,677,646,272,74,1669
E01023333,544,333,282,310,1469
E01023334,595,645,160,15,1415
E01023335,674,565,150,30,1419
E01023336,764,283,326,215,1588
E01023337,505,429,273,132,1339
E01023338,495,285,350,571,1701
E01023339,413,185,140,441,1179
E01023340,657,417,196,102,1372
E01023341,703,519,109,134,1465
E01023342,939,338,316,390,1983
E01023343,508,172,92,562,1334
E01023344,765,402,153,86,1406
E01023345,552,303,184,230,1269
E01023346,387,276,92,258,1013
E01023347,390,383,73,205,1051
E01023348,282,139,134,647,1202
E01023349,521,261,139,564,1485
E01023350,434,226,82,545,1287
E01023351,522,380,163,200,1265
E01023352,739,813,193,206,1951
E01023354,696,417,198,52,1363
E01023355,468,558,92,136,1254
E01023356,325,386,90,93,894
E01023357,455,217,97,512,1281
E01023358,368,179,160,384,1091
E01023359,582,229,74,480,1365
E01023360,541,306,73,201,1121
E01023361,484,338,469,140,1431
E01023362,557,719,159,8,1443
E01023363,644,434,111,14,1203
E01023364,472,477,76,12,1037
E01023365,358,281,231,162,1032
E01023366,410,268,105,405,1188
E01023367,407,397,26,18,848
E01023368,609,424,209,51,1293
E01023369,355,201,78,496,1130
E01023370,620,326,174,158,1278
E01023371,469,451,39,164,1123
E01023372,541,508,47,31,1127
E01023373,429,285,95,112,921
E01023374,490,425,188,47,1150
E01023375,515,499,75,152,1241
E01023376,406,285,104,202,997
E01023377,414,499,59,10,982
E01023378,581,607,103,21,1312
E01023379,619,434,176,80,1309
E01023380,484,337,75,35,931
E01023381,462,546,63,25,1096
E01023382,462,331,140,245,1178
E01023383,531,311,99,250,1191
E01023384,543,268,144,548,1503
E01023385,603,442,76,277,1398
E01023386,401,226,132,460,1219
E01023387,377,167,79,378,1001
E01023388,518,368,174,212,1272
E01023389,677,441,107,129,1354
E01023390,662,358,159,429,1608
E01023391,622,329,144,228,1323
E01023392,479,226,84,441,1230
E01023393,452,199,220,539,1410
E01023394,507,256,109,211,1083
E01023395,518,188,149,373,1228
E01023396,565,311,106,272,1254
E01023397,278,88,63,590,1019
E01023398,844,379,500,233,1956
E01023399,508,287,270,296,1361
E01023400,490,337,242,367,1436
E01023401,444,133,117,658,1352
E01023402,452,275,165,379,1271
E01023403,362,266,148,418,1194
E01023404,203,54,92,630,979
E01023405,266,163,118,594,1141
E01023406,606,460,181,298,1545
E01023407,596,466,108,152,1322
E01023408,567,546,121,63,1297
E01023409,461,367,141,237,1206
E01023410,452,585,53,74,1164
E01023411,487,288,92,292,1159
E01023412,473,553,20,49,1095
E01023413,411,232,74,321,1038
E01023414,494,215,169,266,1144
E01023415,484,413,58,153,1108
E01023416,447,600,136,26,1209
E01023417,373,418,130,182,1103
E01023418,424,189,64,463,1140
E01023419,837,374,220,196,1627
E01023420,569,470,112,84,1235
E01023421,528,427,143,99,1197
E01023422,419,524,70,9,1022
E01023423,495,437,56,79,1067
E01023424,515,345,96,140,1096
E01023425,475,441,76,67,1059
E01023426,450,319,282,96,1147
E01023427,539,211,68,470,1288
E01023428,596,358,166,95,1215
E01023429,449,245,100,666,1460
E01023430,411,360,100,70,941
E01023431,385,331,152,139,1007
E01023432,585,322,119,114,1140
E01023433,520,232,161,275,1188
E01023434,583,238,212,201,1234
E01023435,584,234,345,60,1223
E01023436,532,341,87,30,990
E01023437,294,98,214,546,1152
E01023438,504,320,198,112,1134
E01023439,448,322,137,182,1089
E01023440,595,666,63,28,1352
E01023441,392,246,249,48,935
E01023442,685,364,374,202,1625
E01023443,670,298,137,141,1246
E01023444,597,337,314,37,1285
E01023445,575,322,105,378,1380
E01023446,579,289,700,253,1821
E01023447,203,91,49,594,937
E01023448,619,303,117,116,1155
E01023449,567,508,197,8,1280
E01023450,536,367,499,232,1634
E01023451,792,739,217,23,1771
E01023452,693,245,54,36,1028
E01023453,488,387,172,25,1072
E01023454,587,341,85,11,1024
E01023455,527,336,130,37,1030
E01023456,696,327,72,6,1101
E01023457,650,370,160,17,1197
E01023458,521,331,150,64,1066
E01023459,643,389,63,2,1097
E01023460,681,382,76,5,1144
E01023461,772,288,47,16,1123
E01023462,462,361,97,142,1062
E01023463,366,383,99,132,980
E01023464,861,704,100,34,1699
E01023465,549,431,92,85,1157
E01023466,528,467,166,249,1410
E01023467,735,823,152,267,1977
E01023468,581,377,109,25,1092
E01023469,445,319,106,325,1195
E01023470,622,325,437,87,1471
E01023471,473,465,102,26,1066
E01023472,354,213,85,408,1060
E01023473,467,638,75,7,1187
E01023474,657,435,101,9,1202
E01023475,423,232,127,378,1160
E01023476,487,578,76,46,1187
E01023477,829,405,378,80,1692
E01023478,494,296,504,177,1471
E01023479,604,391,213,92,1300
E01023480,471,503,97,223,1294
E01023481,384,295,261,32,972
E01023482,966,280,127,31,1404
E01023483,784,450,152,120,1506
E01023484,616,208,108,246,1178
E01023485,746,679,260,190,1875
E01023486,778,860,201,196,2035
E01023487,370,217,63,441,1091
E01023488,351,195,97,531,1174
E01023489,534,387,125,48,1094
E01023490,443,310,37,173,963
E01023491,351,336,158,169,1014
E01023492,516,386,110,190,1202
E01023493,887,665,169,192,1913
E01023494,338,351,121,171,981
E01023495,428,358,101,104,991
E01023496,336,308,128,114,886
E01023497,469,443,144,202,1258
E01023498,1036,594,188,297,2115
E01023499,587,343,108,378,1416
E01023500,589,651,51,11,1302
E01023501,633,444,109,62,1248
E01023502,593,433,358,20,1404
E01023503,623,612,164,43,1442
E01023504,398,288,167,218,1071
E01023505,737,369,201,43,1350
E01023506,457,439,98,137,1131
E01023507,594,436,145,61,1236
E01023508,490,382,152,161,1185
E01023509,473,321,100,174,1068
E01023510,532,497,101,68,1198
E01023511,452,208,413,237,1310
E01023512,715,414,285,114,1528
E01023513,461,411,62,251,1185
E01023514,479,349,440,175,1443
E01023515,725,323,203,10,1261
E01023516,872,655,143,32,1702
E01023517,493,367,177,242,1279
E01023518,562,429,68,427,1486
E01023519,638,270,93,332,1333
E01023520,637,509,117,25,1288
E01023523,691,548,83,11,1333
E01023524,484,612,60,9,1165
E01023525,454,487,355,78,1374
E01023526,643,634,134,6,1417
E01023527,439,307,93,294,1133
E01023528,497,370,330,46,1243
E01023529,489,213,113,337,1152
E01023530,151,106,304,403,964
E01023531,675,338,236,266,1515
E01023532,633,369,209,75,1286
E01023533,488,216,127,377,1208
E01023534,554,222,58,485,1319
E01023535,539,237,130,373,1279
E01023536,240,91,120,766,1217
E01023537,538,288,121,466,1413
E01023538,385,202,201,563,1351
E01023539,974,351,711,157,2193
E01023540,630,363,88,212,1293
E01023541,807,391,129,146,1473
E01023542,614,307,164,326,1411
E01023543,428,203,125,366,1122
E01023544,500,214,115,98,927
E01023545,431,162,213,187,993
E01023546,593,264,163,358,1378
E01023547,448,241,118,517,1324
E01023548,571,654,210,50,1485
E01023549,508,542,257,33,1340
E01023550,451,458,407,23,1339
E01023551,604,510,70,8,1192
E01023552,619,395,63,228,1305
E01023553,623,340,208,33,1204
E01023554,519,313,334,169,1335
E01023555,453,349,203,304,1309
E01023556,607,372,103,160,1242
E01023557,613,396,107,62,1178
E01023558,615,468,195,29,1307
E01023559,557,471,150,22,1200
E01023560,364,160,152,439,1115
E01023561,488,343,197,228,1256
E01023562,544,482,63,86,1175
E01023563,537,390,199,46,1172
E01023564,602,263,240,173,1278
E01023565,668,403,208,47,1326
E01023566,641,510,56,7,1214
E01023567,868,625,84,42,1619
E01023568,527,651,61,32,1271
E01023569,534,393,124,199,1250
E01023570,469,225,195,311,1200
E01023571,501,571,93,30,1195
E01023572,558,414,123,129,1224
E01023573,319,152,162,371,1004
E01023574,440,272,123,418,1253
E01023575,542,390,154,191,1277
E01023576,441,616,150,18,1225
E01023577,551,725,174,17,1467
E01023578,509,723,126,5,1363
E01023579,368,325,395,65,1153
E01023580,520,484,284,78,1366
E01023581,618,243,81,31,973
E01023582,602,261,95,233,1191
E01023583,438,251,145,244,1078
E01023584,334,226,118,165,843
E01023585,333,339,174,81,927
E01023586,487,460,144,136,1227
E01023587,526,217,137,12,892
E01023588,648,317,91,26,1082
E01023589,457,428,295,183,1363
E01023590,571,371,209,188,1339
E01023591,548,482,91,72,1193
E01023592,357,206,74,462,1099
E01023593,433,262,91,323,1109
E01023594,591,616,175,450,1832
E01023595,552,436,162,72,1222
E01023596,345,291,55,229,920
E01023597,429,352,107,82,970
E01023598,340,378,171,178,1067
E01023600,403,293,129,260,1085
E01023601,603,303,618,289,1813
E01023602,597,331,233,69,1230
E01023603,625,405,175,31,1236
E01023604,537,399,108,54,1098
E01023605,504,128,390,180,1202
E01023606,482,340,209,287,1318
E01023607,533,511,98,14,1156
E01023608,513,614,83,21,1231
E01023609,462,412,336,56,1266
E01023610,568,313,116,12,1009
E01023611,369,287,80,544,1280
E01023612,598,442,163,198,1401
E01023613,264,179,120,743,1306
E01023614,718,724,123,34,1599
E01023615,523,607,98,21,1249
E01023616,539,482,461,174,1656
E01023617,562,521,83,70,1236
E01023618,495,305,128,263,1191
E01023619,642,340,286,95,1363
E01023620,376,165,99,401,1041
E01023621,468,276,144,207,1095
E01023622,311,262,89,233,895
E01023623,407,356,156,227,1146
E01023624,352,246,213,232,1043
E01023625,317,294,227,41,879
E01023626,694,708,117,211,1730
E01023627,598,506,184,60,1348
E01023628,609,453,229,96,1387
E01023629,467,400,162,420,1449
E01023630,427,214,72,511,1224
E01023631,398,244,128,532,1302
E01023632,406,329,94,245,1074
E01023633,342,178,229,316,1065
E01023634,407,477,167,68,1119
E01023635,428,306,77,367,1178
E01023636,622,412,84,343,1461
E01023637,385,217,79,701,1382
E01023638,450,287,108,414,1259
E01023639,429,390,108,132,1059
E01023640,298,165,65,458,986
E01023641,322,173,52,493,1040
E01023642,468,573,27,36,1104
E01023643,428,281,60,274,1043
E01023644,422,562,190,172,1346
E01023645,403,403,119,300,1225
E01023646,285,160,46,531,1022
E01023647,507,610,95,48,1260
E01023648,354,487,92,46,979
E01023649,407,294,245,110,1056
E01023650,262,129,113,628,1132
E01023651,395,330,114,133,972
E01023652,307,225,66,513,1111
E01023653,668,477,235,305,1685
E01023654,623,511,128,22,1284
E01023655,549,526,78,105,1258
E01023656,714,384,450,273,1821
E01023657,965,786,218,44,2013
E01023658,503,434,77,246,1260
E01023659,602,422,49,14,1087
E01023660,698,536,381,225,1840
E01023661,398,226,67,371,1062
E01023662,680,268,176,81,1205
E01023663,598,600,292,201,1691
E01023664,673,340,229,70,1312
E01023665,588,345,230,33,1196
E01023666,445,230,498,255,1428
E01023667,544,328,241,12,1125
E01023668,595,326,50,72,1043
E01023669,426,192,88,556,1262
E01023670,784,393,169,188,1534
E01023671,592,357,108,421,1478
E01023672,602,382,91,341,1416
E01023673,487,475,103,38,1103
E01023674,659,376,322,68,1425
E01023675,474,509,56,28,1067
E01023676,580,372,584,201,1737
E01023677,369,117,77,283,846
E01023678,770,424,145,85,1424
E01023679,501,370,94,217,1182
E01023680,415,341,132,123,1011
E01023681,379,266,182,488,1315
E01023682,492,413,234,214,1353
E01023683,405,412,96,373,1286
E01023684,546,612,161,33,1352
E01023685,613,377,139,120,1249
E01023686,544,490,61,19,1114
E01023687,381,249,84,442,1156
E01023688,487,302,193,150,1132
E01023689,423,370,143,36,972
E01023690,574,463,112,17,1166
E01023691,575,442,48,16,1081
E01023692,371,241,99,221,932
E01023693,517,349,75,83,1024
E01023694,590,417,64,6,1077
E01023695,582,573,46,40,1241
E01023696,511,792,54,11,1368
E01023697,618,463,228,132,1441
E01023698,632,596,35,12,1275
E01023699,447,568,125,4,1144
E01023700,390,578,37,3,1008
E01023701,363,495,400,167,1425
E01023702,477,390,326,16,1209
E01023703,534,375,107,21,1037
E01023704,623,265,303,113,1304
E01023705,527,260,167,338,1292
E01023706,621,409,187,76,1293
E01023708,532,326,138,223,1219
E01023709,590,427,107,221,1345
E01023710,586,601,36,20,1243
E01023711,565,513,72,98,1248
E01023712,530,398,290,147,1365
E01023713,649,385,145,227,1406
E01023714,578,705,85,15,1383
E01023715,571,449,56,93,1169
E01023716,751,466,325,26,1568
E01023717,540,281,107,54,982
E01023718,631,673,87,26,1417
E01023719,346,263,85,207,901
E01023720,568,348,250,251,1417
E01023721,534,495,60,30,1119
E01023722,450,404,220,70,1144
E01023723,501,285,80,454,1320
E01023724,502,535,142,72,1251
E01023725,557,508,83,27,1175
E01023726,629,216,516,69,1430
E01023727,392,275,685,262,1614
E01023728,691,472,456,131,1750
E01023729,417,286,486,270,1459
E01023730,648,653,62,13,1376
E01023731,513,470,133,56,1172
E01023732,561,615,162,15,1353
E01023733,649,631,56,4,1340
E01023734,671,507,112,22,1312
E01023735,711,521,187,40,1459
E01023736,474,346,150,236,1206
E01023737,326,166,145,403,1040
E01023738,394,206,133,499,1232
E01023739,448,229,147,232,1056
E01023740,383,254,306,155,1098
E01023741,612,345,152,110,1219
E01023742,420,681,58,4,1163
E01023743,503,578,317,16,1414
E01023744,476,698,66,0,1240
E01023745,567,525,266,27,1385
E01023746,401,251,94,421,1167
E01023747,593,488,127,168,1376
E01023748,404,569,94,73,1140
E01023749,632,585,73,36,1326
E01023750,338,113,86,470,1007
E01023751,449,219,64,189,921
E01023752,462,225,73,262,1022
E01023753,706,303,177,27,1213
E01023754,534,181,74,224,1013
E01023755,451,311,134,373,1269
E01023756,409,176,113,498,1196
E01023757,480,273,203,507,1463
E01023758,281,241,264,757,1543
E01023759,555,222,87,281,1145
E01023760,578,360,88,223,1249
E01023761,703,275,244,440,1662
E01023762,542,331,84,269,1226
E01023763,634,328,73,165,1200
E01023764,551,301,94,252,1198
E01023765,492,359,61,258,1170
E01023766,469,255,95,369,1188
E01023767,777,268,157,8,1210
E01023768,827,326,168,29,1350
E01023769,586,355,85,320,1346
E01023770,702,402,133,31,1268
E01023771,670,313,171,158,1312
E01023772,580,308,149,363,1400
E01023773,353,173,85,421,1032
E01023774,470,250,194,316,1230
E01023775,512,267,309,509,1597
E01023776,973,492,286,298,2049
E01023777,623,444,193,193,1453
E01023778,365,169,104,658,1296
E01023779,470,230,189,390,1279
E01023780,513,247,130,308,1198
E01023781,410,269,163,519,1361
E01023782,467,389,110,213,1179
E01023783,526,198,176,408,1308
E01023784,575,359,82,308,1324
E01023785,481,203,108,437,1229
E01023786,445,277,181,299,1202
E01023787,507,224,170,201,1102
E01023788,530,217,157,301,1205
E01023789,716,219,154,387,1476
E01023790,557,180,190,350,1277
E01023791,547,285,84,347,1263
E01023792,482,203,96,425,1206
E01023793,336,194,101,471,1102
E01023794,442,211,108,446,1207
E01023795,510,313,216,241,1280
E01023796,348,200,200,459,1207
E01023797,408,168,83,407,1066
E01023798,520,291,234,154,1199
E01023799,495,359,85,177,1116
E01023800,563,451,255,270,1539
E01023801,1019,252,224,275,1770
E01023802,676,474,133,94,1377
E01023803,591,545,41,52,1229
E01023804,444,312,96,338,1190
E01023805,574,222,80,371,1247
E01023806,785,317,128,462,1692
E01023807,487,400,57,264,1208
E01023808,905,614,423,108,2050
E01023809,596,548,153,111,1408
E01023810,687,738,75,7,1507
E01023811,524,592,136,3,1255
E01023812,554,566,48,3,1171
E01023813,670,409,54,12,1145
E01023814,340,494,75,14,923
E01023815,508,480,103,100,1191
E01023816,375,425,64,115,979
E01023817,415,412,259,8,1094
E01023818,502,531,24,24,1081
E01023819,593,373,189,91,1246
E01023820,443,486,82,42,1053
E01023821,528,426,55,29,1038
E01023822,548,431,69,26,1074
E01023823,466,366,83,197,1112
E01023824,772,664,87,27,1550
E01023825,942,593,251,12,1798
E01023826,570,402,68,86,1126
E01023827,765,295,153,432,1645
E01023828,409,186,97,462,1154
E01023829,493,231,82,488,1294
E01023830,503,317,126,249,1195
E01023831,894,367,134,146,1541
E01023832,664,214,175,252,1305
E01023833,1000,440,159,170,1769
E01023834,650,394,102,85,1231
E01023835,482,370,33,235,1120
E01023836,452,174,199,304,1129
E01023837,632,296,180,123,1231
E01023838,316,183,74,385,958
E01023839,857,859,128,11,1855
E01023840,328,457,364,12,1161
E01023841,515,596,238,3,1352
E01023842,401,177,68,521,1167
E01023843,743,237,135,379,1494
E01023844,257,99,148,717,1221
E01023845,611,430,73,264,1378
E01023846,656,451,61,70,1238
E01023847,747,348,225,125,1445
E01023848,601,234,81,345,1261
E01023849,479,579,88,45,1191
E01023850,378,292,364,160,1194
E01023851,371,399,473,57,1300
E01023852,479,398,132,115,1124
E01023853,795,747,81,14,1637
E01023854,553,748,147,105,1553
E01023855,685,221,532,50,1488
E01023856,894,303,561,42,1800
E01023857,490,175,297,311,1273
E01023858,684,229,433,33,1379
E01023859,627,202,750,124,1703
E01023860,428,147,428,524,1527
E01023861,516,325,910,161,1912
E01023862,609,345,481,202,1637
E01023863,509,346,466,43,1364
E01023864,441,141,266,284,1132
E01023865,340,122,135,618,1215
E01023866,318,135,84,550,1087
E01023867,584,280,600,191,1655
E01023868,510,262,128,409,1309
E01023869,496,177,120,265,1058
E01023870,405,112,111,443,1071
E01023871,464,213,186,53,916
E01023872,654,384,247,55,1340
E01023873,333,179,91,390,993
E01023874,492,294,55,173,1014
E01023875,724,567,160,99,1550
E01023876,386,108,50,735,1279
E01023877,539,241,80,433,1293
E01023878,723,696,166,24,1609
E01023879,700,413,512,75,1700
E01023880,495,322,544,120,1481
E01023881,650,410,109,72,1241
E01023882,624,485,102,61,1272
E01023883,450,230,114,478,1272
E01023884,667,323,304,84,1378
E01023885,743,474,199,25,1441
E01023886,984,467,488,173,2112
E01023887,587,667,96,15,1365
E01023888,535,430,181,88,1234
E01023889,669,631,48,27,1375
E01023890,503,303,109,89,1004
E01023891,339,138,75,511,1063
E01023892,488,254,79,204,1025
E01023893,639,565,168,39,1411
E01023894,627,364,124,21,1136
E01023895,552,290,486,16,1344
E01023896,545,357,124,16,1042
E01023897,559,537,109,114,1319
E01023898,673,490,78,12,1253
E01023899,377,240,472,51,1140
E01023900,552,325,444,13,1334
E01023901,714,224,454,27,1419
E01023902,464,276,339,151,1230
E01023903,531,211,332,96,1170
E01023904,656,334,112,459,1561
E01023905,719,259,201,316,1495
E01023906,465,168,52,502,1187
E01023907,643,403,200,124,1370
E01023908,530,589,138,17,1274
E01023909,414,446,69,8,937
E01023910,505,458,142,28,1133
E01023911,527,570,122,76,1295
E01023912,553,367,109,146,1175
E01023913,456,269,91,275,1091
E01023914,452,274,101,532,1359
E01023915,444,208,184,342,1178
E01023916,571,291,92,366,1320
E01023917,557,507,135,206,1405
E01023918,313,475,270,442,1500
E01023919,549,567,45,68,1229
E01023920,113,74,396,709,1292
E01023921,364,194,773,459,1790
E01023922,300,152,503,483,1438
E01023923,387,320,625,273,1605
E01023924,189,87,626,499,1401
E01023925,342,317,268,113,1040
E01023926,571,552,333,44,1500
E01023927,394,188,269,478,1329
E01023929,474,313,190,320,1297
E01023930,371,174,307,451,1303
E01023932,290,189,658,339,1476
E01023933,253,149,408,464,1274
E01023934,228,109,692,226,1255
E01023935,284,218,475,194,1171
E01023936,428,308,596,476,1808
E01023937,149,113,579,343,1184
E01023938,577,401,196,122,1296
E01023939,331,154,74,392,951
E01023940,479,247,130,505,1361
E01023941,964,293,366,537,2160
E01023942,474,195,109,468,1246
E01023943,479,228,66,371,1144
E01023944,636,325,115,528,1604
E01023945,482,224,43,508,1257
E01023946,462,348,106,316,1232
E01023947,483,477,227,133,1320
E01023948,584,717,52,6,1359
E01023949,712,844,47,2,1605
E01023950,662,360,121,133,1276
E01023951,352,262,78,618,1310
E01023952,551,226,269,372,1418
E01023953,619,331,131,88,1169
E01023954,293,116,133,718,1260
E01023955,284,154,61,516,1015
E01023956,365,83,88,489,1025
E01023957,334,103,162,528,1127
E01023958,204,56,109,657,1026
E01023959,486,551,85,25,1147
E01023960,473,359,86,334,1252
E01023961,372,273,96,406,1147
E01023962,448,414,55,235,1152
E01023963,682,504,316,365,1867
E01023964,488,522,166,26,1202
E01023965,581,502,46,7,1136
E01023966,577,627,82,24,1310
E01023967,481,280,133,184,1078
E01023968,455,501,51,49,1056
E01023969,433,451,140,126,1150
E01023970,347,194,117,431,1089
E01023971,589,596,78,50,1313
E01023972,448,158,92,313,1011
E01023973,373,111,190,539,1213
E01023974,375,217,115,323,1030
E01023975,397,271,149,455,1272
E01023976,499,226,162,415,1302
E01023977,504,262,164,42,972
E01023978,348,613,89,14,1064
E01023979,382,346,95,192,1015
E01023980,355,423,45,133,956
E01023981,404,225,76,262,967
E01023983,443,568,118,23,1152
E01023984,308,170,78,345,901
E01023985,338,503,74,48,963
E01023986,341,350,118,219,1028
E01023987,242,321,123,172,858
E01023988,431,456,196,51,1134
E01023989,465,419,43,36,963
E01023990,332,310,106,235,983
E01023992,515,240,252,192,1199
E01023993,635,258,189,28,1110
E01023995,474,403,100,9,986
E01023996,592,269,143,9,1013
E01023997,446,435,105,212,1198
E01023998,325,401,71,124,921
E01023999,798,782,177,34,1791
E01024001,407,273,227,306,1213
E01024002,450,208,348,84,1090
E01024003,595,652,132,71,1450
E01024004,604,522,233,39,1398
E01024005,580,347,180,123,1230
E01024006,611,225,104,10,950
E01024008,919,265,259,22,1465
E01024009,280,478,144,36,938
E01024010,326,416,132,193,1067
E01024011,426,416,91,45,978
E01024012,361,371,63,74,869
E01024013,570,469,169,165,1373
E01024014,615,606,103,41,1365
E01024015,559,592,162,32,1345
E01024016,525,227,333,24,1109
E01024017,713,290,235,155,1393
E01024019,408,128,183,305,1024
E01024020,386,130,147,598,1261
E01024021,358,277,380,44,1059
E01024022,408,470,134,151,1163
E01024023,791,364,488,210,1853
E01024024,572,885,226,221,1904
E01024025,190,388,133,233,944
E01024026,417,433,85,98,1033
E01024027,361,233,499,165,1258
E01024028,414,184,195,496,1289
E01024029,746,508,291,314,1859
E01024031,430,518,154,121,1223
E01024032,513,530,115,103,1261
E01024033,593,522,143,146,1404
E01024034,987,643,220,81,1931
E01024035,342,386,75,80,883
E01024036,462,384,90,132,1068
E01024037,591,534,172,125,1422
E01024038,510,778,152,121,1561
E01024039,590,487,92,51,1220
E01024040,243,291,136,274,944
E01024041,300,409,197,9,915
E01024042,443,341,135,136,1055
E01024043,459,560,77,14,1110
E01024044,381,361,797,117,1656
E01024045,414,517,303,112,1346
E01024046,480,485,355,107,1427
E01024047,99,68,575,329,1071
E01024048,143,167,727,251,1288
E01024049,166,109,307,582,1164
E01024052,759,305,247,357,1668
E01024053,677,526,255,23,1481
E01024054,567,623,195,84,1469
E01024055,493,684,107,25,1309
E01024056,680,905,49,4,1638
E01024057,666,781,104,6,1557
E01024058,620,487,185,9,1301
E01024059,366,425,161,317,1269
E01024060,502,412,293,28,1235
E01024061,257,184,124,578,1143
E01024062,597,470,112,63,1242
E01024063,652,476,109,15,1252
E01024064,998,656,177,76,1907
E01024065,775,593,196,19,1583
E01024066,407,315,137,361,1220
E01024067,366,405,131,7,909
E01024068,422,536,168,42,1168
E01024069,527,283,213,28,1051
E01024070,328,378,344,84,1134
E01024071,586,341,190,195,1312
E01024072,364,253,427,15,1059
E01024073,769,539,198,55,1561
E01024074,625,476,72,8,1181
E01024075,558,501,155,79,1293
E01024076,843,408,183,18,1452
E01024077,580,387,167,2,1136
E01024078,355,299,640,56,1350
E01024079,527,474,157,22,1180
E01024080,279,188,415,81,963
E01024081,354,273,413,168,1208
E01024082,465,357,228,44,1094
E01024083,314,319,128,346,1107
E01024084,341,268,105,173,887
E01024085,463,521,226,39,1249
E01024086,689,367,248,239,1543
E01024087,363,404,129,36,932
E01024088,473,422,213,81,1189
E01024089,358,406,159,30,953
E01024090,296,201,731,358,1586
E01024091,329,149,203,408,1089
E01024092,145,105,732,377,1359
E01024093,157,145,458,441,1201
E01024094,911,842,156,61,1970
E01024095,460,399,280,13,1152
E01024096,573,702,121,36,1432
E01024097,518,609,81,120,1328
E01024098,498,713,81,8,1300
E01024099,141,126,640,368,1275
E01024100,216,291,763,131,1401
E01024101,271,261,866,234,1632
E01024102,321,443,685,121,1570
E01024103,118,229,517,525,1389
E01024104,316,404,1000,97,1817
E01024105,516,686,70,41,1313
E01024106,466,613,173,7,1259
E01024107,594,497,92,13,1196
E01024108,228,330,93,277,928
E01024109,806,866,135,34,1841
E01024110,428,510,123,31,1092
E01024111,475,304,99,293,1171
E01024112,653,557,102,18,1330
E01024113,378,433,201,41,1053
E01024114,623,679,138,2,1442
E01024115,455,677,77,7,1216
E01024116,434,581,154,30,1199
E01024117,484,606,92,19,1201
E01024118,625,522,186,85,1418
E01024119,499,282,130,244,1155
E01024120,516,671,168,11,1366
E01024121,313,386,571,67,1337
E01024122,296,248,377,247,1168
E01024123,456,450,399,52,1357
E01024124,138,228,557,20,943
E01024126,249,158,359,421,1187
E01024127,552,551,125,76,1304
E01024128,297,143,297,492,1229
E01024129,302,249,777,106,1434
E01024130,596,386,717,410,2109
E01024131,374,461,412,27,1274
E01024132,448,259,49,251,1007
E01024133,605,221,99,20,945
E01024134,627,390,91,205,1313
E01024135,379,210,172,280,1041
E01024136,548,403,257,46,1254
E01024137,582,425,152,30,1189
E01024138,593,378,135,163,1269
E01024139,661,691,109,5,1466
E01024140,1188,230,502,150,2070
E01024141,638,348,172,71,1229
E01024142,967,261,510,405,2143
E01024143,969,307,479,55,1810
E01024144,674,450,72,4,1200
E01024145,690,474,119,5,1288
E01024146,624,502,76,0,1202
E01024147,742,501,127,6,1376
E01024148,273,137,125,780,1315
E01024149,994,269,333,570,2166
E01024150,531,707,64,11,1313
E01024151,521,668,27,10,1226
E01024152,1085,380,214,208,1887
E01024153,585,536,36,16,1173
E01024154,329,210,41,400,980
E01024155,307,176,61,498,1042
E01024156,526,307,385,136,1354
E01024157,555,563,120,108,1346
E01024158,470,495,192,89,1246
E01024159,619,677,57,17,1370
E01024160,492,630,66,6,1194
E01024161,849,324,305,85,1563
E01024162,634,222,414,57,1327
E01024163,674,481,213,50,1418
E01024164,666,332,455,38,1491
E01024165,274,121,141,631,1167
E01024166,521,194,132,431,1278
E01024167,642,314,237,249,1442
E01024168,466,261,76,206,1009
E01024169,435,252,163,335,1185
E01024170,415,194,131,437,1177
E01024171,541,265,222,179,1207
E01024172,671,267,541,132,1611
E01024173,729,552,96,36,1413
E01024174,472,227,69,186,954
E01024175,527,334,86,89,1036
E01024176,470,292,289,245,1296
E01024177,295,178,68,528,1069
E01024178,534,218,195,295,1242
E01024179,690,260,829,364,2143
E01024180,539,189,379,56,1163
E01024181,569,246,199,26,1040
E01024182,450,198,447,190,1285
E01024183,575,393,89,22,1079
E01024184,777,376,297,66,1516
E01024185,725,436,330,118,1609
E01024186,564,381,78,10,1033
E01024187,456,350,47,37,890
E01024188,482,437,58,34,1011
E01024189,585,437,90,188,1300
E01024190,379,353,343,116,1191
E01024191,651,371,116,243,1381
E01024192,386,262,87,529,1264
E01024193,274,176,214,553,1217
E01024194,497,267,287,123,1174
E01024195,502,257,87,259,1105
E01024196,341,207,115,492,1155
E01024197,459,354,207,238,1258
E01024198,747,1046,164,98,2055
E01024200,602,594,192,47,1435
E01024201,518,402,226,65,1211
E01024202,495,477,155,360,1487
E01024203,564,559,184,27,1334
E01024204,460,418,87,291,1256
E01024205,583,428,93,172,1276
E01024206,532,592,129,208,1461
E01024207,562,560,192,123,1437
E01024208,468,377,228,214,1287
E01024209,503,543,226,140,1412
E01024212,588,429,189,58,1264
E01024213,597,468,87,1,1153
E01024214,409,247,460,145,1261
E01024215,327,132,619,97,1175
E01024216,616,312,232,21,1181
E01024217,505,428,248,212,1393
E01024218,341,199,119,308,967
E01024219,362,416,84,177,1039
E01024220,466,621,183,54,1324
E01024221,565,553,131,27,1276
E01024222,472,281,169,315,1237
E01024223,555,348,117,233,1253
E01024224,549,502,114,103,1268
E01024225,613,424,201,89,1327
E01024226,452,368,117,254,1191
E01024227,503,350,260,77,1190
E01024228,329,534,405,47,1315
E01024229,495,385,215,168,1263
E01024230,354,525,305,29,1213
E01024231,366,407,503,24,1300
E01024232,541,912,161,117,1731
E01024233,651,611,62,3,1327
E01024234,514,548,69,41,1172
E01024235,502,572,159,27,1260
E01024236,493,605,165,110,1373
E01024237,399,800,130,45,1374
E01024238,371,210,439,121,1141
E01024239,418,335,453,230,1436
E01024240,269,90,183,594,1136
E01024241,562,239,455,280,1536
E01024242,524,627,218,30,1399
E01024243,458,424,139,361,1382
E01024244,421,618,438,77,1554
E01024245,587,596,162,138,1483
E01024246,466,268,629,160,1523
E01024247,414,291,537,319,1561
E01024248,494,215,330,397,1436
E01024249,387,312,258,631,1588
E01024250,491,585,164,169,1409
E01024251,447,552,127,202,1328
E01024252,788,735,431,53,2007
E01024253,492,795,156,16,1459
E01024254,635,509,144,307,1595
E01024255,473,727,73,49,1322
E01024256,604,534,44,12,1194
E01024257,362,170,680,385,1597
E01024258,464,346,336,116,1262
E01024259,626,474,128,2,1230
E01024260,630,540,302,45,1517
E01024261,727,840,222,37,1826
E01024262,515,295,298,233,1341
E01024263,342,205,107,517,1171
E01024264,450,261,57,445,1213
E01024265,484,466,81,17,1048
E01024266,339,329,88,198,954
E01024267,544,525,90,88,1247
E01024268,590,661,82,10,1343
E01024269,689,787,75,19,1570
E01024270,528,543,87,9,1167
E01024271,487,395,113,161,1156
E01024272,533,609,56,39,1237
E01024273,682,481,78,10,1251
E01024274,584,603,55,18,1260
E01024275,668,334,79,3,1084
E01024276,792,533,518,117,1960
E01024277,460,226,300,384,1370
E01024278,253,112,285,728,1378
E01024279,427,224,337,148,1136
E01024280,446,206,168,468,1288
E01024281,493,383,119,135,1130
E01024282,520,294,363,63,1240
E01024283,481,262,204,59,1006
E01024284,465,297,341,93,1196
E01024285,520,363,76,129,1088
E01024286,661,532,64,72,1329
E01024287,438,325,81,359,1203
E01024288,429,539,48,55,1071
E01024290,478,410,299,75,1262
E01024291,331,363,586,152,1432
E01024292,516,486,261,46,1309
E01024293,504,409,288,95,1296
E01024294,596,189,205,578,1568
E01024295,323,185,567,386,1461
E01024296,754,394,839,258,2245
E01024297,710,456,57,13,1236
E01024298,574,540,59,10,1183
E01024299,564,479,104,6,1153
E01024300,594,512,55,48,1209
E01024301,354,450,113,87,1004
E01024302,489,508,102,134,1233
E01024303,607,250,176,173,1206
E01024304,524,309,127,255,1215
E01024305,236,135,112,605,1088
E01024306,185,84,45,527,841
E01024307,438,396,60,316,1210
E01024308,274,151,75,580,1080
E01024309,378,168,72,317,935
E01024310,414,384,63,379,1240
E01024311,361,172,94,323,950
E01024312,485,333,73,146,1037
E01024313,614,415,173,82,1284
E01024314,457,382,120,70,1029
E01024315,493,262,99,352,1206
E01024316,669,505,154,107,1435
E01024317,638,417,197,89,1341
E01024318,612,400,208,15,1235
E01024319,478,403,79,245,1205
E01024320,524,401,44,4,973
E01024321,574,759,66,7,1406
E01024322,426,476,46,20,968
E01024323,468,552,100,6,1126
E01024324,575,471,129,5,1180
E01024325,732,1067,125,64,1988
E01024326,639,812,93,16,1560
E01024327,653,490,149,24,1316
E01024328,501,545,143,67,1256
E01024329,566,581,75,10,1232
E01024330,619,567,83,8,1277
E01024331,515,519,99,28,1161
E01024332,413,382,130,85,1010
E01024333,682,214,129,17,1042
E01024334,520,189,76,8,793
E01024335,672,436,142,44,1294
E01024336,711,493,130,4,1338
E01024337,623,453,110,3,1189
E01024338,709,348,65,5,1127
E01024339,578,284,508,150,1520
E01024340,703,404,636,92,1835
E01024341,579,656,148,2,1385
E01024342,584,382,138,254,1358
E01024343,588,432,63,44,1127
E01024344,522,582,74,11,1189
E01024345,516,465,181,78,1240
E01024346,412,421,168,82,1083
E01024347,615,515,141,59,1330
E01024348,662,349,84,2,1097
E01024349,643,197,229,5,1074
E01024350,561,369,115,102,1147
E01024351,540,476,187,69,1272
E01024352,453,240,426,335,1454
E01024353,695,623,163,17,1498
E01024354,495,438,224,7,1164
E01024355,686,421,427,40,1574
E01024356,487,290,423,47,1247
E01024357,563,249,344,154,1310
E01024358,523,327,164,365,1379
E01024360,597,322,205,108,1232
E01024361,547,522,145,179,1393
E01024362,652,496,184,62,1394
E01024363,766,642,130,118,1656
E01024364,457,579,159,141,1336
E01024365,601,618,174,41,1434
E01024366,523,581,181,73,1358
E01024367,493,278,204,114,1089
E01024369,575,458,149,33,1215
E01024371,591,463,118,131,1303
E01024372,584,249,601,139,1573
E01024373,512,318,410,250,1490
E01024374,356,133,215,514,1218
E01024375,884,777,170,155,1986
E01024376,890,763,98,112,1863
E01024377,490,494,223,121,1328
E01024378,460,333,136,175,1104
E01024379,622,479,206,69,1376
E01024380,593,534,209,17,1353
E01024381,474,276,104,267,1121
E01024382,425,158,520,89,1192
E01024383,465,128,820,181,1594
E01024384,619,334,218,279,1450
E01024385,565,460,88,152,1265
E01024386,633,489,183,28,1333
E01024387,796,770,328,127,2021
E01024388,1227,393,214,384,2218
E01024389,246,136,103,1026,1511
E01024390,234,138,78,552,1002
E01024391,348,163,72,441,1024
E01024392,582,259,120,321,1282
E01024393,476,391,83,255,1205
E01024394,596,461,52,35,1144
E01024395,574,222,53,286,1135
E01024396,472,243,75,401,1191
E01024397,348,220,99,517,1184
E01024398,438,219,63,600,1320
E01024399,364,244,66,422,1096
E01024400,418,439,66,149,1072
E01024401,593,238,187,141,1159
E01024402,558,558,62,26,1204
E01024403,746,283,289,115,1433
E01024404,608,566,84,2,1260
E01024405,739,622,221,108,1690
E01024406,459,346,189,77,1071
E01024407,557,453,149,12,1171
E01024408,586,425,118,28,1157
E01024409,495,487,146,79,1207
E01024410,551,534,81,120,1286
E01024411,350,291,208,123,972
E01024413,620,285,227,174,1306
E01024414,696,323,143,63,1225
E01024415,611,442,40,20,1113
E01024416,534,464,174,63,1235
E01024417,455,392,192,217,1256
E01024418,436,475,60,82,1053
E01024419,538,611,237,37,1423
E01024420,627,573,286,157,1643
E01024421,662,569,167,191,1589
E01024422,675,332,219,188,1414
E01024423,539,355,341,103,1338
E01024424,411,486,84,23,1004
E01024425,516,394,197,171,1278
E01024426,735,544,170,27,1476
E01024427,361,257,62,328,1008
E01024428,473,283,56,206,1018
E01024429,410,273,118,394,1195
E01024430,491,424,156,53,1124
E01024431,597,665,135,100,1497
E01024432,499,422,111,184,1216
E01024433,523,379,121,63,1086
E01024434,822,474,146,188,1630
E01024435,603,511,96,39,1249
E01024436,494,733,64,48,1339
E01024437,568,452,100,148,1268
E01024438,694,479,73,16,1262
E01024439,607,497,70,108,1282
E01024440,584,641,287,48,1560
E01024441,537,710,34,14,1295
E01024442,523,625,82,20,1250
E01024443,467,678,64,27,1236
E01024444,386,214,78,330,1008
E01024445,542,439,63,21,1065
E01024446,634,506,92,11,1243
E01024447,434,464,49,155,1102
E01024448,430,361,80,104,975
E01024449,462,631,47,46,1186
E01024450,507,431,99,163,1200
E01024451,601,584,337,242,1764
E01024452,399,413,171,139,1122
E01024453,521,665,82,25,1293
E01024454,501,446,71,189,1207
E01024455,381,306,166,88,941
E01024456,278,494,121,113,1006
E01024457,368,235,69,263,935
E01024458,375,496,190,20,1081
E01024459,461,495,175,117,1248
E01024460,437,349,131,356,1273
E01024461,733,611,391,152,1887
E01024462,519,465,100,216,1300
E01024463,445,516,111,36,1108
E01024464,461,597,126,43,1227
E01024465,465,256,227,191,1139
E01024466,385,263,94,283,1025
E01024467,593,514,128,42,1277
E01024468,451,396,220,91,1158
E01024469,369,380,518,24,1291
E01024470,393,521,207,84,1205
E01024471,305,420,334,173,1232
E01024472,498,331,98,199,1126
E01024473,685,486,87,62,1320
E01024474,508,463,48,9,1028
E01024475,527,469,145,79,1220
E01024476,345,114,62,607,1128
E01024477,396,187,85,463,1131
E01024478,525,450,66,128,1169
E01024479,602,532,66,40,1240
E01024480,372,293,101,577,1343
E01024481,497,273,67,417,1254
E01024482,429,201,91,457,1178
E01024483,527,426,261,60,1274
E01024484,339,472,136,43,990
E01024485,505,324,104,366,1299
E01024486,564,706,179,225,1674
E01024487,386,507,154,27,1074
E01024488,345,619,98,120,1182
E01024489,547,839,106,33,1525
E01024490,692,841,199,49,1781
E01024491,579,261,263,64,1167
E01024492,501,340,232,171,1244
E01024493,472,267,157,246,1142
E01024494,532,343,176,271,1322
E01024495,416,261,431,234,1342
E01024496,422,262,171,333,1188
E01024497,449,412,145,279,1285
E01024498,317,181,126,618,1242
E01024499,453,259,388,115,1215
E01024500,334,168,203,228,933
E01024501,432,216,433,44,1125
E01024502,382,150,349,171,1052
E01024503,551,415,164,262,1392
E01024504,278,191,979,174,1622
E01024505,492,286,363,257,1398
E01024507,304,146,829,309,1588
E01024508,256,271,938,118,1583
E01024509,214,393,709,56,1372
E01024510,306,430,625,23,1384
E01024511,425,464,203,8,1100
E01024512,506,429,416,19,1370
E01024513,498,432,288,77,1295
E01024514,454,363,229,21,1067
E01024515,481,597,144,8,1230
E01024516,448,486,70,147,1151
E01024517,395,270,645,14,1324
E01024518,641,509,90,170,1410
E01024519,385,402,304,6,1097
E01024520,466,243,192,229,1130
E01024521,474,544,376,43,1437
E01024522,327,441,271,99,1138
E01024523,408,762,107,5,1282
E01024524,294,392,179,367,1232
E01024525,262,539,481,53,1335
E01024526,482,654,119,7,1262
E01024527,366,699,131,11,1207
E01024528,332,279,225,180,1016
E01024529,338,535,101,249,1223
E01024530,545,540,105,38,1228
E01024531,409,470,119,183,1181
E01024532,512,550,161,17,1240
E01024533,317,507,196,10,1030
E01024534,424,257,143,340,1164
E01024535,740,660,372,83,1855
E01024536,759,699,119,49,1626
E01024537,561,627,212,15,1415
E01024538,522,783,110,6,1421
E01024539,524,408,287,396,1615
E01024540,545,646,82,30,1303
E01024541,681,373,289,476,1819
E01024542,772,566,192,54,1584
E01024544,487,549,111,39,1186
E01024545,467,584,166,15,1232
E01024546,560,512,135,93,1300
E01024547,371,528,116,105,1120
E01024548,357,328,121,187,993
E01024549,354,323,129,112,918
E01024550,675,708,204,49,1636
E01024551,738,469,373,177,1757
E01024552,599,262,134,457,1452
E01024553,529,607,419,97,1652
E01024554,887,760,199,138,1984
E01024555,348,389,120,108,965
E01024556,338,373,164,99,974
E01024557,453,378,108,244,1183
E01024558,585,524,142,72,1323
E01024559,423,284,276,109,1092
E01024560,406,246,158,183,993
E01024561,573,253,214,19,1059
E01024562,568,323,186,47,1124
E01024563,309,247,97,568,1221
E01024564,349,391,67,52,859
E01024565,401,365,157,114,1037
E01024566,410,428,169,191,1198
E01024567,982,376,305,383,2046
E01024568,1254,520,274,67,2115
E01024569,668,513,169,61,1411
E01024570,541,488,100,257,1386
E01024571,566,453,168,78,1265
E01024572,456,365,108,9,938
E01024573,481,448,73,85,1087
E01024575,464,405,38,54,961
E01024576,832,239,215,7,1293
E01024577,520,281,77,160,1038
E01024578,783,220,155,116,1274
E01024579,1004,196,347,484,2031
E01024580,386,577,290,121,1374
E01024581,544,318,164,31,1057
E01024582,586,441,160,92,1279
E01024583,630,260,134,200,1224
E01024584,396,233,170,518,1317
E01024585,345,333,120,332,1130
E01024586,597,565,145,35,1342
E01024587,488,595,133,27,1243
E01024588,549,531,76,41,1197
E01024589,610,620,88,35,1353
E01024590,210,132,199,564,1105
E01024591,645,286,262,220,1413
E01024592,529,322,130,40,1021
E01024593,497,243,167,109,1016
E01024594,503,539,104,33,1179
E01024595,558,471,165,35,1229
E01024596,441,383,292,140,1256
E01024597,284,235,238,361,1118
E01024598,606,366,215,28,1215
E01024599,595,289,440,150,1474
E01024600,385,331,112,395,1223
E01024601,573,409,164,221,1367
E01024602,524,381,200,121,1226
E01024603,526,317,130,25,998
E01024604,328,109,98,320,855
E01024605,512,485,83,38,1118
E01024606,520,366,124,54,1064
E01024608,468,392,402,181,1443
E01024609,205,118,435,112,870
E01024610,375,267,493,24,1159
E01024611,391,159,504,44,1098
E01024612,459,313,366,43,1181
E01024613,299,196,368,217,1080
E01024614,265,150,174,536,1125
E01024615,264,150,106,591,1111
E01024616,420,343,147,369,1279
E01024618,600,471,243,126,1440
E01024619,582,420,164,12,1178
E01024620,448,474,103,48,1073
E01024621,224,137,66,439,866
E01024622,495,475,180,195,1345
E01024623,646,481,134,249,1510
E01024624,492,408,320,206,1426
E01024625,679,636,157,76,1548
E01024626,592,448,148,28,1216
E01024627,470,397,133,497,1497
E01024628,514,426,176,99,1215
E01024629,496,332,59,41,928
E01024630,499,667,132,121,1419
E01024631,569,683,81,36,1369
E01024632,629,638,48,33,1348
E01024633,439,271,115,369,1194
E01024634,459,195,144,258,1056
E01024635,490,568,202,60,1320
E01024636,557,1016,259,7,1839
E01024637,479,806,109,8,1402
E01024638,448,682,183,62,1375
E01024639,411,644,305,52,1412
E01024640,449,689,142,84,1364
E01024641,313,448,179,296,1236
E01024642,332,755,150,8,1245
E01024643,314,290,355,66,1025
E01024644,461,574,63,12,1110
E01024645,510,339,188,131,1168
E01024646,389,349,658,134,1530
E01024647,498,263,427,25,1213
E01024648,401,270,398,121,1190
E01024649,329,271,712,84,1396
E01024650,591,527,99,5,1222
E01024651,367,454,288,93,1202
E01024652,706,694,152,1,1553
E01024653,515,634,185,18,1352
E01024654,480,570,166,90,1306
E01024655,458,644,135,1,1238
E01024656,452,626,320,25,1423
E01024657,220,106,1185,41,1552
E01024658,271,269,749,296,1585
E01024659,390,303,383,51,1127
E01024660,260,209,754,67,1290
E01024661,330,208,509,67,1114
E01024662,378,397,118,343,1236
E01024663,230,112,93,652,1087
E01024664,426,235,211,238,1110
E01024665,547,310,204,86,1147
E01024666,335,257,114,541,1247
E01024667,215,170,522,531,1438
E01024668,383,156,279,45,863
E01024669,503,303,429,64,1299
E01024670,388,221,494,76,1179
E01024671,252,333,692,118,1395
E01024672,376,227,104,425,1132
E01024673,565,534,297,83,1479
E01024674,711,456,91,35,1293
E01024675,756,765,221,8,1750
E01024676,278,149,649,206,1282
E01024677,439,174,468,131,1212
E01024678,173,141,924,292,1530
E01024679,361,592,87,98,1138
E01024680,594,486,187,36,1303
E01024681,540,329,408,17,1294
E01024682,389,175,118,594,1276
E01024683,296,190,115,659,1260
E01024684,497,345,249,138,1229
E01024685,522,434,185,293,1434
E01024686,490,475,145,248,1358
E01024687,309,166,119,523,1117
E01024688,441,592,165,135,1333
E01024689,447,441,149,21,1058
E01024690,396,511,91,205,1203
E01024691,454,367,126,22,969
E01024692,452,492,280,117,1341
E01024693,483,482,139,11,1115
E01024694,489,317,327,259,1392
E01024695,471,174,241,36,922
E01024696,453,365,199,79,1096
E01024697,239,114,264,293,910
E01024698,429,351,319,55,1154
E01024699,436,337,139,452,1364
E01024700,605,430,316,32,1383
E01024701,619,649,327,48,1643
E01024702,351,347,143,252,1093
E01024703,555,527,253,86,1421
E01024704,595,498,138,109,1340
E01024705,251,329,391,26,997
E01024706,476,430,242,10,1158
E01024707,435,443,206,3,1087
E01024708,446,716,105,11,1278
E01024709,447,574,70,70,1161
E01024710,237,157,537,8,939
E01024711,579,401,126,51,1157
E01024712,626,512,100,14,1252
E01024713,475,282,219,308,1284
E01024714,290,517,295,94,1196
E01024715,316,403,683,53,1455
E01024716,778,458,258,112,1606
E01024717,275,252,129,621,1277
E01024718,517,564,27,28,1136
E01024719,838,369,186,173,1566
E01024720,574,483,51,32,1140
E01024721,537,441,67,13,1058
E01024722,624,354,102,20,1100
E01024723,524,468,157,80,1229
E01024724,745,579,129,70,1523
E01024725,540,535,195,24,1294
E01024726,497,471,144,297,1409
E01024727,1185,537,258,92,2072
E01024728,608,404,73,240,1325
E01024729,477,439,40,402,1358
E01024730,388,543,53,82,1066
E01024731,400,498,42,27,967
E01024732,412,230,438,73,1153
E01024733,543,487,307,52,1389
E01024734,528,533,95,139,1295
E01024735,643,497,75,57,1272
E01024736,602,363,100,277,1342
E01024737,822,487,187,287,1783
E01024740,655,452,170,186,1463
E01024741,349,167,42,563,1121
E01024742,389,303,111,518,1321
E01024743,553,496,129,301,1479
E01024744,695,685,217,75,1672
E01024745,573,612,180,76,1441
E01024746,321,321,168,60,870
E01024747,334,273,90,531,1228
E01024748,549,542,51,25,1167
E01024749,329,284,53,496,1162
E01024750,427,511,42,234,1214
E01024751,483,712,65,17,1277
E01024752,607,566,91,29,1293
E01024753,566,506,79,97,1248
E01024754,617,478,121,99,1315
E01024755,716,643,155,66,1580
E01024756,458,231,284,284,1257
E01024757,551,361,267,105,1284
E01024758,563,357,132,197,1249
E01024760,623,301,34,167,1125
E01024761,919,517,172,145,1753
E01024762,998,431,161,83,1673
E01024763,576,347,36,142,1101
E01024764,418,329,81,192,1020
E01024765,598,439,47,48,1132
E01024766,686,393,287,302,1668
E01024767,306,263,67,499,1135
E01024768,547,467,306,44,1364
E01024771,605,247,202,346,1400
E01024772,727,389,97,119,1332
E01024773,756,554,88,53,1451
E01024774,876,402,292,394,1964
E01024775,356,158,60,604,1178
E01024776,360,235,26,409,1030
E01024777,306,280,40,394,1020
E01024778,647,302,264,30,1243
E01024779,564,353,356,221,1494
E01024780,446,271,142,358,1217
E01024781,796,565,202,71,1634
E01024782,648,298,60,20,1026
E01024783,444,401,219,283,1347
E01024784,501,456,93,64,1114
E01024785,621,329,88,130,1168
E01024786,514,489,143,327,1473
E01024787,388,349,132,84,953
E01024788,366,275,112,392,1145
E01024789,517,542,313,134,1506
E01024790,228,217,159,275,879
E01024791,447,466,127,51,1091
E01024792,606,641,193,55,1495
E01024793,536,567,136,146,1385
E01024794,536,441,154,157,1288
E01024795,289,160,103,530,1082
E01024796,364,331,195,238,1128
E01024797,488,616,207,98,1409
E01024798,720,639,285,260,1904
E01024799,585,585,402,49,1621
E01024800,560,627,123,11,1321
E01024801,559,297,1234,125,2215
E01024802,522,325,871,36,1754
E01024803,646,684,238,171,1739
E01024804,421,408,203,49,1081
E01024805,524,392,273,136,1325
E01024806,413,406,188,266,1273
E01024807,424,344,150,328,1246
E01024808,560,476,234,39,1309
E01024809,468,450,114,153,1185
E01024810,572,444,156,114,1286
E01024811,420,474,56,70,1020
E01024812,444,418,74,96,1032
E01024813,513,272,350,244,1379
E01024814,549,432,46,55,1082
E01024815,410,304,68,265,1047
E01024816,513,308,54,164,1039
E01024817,599,584,194,54,1431
E01024818,510,553,166,139,1368
E01024819,416,315,640,76,1447
E01024820,549,534,183,11,1277
E01024821,563,537,319,222,1641
E01024822,505,692,190,100,1487
E01024823,439,395,665,44,1543
E01024824,546,484,129,45,1204
E01024825,519,472,85,27,1103
E01024826,533,443,86,136,1198
E01024827,563,409,81,152,1205
E01024828,442,355,138,271,1206
E01024829,620,450,146,94,1310
E01024830,460,356,270,401,1487
E01024831,385,217,110,406,1118
E01024832,562,336,308,42,1248
E01024833,626,179,677,499,1981
E01024834,790,348,415,181,1734
E01024835,820,360,402,30,1612
E01024836,558,222,245,316,1341
E01024837,732,462,74,147,1415
E01024838,612,377,324,9,1322
E01024839,691,452,137,109,1389
E01024840,368,182,147,695,1392
E01024841,359,285,149,706,1499
E01024842,450,337,81,414,1282
E01024843,440,163,146,353,1102
E01024844,585,273,254,160,1272
E01024845,398,411,78,172,1059
E01024846,555,272,159,292,1278
E01024847,540,298,202,240,1280
E01024848,350,327,85,291,1053
E01024849,597,358,224,129,1308
E01024850,476,501,65,11,1053
E01024851,525,465,199,97,1286
E01024852,461,554,56,5,1076
E01024853,428,459,95,94,1076
E01024854,512,543,144,55,1254
E01024855,288,258,294,370,1210
E01024856,412,374,297,39,1122
E01024857,423,282,201,235,1141
E01024858,195,211,507,104,1017
E01024859,669,309,215,27,1220
E01024860,515,415,85,41,1056
E01024861,551,429,72,40,1092
E01024862,640,492,135,24,1291
E01024863,437,304,106,284,1131
E01024864,587,425,257,53,1322
E01024865,393,272,115,442,1222
E01024866,629,361,134,375,1499
E01024867,516,648,43,12,1219
E01024868,420,412,133,27,992
E01024869,525,646,76,4,1251
E01024870,392,461,95,30,978
E01024871,509,426,102,31,1068
E01024872,256,189,150,473,1068
E01024873,562,378,62,140,1142
E01024874,455,373,55,4,887
E01024875,180,484,189,70,923
E01024876,229,434,264,72,999
E01024877,263,276,324,202,1065
E01024878,266,443,246,59,1014
E01024879,429,300,171,141,1041
E01024880,474,425,88,183,1170
E01024881,498,341,271,26,1136
E01024882,468,258,328,128,1182
E01024883,422,270,139,363,1194
E01024884,501,469,116,194,1280
E01024885,398,303,555,83,1339
E01024886,423,310,336,24,1093
E01024887,552,334,131,163,1180
E01024888,660,532,141,40,1373
E01024889,385,368,225,82,1060
E01024890,376,217,196,319,1108
E01024891,450,484,93,242,1269
E01024892,473,474,102,137,1186
E01024893,396,302,410,30,1138
E01024894,527,325,84,154,1090
E01024895,318,290,378,35,1021
E01024896,484,436,112,88,1120
E01024897,390,470,157,24,1041
E01024898,441,372,383,25,1221
E01024899,418,308,200,326,1252
E01024900,307,179,181,519,1186
E01024901,851,424,209,12,1496
E01024902,517,314,242,107,1180
E01024903,383,210,84,282,959
E01024904,561,482,250,67,1360
E01024905,553,381,61,21,1016
E01024906,298,336,396,226,1256
E01024907,305,325,327,38,995
E01024908,184,150,317,209,860
E01024909,413,250,350,174,1187
E01024910,454,388,297,25,1164
E01024911,558,403,222,253,1436
E01024912,566,545,42,7,1160
E01024913,732,247,72,5,1056
E01024914,629,569,49,14,1261
E01024915,759,558,199,215,1731
E01024916,611,667,108,5,1391
E01024917,635,349,223,183,1390
E01024918,632,687,116,33,1468
E01024919,891,235,287,555,1968
E01024920,653,787,121,140,1701
E01024921,713,824,205,22,1764
E01024922,549,446,90,56,1141
E01024923,453,510,65,27,1055
E01024924,521,542,57,88,1208
E01024925,385,280,228,399,1292
E01024926,648,310,133,419,1510
E01024927,574,479,192,92,1337
E01024928,527,416,154,130,1227
E01024929,344,187,109,331,971
E01024930,514,353,169,112,1148
E01024931,458,363,202,142,1165
E01024932,395,393,51,27,866
E01024933,370,408,141,226,1145
E01024934,477,587,96,55,1215
E01024935,512,643,38,14,1207
E01024936,542,412,302,49,1305
E01024937,529,616,85,17,1247
E01024938,609,612,96,26,1343
E01024939,685,647,76,20,1428
E01024940,472,262,400,278,1412
E01024941,472,247,184,368,1271
E01024942,426,239,118,514,1297
E01024943,810,289,309,290,1698
E01024944,867,298,93,73,1331
E01024945,1022,404,362,340,2128
E01024946,530,359,43,71,1003
E01024947,667,291,56,13,1027
E01024948,634,461,71,33,1199
E01024949,1028,315,260,192,1795
E01024950,612,402,54,1,1069
E01024951,232,92,51,533,908
E01024952,326,154,81,416,977
E01024953,264,91,66,666,1087
E01024954,487,388,141,172,1188
E01024955,657,454,106,13,1230
E01024956,630,525,52,10,1217
E01024957,532,585,48,7,1172
E01024958,509,254,71,223,1057
E01024959,528,298,198,313,1337
E01024960,611,315,111,226,1263
E01024961,637,508,113,55,1313
E01024962,570,633,64,20,1287
E01024963,552,558,89,71,1270
E01024964,500,569,106,46,1221
E01024965,508,615,54,6,1183
E01024966,619,529,118,7,1273
E01024967,475,567,53,2,1097
E01024968,889,372,117,21,1399
E01024969,475,400,60,200,1135
E01024970,592,463,47,12,1114
E01024971,447,458,105,27,1037
E01024972,552,475,49,8,1084
E01024973,802,761,129,46,1738
E01024974,529,577,115,38,1259
E01024975,521,386,91,27,1025
E01024976,548,456,112,114,1230
E01024977,989,617,126,67,1799
E01024978,510,353,80,105,1048
E01024979,533,510,81,18,1142
E01024980,438,517,77,95,1127
E01024981,404,599,163,31,1197
E01024982,320,439,189,66,1014
E01024983,608,360,162,24,1154
E01024984,475,537,200,19,1231
E01024985,502,513,116,23,1154
E01024986,307,479,493,30,1309
E01024987,268,142,574,102,1086
E01024988,339,439,461,30,1269
E01024989,531,413,236,11,1191
E01024990,386,497,382,54,1319
E01024991,200,405,179,27,811
E01024992,299,788,115,13,1215
E01024993,524,554,97,40,1215
E01024994,494,656,178,7,1335
E01024995,446,542,196,6,1190
E01024996,274,303,392,29,998
E01024997,523,553,113,13,1202
E01024998,465,484,132,279,1360
E01024999,539,507,116,116,1278
E01025000,469,495,115,36,1115
E01025001,367,547,181,237,1332
E01025002,573,332,205,48,1158
E01025003,533,711,149,2,1395
E01025004,511,443,106,23,1083
E01025005,378,718,150,35,1281
E01025006,329,184,192,350,1055
E01025007,527,365,99,16,1007
E01025008,447,443,70,13,973
E01025009,427,432,234,152,1245
E01025010,488,449,54,45,1036
E01025011,450,264,248,189,1151
E01025012,881,496,102,122,1601
E01025013,538,260,227,246,1271
E01025014,577,512,149,134,1372
E01025015,643,492,90,46,1271
E01025016,861,885,194,14,1954
E01025017,384,426,111,338,1259
E01025018,362,568,114,11,1055
E01025019,436,615,99,37,1187
E01025020,401,295,160,152,1008
E01025021,494,460,201,61,1216
E01025022,624,448,353,58,1483
E01025023,518,507,74,27,1126
E01025024,344,504,204,81,1133
E01025025,598,359,198,66,1221
E01025026,365,523,148,55,1091
E01025027,510,353,371,107,1341
E01025028,521,396,87,118,1122
E01025029,605,816,216,61,1698
E01025030,522,313,204,218,1257
E01025031,314,628,76,21,1039
E01025032,400,308,164,238,1110
E01025033,1142,342,174,26,1684
E01025034,600,476,259,31,1366
E01025035,592,377,109,165,1243
E01025036,257,330,486,149,1222
E01025037,387,427,156,157,1127
E01025038,506,500,87,43,1136
E01025039,578,365,62,8,1013
E01025040,589,482,133,15,1219
E01025041,189,468,198,370,1225
E01025042,288,808,259,83,1438
E01025044,323,340,240,42,945
E01025045,259,169,85,400,913
E01025046,252,238,255,244,989
E01025048,572,572,121,52,1317
E01025049,402,326,335,223,1286
E01025050,596,341,192,64,1193
E01025051,375,301,100,289,1065
E01025052,603,522,95,19,1239
E01025053,625,348,171,76,1220
E01025054,607,430,183,217,1437
E01025055,423,328,259,159,1169
E01025056,488,612,54,0,1154
E01025057,567,503,203,30,1303
E01025058,401,345,114,259,1119
E01025059,357,381,133,287,1158
E01025060,412,363,323,11,1109
E01025061,354,698,77,130,1259
E01025062,347,354,407,83,1191
E01025063,497,394,106,265,1262
E01025064,566,685,76,29,1356
E01025065,574,355,315,74,1318
E01025066,644,418,133,43,1238
E01025067,408,317,395,48,1168
E01025068,363,241,415,155,1174
E01025069,478,349,272,24,1123
E01025070,280,213,210,183,886
E01025071,509,322,228,87,1146
E01025072,399,302,321,58,1080
E01025073,432,442,175,25,1074
E01025074,516,572,78,12,1178
E01025075,602,340,271,139,1352
E01025076,433,260,212,174,1079
E01025077,390,330,147,249,1116
E01025078,663,466,88,20,1237
E01025079,668,653,86,12,1419
E01025080,654,520,122,18,1314
E01025081,755,459,123,10,1347
E01025082,385,276,110,473,1244
E01025083,442,390,465,133,1430
E01025084,325,503,192,101,1121
E01025085,437,505,137,14,1093
E01025086,417,637,111,5,1170
E01025087,258,457,306,27,1048
E01025088,468,331,98,8,905
E01025089,475,529,106,54,1164
E01025090,620,723,93,4,1440
E01025091,476,280,142,269,1167
E01025092,361,208,51,296,916
E01025093,205,170,971,123,1469
E01025094,284,205,338,203,1030
E01025095,390,321,205,10,926
E01025096,678,453,132,14,1277
E01025097,466,333,108,282,1189
E01025098,402,481,195,11,1089
E01025099,293,252,632,144,1321
E01025100,545,304,232,101,1182
E01025101,280,153,239,416,1088
E01025102,373,425,391,21,1210
E01025103,518,438,117,11,1084
E01025105,317,451,321,6,1095
E01025106,593,480,229,70,1372
E01025107,521,625,210,12,1368
E01025108,383,432,78,94,987
E01025109,346,405,79,15,845
E01025110,241,167,598,104,1110
E01025111,680,430,188,74,1372
E01025112,413,288,343,282,1326
E01025113,616,440,199,15,1270
E01025114,486,603,155,20,1264
E01025115,528,288,190,205,1211
E01025116,405,343,330,47,1125
E01025117,249,167,619,58,1093
E01025118,384,287,183,18,872
E01025119,488,412,166,2,1068
E01025120,443,207,409,15,1074
E01025121,714,462,180,39,1395
E01025122,595,621,186,18,1420
E01025123,1072,480,174,51,1777
E01025124,409,284,162,312,1167
E01025125,195,153,531,29,908
E01025126,780,426,334,22,1562
E01025127,491,580,96,7,1174
E01025128,317,194,599,73,1183
E01025129,221,181,640,50,1092
E01025130,571,949,217,68,1805
E01025131,474,561,150,91,1276
E01025132,345,644,189,21,1199
E01025133,428,597,116,60,1201
E01025136,364,208,327,271,1170
E01025137,514,433,146,58,1151
E01025138,511,298,277,31,1117
E01025139,274,232,816,32,1354
E01025140,386,321,339,66,1112
E01025141,486,442,165,96,1189
E01025142,491,658,78,25,1252
E01025143,375,304,168,334,1181
E01025144,476,307,434,214,1431
E01025145,483,278,364,37,1162
E01025146,718,678,181,16,1593
E01025147,421,349,355,54,1179
E01025148,556,952,163,64,1735
E01025149,877,407,315,103,1702
E01025150,601,393,114,84,1192
E01025151,382,171,371,363,1287
E01025152,515,296,106,240,1157
E01025153,516,371,68,46,1001
E01025154,305,114,91,532,1042
E01025155,551,398,73,9,1031
E01025156,197,70,71,456,794
E01025157,321,248,43,351,963
E01025158,417,664,63,10,1154
E01025159,484,550,110,33,1177
E01025160,373,658,46,5,1082
E01025161,287,665,81,3,1036
E01025162,397,686,87,17,1187
E01025163,445,685,58,19,1207
E01025164,500,481,145,18,1144
E01025165,700,303,131,20,1154
E01025166,279,523,147,51,1000
E01025167,309,425,199,29,962
E01025168,363,392,123,40,918
E01025169,424,484,76,55,1039
E01025170,493,631,203,94,1421
E01025171,293,415,187,434,1329
E01025172,522,394,225,73,1214
E01025173,440,457,135,308,1340
E01025174,520,568,88,30,1206
E01025175,598,524,123,29,1274
E01025176,704,400,393,164,1661
E01025177,640,728,141,12,1521
E01025178,633,609,190,73,1505
E01025179,630,475,175,32,1312
E01025180,796,555,138,47,1536
E01025181,305,234,132,456,1127
E01025182,217,489,275,230,1211
E01025183,312,468,376,112,1268
E01025184,242,595,275,33,1145
E01025185,473,667,252,67,1459
E01025186,383,479,237,32,1131
E01025187,490,428,106,125,1149
E01025188,366,513,362,294,1535
E01025189,402,402,366,93,1263
E01025190,612,536,112,61,1321
E01025191,478,421,107,25,1031
E01025192,493,289,234,72,1088
E01025193,498,407,77,151,1133
E01025194,507,307,247,60,1121
E01025195,493,397,110,6,1006
E01025196,479,335,465,48,1327
E01025197,487,553,97,4,1141
E01025198,392,382,244,105,1123
E01025199,594,553,222,35,1404
E01025200,465,465,158,145,1233
E01025201,517,463,185,126,1291
E01025202,467,490,115,72,1144
E01025203,593,654,169,31,1447
E01025204,629,613,139,23,1404
E01025205,509,267,245,51,1072
E01025206,383,460,83,77,1003
E01025207,329,298,334,134,1095
E01025208,291,251,184,309,1035
E01025209,546,452,68,270,1336
E01025210,536,371,303,210,1420
E01025211,497,579,106,58,1240
E01025212,466,592,78,18,1154
E01025213,344,403,80,29,856
E01025214,543,537,57,7,1144
E01025215,336,439,129,136,1040
E01025216,689,429,214,181,1513
E01025217,333,373,355,79,1140
E01025218,166,299,185,264,914
E01025219,203,310,324,41,878
E01025220,322,176,221,423,1142
E01025221,437,221,116,222,996
E01025222,519,509,108,63,1199
E01025223,369,328,177,215,1089
E01025224,436,674,316,120,1546
E01025225,562,547,174,19,1302
E01025226,371,275,380,245,1271
E01025227,416,431,496,267,1610
E01025228,617,426,176,36,1255
E01025229,413,844,270,54,1581
E01025230,297,517,282,99,1195
E01025231,457,492,161,26,1136
E01025232,472,191,587,94,1344
E01025233,597,376,96,14,1083
E01025234,506,276,96,221,1099
E01025235,648,559,90,60,1357
E01025236,272,209,82,473,1036
E01025237,499,300,89,301,1189
E01025238,412,152,104,483,1151
E01025239,507,460,86,135,1188
E01025240,630,575,91,4,1300
E01025241,550,602,133,15,1300
E01025242,527,665,67,17,1276
E01025243,609,500,291,140,1540
E01025244,325,522,270,92,1209
E01025245,639,459,168,608,1874
E01025246,405,573,221,47,1246
E01025247,292,386,382,214,1274
E01025248,178,121,96,519,914
E01025249,334,288,92,96,810
E01025250,400,283,262,275,1220
E01025251,379,457,171,160,1167
E01025252,459,326,124,195,1104
E01025253,948,229,170,14,1361
E01025254,513,366,46,6,931
E01025255,800,276,112,6,1194
E01025256,574,499,87,79,1239
E01025257,590,507,26,7,1130
E01025258,555,636,60,6,1257
E01025259,839,773,79,17,1708
E01025260,383,156,103,503,1145
E01025261,538,500,113,33,1184
E01025262,455,335,96,368,1254
E01025263,305,201,110,482,1098
E01025264,345,213,121,475,1154
E01025265,679,306,98,127,1210
E01025266,498,494,44,8,1044
E01025267,508,342,69,239,1158
E01025268,513,265,113,439,1330
E01025269,511,235,120,355,1221
E01025270,724,376,108,114,1322
E01025271,442,369,59,378,1248
E01025272,715,365,108,57,1245
E01025273,775,260,43,4,1082
E01025274,388,213,828,179,1608
E01025275,370,196,461,276,1303
E01025276,474,364,474,66,1378
E01025277,562,753,86,63,1464
E01025278,981,809,187,24,2001
E01025279,586,813,152,16,1567
E01025280,731,560,137,38,1466
E01025281,542,600,80,2,1224
E01025282,519,522,69,8,1118
E01025283,379,129,88,530,1126
E01025284,685,321,89,234,1329
E01025285,455,268,85,265,1073
E01025286,345,142,84,682,1253
E01025287,440,222,137,755,1554
E01025288,397,232,557,167,1353
E01025289,299,320,596,231,1446
E01025290,239,270,742,206,1457
E01025291,353,340,274,166,1133
E01025292,99,106,521,474,1200
E01025293,296,304,397,654,1651
E01025294,492,323,509,67,1391
E01025295,377,211,500,547,1635
E01025296,445,300,226,437,1408
E01025297,517,314,442,227,1500
E01025298,374,321,321,153,1169
E01025299,538,537,102,15,1192
E01025300,259,363,100,215,937
E01025301,457,261,94,78,890
E01025302,455,450,107,0,1012
E01025303,625,382,106,11,1124
E01025304,455,626,205,74,1360
E01025305,361,521,247,156,1285
E01025306,200,231,878,221,1530
E01025308,445,232,669,48,1394
E01025309,402,381,78,85,946
E01025310,465,239,487,76,1267
E01025311,473,248,310,67,1098
E01025312,577,259,487,38,1361
E01025313,164,133,416,376,1089
E01025314,432,237,664,110,1443
E01025315,330,412,371,15,1128
E01025316,594,519,77,12,1202
E01025317,353,322,163,30,868
E01025318,398,329,65,47,839
E01025319,847,530,173,39,1589
E01025320,289,427,364,8,1088
E01025321,359,356,254,87,1056
E01025322,363,483,203,64,1113
E01025323,327,453,112,52,944
E01025324,556,462,96,4,1118
E01025325,474,315,239,229,1257
E01025326,438,572,172,17,1199
E01025327,473,437,115,34,1059
E01025328,364,457,109,14,944
E01025329,409,474,110,177,1170
E01025330,372,389,107,190,1058
E01025331,365,516,187,52,1120
E01025332,381,443,46,4,874
E01025333,455,447,84,33,1019
E01025334,432,569,192,63,1256
E01025335,339,324,147,313,1123
E01025336,398,422,94,24,938
E01025337,517,600,104,79,1300
E01025338,518,416,245,92,1271
E01025339,549,410,97,164,1220
E01025340,451,474,155,58,1138
E01025341,425,494,37,9,965
E01025342,493,588,143,71,1295
E01025343,514,418,127,84,1143
E01025344,364,394,170,160,1088
E01025345,463,536,149,24,1172
E01025346,464,423,240,75,1202
E01025347,594,376,186,125,1281
E01025348,383,758,143,58,1342
E01025349,460,479,154,41,1134
E01025350,417,458,81,84,1040
E01025351,866,672,294,46,1878
E01025352,550,583,25,0,1158
E01025353,420,381,51,6,858
E01025354,397,469,182,36,1084
E01025355,991,653,88,17,1749
E01025356,443,329,256,110,1138
E01025357,492,315,145,111,1063
E01025358,898,712,183,21,1814
E01025359,597,573,122,82,1374
E01025360,675,480,248,224,1627
E01025361,912,509,204,40,1665
E01025362,815,497,109,157,1578
E01025363,455,366,83,124,1028
E01025364,526,488,86,10,1110
E01025365,599,486,147,22,1254
E01025366,419,289,295,137,1140
E01025367,795,414,146,36,1391
E01025368,510,444,213,96,1263
E01025369,305,213,272,165,955
E01025370,417,443,117,14,991
E01025371,389,270,160,303,1122
E01025373,549,515,151,77,1292
E01025374,480,342,102,238,1162
E01025375,747,468,136,23,1374
E01025376,668,377,261,392,1698
E01025377,575,468,76,21,1140
E01025378,635,442,130,17,1224
E01025379,373,295,93,287,1048
E01025380,601,532,76,7,1216
E01025381,409,324,112,270,1115
E01025382,443,296,205,417,1361
E01025383,1011,497,221,95,1824
E01025384,440,429,78,50,997
E01025385,286,153,144,407,990
E01025387,485,352,68,144,1049
E01025388,445,420,223,85,1173
E01025389,367,265,169,161,962
E01025390,296,234,92,261,883
E01025391,477,294,111,282,1164
E01025392,409,361,186,62,1018
E01025393,585,380,151,82,1198
E01025394,499,301,207,206,1213
E01025395,532,512,204,54,1302
E01025396,263,214,167,446,1090
E01025397,471,371,312,87,1241
E01025398,444,241,132,201,1018
E01025399,451,278,154,296,1179
E01025400,702,499,83,136,1420
E01025401,576,465,182,25,1248
E01025402,604,270,165,86,1125
E01025403,991,399,143,8,1541
E01025404,384,623,58,7,1072
E01025405,411,315,137,104,967
E01025406,461,423,70,97,1051
E01025407,587,295,361,301,1544
E01025408,521,641,95,7,1264
E01025409,541,423,117,30,1111
E01025410,695,376,33,4,1108
E01025411,807,625,209,23,1664
E01025412,539,397,81,198,1215
E01025413,675,656,91,53,1475
E01025414,596,726,37,16,1375
E01025415,799,501,163,201,1664
E01025416,676,443,66,64,1249
E01025417,606,470,60,76,1212
E01025418,530,459,122,41,1152
E01025419,604,424,100,135,1263
E01025420,1256,725,135,113,2229
E01025421,927,320,305,189,1741
E01025422,515,327,121,173,1136
E01025423,277,170,69,508,1024
E01025424,500,449,69,5,1023
E01025425,581,432,52,0,1065
E01025426,485,479,51,5,1020
E01025427,440,323,113,340,1216
E01025428,552,327,100,211,1190
E01025429,358,134,123,414,1029
E01025430,807,618,129,43,1597
E01025431,754,232,278,106,1370
E01025433,784,500,152,46,1482
E01025434,663,965,50,26,1704
E01025435,496,446,144,139,1225
E01025436,888,835,121,37,1881
E01025437,625,620,168,68,1481
E01025438,494,514,48,7,1063
E01025439,454,589,83,2,1128
E01025440,487,594,109,5,1195
E01025441,506,566,79,62,1213
E01025442,413,184,133,140,870
E01025443,557,499,77,9,1142
E01025444,573,346,144,13,1076
E01025445,258,177,74,499,1008
E01025446,606,452,101,95,1254
E01025447,224,92,42,532,890
E01025448,657,480,167,36,1340
E01025449,392,354,51,45,842
E01025450,360,199,89,146,794
E01025451,949,492,71,23,1535
E01025452,509,223,123,474,1329
E01025453,660,589,101,14,1364
E01025454,431,507,41,71,1050
E01025455,465,667,83,27,1242
E01025456,381,463,82,39,965
E01025457,534,478,138,11,1161
E01025458,546,409,145,118,1218
E01025459,627,531,149,60,1367
E01025460,637,315,110,572,1634
E01025461,861,589,78,15,1543
E01025462,743,512,122,3,1380
E01025463,630,371,89,6,1096
E01025464,590,433,39,8,1070
E01025465,406,348,107,68,929
E01025466,563,543,75,25,1206
E01025467,705,927,91,4,1727
E01025468,936,280,57,53,1326
E01025469,625,226,122,354,1327
E01025470,805,307,68,21,1201
E01025471,519,154,147,303,1123
E01025472,524,567,31,15,1137
E01025473,500,432,98,121,1151
E01025474,316,374,164,100,954
E01025475,517,662,56,13,1248
E01025476,468,485,94,15,1062
E01025477,493,401,63,43,1000
E01025478,428,534,36,6,1004
E01025479,702,686,239,71,1698
E01025480,498,100,114,289,1001
E01025481,448,165,129,407,1149
E01025482,310,141,100,496,1047
E01025483,662,500,193,401,1756
E01025484,798,635,112,22,1567
E01025485,640,480,196,66,1382
E01025486,653,466,126,77,1322
E01025487,606,432,90,144,1272
E01025488,508,330,647,170,1655
E01025489,455,352,227,49,1083
E01025490,288,302,385,100,1075
E01025491,454,569,87,40,1150
E01025492,534,285,92,103,1014
E01025493,245,127,152,627,1151
E01025494,335,189,260,400,1184
E01025495,748,745,156,64,1713
E01025496,415,383,92,83,973
E01025497,684,432,78,19,1213
E01025498,475,468,95,10,1048
E01025499,431,422,209,102,1164
E01025500,383,377,367,127,1254
E01025501,364,561,43,1,969
E01025502,611,591,81,20,1303
E01025503,425,160,158,241,984
E01025504,236,130,142,315,823
E01025505,539,323,126,172,1160
E01025506,682,826,137,36,1681
E01025507,554,587,137,5,1283
E01025508,427,548,151,44,1170
E01025509,364,393,101,157,1015
E01025510,411,637,45,6,1099
E01025511,361,495,76,13,945
E01025512,486,421,99,33,1039
E01025513,761,696,103,95,1655
E01025514,801,822,229,55,1907
E01025515,520,671,108,54,1353
E01025516,548,523,119,56,1246
E01025517,438,368,160,244,1210
E01025518,283,269,501,225,1278
E01025519,422,536,66,2,1026
E01025520,350,197,92,304,943
E01025521,562,259,145,289,1255
E01025522,400,383,87,120,990
E01025523,631,274,181,174,1260
E01025524,371,206,141,513,1231
E01025525,632,367,106,173,1278
E01025526,590,411,240,176,1417
E01025527,348,207,130,393,1078
E01025528,482,152,158,448,1240
E01025529,595,291,182,255,1323
E01025530,599,557,61,14,1231
E01025531,341,541,63,36,981
E01025532,644,514,66,11,1235
E01025533,543,492,178,104,1317
E01025534,656,528,104,87,1375
E01025535,658,353,89,104,1204
E01025536,476,283,92,351,1202
E01025537,524,545,115,78,1262
E01025538,492,662,103,38,1295
E01025539,500,414,89,70,1073
E01025540,437,444,63,38,982
E01025541,676,367,231,56,1330
E01025542,720,539,123,3,1385
E01025543,693,363,251,70,1377
E01025544,509,492,170,128,1299
E01025545,577,742,161,20,1500
E01025546,487,364,280,75,1206
E01025547,429,588,241,86,1344
E01025548,379,871,97,15,1362
E01025549,728,707,188,51,1674
E01025550,548,619,93,9,1269
E01025551,565,426,85,24,1100
E01025552,607,398,43,9,1057
E01025553,1026,804,209,60,2099
E01025554,435,648,137,128,1348
E01025555,437,622,124,22,1205
E01025556,520,474,144,85,1223
E01025557,679,473,87,36,1275
E01025558,400,825,130,135,1490
E01025559,516,582,252,159,1509
E01025560,329,745,95,6,1175
E01025561,561,537,89,23,1210
E01025562,650,792,204,109,1755
E01025563,328,500,55,5,888
E01025564,548,630,137,46,1361
E01025565,504,673,80,21,1278
E01025566,693,876,85,24,1678
E01025567,486,489,184,158,1317
E01025568,582,702,168,7,1459
E01025569,656,821,121,4,1602
E01025570,223,356,436,23,1038
E01025571,458,395,219,31,1103
E01025572,381,635,135,44,1195
E01025573,546,468,124,21,1159
E01025574,380,285,339,222,1226
E01025575,159,125,117,473,874
E01025576,876,774,253,33,1936
E01025577,501,339,169,159,1168
E01025578,522,342,118,238,1220
E01025579,383,228,146,258,1015
E01025580,417,509,72,51,1049
E01025581,539,361,227,23,1150
E01025582,351,226,345,78,1000
E01025583,427,271,301,32,1031
E01025584,281,261,573,185,1300
E01025585,749,875,168,76,1868
E01025586,504,679,137,33,1353
E01025587,467,633,143,52,1295
E01025588,364,627,172,52,1215
E01025589,427,335,167,79,1008
E01025590,356,214,118,446,1134
E01025591,526,768,84,20,1398
E01025592,266,170,57,617,1110
E01025593,443,685,134,38,1300
E01025594,446,727,168,3,1344
E01025595,493,658,89,4,1244
E01025596,919,526,114,45,1604
E01025597,399,405,72,8,884
E01025598,419,510,270,70,1269
E01025599,397,378,58,10,843
E01025600,615,537,122,5,1279
E01025601,459,671,95,2,1227
E01025602,647,420,188,16,1271
E01025603,481,704,125,8,1318
E01025604,554,437,254,13,1258
E01025605,534,486,63,33,1116
E01025606,320,190,128,304,942
E01025607,645,508,83,59,1295
E01025608,667,508,121,18,1314
E01025609,562,724,265,86,1637
E01025610,498,435,118,191,1242
E01025611,553,523,85,63,1224
E01025612,543,539,89,189,1360
E01025613,457,469,109,157,1192
E01025614,708,508,90,80,1386
E01025615,777,346,65,6,1194
E01025616,697,542,63,31,1333
E01025617,603,636,132,38,1409
E01025618,647,432,105,174,1358
E01025619,603,625,89,36,1353
E01025620,399,320,56,102,877
E01025621,399,379,94,17,889
E01025622,536,518,194,115,1363
E01025623,581,561,73,80,1295
E01025624,804,514,109,13,1440
E01025625,359,225,112,285,981
E01025626,488,275,242,30,1035
E01025627,856,543,159,173,1731
E01025629,532,511,67,133,1243
E01025630,642,693,66,8,1409
E01025631,465,387,101,2,955
E01025632,713,324,47,1,1085
E01025633,766,507,129,10,1412
E01025634,584,443,80,4,1111
E01025635,503,402,44,17,966
E01025636,407,518,153,53,1131
E01025637,449,428,133,65,1075
E01025638,446,696,61,22,1225
E01025639,386,488,85,50,1009
E01025640,543,458,155,92,1248
E01025641,718,518,145,76,1457
E01025642,812,426,192,98,1528
E01025643,687,411,84,83,1265
E01025644,536,421,70,99,1126
E01025645,432,335,113,57,937
E01025646,526,304,169,288,1287
E01025647,604,430,95,163,1292
E01025648,1046,397,71,8,1522
E01025649,646,599,79,5,1329
E01025650,771,330,81,28,1210
E01025651,692,515,71,18,1296
E01025652,556,421,122,10,1109
E01025653,597,373,153,142,1265
E01025654,426,503,107,11,1047
E01025655,566,494,189,3,1252
E01025656,533,405,133,2,1073
E01025657,792,469,113,177,1551
E01025658,892,424,122,19,1457
E01025659,613,572,245,77,1507
E01025660,667,588,77,13,1345
E01025661,804,376,102,55,1337
E01025662,521,375,109,241,1246
E01025663,559,454,67,101,1181
E01025664,387,507,68,104,1066
E01025665,540,580,93,40,1253
E01025666,493,382,129,190,1194
E01025667,486,314,85,77,962
E01025668,1027,331,455,28,1841
E01025669,1040,201,340,12,1593
E01025670,477,369,46,178,1070
E01025671,686,588,158,41,1473
E01025672,665,585,90,109,1449
E01025673,524,427,199,180,1330
E01025674,599,466,126,79,1270
E01025675,538,507,166,49,1260
E01025676,889,578,127,50,1644
E01025677,451,350,120,186,1107
E01025678,722,557,86,26,1391
E01025679,900,750,192,128,1970
E01025680,623,650,78,9,1360
E01025681,580,618,109,31,1338
E01025682,488,666,67,59,1280
E01025683,646,444,102,147,1339
E01025684,778,536,167,17,1498
E01025685,511,474,57,40,1082
E01025686,626,443,87,9,1165
E01025687,466,743,122,17,1348
E01025688,381,463,245,160,1249
E01025689,383,287,573,402,1645
E01025690,253,142,334,421,1150
E01025692,834,452,191,140,1617
E01025693,626,695,220,49,1590
E01025695,533,543,201,22,1299
E01025696,549,452,101,29,1131
E01025697,328,282,204,370,1184
E01025698,573,532,164,33,1302
E01025699,212,119,294,577,1202
E01025700,400,177,381,405,1363
E01025701,437,227,262,285,1211
E01025702,460,422,132,48,1062
E01025703,520,348,596,166,1630
E01025704,380,291,309,133,1113
E01025705,347,181,371,121,1020
E01025706,408,261,295,359,1323
E01025707,377,489,270,64,1200
E01025708,402,591,83,6,1082
E01025709,364,425,224,25,1038
E01025710,398,497,84,8,987
E01025711,487,740,73,6,1306
E01025712,431,656,63,10,1160
E01025713,445,410,144,3,1002
E01025714,1004,396,151,67,1618
E01025715,382,247,168,373,1170
E01025716,469,341,167,250,1227
E01025717,686,226,153,530,1595
E01025718,221,153,433,342,1149
E01025719,415,465,358,50,1288
E01025720,197,193,1107,163,1660
E01025721,180,236,926,165,1507
E01025722,285,321,207,62,875
E01025723,290,199,891,173,1553
E01025724,136,102,1144,52,1434
E01025725,212,212,143,501,1068
E01025726,857,323,225,64,1469
E01025727,406,313,120,390,1229
E01025728,728,515,80,152,1475
E01025729,741,466,64,31,1302
E01025730,454,541,241,38,1274
E01025731,629,592,49,43,1313
E01025732,621,476,118,49,1264
E01025733,487,485,172,120,1264
E01025734,537,637,77,11,1262
E01025735,618,466,278,130,1492
E01025736,548,606,58,24,1236
E01025737,771,419,158,82,1430
E01025738,508,579,91,8,1186
E01025739,408,534,107,150,1199
E01025740,551,425,187,70,1233
E01025741,702,496,87,0,1285
E01025742,443,363,93,330,1229
E01025743,784,440,173,81,1478
E01025744,747,680,120,9,1556
E01025745,554,521,89,61,1225
E01025746,562,447,179,242,1430
E01025747,682,428,149,209,1468
E01025748,863,518,254,95,1730
E01025749,533,366,90,260,1249
E01025750,579,494,85,12,1170
E01025751,867,439,245,116,1667
E01025752,811,583,128,91,1613
E01025753,472,340,132,283,1227
E01025754,506,483,57,20,1066
E01025755,615,484,98,37,1234
E01025756,687,406,331,88,1512
E01025757,688,283,163,24,1158
E01025758,800,440,118,43,1401
E01025759,372,443,187,188,1190
E01025760,489,479,90,32,1090
E01025761,660,561,122,55,1398
E01025762,505,485,127,93,1210
E01025763,577,577,158,49,1361
E01025764,543,525,66,20,1154
E01025765,506,739,102,26,1373
E01025766,652,339,247,379,1617
E01025767,585,470,109,78,1242
E01025768,487,536,91,49,1163
E01025769,518,469,149,58,1194
E01025770,551,603,288,90,1532
E01025771,866,757,245,138,2006
E01025772,1125,340,199,47,1711
E01025773,745,295,59,20,1119
E01025774,638,321,64,15,1038
E01025775,676,553,99,146,1474
E01025776,868,558,116,42,1584
E01025777,791,809,138,89,1827
E01025778,826,410,163,119,1518
E01025779,699,424,90,42,1255
E01025780,591,424,52,16,1083
E01025781,561,423,182,56,1222
E01025782,453,457,95,99,1104
E01025783,478,621,109,22,1230
E01025784,480,441,109,36,1066
E01025785,808,589,173,104,1674
E01025786,506,387,124,273,1290
E01025787,547,696,124,27,1394
E01025788,389,401,98,66,954
E01025789,399,333,104,74,910
E01025790,1024,684,121,22,1851
E01025791,715,708,198,182,1803
E01025792,670,641,326,290,1927
E01025793,947,565,135,337,1984
E01025794,686,574,167,18,1445
E01025795,528,552,268,90,1438
E01025796,552,325,235,453,1565
E01025797,589,593,127,59,1368
E01025798,546,612,301,44,1503
E01025799,962,330,151,17,1460
E01025800,462,304,144,40,950
E01025801,361,277,223,147,1008
E01025802,442,561,109,20,1132
E01025803,683,463,69,3,1218
E01025804,605,648,191,121,1565
E01025805,584,584,82,34,1284
E01025806,392,204,133,470,1199
E01025807,530,260,260,33,1083
E01025808,952,765,205,115,2037
E01025809,778,703,219,97,1797
E01025810,888,798,163,85,1934
E01025812,614,594,119,69,1396
E01025813,646,607,43,8,1304
E01025814,501,631,83,35,1250
E01025815,589,761,232,88,1670
E01025816,797,717,159,105,1778
E01025817,719,761,105,59,1644
E01025818,409,402,204,94,1109
E01025819,549,431,150,228,1358
E01025820,700,459,106,50,1315
E01025821,666,357,296,29,1348
E01025822,377,373,81,344,1175
E01025823,577,308,96,231,1212
E01025824,548,394,131,121,1194
E01025825,531,502,84,110,1227
E01025826,702,270,92,71,1135
E01025827,341,523,63,284,1211
E01025828,472,593,72,67,1204
E01025829,399,310,69,388,1166
E01025830,467,382,111,175,1135
E01025831,514,377,114,70,1075
E01025832,687,489,80,9,1265
E01025833,597,454,164,62,1277
E01025834,603,508,83,12,1206
E01025835,555,748,73,8,1384
E01025836,521,520,62,3,1106
E01025837,726,564,219,117,1626
E01025838,374,669,105,98,1246
E01025839,696,425,155,58,1334
E01025840,547,478,159,109,1293
E01025841,645,685,71,69,1470
E01025842,599,285,117,371,1372
E01025843,547,404,217,145,1313
E01025844,458,215,178,457,1308
E01025845,610,648,68,18,1344
E01025846,859,705,72,21,1657
E01025847,790,411,112,13,1326
E01025848,497,530,129,145,1301
E01025849,557,368,324,135,1384
E01025850,486,375,191,87,1139
E01025851,485,472,66,28,1051
E01025852,489,278,536,55,1358
E01025853,1182,494,365,120,2161
E01025854,828,369,159,36,1392
E01025855,590,352,140,56,1138
E01025856,302,270,97,387,1056
E01025857,669,370,128,19,1186
E01025858,659,357,473,30,1519
E01025859,565,528,75,2,1170
E01025860,651,474,57,0,1182
E01025861,696,495,173,44,1408
E01025862,449,711,105,4,1269
E01025863,503,485,141,216,1345
E01025864,766,290,107,63,1226
E01025865,621,373,198,234,1426
E01025866,467,396,90,339,1292
E01025867,608,446,156,45,1255
E01025868,489,525,122,112,1248
E01025869,542,556,139,50,1287
E01025870,549,548,57,17,1171
E01025871,409,417,101,91,1018
E01025872,488,722,71,42,1323
E01025873,562,593,112,54,1321
E01025874,507,530,60,197,1294
E01025875,436,362,92,330,1220
E01025876,716,624,94,37,1471
E01025877,630,454,159,59,1302
E01025878,1085,556,124,246,2011
E01025879,372,265,88,268,993
E01025880,656,527,60,21,1264
E01025881,473,560,95,58,1186
E01025882,495,538,181,115,1329
E01025883,577,587,110,67,1341
E01025884,708,283,144,223,1358
E01025885,626,671,149,36,1482
E01025886,621,537,172,145,1475
E01025887,471,504,457,80,1512
E01025888,586,618,221,45,1470
E01025889,558,605,213,82,1458
E01025890,374,363,111,168,1016
E01025891,470,441,98,35,1044
E01025892,527,495,205,55,1282
E01025893,873,683,135,42,1733
E01025894,361,297,289,342,1289
E01025895,774,363,161,89,1387
E01025896,622,578,95,34,1329
E01025897,610,345,344,327,1626
E01025898,353,344,173,139,1009
E01025899,381,189,240,75,885
E01025900,426,230,113,396,1165
E01025901,537,739,145,56,1477
E01025902,587,672,80,34,1373
E01025903,631,330,399,81,1441
E01025904,826,650,96,17,1589
E01025905,406,340,85,497,1328
E01025906,870,387,79,19,1355
E01025907,471,394,139,370,1374
E01025908,584,646,192,36,1458
E01025909,597,631,208,139,1575
E01025910,575,560,223,101,1459
E01025911,525,483,177,63,1248
E01025912,334,333,552,59,1278
E01025913,735,757,134,172,1798
E01025914,546,508,38,6,1098
E01025915,408,438,129,55,1030
E01025916,548,439,184,47,1218
E01025917,723,483,291,94,1591
E01025918,374,332,130,384,1220
E01025919,473,377,63,250,1163
E01025920,394,404,92,376,1266
E01025921,506,578,130,111,1325
E01025923,451,442,133,123,1149
E01025924,385,263,146,56,850
E01025925,737,625,485,237,2084
E01025926,575,476,136,85,1272
E01025927,496,460,72,267,1295
E01025928,630,460,125,17,1232
E01025929,880,449,204,119,1652
E01025930,475,338,329,140,1282
E01025931,568,381,263,224,1436
E01025932,276,88,65,675,1104
E01025933,443,349,38,275,1105
E01025934,282,217,100,570,1169
E01025935,352,594,39,59,1044
E01025936,336,348,60,307,1051
E01025937,659,429,122,56,1266
E01025938,513,310,77,123,1023
E01025939,763,442,208,120,1533
E01025940,737,531,115,181,1564
E01025941,563,527,102,66,1258
E01025942,670,625,100,61,1456
E01025943,530,360,149,414,1453
E01025944,530,457,168,69,1224
E01025945,448,500,242,108,1298
E01025946,479,413,372,121,1385
E01025947,604,743,128,45,1520
E01025948,661,276,195,161,1293
E01025949,340,279,216,478,1313
E01025950,480,249,144,431,1304
E01025951,729,532,97,50,1408
E01025952,444,606,62,135,1247
E01025953,387,273,78,151,889
E01025954,583,355,88,145,1171
E01025955,446,569,72,35,1122
E01025956,361,346,81,135,923
E01025957,618,306,249,235,1408
E01025958,689,385,139,74,1287
E01025959,822,692,146,58,1718
E01025960,506,598,63,59,1226
E01025961,520,576,86,66,1248
E01025962,395,363,72,311,1141
E01025963,566,381,99,173,1219
E01025964,610,553,121,62,1346
E01025965,458,442,131,71,1102
E01025966,523,363,80,299,1265
E01025967,546,795,45,52,1438
E01025968,762,610,139,20,1531
E01025969,765,361,193,138,1457
E01025970,517,571,61,5,1154
E01025971,434,502,79,10,1025
E01025972,487,422,87,17,1013
E01025973,627,751,50,4,1432
E01025974,516,403,214,21,1154
E01025975,498,575,61,38,1172
E01025976,365,342,112,285,1104
E01025977,373,566,191,15,1145
E01025978,462,507,215,113,1297
E01025979,538,424,99,23,1084
E01025980,548,537,60,2,1147
E01025981,607,571,133,1,1312
E01025982,846,471,106,25,1448
E01025983,458,348,141,42,989
E01025984,610,464,88,0,1162
E01025985,433,675,57,5,1170
E01025986,500,608,88,9,1205
E01025987,483,205,217,213,1118
E01025988,580,160,247,209,1196
E01025989,623,251,243,206,1323
E01025990,478,623,71,16,1188
E01025991,527,614,64,15,1220
E01025992,436,351,168,291,1246
E01025993,575,548,38,52,1213
E01025994,511,246,130,290,1177
E01025995,572,527,117,8,1224
E01025997,538,256,75,300,1169
E01025998,796,500,150,19,1465
E01025999,469,386,80,193,1128
E01026000,504,543,65,1,1113
E01026001,553,490,103,18,1164
E01026003,550,599,86,95,1330
E01026004,680,651,89,10,1430
E01026005,612,576,106,119,1413
E01026006,472,302,1108,235,2117
E01026007,423,416,49,49,937
E01026008,356,413,81,168,1018
E01026009,372,407,110,168,1057
E01026010,156,73,283,618,1130
E01026011,611,375,640,641,2267
E01026012,229,338,50,349,966
E01026013,521,585,85,42,1233
E01026014,653,589,171,133,1546
E01026015,587,301,211,64,1163
E01026016,727,728,183,277,1915
E01026017,447,399,129,357,1332
E01026018,464,751,132,74,1421
E01026019,789,446,278,659,2172
E01026020,641,658,308,186,1793
E01026021,401,587,424,52,1464
E01026022,592,873,201,49,1715
E01026023,370,503,126,194,1193
E01026024,688,621,153,183,1645
E01026025,410,321,734,278,1743
E01026026,457,271,157,625,1510
E01026027,592,440,261,192,1485
E01026028,505,430,267,307,1509
E01026029,970,571,377,68,1986
E01026030,418,265,425,660,1768
E01026031,406,667,94,55,1222
E01026032,426,402,643,177,1648
E01026033,632,663,202,121,1618
E01026034,583,517,143,252,1495
E01026035,708,836,203,3,1750
E01026036,374,307,610,60,1351
E01026037,250,233,298,280,1061
E01026038,488,420,137,26,1071
E01026039,393,493,72,42,1000
E01026040,491,335,116,61,1003
E01026041,340,239,60,432,1071
E01026042,352,330,313,212,1207
E01026043,428,495,180,206,1309
E01026044,341,630,137,48,1156
E01026045,479,740,251,131,1601
E01026046,301,341,202,126,970
E01026047,325,622,104,21,1072
E01026048,263,609,347,121,1340
E01026049,417,694,193,45,1349
E01026050,388,833,178,64,1463
E01026051,503,391,119,34,1047
E01026052,271,423,382,124,1200
E01026053,520,373,498,70,1461
E01026054,483,323,271,217,1294
E01026055,350,495,67,49,961
E01026056,373,415,120,66,974
E01026057,622,720,231,91,1664
E01026058,769,770,176,93,1808
E01026059,320,429,94,72,915
E01026060,332,564,159,61,1116
E01026061,501,465,44,13,1023
E01026062,498,290,120,74,982
E01026063,442,584,60,12,1098
E01026064,405,286,145,337,1173
E01026065,522,768,178,34,1502
E01026066,537,775,242,48,1602
E01026067,447,415,442,256,1560
E01026068,534,755,404,90,1783
E01026069,271,875,324,261,1731
E01026070,494,677,394,72,1637
E01026071,577,767,373,86,1803
E01026072,403,706,302,187,1598
E01026073,394,587,350,350,1681
E01026074,461,877,209,217,1764
E01026075,580,822,281,151,1834
E01026076,767,789,184,129,1869
E01026077,291,315,76,240,922
E01026078,318,260,126,181,885
E01026079,593,776,193,104,1666
E01026080,638,771,212,50,1671
E01026081,665,559,597,137,1958
E01026082,496,1126,250,71,1943
E01026083,320,252,120,704,1396
E01026084,419,437,276,130,1262
E01026085,497,1062,328,56,1943
E01026087,253,194,134,288,869
E01026088,439,474,99,32,1044
E01026089,553,803,272,68,1696
E01026090,371,413,126,200,1110
E01026091,394,322,93,114,923
E01026092,368,222,462,82,1134
E01026093,268,258,778,73,1377
E01026094,330,473,191,412,1406
E01026095,297,245,328,13,883
E01026096,541,433,177,19,1170
E01026097,266,525,183,339,1313
E01026098,633,760,166,100,1659
E01026099,586,879,184,89,1738
E01026100,462,470,385,88,1405
E01026101,255,264,194,278,991
E01026102,755,833,172,161,1921
E01026103,395,953,326,92,1766
E01026104,449,1212,196,139,1996
E01026105,582,881,329,70,1862
E01026106,395,432,66,80,973
E01026107,507,345,103,15,970
E01026108,581,417,252,626,1876
E01026109,391,1200,331,49,1971
E01026110,431,522,163,125,1241
E01026111,434,505,165,185,1289
E01026112,174,183,239,298,894
E01026113,499,892,237,99,1727
E01026114,267,340,528,68,1203
E01026115,348,375,468,230,1421
E01026116,489,517,213,145,1364
E01026117,506,761,191,88,1546
E01026118,494,788,138,20,1440
E01026119,256,546,103,30,935
E01026120,357,449,241,128,1175
E01026121,680,916,272,203,2071
E01026122,281,224,628,222,1355
E01026123,710,259,326,496,1791
E01026124,389,202,601,76,1268
E01026125,342,247,286,8,883
E01026126,218,117,478,607,1420
E01026127,350,103,113,502,1068
E01026128,1063,456,377,208,2104
E01026129,244,66,86,823,1219
E01026130,487,502,102,36,1127
E01026131,437,296,131,254,1118
E01026132,176,106,692,230,1204
E01026133,490,404,725,182,1801
E01026134,376,186,496,197,1255
E01026135,668,501,114,70,1353
E01026136,563,529,87,24,1203
E01026137,565,296,73,22,956
E01026138,697,416,85,31,1229
E01026139,471,475,53,11,1010
E01026140,414,189,154,265,1022
E01026141,655,345,80,43,1123
E01026142,399,254,95,270,1018
E01026143,331,230,878,50,1489
E01026144,331,197,693,102,1323
E01026145,392,298,568,78,1336
E01026146,170,132,889,286,1477
E01026147,882,501,496,18,1897
E01026148,368,265,714,227,1574
E01026149,374,283,120,559,1336
E01026150,264,155,102,631,1152
E01026151,541,400,359,211,1511
E01026152,141,45,56,826,1068
E01026153,869,476,418,191,1954
E01026154,403,219,104,365,1091
E01026155,636,400,276,42,1354
E01026156,286,201,67,402,956
E01026157,220,302,132,413,1067
E01026158,526,522,135,31,1214
E01026159,635,305,194,26,1160
E01026160,606,352,147,5,1110
E01026161,365,207,118,433,1123
E01026162,514,417,109,151,1191
E01026163,642,344,145,11,1142
E01026164,384,488,113,63,1048
E01026165,377,274,100,404,1155
E01026166,322,230,84,320,956
E01026167,292,500,455,68,1315
E01026168,259,155,79,588,1081
E01026169,505,511,79,301,1396
E01026170,341,288,124,379,1132
E01026171,509,650,90,13,1262
E01026172,380,235,95,380,1090
E01026173,178,103,67,789,1137
E01026174,457,182,367,80,1086
E01026175,472,177,447,355,1451
E01026176,190,127,812,343,1472
E01026177,340,177,983,67,1567
E01026178,393,275,628,95,1391
E01026179,253,124,401,79,857
E01026180,433,461,127,159,1180
E01026182,488,416,139,79,1122
E01026183,713,675,267,394,2049
E01026184,153,148,635,84,1020
E01026185,506,634,174,176,1490
E01026186,581,610,139,19,1349
E01026187,869,373,227,10,1479
E01026188,752,396,315,298,1761
E01026189,587,793,134,5,1519
E01026190,373,391,127,303,1194
E01026191,619,486,96,134,1335
E01026192,385,367,121,89,962
E01026193,501,489,105,80,1175
E01026194,602,590,129,174,1495
E01026195,660,627,212,62,1561
E01026196,418,498,188,107,1211
E01026197,555,357,162,67,1141
E01026198,213,56,577,35,881
E01026199,782,798,222,74,1876
E01026200,600,493,174,52,1319
E01026201,625,598,189,212,1624
E01026202,561,662,126,182,1531
E01026203,641,689,139,43,1512
E01026204,609,731,79,8,1427
E01026205,439,410,97,244,1190
E01026206,806,567,146,5,1524
E01026207,336,442,122,120,1020
E01026208,594,447,126,137,1304
E01026209,650,844,178,128,1800
E01026210,680,648,263,269,1860
E01026211,717,494,195,86,1492
E01026212,558,489,128,92,1267
E01026213,473,499,163,301,1436
E01026214,467,369,64,54,954
E01026215,361,498,52,13,924
E01026218,351,560,94,31,1036
E01026219,468,475,63,11,1017
E01026220,655,956,109,212,1932
E01026221,656,674,360,235,1925
E01026222,610,656,229,35,1530
E01026223,796,731,185,39,1751
E01026224,456,377,125,413,1371
E01026225,716,310,122,123,1271
E01026226,626,828,116,7,1577
E01026227,379,230,318,272,1199
E01026228,566,288,228,93,1175
E01026229,633,323,152,94,1202
E01026230,317,177,127,349,970
E01026231,1124,531,385,62,2102
E01026232,646,553,293,290,1782
E01026233,713,507,167,13,1400
E01026234,1234,584,249,80,2147
E01026235,339,342,201,379,1261
E01026236,348,484,103,48,983
E01026237,410,442,72,19,943
E01026238,582,327,128,29,1066
E01026239,593,479,223,120,1415
E01026240,938,643,111,241,1933
E01026241,744,324,250,234,1552
E01026242,579,520,94,57,1250
E01026243,430,321,88,244,1083
E01026244,438,488,81,105,1112
E01026245,701,859,136,79,1775
E01026246,697,816,152,279,1944
E01026247,587,692,160,141,1580
E01026248,791,594,249,215,1849
E01026249,625,708,153,94,1580
E01026250,482,390,390,213,1475
E01026251,601,747,97,66,1511
E01026252,552,561,205,130,1448
E01026253,524,480,181,261,1446
E01026254,497,596,149,292,1534
E01026255,550,708,281,67,1606
E01026256,480,481,128,269,1358
E01026257,554,919,89,58,1620
E01026258,612,773,94,35,1514
E01026259,587,507,144,196,1434
E01026260,587,556,198,278,1619
E01026262,589,571,132,25,1317
E01026263,766,440,237,87,1530
E01026264,467,393,248,138,1246
E01026265,454,358,118,94,1024
E01026266,454,397,720,110,1681
E01026267,927,702,547,113,2289
E01026268,472,439,327,377,1615
E01026269,667,862,263,57,1849
E01026270,344,358,391,382,1475
E01026271,429,228,281,513,1451
E01026272,330,390,246,89,1055
E01026273,579,661,109,52,1401
E01026274,747,411,262,57,1477
E01026275,583,463,384,227,1657
E01026276,768,891,176,173,2008
E01026277,362,311,272,354,1299
E01026278,402,485,246,52,1185
E01026279,427,463,137,112,1139
E01026280,861,811,193,225,2090
E01026281,469,472,92,70,1103
E01026282,499,486,128,285,1398
E01026283,553,679,111,91,1434
E01026284,728,587,120,173,1608
E01026285,496,513,91,114,1214
E01026286,402,372,131,112,1017
E01026287,398,414,178,223,1213
E01026288,415,230,131,515,1291
E01026289,757,469,152,234,1612
E01026290,741,685,194,207,1827
E01026291,657,705,105,146,1613
E01026292,567,472,131,13,1183
E01026293,825,413,358,26,1622
E01026294,791,272,189,26,1278
E01026296,487,637,128,53,1305
E01026297,426,366,78,268,1138
E01026298,469,322,312,351,1454
E01026299,540,402,168,204,1314
E01026300,581,607,57,26,1271
E01026301,543,573,177,30,1323
E01026302,556,315,103,12,986
E01026303,666,304,107,1,1078
E01026304,628,468,99,24,1219
E01026305,652,239,187,12,1090
E01026306,501,380,105,289,1275
E01026307,490,429,141,23,1083
E01026308,262,96,56,641,1055
E01026309,498,380,242,159,1279
E01026310,323,259,83,258,923
E01026311,514,182,221,359,1276
E01026312,205,65,54,583,907
E01026313,553,474,135,105,1267
E01026314,472,330,114,122,1038
E01026315,467,571,478,216,1732
E01026316,701,639,470,183,1993
E01026317,547,302,699,141,1689
E01026318,490,203,517,272,1482
E01026319,718,605,383,31,1737
E01026320,755,463,120,9,1347
E01026321,501,437,112,4,1054
E01026322,414,362,176,15,967
E01026323,466,350,424,315,1555
E01026324,991,575,176,33,1775
E01026325,407,232,90,436,1165
E01026326,481,440,108,187,1216
E01026327,418,339,75,300,1132
E01026328,336,160,78,536,1110
E01026329,545,608,213,145,1511
E01026330,718,699,182,146,1745
E01026331,668,556,408,342,1974
E01026332,774,703,216,134,1827
E01026333,1064,658,166,127,2015
E01026334,707,435,73,77,1292
E01026335,478,575,188,63,1304
E01026336,382,380,134,376,1272
E01026337,610,521,75,70,1276
E01026338,423,355,130,94,1002
E01026339,491,218,132,142,983
E01026340,691,639,169,311,1810
E01026341,487,485,102,147,1221
E01026342,662,301,117,45,1125
E01026343,397,287,630,178,1492
E01026344,592,262,376,22,1252
E01026345,431,324,138,263,1156
E01026346,408,310,168,86,972
E01026347,428,478,283,187,1376
E01026348,418,203,59,259,939
E01026349,304,392,255,332,1283
E01026350,296,433,450,154,1333
E01026351,280,418,452,131,1281
E01026352,474,525,57,20,1076
E01026353,328,321,444,235,1328
E01026354,415,482,86,21,1004
E01026355,735,917,182,100,1934
E01026356,706,258,166,16,1146
E01026357,572,384,153,63,1172
E01026358,479,555,141,25,1200
E01026359,549,641,95,18,1303
E01026360,831,662,132,132,1757
E01026361,858,713,280,288,2139
E01026362,813,435,100,33,1381
E01026363,370,448,146,46,1010
E01026364,663,543,91,83,1380
E01026365,740,974,170,75,1959
E01026366,676,655,187,197,1715
E01026367,371,421,334,225,1351
E01026368,526,576,124,89,1315
E01026369,324,339,102,140,905
E01026370,709,860,158,28,1755
E01026371,419,512,77,24,1032
E01026372,894,802,153,143,1992
E01026373,693,622,151,142,1608
E01026374,224,136,68,653,1081
E01026375,421,217,116,444,1198
E01026376,365,344,97,555,1361
E01026377,729,327,152,467,1675
E01026378,482,335,326,169,1312
E01026379,577,438,253,63,1331
E01026380,659,454,151,183,1447
E01026381,528,380,186,281,1375
E01026382,536,417,310,59,1322
E01026383,293,219,382,79,973
E01026384,465,323,514,139,1441
E01026385,302,393,226,50,971
E01026386,402,204,415,23,1044
E01026387,918,960,186,146,2210
E01026388,776,848,135,57,1816
E01026389,468,446,329,70,1313
E01026390,485,480,204,349,1518
E01026391,509,744,238,82,1573
E01026392,982,1041,300,135,2458
E01026393,441,671,98,4,1214
E01026394,645,497,212,105,1459
E01026395,418,642,111,68,1239
E01026396,389,610,75,5,1079
E01026397,878,608,357,33,1876
E01026398,486,446,147,201,1280
E01026399,529,395,194,69,1187
E01026400,597,215,433,28,1273
E01026401,596,576,68,16,1256
E01026402,738,596,139,32,1505
E01026403,491,432,87,76,1086
E01026404,747,784,179,162,1872
E01026405,518,462,70,36,1086
E01026406,445,576,46,5,1072
E01026407,536,327,119,119,1101
E01026408,428,472,87,105,1092
E01026409,452,349,130,67,998
E01026410,394,861,91,65,1411
E01026411,833,767,335,120,2055
E01026412,548,540,115,126,1329
E01026413,836,740,107,55,1738
E01026414,597,522,244,29,1392
E01026415,338,182,213,31,764
E01026416,375,336,208,146,1065
E01026419,416,387,143,64,1010
E01026420,360,414,117,51,942
E01026421,526,619,181,93,1419
E01026422,571,898,209,18,1696
E01026423,627,382,218,186,1413
E01026424,600,633,319,142,1694
E01026425,436,401,203,490,1530
E01026426,565,427,509,454,1955
E01026427,635,759,226,141,1761
E01026428,974,614,252,282,2122
E01026429,411,388,256,198,1253
E01026430,557,528,131,142,1358
E01026431,342,399,91,85,917
E01026432,536,536,113,32,1217
E01026433,468,212,295,141,1116
E01026434,628,718,293,36,1675
E01026435,636,539,383,182,1740
E01026436,737,734,222,186,1879
E01026437,298,501,110,111,1020
E01026438,266,344,135,109,854
E01026439,487,646,165,27,1325
E01026440,334,291,249,68,942
E01026441,410,472,184,208,1274
E01026442,515,770,255,233,1773
E01026443,475,606,371,251,1703
E01026444,514,623,309,264,1710
E01026445,573,809,220,293,1895
E01026446,493,834,182,159,1668
E01026447,419,165,219,424,1227
E01026448,831,654,214,58,1757
E01026449,584,427,424,96,1531
E01026450,628,541,217,22,1408
E01026451,653,705,173,170,1701
E01026452,512,572,136,151,1371
E01026453,457,467,198,156,1278
E01026454,819,250,204,15,1288
E01026455,295,471,340,365,1471
E01026456,358,401,164,21,944
E01026457,291,713,92,41,1137
E01026458,390,367,143,307,1207
E01026459,263,443,175,294,1175
E01026461,370,564,153,28,1115
E01026462,762,822,171,95,1850
E01026464,389,426,139,83,1037
E01026465,444,332,318,343,1437
E01026466,617,203,438,248,1506
E01026467,302,115,187,864,1468
E01026468,561,579,621,165,1926
E01026469,516,384,337,76,1313
E01026470,1092,365,695,30,2182
E01026471,497,211,276,15,999
E01026472,528,340,137,2,1007
E01026473,557,348,229,14,1148
E01026474,449,335,237,313,1334
E01026475,498,361,156,203,1218
E01026476,412,221,203,315,1151
E01026477,374,180,121,437,1112
E01026478,416,187,204,438,1245
E01026479,491,469,109,200,1269
E01026480,513,582,103,39,1237
E01026481,414,300,99,150,963
E01026483,261,264,248,169,942
E01026484,433,494,127,75,1129
E01026485,337,428,73,64,902
E01026486,372,651,162,117,1302
E01026487,532,341,314,44,1231
E01026488,157,189,322,255,923
E01026489,348,618,130,75,1171
E01026490,460,719,136,55,1370
E01026491,671,708,331,104,1814
E01026492,420,358,162,108,1048
E01026493,318,416,191,24,949
E01026494,603,802,288,145,1838
E01026495,287,477,122,190,1076
E01026496,304,484,107,29,924
E01026497,477,573,158,36,1244
E01026498,321,476,125,171,1093
E01026499,281,498,164,331,1274
E01026500,498,656,144,96,1394
E01026501,438,589,143,141,1311
E01026502,297,442,132,81,952
E01026503,388,632,160,35,1215
E01026504,443,520,215,73,1251
E01026505,416,346,106,253,1121
E01026506,474,623,34,28,1159
E01026507,457,498,89,56,1100
E01026508,421,513,119,128,1181
E01026509,563,598,164,26,1351
E01026510,484,662,154,25,1325
E01026511,361,345,103,135,944
E01026512,409,364,87,196,1056
E01026513,482,456,73,70,1081
E01026514,468,431,196,112,1207
E01026515,357,392,122,24,895
E01026516,340,336,166,210,1052
E01026517,442,460,178,53,1133
E01026518,618,182,106,113,1019
E01026519,681,308,272,82,1343
E01026520,307,493,72,87,959
E01026521,336,551,115,9,1011
E01026522,415,434,161,127,1137
E01026523,547,492,263,195,1497
E01026524,419,477,198,112,1206
E01026525,290,407,149,60,906
E01026526,424,629,57,125,1235
E01026527,467,723,79,19,1288
E01026528,373,610,56,115,1154
E01026529,518,530,129,146,1323
E01026530,534,736,161,40,1471
E01026531,615,737,90,11,1453
E01026532,680,584,118,50,1432
E01026533,376,506,73,71,1026
E01026534,538,506,149,74,1267
E01026535,599,489,213,52,1353
E01026536,622,448,148,117,1335
E01026537,657,290,94,76,1117
E01026538,428,474,169,174,1245
E01026539,559,571,115,106,1351
E01026540,466,672,85,17,1240
E01026541,743,470,225,440,1878
E01026542,507,609,86,51,1253
E01026543,518,564,132,11,1225
E01026544,714,468,147,62,1391
E01026545,649,355,74,143,1221
E01026546,570,570,87,13,1240
E01026547,381,433,210,137,1161
E01026548,428,427,124,41,1020
E01026549,479,617,135,223,1454
E01026550,478,313,83,29,903
E01026551,456,387,77,26,946
E01026552,496,654,48,10,1208
E01026553,456,372,104,177,1109
E01026554,483,428,50,34,995
E01026555,465,528,70,184,1247
E01026556,447,450,133,160,1190
E01026557,478,600,122,8,1208
E01026558,413,621,80,11,1125
E01026559,553,603,77,34,1267
E01026560,434,672,61,7,1174
E01026561,445,700,82,10,1237
E01026562,516,343,52,16,927
E01026563,674,158,127,115,1074
E01026564,631,338,105,78,1152
E01026565,522,128,174,80,904
E01026566,517,436,161,65,1179
E01026567,473,864,86,11,1434
E01026568,701,535,49,7,1292
E01026569,460,480,73,218,1231
E01026570,501,722,96,21,1340
E01026571,542,558,110,10,1220
E01026572,549,562,96,17,1224
E01026573,414,407,97,218,1136
E01026574,783,382,140,25,1330
E01026575,486,497,188,172,1343
E01026576,883,320,271,70,1544
E01026577,457,545,274,123,1399
E01026578,748,489,123,129,1489
E01026579,444,618,142,85,1289
E01026580,391,670,130,126,1317
E01026581,673,505,117,40,1335
E01026582,796,658,114,33,1601
E01026583,451,449,78,98,1076
E01026584,485,717,73,13,1288
E01026585,392,466,82,158,1098
E01026586,257,268,90,271,886
E01026587,663,622,124,31,1440
E01026588,893,854,291,104,2142
E01026589,480,460,141,91,1172
E01026590,439,631,143,10,1223
E01026591,593,761,148,11,1513
E01026592,348,566,111,289,1314
E01026593,396,620,122,10,1148
E01026594,510,613,199,70,1392
E01026595,289,319,376,344,1328
E01026596,407,441,362,106,1316
E01026597,208,185,570,498,1461
E01026598,297,222,604,160,1283
E01026599,398,308,363,53,1122
E01026600,362,278,159,352,1151
E01026601,451,329,296,132,1208
E01026602,402,525,116,222,1265
E01026603,301,169,125,684,1279
E01026604,301,242,113,604,1260
E01026605,479,732,124,37,1372
E01026606,402,727,117,112,1358
E01026607,478,635,148,72,1333
E01026608,393,544,84,51,1072
E01026609,390,312,157,125,984
E01026610,535,351,309,19,1214
E01026611,339,590,239,44,1212
E01026612,754,834,331,109,2028
E01026613,483,506,89,30,1108
E01026614,482,658,125,131,1396
E01026615,537,524,69,7,1137
E01026616,533,307,87,49,976
E01026617,276,309,78,408,1071
E01026618,394,414,173,327,1308
E01026619,268,179,116,558,1121
E01026620,260,153,104,604,1121
E01026621,462,335,97,266,1160
E01026622,167,134,164,680,1145
E01026623,266,307,537,123,1233
E01026624,279,266,593,246,1384
E01026625,119,83,182,913,1297
E01026626,312,287,640,253,1492
E01026627,408,701,81,6,1196
E01026628,458,598,83,47,1186
E01026629,546,447,123,102,1218
E01026630,448,331,244,276,1299
E01026631,524,435,355,39,1353
E01026632,445,412,299,200,1356
E01026633,514,276,520,108,1418
E01026634,429,323,296,93,1141
E01026635,446,282,538,446,1712
E01026636,448,616,152,96,1312
E01026637,618,815,222,15,1670
E01026638,510,382,142,201,1235
E01026639,506,472,259,50,1287
E01026640,389,625,128,214,1356
E01026641,233,179,99,648,1159
E01026642,430,514,99,51,1094
E01026643,372,526,250,48,1196
E01026644,138,55,1029,122,1344
E01026645,190,640,228,129,1187
E01026646,252,665,298,265,1480
E01026647,739,844,142,135,1860
E01026648,423,479,195,142,1239
E01026649,534,448,198,73,1253
E01026650,224,203,453,34,914
E01026651,720,732,289,155,1896
E01026652,377,392,139,162,1070
E01026653,473,898,134,27,1532
E01026654,342,473,197,284,1296
E01026655,354,627,172,23,1176
E01026656,427,621,281,261,1590
E01026659,537,417,164,156,1274
E01026660,532,603,138,108,1381
E01026661,501,558,117,59,1235
E01026662,590,186,369,645,1790
E01026663,530,226,122,468,1346
E01026664,768,304,513,201,1786
E01026665,614,759,262,222,1857
E01026666,387,246,206,606,1445
E01026667,487,477,293,50,1307
E01026668,509,427,272,66,1274
E01026669,542,722,143,23,1430
E01026670,569,225,122,251,1167
E01026671,573,503,62,8,1146
E01026672,590,526,109,38,1263
E01026673,656,370,183,19,1228
E01026674,341,484,80,66,971
E01026675,460,419,94,47,1020
E01026676,390,929,125,32,1476
E01026677,388,459,169,244,1260
E01026678,348,794,160,46,1348
E01026679,761,726,322,203,2012
E01026680,201,707,132,257,1297
E01026681,277,710,208,50,1245
E01026682,269,502,147,76,994
E01026683,275,487,345,17,1124
E01026684,437,404,76,42,959
E01026685,465,471,56,96,1088
E01026686,488,899,310,35,1732
E01026687,213,152,156,687,1208
E01026688,356,173,122,417,1068
E01026689,343,220,569,121,1253
E01026690,331,186,130,469,1116
E01026691,347,449,71,63,930
E01026692,491,408,125,4,1028
E01026693,734,503,168,160,1565
E01026694,612,765,417,265,2059
E01026695,454,776,381,219,1830
E01026696,383,317,99,132,931
E01026697,415,491,140,34,1080
E01026698,281,392,714,302,1689
E01026699,98,128,485,596,1307
E01026700,240,227,462,280,1209
E01026701,369,856,125,58,1408
E01026702,294,451,168,153,1066
E01026703,265,466,169,84,984
E01026704,349,200,277,545,1371
E01026705,522,452,139,117,1230
E01026706,465,390,330,104,1289
E01026707,384,1367,105,122,1978
E01026708,462,573,66,22,1123
E01026709,649,696,118,48,1511
E01026710,386,495,99,9,989
E01026711,424,368,133,269,1194
E01026712,613,521,130,103,1367
E01026713,544,569,107,63,1283
E01026714,755,585,201,53,1594
E01026715,509,482,149,60,1200
E01026716,602,584,152,205,1543
E01026717,482,489,166,116,1253
E01026718,457,622,618,231,1928
E01026719,851,713,154,156,1874
E01026720,491,463,90,54,1098
E01026721,415,446,92,103,1056
E01026722,913,679,231,152,1975
E01026723,598,636,97,41,1372
E01026724,484,601,174,115,1374
E01026725,449,547,117,129,1242
E01026726,724,656,190,172,1742
E01026727,748,870,348,143,2109
E01026728,734,773,227,184,1918
E01026729,538,774,336,158,1806
E01026730,710,800,286,245,2041
E01026731,151,539,70,101,861
E01026732,279,456,239,99,1073
E01026733,551,816,275,283,1925
E01026734,192,320,428,46,986
E01026735,155,462,388,35,1040
E01026736,271,464,138,223,1096
E01026737,648,890,269,181,1988
E01026738,630,992,223,254,2099
E01026739,336,851,298,248,1733
E01026740,651,927,297,148,2023
E01026741,345,917,168,204,1634
E01026742,167,800,129,45,1141
E01026743,359,764,280,506,1909
E01026744,453,886,167,230,1736
E01026745,449,556,166,237,1408
E01026746,529,596,236,49,1410
E01026747,271,317,244,275,1107
E01026748,418,696,93,38,1245
E01026749,348,358,112,353,1171
E01026750,294,483,179,176,1132
E01026751,322,627,118,102,1169
E01026752,400,564,162,88,1214
E01026753,307,344,146,486,1283
E01026754,466,390,152,132,1140
E01026755,269,639,48,88,1044
E01026756,252,303,109,290,954
E01026757,513,530,195,35,1273
E01026758,502,444,178,41,1165
E01026759,324,394,85,230,1033
E01026760,379,389,216,81,1065
E01026761,435,546,167,147,1295
E01026762,571,1000,315,125,2011
E01026763,131,315,315,365,1126
E01026764,155,598,222,121,1096
E01026765,234,548,186,198,1166
E01026766,687,846,205,187,1925
E01026767,345,439,120,126,1030
E01026768,395,174,325,59,953
E01026769,488,972,196,197,1853
E01026770,376,724,466,50,1616
E01026771,377,603,165,188,1333
E01026772,350,887,194,41,1472
E01026773,435,883,229,209,1756
E01026774,507,511,141,76,1235
E01026775,280,287,119,332,1018
E01026776,438,534,297,67,1336
E01026777,250,562,79,120,1011
E01026778,238,684,196,102,1220
E01026779,358,315,138,308,1119
E01026780,702,752,497,143,2094
E01026781,579,992,223,79,1873
E01026782,407,619,511,309,1846
E01026783,440,873,147,114,1574
E01026784,197,284,110,269,860
E01026785,316,609,141,80,1146
E01026786,543,859,314,114,1830
E01026787,273,313,139,121,846
E01026788,300,492,164,114,1070
E01026789,381,438,121,76,1016
E01026790,367,301,159,121,948
E01026791,269,148,240,507,1164
E01026792,400,261,137,369,1167
E01026793,241,140,195,707,1283
E01026794,651,260,252,472,1635
E01026796,239,220,412,472,1343
E01026797,759,260,564,351,1934
E01026798,288,124,147,620,1179
E01026799,424,107,124,491,1146
E01026800,297,137,348,763,1545
E01026801,526,541,174,99,1340
E01026802,402,377,267,243,1289
E01026803,302,302,96,423,1123
E01026804,393,437,73,273,1176
E01026805,330,286,91,432,1139
E01026806,411,453,75,37,976
E01026807,350,247,126,242,965
E01026808,235,73,74,575,957
E01026809,313,248,52,621,1234
E01026810,353,518,137,167,1175
E01026811,419,716,124,69,1328
E01026812,466,552,161,22,1201
E01026813,380,728,100,31,1239
E01026814,261,305,260,429,1255
E01026815,430,459,270,51,1210
E01026816,428,254,482,301,1465
E01026817,295,343,146,393,1177
E01026818,329,204,80,534,1147
E01026819,205,129,98,666,1098
E01026820,322,236,115,667,1340
E01026821,367,275,84,528,1254
E01026822,225,314,626,652,1817
E01026823,315,297,728,351,1691
E01026824,202,158,323,623,1306
E01026825,262,139,406,332,1139
E01026826,151,87,351,640,1229
E01026827,133,92,229,849,1303
E01026828,322,130,112,707,1271
E01026829,406,148,403,630,1587
E01026830,220,149,211,492,1072
E01026831,371,185,417,102,1075
E01026832,257,117,76,562,1012
E01026833,140,57,62,820,1079
E01026834,291,167,130,565,1153
E01026835,309,264,630,60,1263
E01026836,411,374,492,25,1302
E01026837,341,314,482,124,1261
E01026838,417,352,491,18,1278
E01026839,351,191,834,34,1410
E01026840,449,310,607,53,1419
E01026841,455,207,518,53,1233
E01026842,508,332,510,56,1406
E01026843,478,269,313,482,1542
E01026844,440,224,250,456,1370
E01026845,530,168,580,61,1339
E01026846,464,208,591,115,1378
E01026848,204,146,230,948,1528
E01026849,430,384,586,96,1496
E01026850,452,338,520,248,1558
E01026852,353,494,165,33,1045
E01026853,253,225,388,671,1537
E01026855,277,393,641,80,1391
E01026856,370,278,869,113,1630
E01026857,315,367,441,213,1336
E01026858,166,181,292,638,1277
E01026859,305,296,211,424,1236
E01026860,141,292,272,260,965
E01026861,210,163,362,518,1253
E01026862,304,214,209,347,1074
E01026863,438,344,586,202,1570
E01026864,467,310,173,276,1226
E01026865,260,106,327,799,1492
E01026866,401,306,442,216,1365
E01026867,253,126,174,601,1154
E01026868,184,105,255,636,1180
E01026869,202,134,80,659,1075
E01026870,328,414,353,221,1316
E01026871,467,524,79,36,1106
E01026872,599,739,255,225,1818
E01026873,361,460,119,87,1027
E01026874,462,506,156,133,1257
E01026875,382,439,81,20,922
E01026876,386,598,119,142,1245
E01026877,507,607,75,75,1264
E01026878,412,333,77,131,953
E01026879,314,350,113,170,947
E01026880,434,594,126,38,1192
E01026881,439,390,184,77,1090
E01026882,664,813,132,53,1662
E01026883,533,531,128,136,1328
E01026884,322,312,90,187,911
E01026885,488,397,162,74,1121
E01026886,515,461,77,94,1147
E01026887,469,408,179,112,1168
E01026888,329,487,152,355,1323
E01026889,419,653,208,42,1322
E01026891,359,406,300,298,1363
E01026892,363,351,189,136,1039
E01026893,278,499,85,24,886
E01026894,684,911,225,200,2020
E01026895,570,395,110,87,1162
E01026896,434,372,115,62,983
E01026897,902,976,210,147,2235
E01026898,384,497,129,151,1161
E01026899,413,483,247,44,1187
E01026900,373,560,101,188,1222
E01026901,435,473,136,64,1108
E01026902,472,539,253,288,1552
E01026903,395,455,90,45,985
E01026904,422,445,101,156,1124
E01026905,249,327,42,284,902
E01026906,403,674,61,33,1171
E01026907,625,583,179,78,1465
E01026908,609,229,219,29,1086
E01026909,357,456,102,241,1156
E01026910,478,597,118,43,1236
E01026911,312,272,105,219,908
E01026912,506,545,127,82,1260
E01026913,617,363,135,229,1344
E01026914,454,577,171,28,1230
E01026915,761,595,129,67,1552
E01026916,722,874,114,23,1733
E01026917,523,539,81,150,1293
E01026918,636,650,133,30,1449
E01026919,516,360,98,187,1161
E01026920,381,430,67,65,943
E01026921,454,546,148,20,1168
E01026922,366,430,110,302,1208
E01026924,419,577,82,200,1278
E01026925,601,291,146,615,1653
E01026926,503,621,136,42,1302
E01026927,718,662,95,47,1522
E01026928,445,423,121,193,1182
E01026929,399,497,118,67,1081
E01026930,462,560,96,110,1228
E01026931,427,424,85,20,956
E01026932,395,391,160,70,1016
E01026933,1036,682,254,138,2110
E01026934,330,378,82,79,869
E01026935,358,468,188,78,1092
E01026936,423,553,97,104,1177
E01026937,435,407,248,86,1176
E01026938,807,533,195,68,1603
E01026939,663,512,127,78,1380
E01026940,595,290,164,330,1379
E01026941,339,522,101,52,1014
E01026942,467,369,58,36,930
E01026943,476,599,140,93,1308
E01026944,409,370,112,50,941
E01026945,902,449,205,104,1660
E01026946,294,518,63,56,931
E01026947,409,357,143,99,1008
E01026948,428,441,88,38,995
E01026949,338,252,216,298,1104
E01026950,362,192,233,376,1163
E01026951,346,208,137,287,978
E01026952,472,278,120,106,976
E01026953,543,436,90,85,1154
E01026954,474,180,164,264,1082
E01026955,743,379,84,7,1213
E01026956,805,215,211,328,1559
E01026957,477,245,265,278,1265
E01026958,559,167,329,310,1365
E01026959,470,275,196,209,1150
E01026960,348,161,238,400,1147
E01026961,368,157,170,271,966
E01026962,482,331,133,200,1146
E01026963,377,87,198,336,998
E01026965,238,115,183,262,798
E01026966,418,358,113,227,1116
E01026967,509,305,220,315,1349
E01026968,247,152,190,447,1036
E01026969,490,323,220,358,1391
E01026970,708,254,138,228,1328
E01026971,641,278,216,255,1390
E01026972,659,267,215,280,1421
E01026973,541,328,113,145,1127
E01026974,435,400,68,66,969
E01026975,394,205,165,354,1118
E01026976,474,198,121,247,1040
E01026977,717,609,122,136,1584
E01026978,555,328,147,131,1161
E01026979,465,429,124,83,1101
E01026980,645,478,138,56,1317
E01026981,412,388,93,60,953
E01026982,578,252,286,381,1497
E01026983,377,200,184,150,911
E01026984,565,372,190,262,1389
E01026985,517,498,91,167,1273
E01026986,994,275,412,485,2166
E01026987,477,356,71,102,1006
E01026988,410,175,158,430,1173
E01026989,554,199,168,165,1086
E01026990,1098,341,384,214,2037
E01026991,474,750,137,48,1409
E01026992,429,285,370,419,1503
E01026993,646,752,123,109,1630
E01026994,342,335,74,108,859
E01026997,618,582,121,74,1395
E01026998,523,590,342,52,1507
E01026999,547,559,145,227,1478
E01027000,510,308,125,190,1133
E01027001,758,279,82,28,1147
E01027002,607,486,133,74,1300
E01027003,613,355,140,37,1145
E01027004,629,560,161,153,1503
E01027005,669,589,243,132,1633
E01027006,706,503,127,155,1491
E01027007,476,204,167,211,1058
E01027008,815,444,313,54,1626
E01027009,414,147,192,360,1113
E01027010,450,430,49,75,1004
E01027011,622,668,170,134,1594
E01027012,535,456,128,281,1400
E01027013,349,103,141,702,1295
E01027014,1050,281,196,84,1611
E01027015,519,457,55,30,1061
E01027016,574,456,175,25,1230
E01027017,381,361,101,370,1213
E01027018,539,576,98,29,1242
E01027019,472,351,158,213,1194
E01027020,438,478,72,24,1012
E01027021,600,633,175,90,1498
E01027022,614,553,196,114,1477
E01027023,676,584,150,241,1651
E01027024,640,580,145,56,1421
E01027025,514,312,202,297,1325
E01027026,656,600,167,131,1554
E01027027,904,568,202,144,1818
E01027028,845,572,228,50,1695
E01027029,525,243,126,320,1214
E01027030,599,585,175,111,1470
E01027031,642,593,287,137,1659
E01027032,502,532,299,172,1505
E01027033,581,503,186,238,1508
E01027034,504,336,173,314,1327
E01027035,378,264,176,295,1113
E01027037,997,509,141,24,1671
E01027038,432,335,142,359,1268
E01027039,656,344,182,159,1341
E01027040,728,410,124,63,1325
E01027041,373,239,197,465,1274
E01027042,940,334,137,61,1472
E01027043,507,578,283,211,1579
E01027044,578,668,280,109,1635
E01027045,647,570,183,183,1583
E01027046,455,376,141,45,1017
E01027047,357,367,142,219,1085
E01027048,331,383,232,142,1088
E01027049,241,345,137,51,774
E01027050,552,613,177,184,1526
E01027051,555,328,229,280,1392
E01027052,620,345,117,51,1133
E01027053,634,473,118,31,1256
E01027054,487,455,74,16,1032
E01027055,508,297,78,34,917
E01027056,398,305,106,387,1196
E01027057,660,488,116,131,1395
E01027058,326,329,73,435,1163
E01027059,617,350,243,117,1327
E01027060,561,324,323,192,1400
E01027061,644,312,129,312,1397
E01027062,820,409,212,274,1715
E01027063,750,540,133,33,1456
E01027064,621,557,90,18,1286
E01027065,575,304,343,182,1404
E01027066,974,574,128,2,1678
E01027067,530,705,91,0,1326
E01027068,1402,580,262,13,2257
E01027069,543,287,207,289,1326
E01027070,690,513,100,26,1329
E01027071,669,432,80,33,1214
E01027072,358,217,70,542,1187
E01027073,728,545,184,179,1636
E01027074,861,607,112,173,1753
E01027075,910,396,198,74,1578
E01027076,762,410,274,271,1717
E01027077,896,372,203,41,1512
E01027078,730,600,158,237,1725
E01027079,744,369,224,57,1394
E01027080,781,594,135,21,1531
E01027081,469,173,152,298,1092
E01027082,526,214,265,230,1235
E01027083,282,147,140,512,1081
E01027084,547,581,90,2,1220
E01027085,449,401,61,98,1009
E01027086,671,567,92,19,1349
E01027087,509,262,140,35,946
E01027088,547,323,119,5,994
E01027089,849,500,162,53,1564
E01027090,379,401,339,67,1186
E01027091,617,376,123,336,1452
E01027092,597,448,101,63,1209
E01027094,572,503,91,71,1237
E01027095,580,294,101,172,1147
E01027096,464,356,86,13,919
E01027097,523,511,110,4,1148
E01027098,489,324,101,34,948
E01027099,525,598,99,1,1223
E01027100,552,481,144,108,1285
E01027101,990,463,287,139,1879
E01027102,683,430,101,111,1325
E01027103,524,489,188,126,1327
E01027104,708,333,493,320,1854
E01027105,582,263,745,56,1646
E01027106,510,268,601,136,1515
E01027107,449,374,172,53,1048
E01027108,483,558,58,6,1105
E01027109,485,332,76,113,1006
E01027110,304,196,440,599,1539
E01027111,687,301,560,66,1614
E01027112,713,339,502,105,1659
E01027113,627,521,385,152,1685
E01027114,637,388,146,118,1289
E01027115,387,488,59,6,940
E01027116,894,320,353,41,1608
E01027117,385,417,246,65,1113
E01027119,567,428,183,205,1383
E01027120,617,281,128,11,1037
E01027121,619,503,42,4,1168
E01027122,431,453,84,10,978
E01027123,544,533,85,127,1289
E01027124,663,426,287,370,1746
E01027125,798,575,89,22,1484
E01027126,665,475,337,223,1700
E01027127,380,214,117,735,1446
E01027128,478,299,121,389,1287
E01027129,688,812,162,148,1810
E01027130,656,472,142,207,1477
E01027131,523,171,241,630,1565
E01027132,518,203,862,116,1699
E01027133,560,299,503,48,1410
E01027134,547,264,559,61,1431
E01027135,640,386,324,55,1405
E01027136,592,289,464,53,1398
E01027137,467,145,189,262,1063
E01027138,667,363,131,46,1207
E01027139,671,186,188,116,1161
E01027140,275,166,111,319,871
E01027141,693,358,89,48,1188
E01027142,503,227,115,224,1069
E01027143,466,408,70,91,1035
E01027144,604,635,62,4,1305
E01027145,483,453,162,86,1184
E01027146,590,533,109,7,1239
E01027147,496,353,239,280,1368
E01027148,659,426,79,13,1177
E01027149,526,482,122,67,1197
E01027151,417,225,487,182,1311
E01027152,401,171,588,257,1417
E01027153,273,93,638,533,1537
E01027154,400,171,675,153,1399
E01027155,436,191,1006,178,1811
E01027156,349,159,115,313,936
E01027158,557,244,314,61,1176
E01027159,515,365,113,57,1050
E01027160,825,279,272,32,1408
E01027161,436,137,89,520,1182
E01027162,641,223,295,82,1241
E01027163,626,390,111,8,1135
E01027164,702,144,314,9,1169
E01027165,683,222,110,3,1018
E01027166,770,213,249,9,1241
E01027167,643,335,133,8,1119
E01027168,303,126,205,598,1232
E01027169,610,369,160,70,1209
E01027170,463,158,124,374,1119
E01027171,518,313,121,242,1194
E01027172,601,496,113,45,1255
E01027173,511,236,160,283,1190
E01027174,608,375,62,38,1083
E01027175,615,173,155,191,1134
E01027176,658,255,121,160,1194
E01027177,331,123,166,468,1088
E01027178,656,123,155,487,1421
E01027179,730,410,138,166,1444
E01027180,483,385,116,291,1275
E01027181,554,662,98,67,1381
E01027182,561,497,122,17,1197
E01027183,538,604,76,5,1223
E01027184,453,217,378,80,1128
E01027185,377,156,277,230,1040
E01027186,700,420,275,13,1408
E01027187,419,222,388,69,1098
E01027188,653,254,211,282,1400
E01027189,498,316,368,139,1321
E01027190,481,529,217,108,1335
E01027191,650,238,326,180,1394
E01027192,447,192,461,19,1119
E01027193,590,493,109,6,1198
E01027194,470,606,88,4,1168
E01027195,378,177,270,309,1134
E01027196,465,313,216,165,1159
E01027197,460,211,101,330,1102
E01027198,380,156,203,419,1158
E01027199,269,74,111,473,927
E01027200,462,118,167,286,1033
E01027201,842,480,223,75,1620
E01027202,502,468,113,201,1284
E01027203,823,163,146,13,1145
E01027204,717,295,113,161,1286
E01027205,1097,223,148,11,1479
E01027206,1275,655,149,50,2129
E01027207,536,583,57,4,1180
E01027208,595,410,136,27,1168
E01027209,527,217,210,8,962
E01027210,461,356,36,74,927
E01027211,487,615,93,4,1199
E01027212,690,271,156,10,1127
E01027213,558,326,154,163,1201
E01027214,421,347,148,340,1256
E01027215,587,398,98,109,1192
E01027216,608,616,160,40,1424
E01027217,749,781,152,67,1749
E01027218,612,653,74,3,1342
E01027219,611,733,131,16,1491
E01027220,445,569,62,51,1127
E01027221,717,521,174,28,1440
E01027222,614,386,48,15,1063
E01027223,347,148,862,381,1738
E01027224,355,205,552,334,1446
E01027225,348,141,782,118,1389
E01027226,351,209,624,294,1478
E01027227,378,168,624,93,1263
E01027228,425,173,862,191,1651
E01027229,451,142,256,356,1205
E01027230,319,161,295,349,1124
E01027231,404,169,238,598,1409
E01027232,453,326,298,119,1196
E01027233,426,73,141,270,910
E01027234,613,240,136,74,1063
E01027235,355,85,147,469,1056
E01027236,493,510,178,63,1244
E01027237,667,370,497,76,1610
E01027238,498,247,579,268,1592
E01027239,416,137,169,477,1199
E01027240,384,197,62,304,947
E01027241,397,154,421,340,1312
E01027242,431,149,124,457,1161
E01027243,455,177,99,428,1159
E01027244,210,72,85,722,1089
E01027245,601,216,209,179,1205
E01027246,555,137,166,464,1322
E01027247,706,209,171,106,1192
E01027248,448,155,164,336,1103
E01027249,453,207,229,385,1274
E01027250,603,391,135,16,1145
E01027252,601,180,163,196,1140
E01027253,829,459,115,54,1457
E01027254,803,436,117,9,1365
E01027255,543,496,77,4,1120
E01027256,517,564,99,16,1196
E01027257,376,422,68,40,906
E01027258,661,343,82,4,1090
E01027259,648,427,172,32,1279
E01027260,533,566,77,34,1210
E01027261,718,576,179,124,1597
E01027262,560,517,153,101,1331
E01027263,577,649,134,172,1532
E01027264,515,398,196,105,1214
E01027265,588,488,122,34,1232
E01027266,602,398,47,0,1047
E01027267,435,188,140,131,894
E01027268,597,258,141,37,1033
E01027269,432,261,162,338,1193
E01027270,859,231,98,4,1192
E01027271,724,221,195,37,1177
E01027272,772,313,107,18,1210
E01027273,528,503,158,246,1435
E01027274,635,487,117,26,1265
E01027275,496,517,86,90,1189
E01027276,1010,681,210,101,2002
E01027277,662,579,158,91,1490
E01027279,552,522,84,244,1402
E01027280,1070,579,171,46,1866
E01027281,650,398,91,210,1349
E01027282,586,433,84,217,1320
E01027283,565,486,156,61,1268
E01027284,767,567,147,98,1579
E01027285,584,540,115,149,1388
E01027286,545,531,113,103,1292
E01027287,500,618,87,134,1339
E01027288,641,549,192,339,1721
E01027289,509,578,105,183,1375
E01027290,667,681,298,107,1753
E01027291,537,552,70,19,1178
E01027292,372,266,63,235,936
E01027293,517,361,102,7,987
E01027294,811,455,108,110,1484
E01027295,837,543,163,178,1721
E01027296,668,568,229,168,1633
E01027297,570,520,146,144,1380
E01027298,594,385,81,8,1068
E01027299,512,329,109,239,1189
E01027300,676,341,79,33,1129
E01027301,905,345,284,121,1655
E01027302,416,228,127,380,1151
E01027303,609,366,199,32,1206
E01027304,609,581,144,75,1409
E01027305,596,520,260,124,1500
E01027306,539,548,204,106,1397
E01027307,728,663,187,132,1710
E01027308,461,406,322,123,1312
E01027309,583,568,97,35,1283
E01027310,306,108,154,488,1056
E01027311,553,317,87,47,1004
E01027312,424,335,110,257,1126
E01027313,402,424,453,34,1313
E01027314,448,314,644,170,1576
E01027315,651,293,682,192,1818
E01027316,463,296,297,133,1189
E01027317,451,315,97,310,1173
E01027318,295,84,81,544,1004
E01027319,539,224,118,265,1146
E01027320,691,286,172,260,1409
E01027321,767,227,98,89,1181
E01027322,508,270,127,53,958
E01027323,463,351,125,187,1126
E01027324,446,497,41,17,1001
E01027325,556,422,162,93,1233
E01027326,491,528,142,87,1248
E01027327,516,247,177,316,1256
E01027328,407,339,123,192,1061
E01027329,542,748,109,96,1495
E01027330,495,240,181,312,1228
E01027331,351,254,148,305,1058
E01027332,509,639,112,15,1275
E01027333,1034,503,229,36,1802
E01027334,238,43,89,532,902
E01027335,505,610,75,59,1249
E01027336,470,342,135,199,1146
E01027337,708,528,164,55,1455
E01027338,823,747,167,180,1917
E01027339,304,144,68,479,995
E01027340,415,379,84,294,1172
E01027341,452,186,169,311,1118
E01027342,427,108,142,388,1065
E01027343,612,456,137,4,1209
E01027344,532,496,112,43,1183
E01027345,662,365,49,6,1082
E01027346,791,221,124,14,1150
E01027347,878,553,121,16,1568
E01027348,741,620,198,110,1669
E01027349,353,171,469,335,1328
E01027350,443,443,192,137,1215
E01027351,368,304,162,454,1288
E01027352,435,265,297,134,1131
E01027353,554,648,178,95,1475
E01027354,856,501,310,246,1913
E01027355,685,548,77,22,1332
E01027356,379,595,397,131,1502
E01027357,453,490,73,25,1041
E01027358,498,517,334,389,1738
E01027359,514,368,177,666,1725
E01027361,654,590,295,212,1751
E01027362,365,324,98,257,1044
E01027363,237,167,71,457,932
E01027364,766,683,207,84,1740
E01027365,594,744,411,106,1855
E01027366,338,503,308,147,1296
E01027367,397,232,534,134,1297
E01027368,462,478,297,225,1462
E01027369,400,672,164,101,1337
E01027370,639,756,99,100,1594
E01027371,580,412,173,285,1450
E01027372,645,860,209,149,1863
E01027373,438,557,550,150,1695
E01027374,431,646,409,286,1772
E01027375,249,450,741,83,1523
E01027376,428,352,130,441,1351
E01027377,285,494,484,206,1469
E01027378,288,413,128,17,846
E01027379,441,629,86,23,1179
E01027380,318,393,331,157,1199
E01027381,301,449,690,143,1583
E01027382,331,595,331,172,1429
E01027383,328,486,179,177,1170
E01027384,346,573,229,121,1269
E01027385,327,170,80,380,957
E01027386,381,464,87,188,1120
E01027387,385,465,241,357,1448
E01027388,361,216,140,444,1161
E01027389,490,376,194,235,1295
E01027390,463,632,265,356,1716
E01027391,520,266,113,232,1131
E01027392,396,179,103,625,1303
E01027393,316,180,101,523,1120
E01027394,468,405,122,14,1009
E01027395,472,165,186,349,1172
E01027396,485,217,94,287,1083
E01027397,359,225,71,479,1134
E01027398,524,225,184,795,1728
E01027399,789,313,104,21,1227
E01027400,797,165,30,5,997
E01027401,776,340,27,3,1146
E01027402,687,333,38,7,1065
E01027403,575,376,28,2,981
E01027404,736,368,100,6,1210
E01027405,630,555,65,14,1264
E01027406,443,620,87,13,1163
E01027407,539,494,108,5,1146
E01027408,398,356,158,194,1106
E01027409,491,477,158,150,1276
E01027410,653,619,50,17,1339
E01027411,314,287,98,371,1070
E01027412,199,111,107,741,1158
E01027413,689,348,130,360,1527
E01027414,524,336,304,20,1184
E01027415,327,319,330,335,1311
E01027416,193,144,166,667,1170
E01027417,443,652,110,99,1304
E01027418,808,384,124,202,1518
E01027419,499,507,104,249,1359
E01027420,522,485,57,135,1199
E01027421,434,306,96,424,1260
E01027422,444,323,126,563,1456
E01027423,414,335,87,387,1223
E01027424,440,262,160,658,1520
E01027425,1091,543,173,45,1852
E01027426,286,102,92,583,1063
E01027427,399,334,238,382,1353
E01027428,697,461,105,13,1276
E01027429,374,286,114,707,1481
E01027430,359,340,88,522,1309
E01027431,465,307,324,322,1418
E01027432,530,349,230,196,1305
E01027433,547,242,159,416,1364
E01027434,470,421,79,207,1177
E01027435,464,323,123,304,1214
E01027436,585,334,79,290,1288
E01027437,886,580,66,7,1539
E01027438,697,435,84,12,1228
E01027439,1011,459,85,7,1562
E01027440,611,526,64,6,1207
E01027441,789,464,242,160,1655
E01027442,512,414,254,178,1358
E01027443,329,171,142,527,1169
E01027444,511,392,163,61,1127
E01027445,581,490,163,106,1340
E01027446,600,512,73,15,1200
E01027447,411,442,527,93,1473
E01027448,622,687,206,41,1556
E01027449,519,593,147,78,1337
E01027450,596,507,188,69,1360
E01027451,453,397,200,395,1445
E01027452,469,451,130,122,1172
E01027453,350,415,253,241,1259
E01027455,544,663,41,16,1264
E01027456,473,617,37,9,1136
E01027457,451,437,125,28,1041
E01027458,580,641,63,15,1299
E01027460,559,660,128,46,1393
E01027461,319,294,95,383,1091
E01027462,474,274,208,562,1518
E01027463,755,407,135,86,1383
E01027464,411,593,110,67,1181
E01027465,520,546,153,29,1248
E01027466,365,295,85,217,962
E01027468,411,616,45,12,1084
E01027469,522,597,60,11,1190
E01027471,656,632,88,3,1379
E01027472,321,370,448,113,1252
E01027473,500,447,409,80,1436
E01027474,654,334,182,337,1507
E01027475,539,525,102,42,1208
E01027476,594,670,351,364,1979
E01027477,315,512,183,17,1027
E01027478,297,366,154,102,919
E01027479,596,654,396,277,1923
E01027480,305,346,307,76,1034
E01027481,382,524,275,199,1380
E01027482,481,554,115,172,1322
E01027483,366,363,261,81,1071
E01027484,580,894,264,112,1850
E01027485,330,433,146,324,1233
E01027486,342,377,145,99,963
E01027487,284,408,137,133,962
E01027488,597,546,376,280,1799
E01027489,514,518,82,208,1322
E01027490,485,413,211,348,1457
E01027491,450,727,101,29,1307
E01027492,644,608,195,27,1474
E01027493,259,202,177,553,1191
E01027494,651,836,301,53,1841
E01027495,255,362,205,65,887
E01027496,360,360,92,179,991
E01027497,1171,454,133,293,2051
E01027498,807,351,155,773,2086
E01027499,537,518,54,119,1228
E01027500,523,325,157,341,1346
E01027501,427,317,84,97,925
E01027502,594,317,73,39,1023
E01027503,451,592,307,171,1521
E01027504,556,724,255,33,1568
E01027505,367,509,192,52,1120
E01027506,302,320,252,58,932
E01027507,522,538,74,17,1151
E01027508,387,327,135,65,914
E01027509,465,512,96,62,1135
E01027510,328,344,178,105,955
E01027511,288,288,309,81,966
E01027512,172,313,334,81,900
E01027513,647,725,109,68,1549
E01027514,509,559,109,174,1351
E01027515,501,307,196,191,1195
E01027516,446,301,68,154,969
E01027517,783,439,241,121,1584
E01027518,319,212,76,535,1142
E01027519,344,221,178,354,1097
E01027520,700,456,59,13,1228
E01027521,840,362,75,12,1289
E01027522,340,240,127,360,1067
E01027523,375,268,126,183,952
E01027524,493,357,164,149,1163
E01027525,571,352,183,323,1429
E01027526,598,424,37,33,1092
E01027527,349,156,84,465,1054
E01027528,362,336,243,109,1050
E01027529,441,342,148,24,955
E01027530,428,204,105,373,1110
E01027531,608,257,187,278,1330
E01027532,789,589,179,53,1610
E01027533,289,146,155,810,1400
E01027534,508,369,192,454,1523
E01027535,549,635,63,11,1258
E01027536,660,327,61,191,1239
E01027537,422,379,120,234,1155
E01027538,866,530,60,22,1478
E01027539,429,369,390,141,1329
E01027540,376,175,292,619,1462
E01027541,549,549,253,124,1475
E01027542,331,304,229,558,1422
E01027543,328,209,70,412,1019
E01027544,441,492,95,129,1157
E01027545,415,386,412,393,1606
E01027546,410,351,426,189,1376
E01027549,739,370,72,43,1224
E01027550,425,297,123,227,1072
E01027551,383,174,125,451,1133
E01027552,395,321,151,180,1047
E01027553,632,368,141,226,1367
E01027554,489,552,64,59,1164
E01027555,612,702,180,67,1561
E01027556,584,574,129,80,1367
E01027557,296,567,419,16,1298
E01027558,602,775,189,41,1607
E01027559,520,531,258,119,1428
E01027560,886,624,228,99,1837
E01027561,562,673,244,77,1556
E01027562,437,597,272,27,1333
E01027563,400,519,146,130,1195
E01027564,344,256,165,173,938
E01027565,586,505,134,19,1244
E01027566,460,384,128,56,1028
E01027567,370,651,208,132,1361
E01027568,730,749,202,126,1807
E01027569,287,587,226,35,1135
E01027570,679,944,310,134,2067
E01027571,414,768,209,64,1455
E01027572,506,693,327,192,1718
E01027573,351,629,200,112,1292
E01027574,526,621,84,7,1238
E01027575,650,611,161,195,1617
E01027576,503,737,60,7,1307
E01027577,556,564,415,77,1612
E01027578,415,395,404,23,1237
E01027579,320,193,75,304,892
E01027580,256,148,89,387,880
E01027581,602,625,541,201,1969
E01027582,486,456,213,86,1241
E01027583,749,595,222,42,1608
E01027584,566,435,129,207,1337
E01027585,360,898,239,51,1548
E01027586,551,570,395,44,1560
E01027587,377,360,94,308,1139
E01027588,538,409,253,41,1241
E01027589,613,451,192,160,1416
E01027590,583,591,246,335,1755
E01027591,493,715,145,73,1426
E01027592,485,761,208,65,1519
E01027593,447,593,313,106,1459
E01027594,319,318,199,394,1230
E01027595,476,605,186,93,1360
E01027596,373,657,172,96,1298
E01027597,422,630,220,35,1307
E01027598,501,917,113,22,1553
E01027599,435,287,179,468,1369
E01027600,603,511,301,131,1546
E01027601,697,545,216,94,1552
E01027603,541,649,269,120,1579
E01027604,455,720,256,43,1474
E01027605,553,258,290,160,1261
E01027606,504,619,125,34,1282
E01027607,397,620,66,10,1093
E01027608,475,234,227,389,1325
E01027609,361,118,117,414,1010
E01027610,555,348,186,258,1347
E01027611,496,796,221,146,1659
E01027612,336,258,119,626,1339
E01027613,420,714,286,66,1486
E01027614,449,493,72,63,1077
E01027615,453,511,69,18,1051
E01027616,414,335,135,275,1159
E01027617,306,347,236,44,933
E01027618,710,1081,193,64,2048
E01027619,698,606,448,144,1896
E01027620,602,494,326,94,1516
E01027621,602,808,274,206,1890
E01027622,540,713,222,111,1586
E01027623,387,606,80,14,1087
E01027624,475,502,72,6,1055
E01027625,313,351,143,523,1330
E01027626,372,559,100,100,1131
E01027627,560,708,226,63,1557
E01027628,484,546,382,111,1523
E01027629,283,188,97,514,1082
E01027630,432,344,478,231,1485
E01027631,443,532,200,19,1194
E01027632,511,415,157,112,1195
E01027633,487,752,271,29,1539
E01027634,717,616,181,87,1601
E01027635,620,574,477,177,1848
E01027636,550,814,277,101,1742
E01027637,492,774,290,45,1601
E01027638,493,496,130,17,1136
E01027639,501,419,115,10,1045
E01027640,566,428,152,62,1208
E01027641,596,361,78,5,1040
E01027642,390,545,161,31,1127
E01027643,396,489,217,97,1199
E01027644,481,376,209,144,1210
E01027645,507,434,294,54,1289
E01027646,464,620,122,56,1262
E01027647,494,596,157,91,1338
E01027648,527,404,121,181,1233
E01027649,502,327,321,176,1326
E01027650,568,439,128,105,1240
E01027651,405,170,114,468,1157
E01027652,478,357,333,16,1184
E01027653,351,472,159,128,1110
E01027654,385,412,134,8,939
E01027655,299,403,211,67,980
E01027656,379,602,420,35,1436
E01027657,419,145,427,44,1035
E01027658,498,291,426,64,1279
E01027659,421,252,755,93,1521
E01027660,511,560,78,97,1246
E01027661,495,449,132,115,1191
E01027662,492,394,58,13,957
E01027663,492,502,129,21,1144
E01027664,495,681,395,85,1656
E01027665,290,368,207,21,886
E01027666,424,667,236,79,1406
E01027667,343,433,265,62,1103
E01027668,433,467,203,107,1210
E01027669,483,500,266,347,1596
E01027670,594,563,117,19,1293
E01027671,607,600,52,6,1265
E01027672,633,711,86,18,1448
E01027673,469,480,368,172,1489
E01027674,501,499,66,14,1080
E01027675,935,746,148,44,1873
E01027676,630,306,149,275,1360
E01027677,338,340,472,52,1202
E01027678,305,152,836,203,1496
E01027679,337,516,451,12,1316
E01027680,283,300,506,26,1115
E01027681,451,558,193,99,1301
E01027682,457,600,237,35,1329
E01027683,568,416,121,56,1161
E01027684,425,485,169,97,1176
E01027685,271,413,209,143,1036
E01027686,241,360,298,27,926
E01027687,497,463,219,56,1235
E01027688,384,529,262,126,1301
E01027689,516,298,225,105,1144
E01027690,505,522,146,40,1213
E01027691,579,349,220,58,1206
E01027692,360,187,308,112,967
E01027693,540,666,273,25,1504
E01027694,333,376,199,60,968
E01027695,526,528,151,124,1329
E01027696,463,462,171,47,1143
E01027697,572,430,98,27,1127
E01027698,477,588,165,21,1251
E01027699,452,531,78,2,1063
E01027700,423,445,68,30,966
E01027701,462,529,252,65,1308
E01027702,274,344,185,149,952
E01027703,526,546,364,79,1515
E01027704,319,489,130,30,968
E01027705,548,357,298,131,1334
E01027706,424,424,434,317,1599
E01027707,526,491,235,171,1423
E01027708,413,505,164,61,1143
E01027709,453,493,42,31,1019
E01027710,270,220,83,249,822
E01027711,443,219,123,218,1003
E01027712,466,351,151,53,1021
E01027713,455,472,316,106,1349
E01027714,489,461,249,113,1312
E01027715,215,234,329,31,809
E01027716,460,622,100,0,1182
E01027717,596,445,129,13,1183
E01027718,625,541,165,79,1410
E01027719,427,550,127,22,1126
E01027720,521,261,165,227,1174
E01027721,662,346,207,11,1226
E01027722,643,173,238,6,1060
E01027723,469,236,154,363,1222
E01027724,484,581,134,78,1277
E01027725,481,456,166,109,1212
E01027726,583,371,204,99,1257
E01027727,553,401,230,119,1303
E01027728,452,508,106,66,1132
E01027729,492,198,301,227,1218
E01027730,444,430,331,25,1230
E01027731,465,355,258,44,1122
E01027732,374,412,222,1,1009
E01027733,459,481,79,13,1032
E01027734,428,576,227,42,1273
E01027735,411,573,321,21,1326
E01027736,429,436,305,99,1269
E01027737,370,331,431,77,1209
E01027738,588,304,170,27,1089
E01027739,422,270,176,23,891
E01027740,251,197,150,771,1369
E01027741,463,478,89,113,1143
E01027742,301,570,172,125,1168
E01027743,333,450,182,72,1037
E01027744,273,487,276,56,1092
E01027745,575,356,178,119,1228
E01027746,554,395,144,110,1203
E01027747,297,274,401,115,1087
E01027748,392,375,116,84,967
E01027749,499,222,166,570,1457
E01027750,868,339,627,132,1966
E01027751,408,420,175,47,1050
E01027752,304,383,270,47,1004
E01027753,225,575,262,86,1148
E01027754,159,163,444,127,893
E01027756,548,434,288,110,1380
E01027758,350,501,274,39,1164
E01027759,406,435,251,79,1171
E01027760,228,445,346,87,1106
E01027761,288,481,138,42,949
E01027762,394,429,213,67,1103
E01027763,241,527,204,30,1002
E01027764,230,510,232,71,1043
E01027765,558,429,137,159,1283
E01027766,330,305,173,192,1000
E01027767,425,592,123,79,1219
E01027768,347,494,91,24,956
E01027769,299,382,141,235,1057
E01027770,340,460,380,156,1336
E01027771,109,49,754,97,1009
E01027772,537,277,219,30,1063
E01027773,204,465,239,27,935
E01027774,519,718,282,97,1616
E01027775,309,584,245,110,1248
E01027776,406,651,162,62,1281
E01027777,278,583,288,49,1198
E01027778,582,667,473,188,1910
E01027779,205,277,334,134,950
E01027780,332,552,529,110,1523
E01027781,199,492,213,187,1091
E01027782,335,613,367,121,1436
E01027783,429,773,280,42,1524
E01027784,366,506,203,295,1370
E01027785,338,277,417,242,1274
E01027786,406,721,183,24,1334
E01027787,357,448,219,386,1410
E01027788,414,524,91,196,1225
E01027789,668,375,268,604,1915
E01027790,583,486,336,129,1534
E01027791,568,571,94,33,1266
E01027792,399,822,280,32,1533
E01027793,338,458,106,281,1183
E01027794,501,866,201,91,1659
E01027795,381,363,176,372,1292
E01027796,434,498,333,192,1457
E01027797,427,550,349,104,1430
E01027798,523,523,340,233,1619
E01027799,471,685,194,105,1455
E01027800,396,699,243,91,1429
E01027801,409,707,187,83,1386
E01027802,370,667,244,81,1362
E01027803,477,448,327,182,1434
E01027804,202,199,806,86,1293
E01027805,284,372,366,235,1257
E01027806,204,149,793,298,1444
E01027807,458,547,129,106,1240
E01027808,461,649,111,36,1257
E01027809,415,634,65,8,1122
E01027810,512,309,423,11,1255
E01027811,500,326,393,43,1262
E01027812,475,248,560,78,1361
E01027813,477,761,289,232,1759
E01027814,384,557,296,68,1305
E01027815,387,526,156,57,1126
E01027816,513,640,94,77,1324
E01027817,341,179,75,480,1075
E01027818,579,308,119,105,1111
E01027819,271,143,92,542,1048
E01027820,367,154,82,372,975
E01027821,357,729,117,41,1244
E01027822,346,528,242,69,1185
E01027823,391,557,91,183,1222
E01027824,359,388,118,378,1243
E01027825,500,220,324,317,1361
E01027826,476,337,290,78,1181
E01027827,300,602,464,70,1436
E01027828,355,837,109,152,1453
E01027829,279,853,169,41,1342
E01027830,521,399,194,306,1420
E01027831,249,494,107,41,891
E01027832,239,423,94,66,822
E01027833,368,687,189,151,1395
E01027834,453,726,141,21,1341
E01027835,544,617,180,135,1476
E01027836,709,855,228,102,1894
E01027837,257,311,124,462,1154
E01027838,425,724,124,56,1329
E01027839,487,591,167,88,1333
E01027840,503,756,239,273,1771
E01027841,305,452,340,41,1138
E01027842,455,651,94,146,1346
E01027843,441,379,112,190,1122
E01027844,548,667,77,23,1315
E01027845,623,645,142,12,1422
E01027846,544,347,472,31,1394
E01027847,281,223,865,170,1539
E01027848,356,348,109,51,864
E01027849,353,483,92,22,950
E01027850,397,273,109,266,1045
E01027851,549,421,265,4,1239
E01027852,238,301,821,44,1404
E01027853,231,420,352,54,1057
E01027854,188,327,721,29,1265
E01027855,453,692,110,16,1271
E01027856,274,634,54,83,1045
E01027857,291,565,205,26,1087
E01027858,533,553,73,24,1183
E01027859,677,572,155,19,1423
E01027860,556,445,102,129,1232
E01027861,408,371,224,71,1074
E01027862,420,324,430,103,1277
E01027863,420,626,73,95,1214
E01027864,364,275,127,376,1142
E01027865,411,474,339,134,1358
E01027866,452,438,129,222,1241
E01027867,388,675,84,23,1170
E01027868,388,849,496,79,1812
E01027869,130,291,390,86,897
E01027870,297,417,322,79,1115
E01027871,397,560,158,123,1238
E01027872,380,280,104,388,1152
E01027873,473,496,184,113,1266
E01027874,277,125,123,620,1145
E01027875,546,594,300,47,1487
E01027876,705,437,133,37,1312
E01027877,475,312,103,124,1014
E01027878,465,264,166,126,1021
E01027879,539,474,108,9,1130
E01027880,645,594,71,17,1327
E01027881,364,387,77,263,1091
E01027882,861,502,99,10,1472
E01027883,415,370,103,43,931
E01027884,656,374,148,79,1257
E01027885,580,503,113,84,1280
E01027886,509,368,133,73,1083
E01027887,601,517,121,40,1279
E01027888,694,458,136,104,1392
E01027889,613,438,166,179,1396
E01027890,790,656,114,76,1636
E01027891,595,623,136,68,1422
E01027892,642,425,178,286,1531
E01027893,775,592,58,95,1520
E01027894,802,555,109,72,1538
E01027895,595,613,81,57,1346
E01027896,851,502,133,109,1595
E01027897,881,635,193,24,1733
E01027898,992,601,217,127,1937
E01027899,651,488,120,89,1348
E01027900,763,484,206,51,1504
E01027901,617,530,106,19,1272
E01027902,489,431,82,172,1174
E01027903,324,342,149,11,826
E01027904,899,573,200,122,1794
E01027905,537,426,342,249,1554
E01027906,456,270,137,265,1128
E01027907,259,80,102,600,1041
E01027908,317,182,431,380,1310
E01027909,458,323,547,341,1669
E01027910,883,290,309,598,2080
E01027911,447,529,110,72,1158
E01027912,386,403,64,20,873
E01027913,470,487,39,4,1000
E01027914,696,591,93,21,1401
E01027915,540,397,127,267,1331
E01027916,532,268,106,320,1226
E01027917,823,422,141,80,1466
E01027918,483,350,199,165,1197
E01027919,456,272,185,42,955
E01027920,489,366,78,96,1029
E01027921,553,470,150,333,1506
E01027922,623,613,97,50,1383
E01027923,756,781,143,191,1871
E01027924,876,616,146,66,1704
E01027925,606,630,83,153,1472
E01027926,519,582,111,30,1242
E01027927,616,378,247,357,1598
E01027928,600,422,405,92,1519
E01027929,1041,437,198,245,1921
E01027930,410,248,127,430,1215
E01027931,620,406,197,356,1579
E01027932,704,407,398,126,1635
E01027933,508,343,290,63,1204
E01027934,623,354,89,26,1092
E01027935,535,291,70,108,1004
E01027936,479,700,64,6,1249
E01027937,414,231,193,237,1075
E01027938,669,307,42,15,1033
E01027939,268,206,83,576,1133
E01027940,548,491,73,2,1114
E01027941,422,435,62,155,1074
E01027942,369,269,121,260,1019
E01027943,504,476,119,32,1131
E01027944,604,579,82,10,1275
E01027945,573,545,180,65,1363
E01027946,516,463,98,166,1243
E01027947,620,487,141,90,1338
E01027948,737,559,187,37,1520
E01027949,564,513,153,30,1260
E01027950,705,622,131,221,1679
E01027951,247,277,96,528,1148
E01027952,498,253,239,429,1419
E01027953,488,569,92,108,1257
E01027954,512,328,190,199,1229
E01027955,374,295,219,79,967
E01027956,359,222,75,539,1195
E01027957,436,374,96,124,1030
E01027958,399,219,103,361,1082
E01027959,769,298,75,21,1163
E01027960,500,566,109,192,1367
E01027961,615,772,128,60,1575
E01027962,658,387,97,62,1204
E01027963,486,351,82,384,1303
E01027964,441,308,132,296,1177
E01027965,294,192,159,359,1004
E01027966,273,200,80,528,1081
E01027967,468,295,449,103,1315
E01027968,206,207,163,361,937
E01027969,438,375,160,113,1086
E01027970,527,444,177,13,1161
E01027971,492,621,89,11,1213
E01027972,817,499,187,217,1720
E01027973,617,613,66,23,1319
E01027974,317,173,121,616,1227
E01027975,624,368,208,134,1334
E01027976,348,320,221,427,1316
E01027977,618,358,234,279,1489
E01027978,421,225,498,256,1400
E01027979,430,705,158,35,1328
E01027980,415,266,94,402,1177
E01027981,473,658,121,74,1326
E01027982,457,487,120,137,1201
E01027983,421,346,272,155,1194
E01027984,568,457,143,74,1242
E01027985,624,330,293,170,1417
E01027986,378,364,121,247,1110
E01027987,484,285,209,380,1358
E01027988,540,583,182,26,1331
E01027989,442,726,129,78,1375
E01027990,791,452,198,55,1496
E01027991,362,366,89,202,1019
E01027992,1103,459,125,36,1723
E01027993,594,557,112,15,1278
E01027994,442,540,104,104,1190
E01027995,599,562,119,34,1314
E01027996,662,444,145,397,1648
E01027997,563,692,128,54,1437
E01027998,611,685,178,71,1545
E01027999,802,812,125,155,1894
E01028000,729,840,169,94,1832
E01028001,268,175,68,500,1011
E01028002,466,524,93,84,1167
E01028003,508,441,71,141,1161
E01028004,493,716,116,26,1351
E01028005,633,751,138,107,1629
E01028006,374,422,136,92,1024
E01028007,393,414,57,47,911
E01028008,293,198,109,367,967
E01028009,454,686,74,15,1229
E01028010,540,520,52,18,1130
E01028011,322,272,295,387,1276
E01028012,481,326,193,109,1109
E01028013,578,494,186,172,1430
E01028014,381,238,105,537,1261
E01028015,602,429,125,97,1253
E01028016,380,493,136,132,1141
E01028017,365,244,119,352,1080
E01028018,562,479,107,65,1213
E01028019,420,272,104,333,1129
E01028020,456,321,547,122,1446
E01028021,541,492,116,87,1236
E01028022,530,333,213,135,1211
E01028023,763,781,214,120,1878
E01028024,670,499,142,185,1496
E01028025,499,342,199,147,1187
E01028026,428,326,124,329,1207
E01028027,453,413,166,120,1152
E01028028,513,358,110,268,1249
E01028029,326,261,181,211,979
E01028030,487,342,91,105,1025
E01028031,381,313,44,158,896
E01028032,541,465,63,35,1104
E01028033,699,687,192,88,1666
E01028034,791,774,162,235,1962
E01028035,751,784,223,131,1889
E01028036,618,718,253,81,1670
E01028037,561,514,227,45,1347
E01028038,461,351,98,288,1198
E01028039,354,491,88,47,980
E01028040,271,247,199,101,818
E01028041,193,205,424,74,896
E01028042,573,392,90,101,1156
E01028043,466,541,141,76,1224
E01028044,341,230,138,551,1260
E01028045,596,464,178,350,1588
E01028046,597,513,154,37,1301
E01028047,1097,259,162,24,1542
E01028048,790,353,87,57,1287
E01028049,604,346,127,307,1384
E01028050,764,467,212,55,1498
E01028051,515,452,138,195,1300
E01028052,637,648,84,25,1394
E01028053,429,368,125,368,1290
E01028054,533,579,60,25,1197
E01028055,317,262,314,313,1206
E01028056,359,300,139,191,989
E01028057,313,224,430,55,1022
E01028058,784,444,153,73,1454
E01028059,922,297,131,10,1360
E01028060,550,755,129,13,1447
E01028061,665,386,146,22,1219
E01028062,438,453,581,101,1573
E01028063,707,605,142,31,1485
E01028064,417,281,141,202,1041
E01028065,269,133,190,668,1260
E01028066,363,182,184,511,1240
E01028067,442,342,116,315,1215
E01028068,471,239,398,269,1377
E01028069,459,391,145,4,999
E01028070,370,527,50,4,951
E01028073,273,285,516,268,1342
E01028074,280,258,628,269,1435
E01028075,378,269,668,92,1407
E01028076,329,385,206,143,1063
E01028077,369,197,268,349,1183
E01028078,467,266,302,262,1297
E01028079,302,301,505,53,1161
E01028080,658,384,310,86,1438
E01028081,341,403,206,74,1024
E01028082,528,384,128,8,1048
E01028083,313,223,326,229,1091
E01028084,628,562,227,18,1435
E01028085,427,456,655,139,1677
E01028086,468,373,395,42,1278
E01028087,463,736,135,12,1346
E01028088,473,656,131,1,1261
E01028089,405,637,65,4,1111
E01028090,421,400,119,207,1147
E01028091,474,652,113,3,1242
E01028092,456,348,103,141,1048
E01028093,357,497,34,0,888
E01028094,629,490,171,107,1397
E01028095,485,476,125,106,1192
E01028096,516,650,256,18,1440
E01028097,532,610,99,8,1249
E01028098,322,212,389,419,1342
E01028099,512,490,111,57,1170
E01028100,551,514,137,208,1410
E01028101,340,212,120,418,1090
E01028102,508,423,130,90,1151
E01028103,363,246,105,227,941
E01028104,605,449,106,52,1212
E01028105,445,366,96,103,1010
E01028106,488,570,138,62,1258
E01028107,607,542,104,56,1309
E01028108,548,575,107,39,1269
E01028109,567,625,154,99,1445
E01028110,390,190,129,431,1140
E01028111,401,477,127,179,1184
E01028112,437,345,236,255,1273
E01028113,431,257,105,387,1180
E01028114,450,539,183,47,1219
E01028115,536,692,64,3,1295
E01028116,589,512,119,69,1289
E01028117,763,356,86,9,1214
E01028118,479,834,93,56,1462
E01028119,1006,461,216,6,1689
E01028120,656,622,60,0,1338
E01028121,591,453,122,3,1169
E01028122,557,297,140,332,1326
E01028123,745,604,149,64,1562
E01028124,523,604,88,58,1273
E01028125,574,555,163,69,1361
E01028126,483,316,132,174,1105
E01028127,395,355,133,448,1331
E01028128,653,672,124,8,1457
E01028129,509,426,72,193,1200
E01028130,545,336,190,329,1400
E01028131,563,495,117,38,1213
E01028132,340,235,73,175,823
E01028133,565,239,313,61,1178
E01028134,578,288,225,81,1172
E01028135,558,533,61,2,1154
E01028136,665,595,105,12,1377
E01028137,1111,408,366,20,1905
E01028138,412,396,116,72,996
E01028139,572,426,120,16,1134
E01028142,663,684,158,87,1592
E01028143,387,382,115,192,1076
E01028144,508,344,259,79,1190
E01028146,693,354,149,39,1235
E01028147,309,110,94,284,797
E01028148,612,871,143,4,1630
E01028149,561,589,127,67,1344
E01028150,466,584,97,38,1185
E01028151,457,381,89,11,938
E01028152,513,549,136,47,1245
E01028153,341,294,96,309,1040
E01028154,670,403,158,135,1366
E01028155,452,403,207,118,1180
E01028156,446,402,150,104,1102
E01028157,520,447,97,3,1067
E01028158,494,364,282,165,1305
E01028159,415,301,188,152,1056
E01028160,565,403,190,80,1238
E01028161,513,354,249,64,1180
E01028162,580,358,133,92,1163
E01028163,522,560,151,17,1250
E01028164,383,267,132,251,1033
E01028165,451,320,231,212,1214
E01028166,530,381,126,309,1346
E01028167,567,404,328,185,1484
E01028168,460,466,87,26,1039
E01028169,518,583,90,40,1231
E01028170,526,398,123,135,1182
E01028171,490,335,158,110,1093
E01028172,447,348,59,65,919
E01028173,182,90,44,441,757
E01028174,447,269,122,318,1156
E01028175,617,522,182,139,1460
E01028176,606,497,118,9,1230
E01028177,487,607,211,11,1316
E01028178,683,825,160,82,1750
E01028179,564,533,91,10,1198
E01028180,475,558,123,66,1222
E01028181,536,418,206,10,1170
E01028182,625,410,143,107,1285
E01028183,374,606,59,29,1068
E01028184,534,314,97,13,958
E01028185,643,345,322,177,1487
E01028186,455,220,332,229,1236
E01028187,459,130,332,169,1090
E01028188,550,235,255,130,1170
E01028189,716,744,208,209,1877
E01028190,713,429,108,39,1289
E01028191,730,399,167,125,1421
E01028192,581,313,171,127,1192
E01028193,478,391,133,141,1143
E01028194,539,412,212,27,1190
E01028195,607,375,169,16,1167
E01028196,587,495,74,11,1167
E01028197,483,496,106,51,1136
E01028198,471,645,66,13,1195
E01028199,478,733,56,9,1276
E01028200,570,628,128,30,1356
E01028201,419,513,40,3,975
E01028202,473,527,101,130,1231
E01028203,488,453,115,110,1166
E01028204,509,494,112,22,1137
E01028205,432,357,89,146,1024
E01028206,564,518,93,50,1225
E01028207,481,489,70,36,1076
E01028208,335,320,97,123,875
E01028209,404,302,185,257,1148
E01028210,416,268,192,257,1133
E01028211,517,350,149,121,1137
E01028212,528,249,105,310,1192
E01028213,547,731,251,68,1597
E01028214,478,577,139,7,1201
E01028215,566,422,80,3,1071
E01028216,524,487,42,4,1057
E01028217,427,414,223,6,1070
E01028218,501,683,96,2,1282
E01028219,482,623,76,6,1187
E01028220,700,518,269,17,1504
E01028222,520,749,72,4,1345
E01028223,295,216,95,180,786
E01028224,314,535,105,291,1245
E01028225,463,477,115,212,1267
E01028226,319,316,287,212,1134
E01028227,294,303,277,196,1070
E01028228,279,310,300,70,959
E01028229,424,496,117,254,1291
E01028230,382,256,114,355,1107
E01028231,441,271,99,365,1176
E01028232,381,584,139,159,1263
E01028233,503,348,407,193,1451
E01028234,409,207,273,429,1318
E01028235,651,569,80,14,1314
E01028236,719,495,152,26,1392
E01028237,559,607,112,53,1331
E01028238,403,415,136,281,1235
E01028239,589,457,193,47,1286
E01028240,581,539,85,33,1238
E01028241,1202,422,143,19,1786
E01028242,616,465,183,19,1283
E01028243,585,566,110,237,1498
E01028244,553,454,148,89,1244
E01028245,341,267,86,361,1055
E01028246,651,589,154,42,1436
E01028247,304,236,512,293,1345
E01028248,438,408,167,191,1204
E01028249,498,401,80,125,1104
E01028250,562,495,137,25,1219
E01028251,740,552,53,18,1363
E01028252,680,406,93,382,1561
E01028253,639,669,82,23,1413
E01028254,401,481,106,104,1092
E01028255,388,675,65,38,1166
E01028256,335,186,105,661,1287
E01028257,522,335,184,189,1230
E01028258,418,597,128,262,1405
E01028259,441,321,118,282,1162
E01028260,567,527,156,168,1418
E01028261,402,276,75,541,1294
E01028262,567,596,82,14,1259
E01028263,182,71,83,906,1242
E01028264,795,666,89,39,1589
E01028267,599,273,117,503,1492
E01028268,369,240,606,126,1341
E01028269,376,278,450,38,1142
E01028270,580,514,135,22,1251
E01028271,431,264,281,371,1347
E01028272,579,406,262,73,1320
E01028273,597,433,161,50,1241
E01028274,379,218,316,215,1128
E01028275,353,163,171,481,1168
E01028276,174,128,199,729,1230
E01028277,443,542,53,21,1059
E01028278,469,499,100,143,1211
E01028279,408,318,79,398,1203
E01028280,399,265,74,344,1082
E01028281,406,140,168,363,1077
E01028282,320,252,112,235,919
E01028283,633,544,239,70,1486
E01028284,343,300,428,197,1268
E01028285,516,318,153,6,993
E01028286,367,415,79,196,1057
E01028287,496,525,115,60,1196
E01028288,554,511,143,28,1236
E01028289,545,440,149,13,1147
E01028290,501,401,108,174,1184
E01028291,621,285,119,208,1233
E01028292,971,629,165,23,1788
E01028293,630,462,355,57,1504
E01028294,539,262,414,185,1400
E01028295,733,659,156,59,1607
E01028296,429,416,128,71,1044
E01028297,476,392,127,491,1486
E01028298,632,451,117,67,1267
E01028299,421,189,135,261,1006
E01028300,465,306,145,317,1233
E01028301,380,282,165,570,1397
E01028302,515,496,120,174,1305
E01028303,464,660,103,70,1297
E01028304,330,194,198,386,1108
E01028305,422,278,297,95,1092
E01028306,505,350,153,281,1289
E01028307,519,247,196,58,1020
E01028308,499,591,154,109,1353
E01028309,491,602,111,23,1227
E01028310,336,244,558,280,1418
E01028311,273,288,445,305,1311
E01028312,607,836,354,101,1898
E01028313,531,405,137,457,1530
E01028314,1163,421,225,186,1995
E01028315,448,654,109,6,1217
E01028316,400,533,117,199,1249
E01028317,533,599,121,70,1323
E01028318,453,263,77,412,1205
E01028319,526,314,121,519,1480
E01028320,320,237,107,613,1277
E01028321,498,627,115,111,1351
E01028322,652,585,127,314,1678
E01028323,564,411,180,87,1242
E01028325,395,428,108,52,983
E01028326,460,352,83,192,1087
E01028327,444,523,154,180,1301
E01028328,591,686,93,56,1426
E01028329,558,551,129,61,1299
E01028330,533,694,102,32,1361
E01028331,445,460,110,135,1150
E01028332,654,631,60,47,1392
E01028333,425,425,190,55,1095
E01028334,416,219,118,418,1171
E01028335,362,423,478,169,1432
E01028336,347,381,138,58,924
E01028337,552,609,87,12,1260
E01028338,519,324,154,310,1307
E01028339,568,342,328,164,1402
E01028340,431,384,127,320,1262
E01028341,472,696,215,29,1412
E01028342,605,274,212,82,1173
E01028343,639,551,167,352,1709
E01028344,649,417,93,26,1185
E01028345,573,783,265,138,1759
E01028346,608,848,185,120,1761
E01028347,482,529,175,50,1236
E01028348,302,345,128,156,931
E01028349,498,531,140,86,1255
E01028350,407,349,86,111,953
E01028351,384,520,42,50,996
E01028352,473,438,63,7,981
E01028353,948,897,216,155,2216
E01028354,553,455,170,15,1193
E01028355,543,380,199,92,1214
E01028356,505,542,130,29,1206
E01028357,525,625,77,19,1246
E01028358,384,408,121,157,1070
E01028359,743,426,113,23,1305
E01028360,715,355,205,125,1400
E01028361,619,355,125,12,1111
E01028362,381,290,64,388,1123
E01028363,663,375,117,0,1155
E01028364,685,451,193,15,1344
E01028365,612,396,320,13,1341
E01028366,495,193,59,265,1012
E01028367,517,424,108,53,1102
E01028368,620,494,89,29,1232
E01028369,510,253,103,264,1130
E01028370,511,427,91,164,1193
E01028371,659,684,131,102,1576
E01028372,334,326,120,191,971
E01028373,375,634,86,46,1141
E01028374,345,322,94,271,1032
E01028375,654,291,300,132,1377
E01028376,526,481,232,11,1250
E01028377,919,429,102,21,1471
E01028378,613,762,217,111,1703
E01028379,504,829,74,12,1419
E01028380,359,205,79,315,958
E01028381,483,600,66,12,1161
E01028382,424,620,132,14,1190
E01028383,347,457,98,55,957
E01028384,643,332,375,7,1357
E01028385,660,444,172,60,1336
E01028386,561,405,310,8,1284
E01028387,509,402,144,279,1334
E01028388,657,488,123,8,1276
E01028389,405,726,95,28,1254
E01028390,505,670,94,94,1363
E01028391,696,794,112,32,1634
E01028392,557,514,248,274,1593
E01028393,378,524,63,10,975
E01028394,462,572,127,76,1237
E01028395,561,423,90,32,1106
E01028396,558,330,308,12,1208
E01028397,648,515,134,72,1369
E01028398,414,322,398,44,1178
E01028399,420,278,301,36,1035
E01028400,627,553,81,5,1266
E01028401,500,365,91,56,1012
E01028402,623,754,122,44,1543
E01028403,700,774,153,144,1771
E01028404,485,589,182,10,1266
E01028405,649,415,176,306,1546
E01028406,570,411,156,176,1313
E01028407,782,637,184,40,1643
E01028408,572,711,303,101,1687
E01028409,450,497,84,15,1046
E01028410,428,435,144,45,1052
E01028411,792,634,213,65,1704
E01028412,632,843,79,13,1567
E01028413,477,448,106,278,1309
E01028414,435,683,128,23,1269
E01028415,541,524,146,55,1266
E01028416,282,132,828,155,1397
E01028417,318,183,786,21,1308
E01028418,323,191,578,169,1261
E01028419,890,751,176,172,1989
E01028420,464,464,146,55,1129
E01028421,695,904,128,36,1763
E01028422,567,434,119,100,1220
E01028423,419,577,162,19,1177
E01028424,532,486,173,70,1261
E01028425,549,156,543,107,1355
E01028426,593,334,118,54,1099
E01028427,427,229,477,71,1204
E01028428,514,513,78,45,1150
E01028429,361,367,59,90,877
E01028430,420,267,422,76,1185
E01028431,484,549,146,83,1262
E01028432,490,525,111,152,1278
E01028433,502,782,115,48,1447
E01028434,511,456,120,10,1097
E01028435,225,216,648,308,1397
E01028437,552,277,333,41,1203
E01028438,501,204,582,62,1349
E01028439,636,189,231,55,1111
E01028440,388,171,617,121,1297
E01028441,868,193,408,386,1855
E01028443,675,266,152,55,1148
E01028444,651,426,153,37,1267
E01028445,497,146,157,267,1067
E01028446,525,380,172,155,1232
E01028447,355,208,305,162,1030
E01028448,443,180,176,376,1175
E01028449,360,182,109,362,1013
E01028450,291,130,92,545,1058
E01028451,481,266,77,195,1019
E01028452,384,193,120,309,1006
E01028453,414,166,103,324,1007
E01028454,374,181,86,538,1179
E01028455,711,280,115,42,1148
E01028456,494,313,139,246,1192
E01028457,625,384,92,20,1121
E01028458,606,130,169,288,1193
E01028459,653,157,298,48,1156
E01028460,971,208,208,97,1484
E01028461,822,143,282,89,1336
E01028462,642,337,155,149,1283
E01028463,1009,200,502,142,1853
E01028464,636,197,215,41,1089
E01028465,707,211,136,15,1069
E01028466,540,283,99,414,1336
E01028467,512,400,228,163,1303
E01028468,452,432,439,246,1569
E01028469,576,593,70,40,1279
E01028470,601,494,139,159,1393
E01028471,423,178,89,322,1012
E01028472,597,292,120,27,1036
E01028473,797,298,130,18,1243
E01028474,506,434,137,187,1264
E01028475,742,752,159,89,1742
E01028476,850,717,162,53,1782
E01028477,578,365,192,51,1186
E01028478,524,103,310,38,975
E01028479,429,469,140,27,1065
E01028480,428,469,170,111,1178
E01028481,378,468,172,123,1141
E01028482,446,458,61,12,977
E01028483,443,370,166,30,1009
E01028484,381,284,141,99,905
E01028485,493,343,75,101,1012
E01028486,386,515,136,28,1065
E01028487,499,317,207,9,1032
E01028488,536,262,284,40,1122
E01028489,378,729,113,18,1238
E01028490,398,360,92,170,1020
E01028491,468,555,189,74,1286
E01028492,534,554,150,16,1254
E01028493,443,395,116,166,1120
E01028494,336,172,142,268,918
E01028495,537,337,149,43,1066
E01028496,459,340,94,203,1096
E01028497,402,494,219,33,1148
E01028498,515,359,130,267,1271
E01028499,527,523,133,78,1261
E01028500,459,312,86,146,1003
E01028501,409,432,92,40,973
E01028502,417,410,108,34,969
E01028503,357,456,98,66,977
E01028504,474,470,147,90,1181
E01028505,287,321,661,119,1388
E01028506,615,449,196,156,1416
E01028507,484,463,185,29,1161
E01028508,362,397,95,36,890
E01028509,520,513,147,65,1245
E01028510,599,538,115,21,1273
E01028511,477,686,152,66,1381
E01028512,586,408,115,96,1205
E01028513,420,172,398,638,1628
E01028514,295,113,136,545,1089
E01028515,573,316,332,116,1337
E01028516,336,342,257,431,1366
E01028517,365,98,125,393,981
E01028518,224,140,107,713,1184
E01028519,359,221,154,396,1130
E01028520,283,157,121,645,1206
E01028521,127,116,838,95,1176
E01028522,66,74,553,395,1088
E01028523,154,165,432,478,1229
E01028524,242,193,245,503,1183
E01028525,248,204,278,551,1281
E01028526,177,181,794,217,1369
E01028527,554,389,355,64,1362
E01028528,384,282,506,44,1216
E01028529,368,203,298,351,1220
E01028530,449,370,398,145,1362
E01028531,541,262,650,148,1601
E01028532,467,309,1086,367,2229
E01028533,488,225,710,320,1743
E01028534,262,368,239,23,892
E01028535,363,355,558,64,1340
E01028536,258,310,416,180,1164
E01028537,205,368,598,248,1419
E01028538,263,245,254,433,1195
E01028539,411,327,630,128,1496
E01028540,300,366,318,112,1096
E01028541,345,272,484,130,1231
E01028542,433,266,569,241,1509
E01028543,172,223,372,350,1117
E01028544,227,305,572,41,1145
E01028545,401,318,552,60,1331
E01028546,398,259,349,531,1537
E01028547,500,325,964,72,1861
E01028548,368,347,601,121,1437
E01028549,293,262,699,168,1422
E01028550,114,121,819,215,1269
E01028551,142,184,807,125,1258
E01028552,369,201,206,530,1306
E01028553,481,283,319,233,1316
E01028554,387,299,268,132,1086
E01028555,504,413,275,111,1303
E01028556,379,265,490,286,1420
E01028557,504,274,386,324,1488
E01028558,482,394,403,81,1360
E01028559,430,314,579,102,1425
E01028560,337,476,266,170,1249
E01028561,431,629,253,13,1326
E01028562,367,281,402,225,1275
E01028563,417,389,373,40,1219
E01028565,326,374,305,4,1009
E01028567,390,213,179,550,1332
E01028568,165,94,76,772,1107
E01028569,278,14,91,766,1149
E01028570,768,88,272,221,1349
E01028571,469,373,313,165,1320
E01028572,557,428,293,37,1315
E01028573,482,436,411,32,1361
E01028574,258,313,313,247,1131
E01028575,380,442,244,204,1270
E01028576,248,97,172,500,1017
E01028577,461,212,198,600,1471
E01028578,488,388,305,111,1292
E01028579,181,168,999,171,1519
E01028580,163,173,829,151,1316
E01028581,263,346,478,69,1156
E01028582,136,117,691,280,1224
E01028583,120,332,252,16,720
E01028584,669,602,593,145,2009
E01028585,115,252,305,12,684
E01028586,205,220,980,146,1551
E01028587,276,200,1075,207,1758
E01028588,160,103,843,69,1175
E01028591,269,363,328,40,1000
E01028592,202,299,363,14,878
E01028594,459,532,232,72,1295
E01028595,386,399,172,175,1132
E01028596,384,452,273,83,1192
E01028597,320,326,304,223,1173
E01028598,829,781,175,164,1949
E01028599,434,479,174,84,1171
E01028600,549,551,77,38,1215
E01028601,254,307,309,78,948
E01028602,85,96,815,58,1054
E01028603,408,340,126,71,945
E01028604,473,208,69,387,1137
E01028605,446,407,71,317,1241
E01028606,427,689,219,105,1440
E01028607,364,449,131,89,1033
E01028608,402,424,44,95,965
E01028609,489,384,56,107,1036
E01028610,521,451,118,168,1258
E01028611,344,394,109,64,911
E01028612,346,388,158,87,979
E01028613,646,375,69,42,1132
E01028614,571,453,66,125,1215
E01028615,530,694,81,31,1336
E01028616,566,443,79,37,1125
E01028617,648,548,167,99,1462
E01028618,616,470,226,94,1406
E01028619,590,538,103,244,1475
E01028620,732,661,380,157,1930
E01028621,234,223,162,343,962
E01028622,477,393,72,68,1010
E01028623,579,385,196,169,1329
E01028624,530,473,67,78,1148
E01028625,905,158,384,19,1466
E01028626,859,177,217,6,1259
E01028627,612,178,254,93,1137
E01028628,679,245,190,28,1142
E01028629,642,170,253,66,1131
E01028630,640,171,340,94,1245
E01028631,371,271,153,104,899
E01028632,526,197,113,330,1166
E01028633,453,211,235,286,1185
E01028634,541,444,59,27,1071
E01028635,525,340,110,251,1226
E01028636,307,217,140,369,1033
E01028637,635,503,86,53,1277
E01028638,397,514,149,91,1151
E01028639,383,364,182,109,1038
E01028640,404,428,151,182,1165
E01028641,312,556,122,17,1007
E01028642,392,422,84,102,1000
E01028643,397,446,152,90,1085
E01028644,472,530,194,124,1320
E01028645,360,676,123,20,1179
E01028646,308,304,143,182,937
E01028647,484,502,193,89,1268
E01028648,420,351,46,130,947
E01028649,418,536,144,160,1258
E01028650,571,585,214,173,1543
E01028651,314,469,188,355,1326
E01028652,463,660,518,70,1711
E01028653,381,225,213,252,1071
E01028654,471,442,115,192,1220
E01028655,417,417,509,85,1428
E01028656,374,593,83,15,1065
E01028657,422,400,151,41,1014
E01028658,396,351,213,35,995
E01028659,565,530,131,64,1290
E01028660,474,519,267,98,1358
E01028661,448,577,131,55,1211
E01028662,403,513,80,34,1030
E01028663,469,361,97,242,1169
E01028664,451,529,42,61,1083
E01028665,443,551,49,22,1065
E01028666,572,292,261,129,1254
E01028667,670,222,152,19,1063
E01028668,545,429,86,78,1138
E01028669,493,371,148,75,1087
E01028670,494,534,69,31,1128
E01028671,352,376,187,242,1157
E01028672,547,674,92,83,1396
E01028673,477,257,94,164,992
E01028674,443,461,55,95,1054
E01028675,422,261,69,229,981
E01028676,575,349,201,433,1558
E01028677,356,341,307,210,1214
E01028678,410,494,240,97,1241
E01028679,582,526,373,250,1731
E01028680,535,512,231,107,1385
E01028681,423,540,92,26,1081
E01028682,366,391,68,165,990
E01028683,439,603,71,60,1173
E01028684,479,400,240,74,1193
E01028685,424,416,66,72,978
E01028686,362,357,134,117,970
E01028688,512,248,122,107,989
E01028689,529,230,217,187,1163
E01028690,466,400,198,287,1351
E01028691,352,429,110,295,1186
E01028692,276,124,66,519,985
E01028693,679,502,83,11,1275
E01028694,688,309,175,15,1187
E01028695,562,540,159,21,1282
E01028696,498,445,83,27,1053
E01028697,438,281,173,316,1208
E01028698,512,348,223,130,1213
E01028699,523,581,155,42,1301
E01028700,374,262,127,501,1264
E01028701,555,423,100,169,1247
E01028702,491,461,60,73,1085
E01028703,482,257,313,322,1374
E01028704,541,449,236,278,1504
E01028705,524,471,60,12,1067
E01028706,673,448,125,4,1250
E01028707,764,400,82,14,1260
E01028708,551,538,190,183,1462
E01028709,524,664,162,14,1364
E01028710,574,617,119,17,1327
E01028711,446,572,151,163,1332
E01028712,598,709,184,152,1643
E01028713,674,638,388,223,1923
E01028714,813,700,184,198,1895
E01028715,327,304,246,197,1074
E01028716,623,288,272,236,1419
E01028717,362,311,314,323,1310
E01028718,469,237,108,345,1159
E01028719,527,592,107,91,1317
E01028720,694,669,192,251,1806
E01028721,614,283,103,46,1046
E01028722,449,550,254,80,1333
E01028723,479,507,62,158,1206
E01028724,549,405,76,33,1063
E01028725,625,228,94,229,1176
E01028726,694,747,263,128,1832
E01028727,551,571,141,56,1319
E01028728,293,335,86,221,935
E01028729,392,299,71,79,841
E01028730,344,481,365,99,1289
E01028731,405,331,71,258,1065
E01028732,391,250,147,144,932
E01028733,394,493,131,54,1072
E01028734,576,537,151,9,1273
E01028735,515,542,145,147,1349
E01028736,858,706,217,93,1874
E01028737,749,760,245,122,1876
E01028738,183,146,574,77,980
E01028739,537,502,144,188,1371
E01028740,553,535,186,19,1293
E01028741,464,406,164,19,1053
E01028742,395,428,327,165,1315
E01028743,176,426,192,37,831
E01028744,376,463,149,61,1049
E01028745,295,377,269,67,1008
E01028746,377,444,84,122,1027
E01028747,224,190,425,66,905
E01028748,205,125,315,145,790
E01028749,827,622,226,220,1895
E01028750,380,352,146,278,1156
E01028751,421,565,155,61,1202
E01028752,604,492,141,110,1347
E01028753,397,397,91,276,1161
E01028754,411,473,161,65,1110
E01028755,544,497,90,189,1320
E01028756,702,492,478,245,1917
E01028757,393,301,124,322,1140
E01028758,578,601,60,33,1272
E01028759,528,316,103,293,1240
E01028760,431,314,95,138,978
E01028761,448,364,81,152,1045
E01028762,556,463,281,135,1435
E01028763,598,632,174,172,1576
E01028764,629,576,195,57,1457
E01028765,556,490,138,395,1579
E01028766,627,543,304,93,1567
E01028767,381,652,225,272,1530
E01028771,471,326,175,265,1237
E01028772,777,410,217,18,1422
E01028773,503,359,158,83,1103
E01028774,316,163,435,168,1082
E01028775,499,387,193,19,1098
E01028776,537,595,326,107,1565
E01028777,319,392,152,62,925
E01028778,415,489,90,220,1214
E01028779,382,350,95,77,904
E01028780,654,597,282,107,1640
E01028781,331,197,48,416,992
E01028782,544,510,128,65,1247
E01028783,395,380,281,221,1277
E01028784,772,672,160,133,1737
E01028785,536,476,146,105,1263
E01028786,417,563,66,19,1065
E01028787,279,350,120,312,1061
E01028788,459,545,248,82,1334
E01028789,529,528,129,19,1205
E01028790,409,364,72,122,967
E01028791,540,575,92,28,1235
E01028792,370,412,87,29,898
E01028793,538,395,115,164,1212
E01028794,495,537,105,50,1187
E01028795,393,485,289,105,1272
E01028796,291,354,196,104,945
E01028797,320,362,115,96,893
E01028798,608,626,250,141,1625
E01028799,664,671,121,137,1593
E01028800,387,352,164,130,1033
E01028801,477,389,124,102,1092
E01028802,484,536,139,19,1178
E01028804,355,492,133,61,1041
E01028806,692,559,234,126,1611
E01028807,731,464,393,201,1789
E01028808,498,445,180,285,1408
E01028809,150,96,56,726,1028
E01028810,652,298,142,21,1113
E01028811,414,264,93,327,1098
E01028813,381,238,86,301,1006
E01028814,524,445,158,48,1175
E01028815,461,510,63,30,1064
E01028816,493,346,171,95,1105
E01028817,529,344,140,175,1188
E01028818,427,524,360,152,1463
E01028819,358,354,116,469,1297
E01028820,637,241,129,37,1044
E01028821,639,172,182,175,1168
E01028822,705,274,144,16,1139
E01028823,321,372,272,87,1052
E01028824,521,442,147,140,1250
E01028825,345,374,178,45,942
E01028826,438,520,209,250,1417
E01028827,411,354,162,264,1191
E01028828,455,467,245,174,1341
E01028829,424,567,82,58,1131
E01028830,423,533,272,29,1257
E01028831,505,566,108,53,1232
E01028832,523,411,340,142,1416
E01028833,409,523,198,86,1216
E01028834,476,484,126,170,1256
E01028835,501,470,126,132,1229
E01028836,377,320,126,386,1209
E01028837,511,552,145,44,1252
E01028838,338,315,137,385,1175
E01028839,446,541,99,15,1101
E01028840,462,422,98,98,1080
E01028841,387,346,350,211,1294
E01028842,476,533,259,96,1364
E01028843,393,519,343,108,1363
E01028844,113,177,574,78,942
E01028845,550,894,182,50,1676
E01028846,484,641,218,103,1446
E01028847,367,415,361,104,1247
E01028848,529,699,132,19,1379
E01028849,481,444,275,380,1580
E01028850,653,572,407,223,1855
E01028851,416,638,234,116,1404
E01028852,364,498,229,241,1332
E01028853,398,191,116,490,1195
E01028854,537,480,164,98,1279
E01028855,501,548,198,23,1270
E01028856,339,367,201,148,1055
E01028857,548,463,226,210,1447
E01028858,495,880,275,78,1728
E01028859,412,474,345,97,1328
E01028860,657,568,133,81,1439
E01028861,347,351,284,75,1057
E01028862,526,549,153,95,1323
E01028863,403,395,107,116,1021
E01028864,457,527,121,110,1215
E01028865,524,616,150,95,1385
E01028866,295,414,318,42,1069
E01028867,327,325,139,288,1079
E01028868,463,531,82,131,1207
E01028869,502,406,146,107,1161
E01028870,512,476,144,66,1198
E01028871,357,289,216,117,979
E01028872,402,467,245,59,1173
E01028873,317,344,344,394,1399
E01028874,399,565,121,70,1155
E01028875,982,595,161,170,1908
E01028876,469,381,286,283,1419
E01028877,499,472,72,12,1055
E01028878,453,499,200,129,1281
E01028879,500,323,161,272,1256
E01028880,476,527,114,155,1272
E01028881,382,557,116,24,1079
E01028882,421,403,346,86,1256
E01028883,277,296,423,67,1063
E01028884,500,380,115,232,1227
E01028885,576,475,421,146,1618
E01028886,497,307,244,279,1327
E01028887,421,532,118,47,1118
E01028888,577,503,135,56,1271
E01028889,382,552,130,78,1142
E01028890,396,361,217,172,1146
E01028891,412,304,443,237,1396
E01028892,410,567,162,21,1160
E01028893,493,543,116,98,1250
E01028894,491,336,104,315,1246
E01028895,443,417,249,214,1323
E01028896,663,500,348,109,1620
E01028897,432,410,122,218,1182
E01028898,452,525,123,72,1172
E01028899,474,540,166,99,1279
E01028902,325,461,116,36,938
E01028903,302,393,75,315,1085
E01028904,491,350,112,218,1171
E01028905,484,240,195,428,1347
E01028906,233,158,417,217,1025
E01028907,465,623,305,38,1431
E01028908,297,206,432,282,1217
E01028909,449,260,134,324,1167
E01028910,396,434,141,33,1004
E01028911,511,480,72,47,1110
E01028912,240,186,121,351,898
E01028913,473,613,127,84,1297
E01028914,316,453,74,100,943
E01028915,420,523,100,93,1136
E01028916,433,755,84,47,1319
E01028917,469,388,244,41,1142
E01028918,514,370,186,93,1163
E01028919,413,326,156,65,960
E01028920,345,352,104,243,1044
E01028921,554,497,112,98,1261
E01028922,381,454,187,21,1043
E01028923,534,623,114,68,1339
E01028924,540,338,114,247,1239
E01028925,461,474,116,13,1064
E01028926,348,341,130,303,1122
E01028927,310,375,124,54,863
E01028928,499,453,117,199,1268
E01028929,523,466,185,21,1195
E01028930,608,357,211,98,1274
E01028931,627,328,373,235,1563
E01028932,789,509,224,47,1569
E01028933,621,364,143,161,1289
E01028934,333,273,119,417,1142
E01028935,525,662,63,23,1273
E01028936,673,878,141,24,1716
E01028937,515,496,125,120,1256
E01028938,490,425,368,106,1389
E01028939,477,405,348,57,1287
E01028940,476,556,130,137,1299
E01028941,515,400,346,218,1479
E01028942,578,311,170,25,1084
E01028943,815,571,343,45,1774
E01028944,473,417,231,302,1423
E01028945,586,307,540,279,1712
E01028946,334,457,864,100,1755
E01028947,402,714,57,28,1201
E01028948,446,461,59,266,1232
E01028949,469,581,141,47,1238
E01028950,617,854,270,134,1875
E01028951,462,504,119,159,1244
E01028952,560,548,271,24,1403
E01028953,477,579,136,24,1216
E01028954,378,527,109,61,1075
E01028955,286,321,77,214,898
E01028956,578,531,61,105,1275
E01028957,266,150,85,669,1170
E01028958,633,370,112,374,1489
E01028959,661,734,411,265,2071
E01028960,373,519,160,38,1090
E01028961,314,392,323,45,1074
E01028962,316,223,95,639,1273
E01028963,598,594,84,30,1306
E01028964,601,621,92,28,1342
E01028965,384,317,117,299,1117
E01028966,508,471,37,27,1043
E01028967,333,159,59,653,1204
E01028968,384,269,87,296,1036
E01028969,450,392,192,98,1132
E01028970,366,427,166,51,1010
E01028971,589,659,343,148,1739
E01028972,565,692,141,4,1402
E01028973,471,399,529,205,1604
E01028974,366,406,149,48,969
E01028975,573,448,146,229,1396
E01028976,487,745,135,35,1402
E01028977,526,678,198,179,1581
E01028978,470,477,134,153,1234
E01028979,424,298,167,116,1005
E01028980,551,664,429,177,1821
E01028981,653,419,176,73,1321
E01028982,606,295,110,247,1258
E01028983,529,285,98,675,1587
E01028984,420,364,141,243,1168
E01028985,440,557,129,20,1146
E01028986,576,563,94,42,1275
E01028987,584,423,522,189,1718
E01028988,629,366,178,161,1334
E01028989,492,299,107,398,1296
E01028990,304,461,132,89,986
E01028991,231,466,234,82,1013
E01028992,291,487,243,228,1249
E01028993,332,573,290,65,1260
E01028994,213,500,169,138,1020
E01028995,452,484,199,142,1277
E01028996,312,600,133,56,1101
E01028997,497,1052,180,222,1951
E01028998,558,1008,272,159,1997
E01028999,394,647,165,118,1324
E01029000,329,497,80,62,968
E01029001,591,713,162,120,1586
E01029002,301,351,165,239,1056
E01029003,446,1113,306,114,1979
E01029004,154,351,343,28,876
E01029005,214,518,241,57,1030
E01029006,347,656,121,207,1331
E01029007,224,219,84,353,880
E01029009,321,538,127,6,992
E01029010,390,298,144,263,1095
E01029011,353,503,148,220,1224
E01029012,598,537,200,139,1474
E01029013,438,589,341,95,1463
E01029014,243,198,115,362,918
E01029015,285,531,309,55,1180
E01029016,345,588,194,35,1162
E01029018,779,756,237,75,1847
E01029019,669,923,239,61,1892
E01029020,420,410,147,163,1140
E01029021,462,404,106,25,997
E01029022,463,437,151,39,1090
E01029023,337,400,116,111,964
E01029024,636,719,153,167,1675
E01029025,443,311,92,224,1070
E01029026,360,336,69,35,800
E01029027,361,403,137,51,952
E01029028,382,309,172,101,964
E01029029,404,351,177,367,1299
E01029030,868,565,123,8,1564
E01029031,578,580,127,23,1308
E01029032,268,594,42,6,910
E01029033,571,367,205,11,1154
E01029034,514,391,179,9,1093
E01029035,575,334,249,28,1186
E01029036,445,282,329,212,1268
E01029037,491,307,144,147,1089
E01029038,463,227,120,249,1059
E01029039,477,542,108,105,1232
E01029040,562,458,184,109,1313
E01029041,484,376,299,417,1576
E01029042,306,195,214,452,1167
E01029043,537,341,144,166,1188
E01029044,511,238,174,115,1038
E01029045,470,382,243,177,1272
E01029046,262,268,417,169,1116
E01029047,450,393,202,130,1175
E01029050,667,650,223,294,1834
E01029051,492,607,168,70,1337
E01029052,548,763,158,226,1695
E01029053,577,829,369,83,1858
E01029054,516,496,150,76,1238
E01029055,383,453,96,38,970
E01029056,703,726,389,26,1844
E01029057,625,630,267,120,1642
E01029058,665,731,264,169,1829
E01029059,613,808,203,113,1737
E01029060,550,713,196,67,1526
E01029061,656,775,220,141,1792
E01029062,229,112,460,304,1105
E01029063,910,481,329,200,1920
E01029064,510,355,239,52,1156
E01029065,751,433,126,23,1333
E01029066,540,476,268,132,1416
E01029067,445,341,127,305,1218
E01029068,236,255,233,204,928
E01029069,344,378,98,61,881
E01029070,542,410,391,96,1439
E01029071,483,314,198,202,1197
E01029072,467,209,205,417,1298
E01029073,363,282,180,151,976
E01029074,408,499,118,30,1055
E01029075,352,463,141,150,1106
E01029076,760,727,122,51,1660
E01029077,567,723,334,79,1703
E01029078,366,679,319,136,1500
E01029079,409,345,193,344,1291
E01029080,492,486,142,100,1220
E01029081,420,468,290,100,1278
E01029082,313,651,157,20,1141
E01029083,257,550,167,18,992
E01029084,447,469,134,188,1238
E01029085,645,532,262,188,1627
E01029086,788,848,140,38,1814
E01029089,834,712,134,102,1782
E01029090,558,458,206,28,1250
E01029091,691,306,318,8,1323
E01029092,768,273,183,5,1229
E01029093,438,205,384,233,1260
E01029094,564,327,393,17,1301
E01029095,378,209,529,159,1275
E01029096,426,296,292,123,1137
E01029097,386,171,213,304,1074
E01029098,424,298,224,199,1145
E01029099,353,189,98,355,995
E01029100,390,144,116,350,1000
E01029101,420,270,76,122,888
E01029102,518,383,194,118,1213
E01029103,486,657,94,1,1238
E01029104,581,538,72,61,1252
E01029105,264,231,157,537,1189
E01029106,211,181,119,663,1174
E01029107,308,275,131,487,1201
E01029108,621,728,252,137,1738
E01029109,358,226,110,340,1034
E01029110,619,323,395,410,1747
E01029111,716,273,420,457,1866
E01029112,403,478,616,142,1639
E01029113,518,708,103,41,1370
E01029114,436,725,108,31,1300
E01029115,605,650,127,14,1396
E01029116,383,425,398,100,1306
E01029117,424,542,354,17,1337
E01029118,671,527,167,46,1411
E01029119,441,454,172,233,1300
E01029120,564,424,211,7,1206
E01029121,420,490,126,37,1073
E01029122,435,520,181,38,1174
E01029123,276,309,117,171,873
E01029124,477,663,157,155,1452
E01029125,391,555,118,74,1138
E01029126,515,519,136,102,1272
E01029127,383,494,236,148,1261
E01029128,716,665,112,21,1514
E01029129,720,591,120,79,1510
E01029130,656,792,178,104,1730
E01029131,541,267,448,307,1563
E01029132,292,195,76,589,1152
E01029133,392,552,101,69,1114
E01029134,599,589,187,238,1613
E01029135,572,645,119,64,1400
E01029136,656,669,133,176,1634
E01029137,596,562,86,70,1314
E01029138,485,462,106,91,1144
E01029139,430,618,120,49,1217
E01029140,992,915,245,159,2311
E01029142,522,561,132,10,1225
E01029143,419,333,128,269,1149
E01029144,453,442,107,42,1044
E01029145,721,694,126,78,1619
E01029147,583,688,102,38,1411
E01029148,480,586,134,80,1280
E01029149,531,465,96,44,1136
E01029150,406,529,112,18,1065
E01029151,386,526,83,83,1078
E01029152,652,711,93,302,1758
E01029153,620,1011,269,106,2006
E01029154,493,527,186,290,1496
E01029155,468,778,182,93,1521
E01029156,640,502,187,185,1514
E01029157,286,323,174,193,976
E01029158,422,355,150,75,1002
E01029159,745,288,166,14,1213
E01029160,1166,361,282,102,1911
E01029161,686,200,247,132,1265
E01029162,506,302,343,88,1239
E01029163,702,786,216,164,1868
E01029164,392,474,181,118,1165
E01029165,309,493,99,98,999
E01029166,684,844,279,80,1887
E01029167,342,342,216,361,1261
E01029168,447,662,175,37,1321
E01029169,538,447,153,82,1220
E01029170,258,204,105,300,867
E01029171,605,649,221,284,1759
E01029172,537,561,73,55,1226
E01029173,472,237,115,135,959
E01029174,315,433,84,100,932
E01029175,457,391,328,469,1645
E01029176,465,441,116,36,1058
E01029177,260,200,100,350,910
E01029178,455,602,119,81,1257
E01029179,312,276,97,233,918
E01029180,391,508,140,151,1190
E01029181,350,525,135,110,1120
E01029182,492,552,100,79,1223
E01029183,461,381,102,217,1161
E01029184,598,712,144,54,1508
E01029185,465,450,341,119,1375
E01029186,402,358,163,299,1222
E01029187,263,316,96,159,834
E01029188,489,628,119,28,1264
E01029189,365,319,56,177,917
E01029190,344,523,167,28,1062
E01029191,344,380,112,176,1012
E01029192,488,381,137,175,1181
E01029193,517,491,333,241,1582
E01029194,836,756,264,139,1995
E01029195,442,497,130,208,1277
E01029196,455,505,125,135,1220
E01029197,396,469,106,78,1049
E01029198,188,97,501,140,926
E01029199,768,558,246,135,1707
E01029200,388,325,235,184,1132
E01029201,488,490,120,68,1166
E01029202,393,225,87,294,999
E01029203,525,543,124,75,1267
E01029204,379,463,111,48,1001
E01029205,588,478,215,157,1438
E01029206,404,457,148,208,1217
E01029207,415,530,104,69,1118
E01029208,278,364,92,176,910
E01029209,402,568,118,15,1103
E01029210,564,538,153,43,1298
E01029211,396,522,112,122,1152
E01029212,310,451,97,43,901
E01029213,319,457,110,173,1059
E01029214,340,443,97,80,960
E01029215,282,305,93,239,919
E01029216,393,640,134,64,1231
E01029217,488,578,127,96,1289
E01029218,478,557,147,347,1529
E01029219,458,610,120,33,1221
E01029220,421,396,51,145,1013
E01029221,584,921,352,80,1937
E01029222,523,546,117,111,1297
E01029223,334,524,95,64,1017
E01029224,485,687,153,60,1385
E01029225,667,788,151,140,1746
E01029226,371,464,244,290,1369
E01029227,516,456,139,143,1254
E01029228,486,507,202,135,1330
E01029229,481,399,491,277,1648
E01029230,535,991,304,139,1969
E01029231,505,400,181,168,1254
E01029232,555,208,340,79,1182
E01029233,366,218,146,332,1062
E01029234,284,363,626,254,1527
E01029235,370,343,171,247,1131
E01029236,307,207,81,521,1116
E01029237,380,210,122,459,1171
E01029238,515,269,119,302,1205
E01029239,286,286,303,292,1167
E01029240,562,312,272,46,1192
E01029241,623,293,317,216,1449
E01029242,588,381,153,90,1212
E01029243,462,751,115,74,1402
E01029244,576,555,100,9,1240
E01029245,843,564,261,105,1773
E01029246,518,462,164,42,1186
E01029247,283,110,92,666,1151
E01029248,436,307,189,296,1228
E01029249,372,343,135,275,1125
E01029250,467,509,102,18,1096
E01029251,438,516,88,57,1099
E01029252,520,401,201,47,1169
E01029253,536,339,166,209,1250
E01029254,475,637,43,18,1173
E01029255,347,373,283,141,1144
E01029256,410,486,95,178,1169
E01029257,649,437,168,402,1656
E01029258,509,475,168,42,1194
E01029259,382,370,170,216,1138
E01029260,946,325,274,90,1635
E01029261,648,808,181,96,1733
E01029262,749,873,232,88,1942
E01029263,515,356,236,15,1122
E01029264,443,559,78,9,1089
E01029265,475,610,104,8,1197
E01029266,253,435,216,103,1007
E01029267,496,557,155,169,1377
E01029268,477,506,211,90,1284
E01029269,706,720,199,72,1697
E01029270,632,718,335,100,1785
E01029271,509,656,194,104,1463
E01029273,414,403,77,60,954
E01029274,528,628,65,48,1269
E01029275,358,527,89,78,1052
E01029276,381,462,169,62,1074
E01029277,357,221,135,121,834
E01029278,288,488,198,107,1081
E01029279,462,468,109,119,1158
E01029280,387,282,139,467,1275
E01029281,508,318,133,403,1362
E01029282,576,176,316,51,1119
E01029283,569,306,99,486,1460
E01029284,239,264,553,307,1363
E01029285,561,364,999,51,1975
E01029286,413,180,500,153,1246
E01029287,546,206,460,27,1239
E01029288,529,362,259,46,1196
E01029289,524,411,550,55,1540
E01029290,440,394,217,124,1175
E01029291,420,356,202,319,1297
E01029292,251,123,143,569,1086
E01029293,155,67,68,781,1071
E01029294,746,384,242,17,1389
E01029295,653,488,200,19,1360
E01029296,494,542,99,69,1204
E01029297,282,171,103,493,1049
E01029298,448,296,91,318,1153
E01029299,346,354,341,183,1224
E01029300,509,293,345,96,1243
E01029301,376,597,429,222,1624
E01029302,453,692,174,38,1357
E01029303,498,843,199,8,1548
E01029304,294,234,114,565,1207
E01029305,465,344,105,236,1150
E01029306,498,442,90,207,1237
E01029307,286,202,67,552,1107
E01029308,551,848,147,63,1609
E01029309,507,292,228,556,1583
E01029310,514,749,240,16,1519
E01029311,273,178,134,529,1114
E01029312,534,334,124,146,1138
E01029313,500,232,174,129,1035
E01029314,780,654,224,349,2007
E01029315,479,613,97,18,1207
E01029316,526,337,286,161,1310
E01029317,449,265,81,210,1005
E01029318,531,565,138,15,1249
E01029319,600,199,264,80,1143
E01029320,409,393,182,271,1255
E01029321,648,915,259,70,1892
E01029322,229,408,173,281,1091
E01029324,500,390,162,224,1276
E01029325,376,790,204,237,1607
E01029326,240,415,166,210,1031
E01029327,540,805,243,126,1714
E01029328,369,732,270,307,1678
E01029329,399,510,343,49,1301
E01029330,376,811,458,42,1687
E01029331,262,852,109,54,1277
E01029333,238,321,129,270,958
E01029334,259,402,169,127,957
E01029335,267,464,163,48,942
E01029336,279,723,384,379,1765
E01029337,552,701,333,204,1790
E01029338,310,743,311,146,1510
E01029339,371,367,135,341,1214
E01029341,313,443,222,119,1097
E01029342,218,558,187,12,975
E01029343,268,568,323,103,1262
E01029345,638,332,158,147,1275
E01029346,378,240,199,477,1294
E01029347,579,592,76,17,1264
E01029348,613,461,140,205,1419
E01029349,411,256,107,310,1084
E01029350,362,317,199,371,1249
E01029351,315,227,112,514,1168
E01029352,456,414,194,54,1118
E01029353,356,499,151,208,1214
E01029354,551,371,117,217,1256
E01029355,465,256,128,382,1231
E01029356,307,295,111,470,1183
E01029357,401,297,161,249,1108
E01029358,251,119,81,475,926
E01029359,470,157,279,373,1279
E01029360,401,354,232,238,1225
E01029361,434,388,136,273,1231
E01029362,357,196,128,541,1222
E01029363,474,380,91,256,1201
E01029364,511,652,166,52,1381
E01029365,580,452,162,91,1285
E01029366,549,849,70,27,1495
E01029367,685,556,206,301,1748
E01029368,490,553,42,0,1085
E01029369,491,379,119,0,989
E01029370,563,569,54,3,1189
E01029371,656,385,129,65,1235
E01029372,411,124,82,407,1024
E01029373,798,385,235,319,1737
E01029374,896,584,314,56,1850
E01029375,1244,339,193,111,1887
E01029376,927,182,209,113,1431
E01029377,820,197,78,5,1100
E01029378,848,359,117,22,1346
E01029379,872,220,104,139,1335
E01029380,793,299,98,15,1205
E01029381,454,354,157,282,1247
E01029382,600,379,231,127,1337
E01029383,743,347,106,77,1273
E01029384,764,520,210,87,1581
E01029385,587,508,124,34,1253
E01029386,496,305,133,224,1158
E01029387,462,357,167,253,1239
E01029388,441,180,136,348,1105
E01029389,615,399,311,59,1384
E01029390,271,181,102,318,872
E01029391,660,532,122,62,1376
E01029392,950,431,110,27,1518
E01029393,654,540,130,106,1430
E01029394,481,587,62,118,1248
E01029395,567,634,148,18,1367
E01029396,654,509,145,114,1422
E01029397,950,355,168,521,1994
E01029398,564,540,94,194,1392
E01029399,657,336,171,81,1245
E01029400,647,342,81,258,1328
E01029401,671,425,149,58,1303
E01029402,734,712,160,15,1621
E01029403,556,340,123,184,1203
E01029404,319,328,359,223,1229
E01029405,555,567,123,73,1318
E01029406,406,479,99,20,1004
E01029407,372,358,325,34,1089
E01029408,533,299,623,164,1619
E01029409,353,358,497,77,1285
E01029410,415,333,346,73,1167
E01029411,353,539,107,60,1059
E01029412,442,455,124,66,1087
E01029413,538,379,167,163,1247
E01029414,698,380,218,31,1327
E01029415,745,237,235,13,1230
E01029416,409,481,136,22,1048
E01029417,364,482,77,81,1004
E01029418,986,621,98,15,1720
E01029419,707,454,116,7,1284
E01029420,645,615,104,25,1389
E01029422,331,438,129,48,946
E01029423,503,346,153,254,1256
E01029424,281,369,130,77,857
E01029425,515,559,104,57,1235
E01029426,429,346,392,138,1305
E01029427,291,258,153,457,1159
E01029428,569,252,271,110,1202
E01029429,402,307,268,33,1010
E01029430,568,475,81,93,1217
E01029431,527,366,56,326,1275
E01029432,465,598,88,83,1234
E01029433,491,327,89,322,1229
E01029434,527,294,239,135,1195
E01029435,481,564,142,45,1232
E01029436,486,284,283,410,1463
E01029437,645,220,232,586,1683
E01029438,505,571,88,85,1249
E01029439,505,600,113,6,1224
E01029440,415,404,185,27,1031
E01029441,501,534,102,123,1260
E01029442,477,514,53,35,1079
E01029443,601,691,82,17,1391
E01029444,478,633,103,151,1365
E01029445,395,271,498,361,1525
E01029446,502,505,271,101,1379
E01029447,387,322,463,73,1245
E01029448,395,394,331,188,1308
E01029449,534,572,168,89,1363
E01029450,371,200,118,495,1184
E01029451,549,454,212,208,1423
E01029452,416,361,84,454,1315
E01029453,268,172,150,586,1176
E01029454,625,700,42,7,1374
E01029455,780,582,93,4,1459
E01029456,512,498,175,62,1247
E01029457,670,320,82,7,1079
E01029458,563,512,77,95,1247
E01029459,702,310,169,36,1217
E01029460,580,455,207,157,1399
E01029461,653,411,272,196,1532
E01029462,513,475,182,86,1256
E01029463,404,453,123,32,1012
E01029464,455,378,97,367,1297
E01029465,561,535,137,57,1290
E01029466,608,552,64,22,1246
E01029467,597,764,269,103,1733
E01029468,275,188,94,663,1220
E01029469,629,649,110,104,1492
E01029470,468,385,185,175,1213
E01029471,622,475,199,37,1333
E01029472,402,401,68,426,1297
E01029473,428,491,143,56,1118
E01029474,396,496,75,22,989
E01029475,740,782,106,52,1680
E01029476,517,540,71,64,1192
E01029477,553,560,129,31,1273
E01029478,540,446,81,203,1270
E01029479,1243,508,191,204,2146
E01029480,773,488,166,44,1471
E01029481,594,616,143,165,1518
E01029482,583,406,96,209,1294
E01029483,586,670,48,16,1320
E01029484,602,561,252,59,1474
E01029485,623,529,115,13,1280
E01029486,519,601,55,74,1249
E01029487,429,311,103,469,1312
E01029488,595,521,184,98,1398
E01029489,576,704,43,15,1338
E01029490,604,460,91,64,1219
E01029491,488,514,202,256,1460
E01029492,282,198,107,899,1486
E01029493,873,509,121,90,1593
E01029494,544,434,154,110,1242
E01029495,696,502,98,72,1368
E01029496,467,245,133,573,1418
E01029497,706,581,147,195,1629
E01029498,595,656,105,145,1501
E01029499,329,239,100,745,1413
E01029500,705,592,64,132,1493
E01029501,384,368,103,389,1244
E01029502,508,374,108,352,1342
E01029503,496,550,79,161,1286
E01029504,460,335,241,252,1288
E01029505,493,625,112,69,1299
E01029506,621,889,69,19,1598
E01029507,706,602,61,25,1394
E01029508,912,688,125,130,1855
E01029509,516,644,109,97,1366
E01029511,583,568,122,41,1314
E01029512,668,509,179,101,1457
E01029513,506,554,38,10,1108
E01029514,512,691,84,18,1305
E01029515,625,761,121,86,1593
E01029516,643,556,199,129,1527
E01029517,557,581,124,117,1379
E01029518,1099,760,204,98,2161
E01029519,782,448,195,307,1732
E01029520,582,683,35,10,1310
E01029521,564,704,113,41,1422
E01029522,483,505,90,189,1267
E01029523,593,611,38,50,1292
E01029524,486,472,219,227,1404
E01029525,594,669,75,166,1504
E01029526,336,310,341,377,1364
E01029527,331,233,63,385,1012
E01029528,456,342,114,116,1028
E01029529,515,266,115,72,968
E01029530,527,426,250,127,1330
E01029531,560,711,86,28,1385
E01029532,516,470,119,109,1214
E01029533,495,550,54,185,1284
E01029534,547,595,118,29,1289
E01029535,383,222,125,399,1129
E01029536,596,598,63,14,1271
E01029537,532,385,94,225,1236
E01029538,396,296,67,505,1264
E01029539,546,499,51,144,1240
E01029540,419,481,52,251,1203
E01029541,451,265,132,359,1207
E01029542,435,440,164,96,1135
E01029543,319,167,57,429,972
E01029544,698,251,85,60,1094
E01029545,652,378,126,102,1258
E01029546,746,257,99,17,1119
E01029547,296,146,243,379,1064
E01029548,264,237,152,512,1165
E01029549,436,470,103,415,1424
E01029551,593,467,134,99,1293
E01029552,462,410,97,240,1209
E01029553,321,249,126,440,1136
E01029554,179,143,72,613,1007
E01029555,463,327,392,302,1484
E01029556,860,843,132,236,2071
E01029557,403,497,120,50,1070
E01029558,419,256,140,397,1212
E01029559,564,307,111,190,1172
E01029560,364,212,102,509,1187
E01029561,401,316,87,351,1155
E01029562,600,354,68,44,1066
E01029563,521,459,62,123,1165
E01029564,227,339,390,90,1046
E01029565,632,345,33,12,1022
E01029566,162,121,51,539,873
E01029567,509,380,173,260,1322
E01029568,395,388,133,262,1178
E01029569,446,473,199,83,1201
E01029570,770,1031,200,72,2073
E01029571,457,516,70,94,1137
E01029572,644,601,79,28,1352
E01029573,556,487,113,50,1206
E01029574,436,528,120,91,1175
E01029575,294,218,97,215,824
E01029576,329,397,121,148,995
E01029577,585,519,149,15,1268
E01029578,407,424,170,321,1322
E01029579,639,531,115,87,1372
E01029580,586,464,100,10,1160
E01029581,666,511,107,31,1315
E01029582,654,715,97,63,1529
E01029583,515,398,128,154,1195
E01029584,479,357,82,60,978
E01029585,540,419,208,41,1208
E01029586,470,576,24,0,1070
E01029587,503,447,68,10,1028
E01029588,561,340,152,240,1293
E01029589,468,525,42,23,1058
E01029590,448,565,52,120,1185
E01029591,328,330,125,462,1245
E01029593,422,315,239,444,1420
E01029594,526,639,217,184,1566
E01029595,428,535,61,68,1092
E01029596,337,578,54,61,1030
E01029597,370,231,90,475,1166
E01029598,428,240,271,466,1405
E01029599,314,343,148,428,1233
E01029600,473,599,85,32,1189
E01029601,470,601,141,83,1295
E01029602,361,371,763,170,1665
E01029603,309,308,332,325,1274
E01029604,242,223,457,518,1440
E01029605,438,480,81,41,1040
E01029606,567,562,57,1,1187
E01029607,445,397,83,248,1173
E01029608,470,679,60,81,1290
E01029609,599,424,270,63,1356
E01029610,555,403,112,22,1092
E01029611,483,251,159,392,1285
E01029612,434,434,90,17,975
E01029613,478,571,64,81,1194
E01029614,534,474,63,325,1396
E01029615,256,241,81,406,984
E01029616,460,654,131,23,1268
E01029617,424,676,237,60,1397
E01029618,395,498,180,252,1325
E01029619,648,698,86,183,1615
E01029620,426,446,81,96,1049
E01029621,538,498,110,93,1239
E01029622,605,420,96,153,1274
E01029623,381,372,39,208,1000
E01029624,668,407,37,97,1209
E01029625,397,487,39,27,950
E01029626,527,495,86,98,1206
E01029627,325,335,105,398,1163
E01029628,412,538,46,20,1016
E01029629,426,536,41,10,1013
E01029630,475,498,100,30,1103
E01029631,593,452,104,45,1194
E01029632,649,602,80,34,1365
E01029633,620,634,44,123,1421
E01029634,434,303,80,343,1160
E01029635,490,346,101,449,1386
E01029636,549,500,94,83,1226
E01029637,869,349,80,106,1404
E01029638,639,653,127,297,1716
E01029639,578,335,40,224,1177
E01029640,639,322,122,74,1157
E01029641,761,549,71,45,1426
E01029642,481,639,79,76,1275
E01029643,355,373,69,399,1196
E01029644,489,604,84,83,1260
E01029645,478,889,149,169,1685
E01029646,494,228,118,279,1119
E01029647,955,335,114,302,1706
E01029648,463,366,108,269,1206
E01029649,289,414,104,216,1023
E01029650,519,641,109,31,1300
E01029651,442,621,134,28,1225
E01029652,601,698,159,12,1470
E01029653,344,414,60,189,1007
E01029654,702,805,167,217,1891
E01029655,563,742,151,228,1684
E01029656,587,666,235,43,1531
E01029657,853,386,101,50,1390
E01029658,337,427,150,168,1082
E01029659,495,541,80,43,1159
E01029660,620,704,192,231,1747
E01029661,779,632,160,15,1586
E01029662,1002,686,126,30,1844
E01029663,674,409,103,10,1196
E01029664,659,378,157,126,1320
E01029665,794,513,181,22,1510
E01029666,377,168,126,606,1277
E01029667,566,758,328,182,1834
E01029668,398,485,131,18,1032
E01029669,433,402,77,175,1087
E01029670,479,450,336,57,1322
E01029671,417,552,76,233,1278
E01029672,552,577,127,50,1306
E01029673,489,461,156,210,1316
E01029674,830,545,58,48,1481
E01029675,458,718,25,101,1302
E01029676,300,335,143,146,924
E01029677,435,538,64,65,1102
E01029678,794,558,71,19,1442
E01029679,320,248,78,508,1154
E01029680,527,509,80,151,1267
E01029681,316,283,94,265,958
E01029682,488,612,111,138,1349
E01029683,325,526,136,79,1066
E01029684,587,514,108,5,1214
E01029685,533,706,52,1,1292
E01029686,516,561,81,10,1168
E01029687,622,717,222,51,1612
E01029688,704,798,174,139,1815
E01029689,488,272,601,57,1418
E01029690,636,407,173,31,1247
E01029691,273,120,331,343,1067
E01029692,446,195,174,423,1238
E01029693,233,124,794,224,1375
E01029694,469,164,532,35,1200
E01029695,616,667,196,195,1674
E01029696,446,520,213,99,1278
E01029697,455,447,149,60,1111
E01029698,495,644,123,42,1304
E01029699,566,364,488,203,1621
E01029700,579,322,150,7,1058
E01029701,361,266,821,250,1698
E01029702,423,514,78,231,1246
E01029703,597,491,103,56,1247
E01029704,488,574,51,64,1177
E01029705,489,656,80,26,1251
E01029706,569,574,127,47,1317
E01029707,475,410,119,179,1183
E01029708,688,594,215,97,1594
E01029709,607,525,96,34,1262
E01029710,491,621,109,22,1243
E01029711,608,469,78,60,1215
E01029712,790,526,88,110,1514
E01029713,518,548,97,142,1305
E01029714,766,432,104,10,1312
E01029715,600,130,159,447,1336
E01029716,422,302,90,445,1259
E01029717,324,211,76,738,1349
E01029718,801,707,109,18,1635
E01029719,459,560,132,183,1334
E01029720,326,177,155,569,1227
E01029721,630,424,164,58,1276
E01029722,507,316,337,220,1380
E01029723,595,553,165,30,1343
E01029724,696,551,168,9,1424
E01029725,310,188,413,361,1272
E01029726,553,537,102,203,1395
E01029727,293,212,122,588,1215
E01029728,510,410,72,166,1158
E01029729,520,273,191,388,1372
E01029730,358,480,72,3,913
E01029731,647,533,75,41,1296
E01029732,461,480,236,32,1209
E01029733,549,667,257,92,1565
E01029734,535,173,162,778,1648
E01029735,912,507,200,267,1886
E01029736,660,409,131,22,1222
E01029737,520,468,114,180,1282
E01029738,531,472,111,9,1123
E01029739,756,460,85,4,1305
E01029740,475,321,128,370,1294
E01029741,741,397,143,47,1328
E01029742,654,815,151,77,1697
E01029743,431,604,121,53,1209
E01029744,928,485,314,69,1796
E01029745,341,483,328,290,1442
E01029746,487,396,137,224,1244
E01029747,580,474,75,77,1206
E01029748,511,565,82,7,1165
E01029749,471,587,207,103,1368
E01029750,466,322,189,220,1197
E01029751,479,676,86,114,1355
E01029752,297,202,70,391,960
E01029753,323,520,123,156,1122
E01029754,504,489,83,33,1109
E01029755,492,645,70,23,1230
E01029756,643,371,223,98,1335
E01029757,674,474,108,1,1257
E01029758,558,667,60,0,1285
E01029759,619,707,104,9,1439
E01029760,489,789,39,3,1320
E01029761,363,584,134,69,1150
E01029762,505,700,86,47,1338
E01029763,417,207,108,481,1213
E01029764,742,241,161,165,1309
E01029765,264,297,170,340,1071
E01029766,520,327,117,253,1217
E01029767,590,728,90,21,1429
E01029768,434,655,63,48,1200
E01029769,505,900,67,8,1480
E01029770,830,734,75,6,1645
E01029771,487,826,52,19,1384
E01029772,689,627,107,70,1493
E01029773,497,743,56,5,1301
E01029774,701,457,271,163,1592
E01029775,495,778,55,4,1332
E01029776,574,865,60,9,1508
E01029777,506,514,94,114,1228
E01029778,610,700,114,26,1450
E01029779,501,825,70,2,1398
E01029780,558,537,56,84,1235
E01029781,525,591,101,65,1282
E01029782,587,481,168,315,1551
E01029783,418,343,116,282,1159
E01029784,847,836,94,13,1790
E01029785,801,601,67,3,1472
E01029786,608,476,103,25,1212
E01029787,474,499,217,201,1391
E01029788,500,533,108,5,1146
E01029789,373,407,65,22,867
E01029790,737,568,67,189,1561
E01029791,518,472,170,23,1183
E01029792,927,716,210,28,1881
E01029793,585,574,95,68,1322
E01029794,477,584,111,16,1188
E01029795,537,609,140,128,1414
E01029796,515,507,87,132,1241
E01029797,441,650,141,67,1299
E01029798,596,555,154,114,1419
E01029799,588,859,92,40,1579
E01029800,589,601,104,10,1304
E01029801,459,753,211,83,1506
E01029802,577,790,122,22,1511
E01029803,550,825,138,42,1555
E01029804,506,412,489,58,1465
E01029805,538,584,134,108,1364
E01029806,478,611,113,56,1258
E01029807,318,289,128,175,910
E01029808,408,438,156,163,1165
E01029809,371,295,63,451,1180
E01029810,348,287,77,299,1011
E01029811,492,363,133,240,1228
E01029812,577,436,412,177,1602
E01029813,823,752,112,64,1751
E01029814,603,478,224,79,1384
E01029815,520,627,59,82,1288
E01029816,540,601,38,35,1214
E01029817,456,747,252,126,1581
E01029818,568,595,67,13,1243
E01029819,583,801,56,7,1447
E01029820,587,309,109,214,1219
E01029821,555,516,125,52,1248
E01029822,832,210,73,49,1164
E01029823,552,593,101,29,1275
E01029824,468,154,116,641,1379
E01029825,603,374,72,41,1090
E01029826,605,506,96,77,1284
E01029827,448,102,121,377,1048
E01029828,354,104,123,369,950
E01029829,840,340,121,220,1521
E01029830,364,189,203,187,943
E01029831,478,362,115,241,1196
E01029832,566,502,114,172,1354
E01029833,807,303,144,85,1339
E01029834,456,355,122,310,1243
E01029835,183,204,405,714,1506
E01029836,375,252,224,180,1031
E01029837,585,299,200,185,1269
E01029838,559,344,371,36,1310
E01029839,674,209,68,11,962
E01029840,262,116,123,417,918
E01029841,611,418,87,105,1221
E01029842,357,121,88,408,974
E01029843,476,187,103,337,1103
E01029844,572,326,94,17,1009
E01029845,81,23,26,676,806
E01029846,457,401,72,118,1048
E01029847,593,462,61,7,1123
E01029848,491,457,56,30,1034
E01029849,373,298,93,394,1158
E01029850,385,249,137,262,1033
E01029851,573,455,462,276,1766
E01029852,423,506,112,354,1395
E01029853,542,377,127,241,1287
E01029854,502,713,72,20,1307
E01029855,651,240,81,202,1174
E01029856,817,231,105,48,1201
E01029857,563,195,72,262,1092
E01029858,775,369,93,54,1291
E01029859,508,101,131,598,1338
E01029860,620,406,77,9,1112
E01029861,460,446,101,135,1142
E01029862,705,277,63,12,1057
E01029863,747,500,174,27,1448
E01029864,692,491,110,42,1335
E01029865,896,329,110,17,1352
E01029867,493,343,131,345,1312
E01029868,745,339,44,26,1154
E01029869,596,378,42,273,1289
E01029870,364,296,85,161,906
E01029871,381,504,145,119,1149
E01029872,488,550,89,31,1158
E01029873,526,741,282,216,1765
E01029874,772,488,132,25,1417
E01029875,620,808,173,168,1769
E01029876,562,671,227,246,1706
E01029877,442,435,116,37,1030
E01029878,367,428,112,62,969
E01029879,417,525,165,116,1223
E01029880,490,607,185,143,1425
E01029881,657,673,178,122,1630
E01029882,367,569,115,160,1211
E01029883,584,820,185,58,1647
E01029884,469,388,194,182,1233
E01029885,694,861,182,60,1797
E01029886,295,322,84,232,933
E01029887,655,573,212,54,1494
E01029888,362,206,94,293,955
E01029889,318,210,94,375,997
E01029890,632,292,101,27,1052
E01029891,754,449,164,157,1524
E01029892,348,368,266,460,1442
E01029893,596,688,507,216,2007
E01029894,381,379,148,54,962
E01029895,470,403,68,25,966
E01029896,384,363,121,267,1135
E01029897,488,630,315,121,1554
E01029898,372,642,202,287,1503
E01029899,601,708,98,60,1467
E01029900,432,468,109,360,1369
E01029901,562,803,373,67,1805
E01029902,622,797,233,133,1785
E01029903,486,582,67,16,1151
E01029904,487,599,61,62,1209
E01029905,369,419,83,33,904
E01029906,419,662,240,153,1474
E01029907,568,779,230,237,1814
E01029908,766,272,205,39,1282
E01029909,753,290,220,22,1285
E01029910,278,177,72,384,911
E01029911,626,798,205,168,1797
E01029912,474,288,209,302,1273
E01029913,248,602,87,28,965
E01029914,495,193,251,282,1221
E01029915,385,311,133,124,953
E01029916,298,185,102,412,997
E01029917,655,595,115,176,1541
E01029918,262,221,239,171,893
E01029919,416,502,213,66,1197
E01029920,312,442,448,279,1481
E01029921,468,502,74,33,1077
E01029922,366,401,104,203,1074
E01029923,537,462,108,34,1141
E01029925,419,442,519,112,1492
E01029926,507,741,194,31,1473
E01029927,511,405,589,364,1869
E01029928,500,413,407,149,1469
E01029929,665,556,290,354,1865
E01029930,480,424,277,52,1233
E01029937,603,457,329,238,1627
E01029938,334,105,231,379,1049
E01029939,553,350,299,49,1251
E01029940,358,263,157,368,1146
E01029941,486,415,394,168,1463
E01029942,427,488,284,30,1229
E01029944,440,596,235,129,1400
E01029945,573,535,304,148,1560
E01029946,569,322,377,385,1653
E01029947,586,650,478,154,1868
E01029949,319,291,225,331,1166
E01029950,347,233,381,508,1469
E01029951,381,521,234,65,1201
E01029952,331,371,184,97,983
E01029953,413,197,360,186,1156
E01029954,566,338,479,542,1925
E01029955,578,357,336,266,1537
E01029956,431,159,461,32,1083
E01029957,469,564,271,72,1376
E01029958,481,287,281,64,1113
E01029960,597,311,479,64,1451
E01029961,474,264,337,43,1118
E01029962,453,218,562,54,1287
E01029963,531,642,79,24,1276
E01029964,481,345,191,27,1044
E01029965,494,607,99,9,1209
E01029966,400,490,187,84,1161
E01029967,367,706,60,7,1140
E01029968,391,270,372,149,1182
E01029969,439,254,193,173,1059
E01029970,587,394,183,282,1446
E01029971,319,191,104,524,1138
E01029973,476,709,89,18,1292
E01029974,628,438,146,19,1231
E01029975,414,378,105,148,1045
E01029976,541,509,114,113,1277
E01029977,573,568,94,18,1253
E01029978,411,335,144,200,1090
E01029979,292,121,112,676,1201
E01029980,309,124,107,660,1200
E01029981,447,338,96,84,965
E01029982,332,134,62,532,1060
E01029983,578,425,231,42,1276
E01029984,437,218,125,371,1151
E01029985,741,300,465,412,1918
E01029986,298,151,113,598,1160
E01029987,342,233,96,547,1218
E01029988,307,142,599,452,1500
E01029990,606,256,387,17,1266
E01029991,630,605,130,22,1387
E01029992,477,347,242,23,1089
E01029994,291,149,86,666,1192
E01029995,642,401,219,45,1307
E01029996,438,322,135,435,1330
E01029997,581,378,96,141,1196
E01029998,410,369,109,528,1416
E01029999,668,445,116,63,1292
E01030000,572,342,240,58,1212
E01030001,485,398,93,285,1261
E01030002,581,414,404,134,1533
E01030003,664,327,305,35,1331
E01030004,556,382,94,6,1038
E01030005,704,353,464,165,1686
E01030006,545,310,374,207,1436
E01030007,535,347,322,17,1221
E01030008,401,445,155,23,1024
E01030009,438,422,219,11,1090
E01030010,376,300,652,185,1513
E01030011,545,611,102,61,1319
E01030012,209,203,64,503,979
E01030013,355,234,118,435,1142
E01030014,363,327,67,398,1155
E01030015,505,482,97,19,1103
E01030016,458,388,239,151,1236
E01030017,298,337,61,431,1127
E01030018,222,159,86,681,1148
E01030019,533,478,112,114,1237
E01030020,517,488,92,170,1267
E01030021,217,173,83,615,1088
E01030022,695,256,599,180,1730
E01030023,384,163,718,202,1467
E01030024,248,177,750,472,1647
E01030025,411,236,542,219,1408
E01030026,587,244,340,121,1292
E01030027,783,307,441,136,1667
E01030028,548,353,122,286,1309
E01030029,442,284,135,416,1277
E01030030,693,294,282,307,1576
E01030031,391,132,86,575,1184
E01030032,275,118,74,605,1072
E01030033,519,663,83,52,1317
E01030034,472,669,70,28,1239
E01030035,370,234,109,644,1357
E01030036,383,282,76,696,1437
E01030037,410,369,101,104,984
E01030038,421,450,113,32,1016
E01030039,441,519,133,79,1172
E01030040,349,381,145,100,975
E01030041,670,789,196,157,1812
E01030042,529,648,118,28,1323
E01030043,535,315,105,47,1002
E01030044,328,412,91,168,999
E01030045,665,575,102,46,1388
E01030046,561,533,118,92,1304
E01030047,478,304,104,150,1036
E01030048,742,724,208,207,1881
E01030049,525,530,146,174,1375
E01030050,864,528,189,26,1607
E01030051,565,472,58,292,1387
E01030052,550,710,193,311,1764
E01030053,617,849,238,195,1899
E01030054,363,502,105,55,1025
E01030055,481,438,112,80,1111
E01030056,699,687,108,322,1816
E01030057,746,630,343,124,1843
E01030058,521,779,214,171,1685
E01030059,733,768,168,193,1862
E01030060,587,424,191,120,1322
E01030061,440,431,173,245,1289
E01030062,465,527,130,24,1146
E01030063,821,649,140,155,1765
E01030064,698,829,155,137,1819
E01030065,639,735,155,158,1687
E01030066,485,560,122,153,1320
E01030067,423,460,151,13,1047
E01030068,568,492,169,156,1385
E01030069,452,510,91,55,1108
E01030070,264,273,462,91,1090
E01030071,516,435,237,30,1218
E01030072,504,540,205,68,1317
E01030073,348,581,81,257,1267
E01030075,799,362,99,6,1266
E01030076,491,319,229,147,1186
E01030077,336,261,116,440,1153
E01030078,708,516,149,16,1389
E01030079,309,238,83,549,1179
E01030080,545,495,110,175,1325
E01030081,687,833,108,278,1906
E01030082,670,923,276,250,2119
E01030083,796,832,161,108,1897
E01030084,578,622,122,15,1337
E01030085,652,448,119,71,1290
E01030086,388,356,81,106,931
E01030087,445,401,120,98,1064
E01030088,351,427,118,70,966
E01030089,716,646,111,205,1678
E01030090,693,813,314,148,1968
E01030091,290,450,682,154,1576
E01030092,397,428,324,267,1416
E01030093,337,410,431,129,1307
E01030094,361,302,340,142,1145
E01030095,384,372,124,83,963
E01030096,473,541,117,89,1220
E01030097,299,400,95,192,986
E01030098,682,763,210,207,1862
E01030099,559,757,206,137,1659
E01030100,654,801,136,136,1727
E01030101,564,692,222,232,1710
E01030103,566,818,109,171,1664
E01030104,723,856,162,87,1828
E01030105,635,298,319,202,1454
E01030106,900,307,262,451,1920
E01030107,731,510,73,36,1350
E01030108,608,344,228,318,1498
E01030109,521,264,120,486,1391
E01030110,959,426,217,566,2168
E01030111,636,415,59,19,1129
E01030112,564,504,243,124,1435
E01030113,574,398,308,265,1545
E01030114,430,138,186,425,1179
E01030115,737,228,211,569,1745
E01030116,1094,355,155,77,1681
E01030117,749,274,157,99,1279
E01030118,639,201,122,320,1282
E01030119,721,757,202,167,1847
E01030120,693,732,187,149,1761
E01030121,728,574,235,271,1808
E01030122,701,632,139,113,1585
E01030123,387,347,107,422,1263
E01030124,422,650,235,17,1324
E01030125,458,424,114,262,1258
E01030127,449,298,252,10,1009
E01030128,636,249,273,18,1176
E01030129,587,431,156,6,1180
E01030130,372,343,112,220,1047
E01030131,220,98,69,581,968
E01030132,165,136,532,47,880
E01030133,290,374,401,134,1199
E01030134,297,289,152,158,896
E01030135,363,501,178,29,1071
E01030137,514,368,362,89,1333
E01030138,629,738,272,275,1914
E01030139,354,181,144,688,1367
E01030140,446,227,82,271,1026
E01030141,509,249,131,348,1237
E01030142,430,828,126,59,1443
E01030143,504,338,204,221,1267
E01030144,396,457,77,93,1023
E01030145,530,425,123,67,1145
E01030146,192,451,139,143,925
E01030147,359,722,121,43,1245
E01030148,443,497,82,2,1024
E01030149,497,582,107,19,1205
E01030150,616,732,229,247,1824
E01030151,637,544,371,80,1632
E01030152,319,1101,169,153,1742
E01030153,210,511,165,197,1083
E01030154,607,740,244,140,1731
E01030155,580,652,170,223,1625
E01030158,384,836,79,12,1311
E01030159,483,505,179,53,1220
E01030160,356,334,143,348,1181
E01030161,390,293,192,202,1077
E01030162,255,281,361,161,1058
E01030163,369,254,387,186,1196
E01030164,483,645,97,32,1257
E01030165,402,423,362,97,1284
E01030166,440,723,88,13,1264
E01030167,382,503,180,37,1102
E01030168,303,218,159,475,1155
E01030169,450,217,306,249,1222
E01030170,357,352,116,550,1375
E01030171,730,530,195,97,1552
E01030172,436,605,227,59,1327
E01030173,299,473,187,247,1206
E01030174,422,412,164,89,1087
E01030175,632,877,158,191,1858
E01030176,507,672,311,157,1647
E01030179,1132,325,299,155,1911
E01030180,531,434,121,14,1100
E01030181,829,332,246,31,1438
E01030183,577,1004,114,15,1710
E01030184,427,762,94,230,1513
E01030185,446,609,156,433,1644
E01030186,375,567,90,160,1192
E01030187,361,406,172,328,1267
E01030188,442,391,361,138,1332
E01030189,452,419,154,284,1309
E01030190,435,903,144,44,1526
E01030191,488,519,280,63,1350
E01030192,496,640,110,4,1250
E01030193,503,624,131,85,1343
E01030194,393,494,206,252,1345
E01030195,493,725,102,21,1341
E01030196,702,456,180,15,1353
E01030197,451,661,208,36,1356
E01030198,381,531,128,73,1113
E01030199,432,668,294,161,1555
E01030200,659,866,150,187,1862
E01030201,493,873,245,172,1783
E01030203,445,856,177,139,1617
E01030204,722,685,56,15,1478
E01030205,605,337,49,6,997
E01030206,486,743,61,12,1302
E01030207,453,643,91,78,1265
E01030208,254,447,165,215,1081
E01030209,433,553,180,107,1273
E01030210,618,405,138,465,1626
E01030211,338,817,374,138,1667
E01030212,491,768,234,147,1640
E01030214,586,332,136,20,1074
E01030215,437,285,180,200,1102
E01030216,538,544,128,20,1230
E01030217,409,502,107,88,1106
E01030218,513,420,165,100,1198
E01030219,395,916,181,160,1652
E01030220,468,708,171,428,1775
E01030221,590,791,151,118,1650
E01030222,371,904,219,134,1628
E01030223,395,494,216,314,1419
E01030224,343,688,209,124,1364
E01030225,350,448,487,85,1370
E01030226,654,460,179,189,1482
E01030227,311,246,93,482,1132
E01030228,465,721,135,158,1479
E01030229,538,804,205,275,1822
E01030230,433,542,365,157,1497
E01030231,455,408,124,248,1235
E01030232,501,530,136,159,1326
E01030233,514,712,56,3,1285
E01030234,501,188,222,257,1168
E01030235,430,656,83,42,1211
E01030236,538,558,169,176,1441
E01030237,1182,754,246,32,2214
E01030238,813,493,133,21,1460
E01030239,927,361,171,43,1502
E01030240,430,733,161,50,1374
E01030241,420,616,100,119,1255
E01030242,432,692,68,23,1215
E01030243,429,499,145,139,1212
E01030244,312,624,248,260,1444
E01030245,393,734,134,105,1366
E01030246,418,308,313,42,1081
E01030247,184,106,409,526,1225
E01030248,402,349,301,96,1148
E01030249,368,286,481,160,1295
E01030250,389,255,615,144,1403
E01030251,525,587,140,59,1311
E01030252,482,767,164,84,1497
E01030253,510,404,164,381,1459
E01030254,420,276,325,119,1140
E01030255,459,295,160,135,1049
E01030256,389,308,310,92,1099
E01030257,489,403,161,161,1214
E01030258,263,203,579,186,1231
E01030259,363,394,96,67,920
E01030260,312,283,209,21,825
E01030261,262,158,104,570,1094
E01030262,341,299,152,208,1000
E01030263,400,586,93,124,1203
E01030264,389,292,294,99,1074
E01030265,444,315,296,66,1121
E01030266,505,419,176,207,1307
E01030267,393,393,76,223,1085
E01030268,482,528,71,7,1088
E01030269,486,688,171,18,1363
E01030270,460,410,208,141,1219
E01030271,408,774,80,28,1290
E01030272,387,731,164,28,1310
E01030273,396,851,121,8,1376
E01030274,190,254,92,476,1012
E01030275,393,423,88,53,957
E01030276,363,347,285,24,1019
E01030277,265,139,76,464,944
E01030278,332,769,82,180,1363
E01030279,247,168,93,552,1060
E01030280,469,634,54,40,1197
E01030281,808,513,192,342,1855
E01030282,150,561,123,187,1021
E01030283,300,409,126,209,1044
E01030284,278,699,75,25,1077
E01030285,681,875,170,136,1862
E01030286,604,825,289,126,1844
E01030287,311,552,80,264,1207
E01030288,429,764,37,7,1237
E01030289,405,380,183,206,1174
E01030290,406,693,110,54,1263
E01030291,309,338,98,376,1121
E01030292,490,627,112,19,1248
E01030293,548,661,115,73,1397
E01030294,454,491,108,148,1201
E01030295,532,762,344,230,1868
E01030296,625,616,111,14,1366
E01030297,739,670,212,30,1651
E01030298,451,401,125,268,1245
E01030299,629,381,86,172,1268
E01030300,466,284,264,294,1308
E01030301,416,489,173,102,1180
E01030302,433,503,297,31,1264
E01030303,566,598,171,15,1350
E01030304,417,254,206,415,1292
E01030305,354,465,265,23,1107
E01030306,417,375,200,19,1011
E01030307,534,572,167,21,1294
E01030308,465,532,225,49,1271
E01030309,397,567,194,50,1208
E01030310,532,272,263,353,1420
E01030311,507,284,129,300,1220
E01030312,471,245,114,215,1045
E01030313,633,307,145,141,1226
E01030314,563,362,186,93,1204
E01030315,633,409,112,109,1263
E01030316,552,559,149,6,1266
E01030317,566,469,194,134,1363
E01030318,323,320,183,358,1184
E01030319,695,482,81,50,1308
E01030320,649,371,228,67,1315
E01030321,618,499,86,16,1219
E01030322,638,327,258,178,1401
E01030323,461,410,110,88,1069
E01030324,632,380,118,94,1224
E01030325,598,407,85,112,1202
E01030326,491,448,398,46,1383
E01030327,518,471,244,20,1253
E01030328,673,476,123,10,1282
E01030329,568,457,152,3,1180
E01030330,564,495,181,23,1263
E01030331,653,432,138,48,1271
E01030332,468,360,104,242,1174
E01030333,548,414,170,48,1180
E01030334,599,381,148,41,1169
E01030335,677,424,128,210,1439
E01030336,744,302,185,229,1460
E01030337,458,293,177,350,1278
E01030338,567,494,158,17,1236
E01030339,393,358,305,72,1128
E01030340,479,404,187,86,1156
E01030341,643,545,230,8,1426
E01030342,456,619,182,15,1272
E01030343,539,489,176,89,1293
E01030344,486,492,154,17,1149
E01030345,587,462,101,124,1274
E01030346,421,366,271,12,1070
E01030347,629,263,270,111,1273
E01030348,562,409,293,20,1284
E01030349,493,493,302,7,1295
E01030350,608,439,194,50,1291
E01030351,622,368,156,49,1195
E01030352,557,370,126,102,1155
E01030353,616,304,179,8,1107
E01030354,367,146,136,458,1107
E01030355,579,356,68,59,1062
E01030356,596,267,83,71,1017
E01030357,542,507,244,13,1306
E01030358,516,429,204,19,1168
E01030359,643,359,551,259,1812
E01030360,436,484,320,22,1262
E01030361,863,385,149,156,1553
E01030362,403,195,94,230,922
E01030363,640,283,220,318,1461
E01030364,475,98,222,410,1205
E01030365,616,443,125,22,1206
E01030366,550,402,459,56,1467
E01030367,528,560,202,16,1306
E01030368,671,425,103,30,1229
E01030369,876,613,141,36,1666
E01030370,606,436,139,11,1192
E01030371,419,264,263,270,1216
E01030372,435,261,192,79,967
E01030373,547,339,157,155,1198
E01030374,468,404,412,51,1335
E01030375,516,336,431,67,1350
E01030376,401,334,254,9,998
E01030377,969,827,70,13,1879
E01030378,609,493,136,23,1261
E01030379,454,383,140,26,1003
E01030380,491,478,107,5,1081
E01030381,408,435,241,83,1167
E01030382,430,416,262,31,1139
E01030383,863,204,233,547,1847
E01030384,1079,283,393,204,1959
E01030385,434,180,187,518,1319
E01030386,607,531,72,0,1210
E01030387,760,372,169,23,1324
E01030388,525,431,105,27,1088
E01030389,471,416,242,128,1257
E01030390,597,398,240,193,1428
E01030391,658,482,319,59,1518
E01030392,615,682,232,19,1548
E01030393,653,732,187,64,1636
E01030394,843,474,73,17,1407
E01030395,609,793,94,8,1504
E01030396,707,637,76,11,1431
E01030398,702,677,35,12,1426
E01030399,808,442,181,233,1664
E01030400,428,166,72,507,1173
E01030401,1073,660,195,37,1965
E01030402,445,250,89,159,943
E01030403,528,490,137,42,1197
E01030404,599,517,129,16,1261
E01030405,642,394,144,83,1263
E01030406,609,418,226,47,1300
E01030407,555,543,50,1,1149
E01030408,805,616,28,4,1453
E01030409,403,389,392,47,1231
E01030410,434,212,404,80,1130
E01030411,468,344,760,203,1775
E01030412,499,419,597,68,1583
E01030413,815,370,211,155,1551
E01030414,513,328,73,134,1048
E01030415,722,437,114,21,1294
E01030416,517,473,84,15,1089
E01030417,441,494,105,3,1043
E01030418,606,434,112,26,1178
E01030419,480,458,302,40,1280
E01030420,342,292,135,168,937
E01030421,612,512,63,30,1217
E01030422,614,324,108,152,1198
E01030423,626,376,103,257,1362
E01030424,487,296,93,337,1213
E01030425,710,492,86,15,1303
E01030426,602,209,150,181,1142
E01030427,683,417,83,25,1208
E01030428,397,407,134,36,974
E01030429,590,292,298,35,1215
E01030430,551,539,139,17,1246
E01030431,508,553,76,86,1223
E01030432,494,272,101,328,1195
E01030433,557,243,117,412,1329
E01030434,624,294,357,19,1294
E01030435,655,467,103,111,1336
E01030436,823,624,352,11,1810
E01030437,528,634,188,29,1379
E01030438,424,464,353,92,1333
E01030439,587,607,142,14,1350
E01030440,408,532,132,176,1248
E01030441,421,438,97,58,1014
E01030442,518,631,31,3,1183
E01030443,472,508,69,4,1053
E01030444,481,558,82,63,1184
E01030445,386,479,142,113,1120
E01030446,443,503,96,5,1047
E01030447,473,442,70,91,1076
E01030448,462,573,198,4,1237
E01030449,233,348,342,157,1080
E01030450,687,281,833,200,2001
E01030451,400,201,696,297,1594
E01030452,550,237,780,136,1703
E01030453,356,283,601,27,1267
E01030454,511,452,280,99,1342
E01030455,317,327,621,123,1388
E01030456,424,606,95,16,1141
E01030457,348,171,724,141,1384
E01030458,374,384,240,16,1014
E01030459,271,305,143,176,895
E01030460,509,568,106,49,1232
E01030461,537,584,121,26,1268
E01030462,552,390,248,172,1362
E01030463,592,424,172,33,1221
E01030464,462,253,115,440,1270
E01030465,482,437,108,136,1163
E01030466,444,727,95,54,1320
E01030467,601,563,137,12,1313
E01030468,224,183,539,167,1113
E01030469,362,340,203,226,1131
E01030470,371,283,493,85,1232
E01030471,358,474,139,17,988
E01030472,342,350,176,121,989
E01030473,563,467,245,71,1346
E01030474,83,45,687,152,967
E01030475,482,487,62,22,1053
E01030476,496,442,39,8,985
E01030477,565,399,123,241,1328
E01030478,527,541,166,142,1376
E01030479,620,322,133,325,1400
E01030480,603,638,141,64,1446
E01030481,552,279,204,352,1387
E01030482,449,239,178,262,1128
E01030483,299,99,149,562,1109
E01030484,521,222,254,371,1368
E01030485,595,285,415,143,1438
E01030486,730,396,191,21,1338
E01030487,528,362,467,25,1382
E01030488,784,349,173,256,1562
E01030489,1039,400,290,160,1889
E01030490,440,570,227,69,1306
E01030491,455,471,323,236,1485
E01030492,676,758,142,66,1642
E01030493,336,156,201,372,1065
E01030494,323,287,281,484,1375
E01030495,513,379,550,105,1547
E01030496,278,151,343,552,1324
E01030497,202,87,263,697,1249
E01030498,540,374,209,24,1147
E01030499,567,604,87,34,1292
E01030500,529,462,221,53,1265
E01030501,651,410,128,93,1282
E01030502,382,436,101,89,1008
E01030503,329,195,187,401,1112
E01030504,410,462,68,9,949
E01030505,573,418,81,164,1236
E01030506,528,480,32,13,1053
E01030507,484,366,108,11,969
E01030508,367,596,58,37,1058
E01030509,310,354,128,114,906
E01030510,601,520,79,63,1263
E01030511,518,541,50,23,1132
E01030512,485,557,144,58,1244
E01030513,452,402,66,170,1090
E01030514,438,491,144,100,1173
E01030515,605,611,152,213,1581
E01030516,283,364,134,263,1044
E01030517,501,636,122,17,1276
E01030518,429,648,30,20,1127
E01030519,452,474,64,249,1239
E01030520,425,409,69,272,1175
E01030521,526,526,203,77,1332
E01030522,441,569,47,8,1065
E01030523,404,441,83,50,978
E01030524,370,1052,270,83,1775
E01030525,533,595,89,42,1259
E01030526,490,357,94,131,1072
E01030527,433,493,241,99,1266
E01030528,519,431,127,95,1172
E01030529,590,383,143,221,1337
E01030530,422,439,92,83,1036
E01030531,952,507,229,167,1855
E01030532,595,364,187,37,1183
E01030533,518,426,82,44,1070
E01030534,362,293,255,178,1088
E01030535,548,473,343,111,1475
E01030536,593,482,206,143,1424
E01030537,552,533,120,182,1387
E01030538,426,303,336,224,1289
E01030539,612,447,159,173,1391
E01030540,645,1020,77,9,1751
E01030541,542,530,37,7,1116
E01030542,531,405,50,7,993
E01030543,573,460,102,32,1167
E01030544,514,500,133,116,1263
E01030545,649,318,184,106,1257
E01030546,558,296,98,352,1304
E01030547,252,205,97,703,1257
E01030548,633,205,297,257,1392
E01030549,597,305,375,201,1478
E01030550,467,301,371,355,1494
E01030551,404,218,120,507,1249
E01030552,329,372,385,24,1110
E01030553,532,545,185,147,1409
E01030554,346,504,66,10,926
E01030555,411,473,387,109,1380
E01030556,582,603,265,63,1513
E01030557,580,526,303,101,1510
E01030558,653,654,204,215,1726
E01030559,419,492,59,31,1001
E01030560,442,523,254,53,1272
E01030561,460,489,84,79,1112
E01030562,580,240,93,140,1053
E01030563,531,331,32,4,898
E01030564,521,418,39,100,1078
E01030565,515,398,86,127,1126
E01030566,726,360,49,40,1175
E01030567,576,588,92,41,1297
E01030568,684,466,74,28,1252
E01030569,1172,424,228,188,2012
E01030570,571,395,180,152,1298
E01030571,669,417,113,52,1251
E01030572,726,238,246,373,1583
E01030573,674,395,182,122,1373
E01030574,773,271,276,66,1386
E01030575,681,376,592,79,1728
E01030576,581,404,301,61,1347
E01030577,534,406,356,62,1358
E01030578,466,237,118,394,1215
E01030579,393,415,223,65,1096
E01030580,853,262,283,85,1483
E01030581,525,439,79,10,1053
E01030582,449,213,304,9,975
E01030583,635,497,72,7,1211
E01030584,703,513,60,45,1321
E01030585,642,499,98,65,1304
E01030586,565,347,130,289,1331
E01030587,513,399,92,195,1199
E01030588,391,228,130,415,1164
E01030589,632,678,118,11,1439
E01030590,800,543,127,32,1502
E01030591,553,414,44,91,1102
E01030592,670,601,189,117,1577
E01030593,492,298,199,118,1107
E01030594,562,319,105,375,1361
E01030595,518,382,102,141,1143
E01030596,563,430,77,20,1090
E01030597,659,370,146,17,1192
E01030598,537,416,199,100,1252
E01030599,358,146,83,625,1212
E01030600,555,307,117,205,1184
E01030601,533,227,70,348,1178
E01030602,709,436,175,68,1388
E01030603,655,488,42,16,1201
E01030604,530,492,128,112,1262
E01030605,602,364,79,77,1122
E01030606,495,490,67,10,1062
E01030607,752,599,49,30,1430
E01030608,475,135,77,389,1076
E01030609,530,175,83,322,1110
E01030610,387,272,138,202,999
E01030611,1126,334,437,150,2047
E01030612,960,288,753,59,2060
E01030613,574,218,620,89,1501
E01030614,668,445,114,66,1293
E01030615,249,119,390,456,1214
E01030616,557,596,123,24,1300
E01030617,501,536,216,90,1343
E01030618,666,285,272,263,1486
E01030619,295,278,96,483,1152
E01030620,507,467,360,84,1418
E01030621,393,340,127,284,1144
E01030622,656,359,357,69,1441
E01030623,727,609,242,38,1616
E01030624,435,365,137,14,951
E01030625,418,398,126,13,955
E01030626,295,421,124,1,841
E01030627,514,423,456,7,1400
E01030628,542,481,77,78,1178
E01030629,444,379,132,16,971
E01030630,527,438,81,221,1267
E01030631,463,259,110,343,1175
E01030632,543,402,89,31,1065
E01030633,426,290,118,268,1102
E01030634,386,209,67,447,1109
E01030635,617,379,161,61,1218
E01030636,506,380,25,58,969
E01030637,487,478,33,9,1007
E01030638,623,520,96,7,1246
E01030639,418,577,161,29,1185
E01030640,492,246,84,423,1245
E01030641,656,474,65,77,1272
E01030642,568,509,90,96,1263
E01030643,449,355,63,219,1086
E01030644,495,515,47,31,1088
E01030645,461,371,194,512,1538
E01030646,794,545,322,33,1694
E01030647,533,635,151,31,1350
E01030648,654,397,126,74,1251
E01030649,546,365,347,117,1375
E01030650,449,194,82,256,981
E01030651,556,308,122,89,1075
E01030652,624,375,178,144,1321
E01030653,425,220,222,264,1131
E01030654,541,368,179,67,1155
E01030655,563,516,128,114,1321
E01030656,534,287,105,323,1249
E01030657,387,130,131,544,1192
E01030658,312,665,166,34,1177
E01030659,553,423,248,121,1345
E01030660,948,447,125,93,1613
E01030661,603,656,72,19,1350
E01030662,564,408,103,140,1215
E01030663,458,311,103,374,1246
E01030664,462,210,171,482,1325
E01030665,564,191,275,171,1201
E01030666,740,363,246,72,1421
E01030667,332,221,433,274,1260
E01030668,501,412,599,55,1567
E01030669,429,283,540,127,1379
E01030670,413,298,529,36,1276
E01030671,274,183,338,37,832
E01030672,616,552,468,37,1673
E01030673,247,300,263,33,843
E01030674,281,144,365,412,1202
E01030675,288,248,445,173,1154
E01030676,135,95,540,391,1161
E01030677,342,467,202,281,1292
E01030678,467,157,144,252,1020
E01030679,374,430,166,6,976
E01030680,553,547,113,34,1247
E01030681,642,437,91,119,1289
E01030682,546,350,118,40,1054
E01030683,589,318,128,58,1093
E01030684,569,291,180,165,1205
E01030685,519,388,129,25,1061
E01030686,546,513,132,9,1200
E01030687,471,372,111,24,978
E01030688,653,392,73,94,1212
E01030689,446,414,251,47,1158
E01030690,525,370,321,63,1279
E01030691,462,563,186,28,1239
E01030692,314,454,219,7,994
E01030693,453,463,49,39,1004
E01030694,517,298,88,186,1089
E01030695,471,529,52,20,1072
E01030696,494,510,127,73,1204
E01030697,681,465,124,21,1291
E01030698,676,504,110,54,1344
E01030699,499,491,90,152,1232
E01030700,705,372,243,96,1416
E01030701,558,443,148,106,1255
E01030702,358,166,138,224,886
E01030703,618,504,106,51,1279
E01030704,475,515,176,77,1243
E01030705,668,520,114,21,1323
E01030706,627,397,111,18,1153
E01030707,554,392,341,43,1330
E01030708,664,417,136,97,1314
E01030709,563,256,139,207,1165
E01030710,591,244,140,321,1296
E01030711,519,257,170,375,1321
E01030712,499,381,216,13,1109
E01030713,555,326,98,32,1011
E01030714,575,325,66,30,996
E01030715,625,495,112,27,1259
E01030716,631,503,97,38,1269
E01030717,570,514,134,109,1327
E01030718,569,341,64,103,1077
E01030719,544,449,62,198,1253
E01030720,589,462,57,142,1250
E01030721,503,452,96,150,1201
E01030722,685,487,111,22,1305
E01030723,636,535,74,65,1310
E01030724,568,290,79,299,1236
E01030725,664,239,359,139,1401
E01030726,670,618,43,33,1364
E01030727,653,540,298,63,1554
E01030728,635,669,105,11,1420
E01030729,556,404,101,190,1251
E01030730,601,779,127,8,1515
E01030731,765,568,137,45,1515
E01030732,511,548,168,34,1261
E01030733,487,554,293,47,1381
E01030734,589,347,201,72,1209
E01030735,545,345,307,84,1281
E01030736,415,250,795,87,1547
E01030737,421,305,300,177,1203
E01030738,452,267,270,234,1223
E01030739,481,294,84,428,1287
E01030740,569,341,102,405,1417
E01030741,715,338,136,209,1398
E01030742,726,621,154,79,1580
E01030743,558,407,142,161,1268
E01030744,416,208,234,466,1324
E01030745,468,211,117,433,1229
E01030746,447,330,161,334,1272
E01030747,581,283,191,64,1119
E01030748,600,441,164,177,1382
E01030749,523,215,107,328,1173
E01030750,604,237,129,286,1256
E01030751,573,372,204,136,1285
E01030752,420,170,197,420,1207
E01030753,545,594,216,58,1413
E01030754,536,613,87,25,1261
E01030755,704,419,170,215,1508
E01030756,677,565,122,23,1387
E01030757,727,290,229,26,1272
E01030758,472,275,116,31,894
E01030759,489,311,162,332,1294
E01030760,508,377,80,26,991
E01030761,669,468,55,42,1234
E01030762,833,479,166,23,1501
E01030763,411,465,100,32,1008
E01030764,428,465,96,6,995
E01030765,440,389,72,228,1129
E01030766,567,380,241,123,1311
E01030767,492,278,128,339,1237
E01030768,435,375,87,166,1063
E01030769,642,517,81,13,1253
E01030770,662,426,126,6,1220
E01030771,554,372,101,7,1034
E01030772,555,348,124,191,1218
E01030773,655,355,109,25,1144
E01030774,631,254,150,10,1045
E01030775,571,519,74,4,1168
E01030776,728,467,89,10,1294
E01030777,711,308,173,58,1250
E01030778,746,602,114,13,1475
E01030779,720,649,88,8,1465
E01030780,658,476,140,18,1292
E01030781,604,359,111,168,1242
E01030782,633,415,130,137,1315
E01030783,697,427,158,39,1321
E01030784,584,234,660,131,1609
E01030785,535,557,117,11,1220
E01030786,509,209,115,547,1380
E01030787,459,247,82,341,1129
E01030788,338,142,60,492,1032
E01030789,608,518,81,16,1223
E01030790,667,451,118,106,1342
E01030791,701,554,110,7,1372
E01030792,565,451,69,3,1088
E01030793,385,119,257,419,1180
E01030794,590,302,250,87,1229
E01030795,707,520,383,112,1722
E01030796,592,455,70,2,1119
E01030797,698,302,117,1,1118
E01030798,570,520,84,17,1191
E01030799,612,415,83,4,1114
E01030800,409,422,442,39,1312
E01030801,418,198,476,187,1279
E01030802,577,499,245,43,1364
E01030803,577,278,325,219,1399
E01030804,708,559,128,19,1414
E01030805,526,281,106,389,1302
E01030806,648,471,64,15,1198
E01030807,506,388,126,52,1072
E01030808,638,430,155,9,1232
E01030809,512,396,169,103,1180
E01030810,541,432,110,14,1097
E01030811,562,493,124,18,1197
E01030812,421,330,147,311,1209
E01030813,541,443,157,98,1239
E01030814,428,350,93,95,966
E01030815,526,362,115,158,1161
E01030816,592,411,198,75,1276
E01030817,634,391,90,51,1166
E01030818,384,324,94,215,1017
E01030819,503,493,197,14,1207
E01030820,669,631,60,21,1381
E01030821,614,529,257,159,1559
E01030822,666,576,149,22,1413
E01030823,851,655,124,88,1718
E01030824,454,267,105,299,1125
E01030825,464,411,161,77,1113
E01030826,536,334,70,194,1134
E01030827,589,407,123,132,1251
E01030828,414,441,137,7,999
E01030829,422,405,245,88,1160
E01030830,589,331,103,15,1038
E01030831,707,864,183,48,1802
E01030832,402,471,122,67,1062
E01030833,374,378,142,158,1052
E01030834,423,375,91,234,1123
E01030835,604,375,101,70,1150
E01030836,430,432,240,178,1280
E01030837,516,391,122,63,1092
E01030838,442,353,139,80,1014
E01030839,433,556,115,22,1126
E01030840,499,353,77,213,1142
E01030841,452,479,48,36,1015
E01030842,640,300,86,362,1388
E01030843,422,299,142,309,1172
E01030844,765,411,103,100,1379
E01030845,588,236,63,92,979
E01030846,579,469,73,53,1174
E01030847,483,567,121,112,1283
E01030848,872,475,216,94,1657
E01030850,730,484,358,160,1732
E01030851,870,358,137,233,1598
E01030852,633,428,189,311,1561
E01030853,675,497,113,100,1385
E01030854,738,682,100,73,1593
E01030855,659,804,110,18,1591
E01030856,549,509,99,60,1217
E01030857,773,290,142,427,1632
E01030858,864,406,226,134,1630
E01030859,863,369,266,59,1557
E01030860,792,308,396,110,1606
E01030861,630,658,208,33,1529
E01030862,482,745,181,128,1536
E01030863,568,715,127,47,1457
E01030864,378,453,214,39,1084
E01030865,340,340,171,278,1129
E01030866,582,510,106,27,1225
E01030867,422,449,150,104,1125
E01030868,478,384,82,78,1022
E01030869,376,265,134,147,922
E01030870,608,623,77,13,1321
E01030871,659,433,89,131,1312
E01030872,461,372,117,466,1416
E01030873,477,450,108,126,1161
E01030874,374,421,202,36,1033
E01030875,378,311,261,103,1053
E01030876,352,616,90,0,1058
E01030877,286,343,119,221,969
E01030878,507,603,92,68,1270
E01030879,309,435,117,29,890
E01030880,570,676,133,147,1526
E01030881,462,552,71,4,1089
E01030882,500,453,79,8,1040
E01030883,431,457,97,51,1036
E01030884,324,336,277,303,1240
E01030885,177,357,371,116,1021
E01030886,424,402,108,74,1008
E01030887,493,388,90,67,1038
E01030888,466,418,202,61,1147
E01030889,426,293,177,266,1162
E01030890,585,347,95,180,1207
E01030891,626,536,102,13,1277
E01030892,546,313,162,10,1031
E01030893,592,378,249,267,1486
E01030894,535,588,107,7,1237
E01030895,338,202,420,263,1223
E01030896,376,189,122,241,928
E01030897,470,407,77,89,1043
E01030898,586,570,85,12,1253
E01030899,678,529,97,16,1320
E01030900,415,425,60,101,1001
E01030901,359,123,124,438,1044
E01030902,492,462,82,29,1065
E01030903,695,353,147,79,1274
E01030904,437,467,80,197,1181
E01030905,505,282,177,229,1193
E01030906,607,506,136,80,1329
E01030907,373,452,85,16,926
E01030908,561,457,198,24,1240
E01030909,403,386,101,93,983
E01030910,371,392,71,127,961
E01030911,514,439,94,208,1255
E01030912,373,307,61,359,1100
E01030913,291,220,57,399,967
E01030914,309,198,141,345,993
E01030915,543,379,82,263,1267
E01030916,538,347,457,39,1381
E01030917,340,233,315,20,908
E01030918,339,267,207,94,907
E01030919,394,455,165,7,1021
E01030920,543,341,222,92,1198
E01030921,494,306,249,325,1374
E01030922,530,406,208,21,1165
E01030923,483,513,94,35,1125
E01030924,480,400,93,8,981
E01030925,604,490,48,39,1181
E01030926,571,400,79,84,1134
E01030927,442,291,78,223,1034
E01030928,544,276,337,221,1378
E01030929,521,296,132,21,970
E01030930,524,557,120,41,1242
E01030931,519,590,169,90,1368
E01030932,491,362,68,244,1165
E01030933,552,412,144,295,1403
E01030934,445,357,129,133,1064
E01030935,510,378,94,31,1013
E01030937,582,388,163,136,1269
E01030938,387,344,122,241,1094
E01030939,436,379,44,73,932
E01030940,507,625,126,131,1389
E01030941,423,399,124,39,985
E01030942,443,458,146,50,1097
E01030943,367,263,90,262,982
E01030944,574,351,111,14,1050
E01030945,482,315,101,17,915
E01030946,397,218,101,348,1064
E01030947,617,396,61,58,1132
E01030948,672,398,149,30,1249
E01030949,725,323,182,91,1321
E01030950,576,485,145,105,1311
E01030951,534,253,210,79,1076
E01030952,275,68,124,605,1072
E01030953,575,433,170,62,1240
E01030954,623,361,763,105,1852
E01030955,546,423,179,9,1157
E01030956,533,215,104,218,1070
E01030957,531,108,90,245,974
E01030958,701,309,151,43,1204
E01030959,423,271,98,69,861
E01030960,801,338,153,105,1397
E01030961,768,637,98,49,1552
E01030962,533,179,158,534,1404
E01030963,556,583,33,14,1186
E01030964,492,567,318,89,1466
E01030965,568,494,91,24,1177
E01030966,581,354,67,81,1083
E01030967,574,543,106,28,1251
E01030968,348,311,129,231,1019
E01030969,558,408,133,23,1122
E01030970,520,258,202,187,1167
E01030971,613,431,81,376,1501
E01030972,649,436,180,194,1459
E01030973,583,384,119,304,1390
E01030974,615,221,171,239,1246
E01030975,564,393,134,46,1137
E01030976,716,344,149,26,1235
E01030977,659,459,165,112,1395
E01030978,599,319,70,120,1108
E01030979,811,233,348,180,1572
E01030980,468,193,505,180,1346
E01030981,518,308,206,211,1243
E01030982,577,309,340,211,1437
E01030983,368,238,596,227,1429
E01030984,628,271,145,456,1500
E01030985,334,93,147,615,1189
E01030986,412,419,60,6,897
E01030987,480,526,102,15,1123
E01030988,530,477,563,23,1593
E01030989,562,380,268,95,1305
E01030990,460,515,143,53,1171
E01030991,497,456,668,30,1651
E01030992,627,426,282,27,1362
E01030993,474,337,1066,141,2018
E01030994,675,286,160,241,1362
E01030995,505,144,137,273,1059
E01030996,554,618,54,15,1241
E01030997,484,620,103,49,1256
E01030998,637,773,89,3,1502
E01030999,494,512,69,10,1085
E01031000,541,499,169,39,1248
E01031001,584,423,205,182,1394
E01031002,623,634,110,9,1376
E01031003,596,537,224,8,1365
E01031004,640,448,466,151,1705
E01031005,464,272,152,247,1135
E01031006,575,310,145,139,1169
E01031007,484,409,77,34,1004
E01031008,434,259,121,259,1073
E01031009,723,545,303,242,1813
E01031010,285,152,326,594,1357
E01031011,764,609,137,96,1606
E01031012,378,389,72,330,1169
E01031013,351,458,97,12,918
E01031014,452,446,59,64,1021
E01031015,295,198,81,521,1095
E01031016,451,453,104,291,1299
E01031017,449,476,97,42,1064
E01031018,383,328,152,45,908
E01031019,767,440,95,68,1370
E01031020,599,460,211,21,1291
E01031021,466,416,229,235,1346
E01031022,569,544,171,74,1358
E01031023,558,643,96,45,1342
E01031024,595,609,140,56,1400
E01031025,524,439,161,176,1300
E01031026,406,314,210,322,1252
E01031027,533,488,125,46,1192
E01031028,535,507,366,128,1536
E01031029,598,396,97,74,1165
E01031030,718,600,178,339,1835
E01031031,952,538,180,338,2008
E01031032,375,289,188,217,1069
E01031033,610,584,107,255,1556
E01031034,845,605,77,40,1567
E01031035,692,565,151,142,1550
E01031036,552,496,103,100,1251
E01031037,429,420,132,237,1218
E01031038,774,534,89,160,1557
E01031039,723,568,69,25,1385
E01031040,747,420,170,121,1458
E01031041,738,528,114,40,1420
E01031042,663,558,104,129,1454
E01031043,383,235,357,435,1410
E01031044,457,322,291,247,1317
E01031045,586,440,233,132,1391
E01031046,398,412,472,98,1380
E01031047,540,394,497,79,1510
E01031048,548,356,121,7,1032
E01031049,898,420,289,155,1762
E01031050,699,336,323,106,1464
E01031051,524,534,59,28,1145
E01031052,497,247,349,66,1159
E01031053,352,294,185,322,1153
E01031054,529,415,119,203,1266
E01031055,711,249,178,106,1244
E01031056,487,346,123,241,1197
E01031057,254,122,118,665,1159
E01031058,486,382,95,214,1177
E01031059,522,341,234,90,1187
E01031060,493,453,101,149,1196
E01031061,693,245,142,115,1195
E01031062,425,493,28,77,1023
E01031063,327,346,64,355,1092
E01031064,334,337,127,208,1006
E01031065,503,352,124,233,1212
E01031066,349,195,116,419,1079
E01031067,419,442,126,303,1290
E01031068,565,746,78,44,1433
E01031069,398,782,83,5,1268
E01031070,517,720,76,10,1323
E01031073,598,532,209,187,1526
E01031074,442,324,258,226,1250
E01031075,480,250,169,382,1281
E01031077,593,238,132,158,1121
E01031078,826,606,175,14,1621
E01031079,494,493,80,184,1251
E01031080,484,374,173,176,1207
E01031081,635,261,171,195,1262
E01031082,769,246,51,22,1088
E01031083,650,442,98,44,1234
E01031084,1027,431,243,17,1718
E01031085,701,381,46,2,1130
E01031086,709,522,151,80,1462
E01031087,781,421,180,302,1684
E01031088,828,370,158,169,1525
E01031089,558,605,81,13,1257
E01031090,398,147,116,429,1090
E01031091,506,469,142,39,1156
E01031092,419,265,207,235,1126
E01031093,531,427,102,53,1113
E01031094,453,235,158,57,903
E01031095,368,261,134,184,947
E01031096,566,320,189,54,1129
E01031097,496,242,139,437,1314
E01031098,564,389,180,37,1170
E01031099,1007,468,301,58,1834
E01031100,634,433,44,8,1119
E01031101,692,385,77,7,1161
E01031102,523,344,156,49,1072
E01031103,535,488,38,12,1073
E01031104,456,768,48,4,1276
E01031105,533,470,120,9,1132
E01031106,522,501,86,102,1211
E01031107,528,292,89,17,926
E01031108,644,370,76,24,1114
E01031109,595,305,135,261,1296
E01031110,474,670,107,17,1268
E01031111,485,424,35,1,945
E01031112,632,559,100,3,1294
E01031113,554,603,56,5,1218
E01031114,489,391,96,315,1291
E01031115,441,476,343,134,1394
E01031116,309,227,107,618,1261
E01031117,437,242,93,340,1112
E01031118,350,266,81,237,934
E01031119,398,369,226,285,1278
E01031120,608,455,99,8,1170
E01031121,575,411,25,4,1015
E01031122,596,614,63,5,1278
E01031123,539,501,40,1,1081
E01031124,563,690,56,2,1311
E01031125,621,434,158,13,1226
E01031127,362,246,109,435,1152
E01031129,358,408,94,86,946
E01031130,636,230,488,58,1412
E01031131,416,315,475,78,1284
E01031132,564,299,607,112,1582
E01031133,467,252,266,275,1260
E01031134,571,761,79,16,1427
E01031135,466,775,97,68,1406
E01031136,605,482,159,103,1349
E01031137,500,204,173,101,978
E01031138,569,225,89,67,950
E01031139,940,351,129,43,1463
E01031140,521,420,71,96,1108
E01031141,552,205,317,306,1380
E01031142,437,81,142,536,1196
E01031143,516,618,152,17,1303
E01031144,361,262,290,90,1003
E01031145,144,176,249,201,770
E01031146,344,398,121,339,1202
E01031147,414,750,74,38,1276
E01031148,452,555,145,212,1364
E01031149,504,551,126,70,1251
E01031150,367,469,62,79,977
E01031151,610,634,52,6,1302
E01031152,382,477,62,41,962
E01031153,471,339,83,212,1105
E01031154,672,610,135,45,1462
E01031155,584,470,68,2,1124
E01031156,640,466,97,3,1206
E01031157,815,500,164,60,1539
E01031158,380,455,57,16,908
E01031159,588,606,93,77,1364
E01031160,698,656,256,189,1799
E01031161,734,663,155,98,1650
E01031162,598,538,152,139,1427
E01031163,420,366,108,383,1277
E01031164,894,482,160,80,1616
E01031165,445,338,113,353,1249
E01031166,644,723,124,65,1556
E01031167,512,360,128,85,1085
E01031168,733,343,571,444,2091
E01031169,679,330,480,132,1621
E01031170,457,277,309,257,1300
E01031171,479,325,171,196,1171
E01031172,407,262,164,441,1274
E01031173,277,241,408,571,1497
E01031174,348,358,387,290,1383
E01031175,407,640,84,19,1150
E01031176,435,194,134,376,1139
E01031177,414,193,124,357,1088
E01031178,399,520,110,150,1179
E01031179,738,523,113,5,1379
E01031180,695,576,184,156,1611
E01031181,706,505,115,144,1470
E01031182,520,691,385,102,1698
E01031183,486,513,361,65,1425
E01031184,515,487,150,81,1233
E01031185,354,248,88,440,1130
E01031186,414,382,65,367,1228
E01031187,560,734,166,101,1561
E01031188,660,934,167,104,1865
E01031189,447,373,193,193,1206
E01031190,590,367,94,283,1334
E01031191,677,611,106,81,1475
E01031192,750,553,198,60,1561
E01031193,591,762,261,190,1804
E01031194,710,602,384,174,1870
E01031195,676,845,114,190,1825
E01031196,795,727,233,153,1908
E01031197,366,382,199,67,1014
E01031198,426,336,105,134,1001
E01031199,427,441,132,209,1209
E01031200,676,402,126,85,1289
E01031201,537,658,73,42,1310
E01031202,508,597,219,14,1338
E01031203,372,401,118,381,1272
E01031204,263,741,96,34,1134
E01031205,529,471,182,80,1262
E01031206,389,372,99,282,1142
E01031207,396,346,107,183,1032
E01031208,703,804,118,56,1681
E01031209,573,769,237,224,1803
E01031210,441,436,97,59,1033
E01031211,353,260,81,152,846
E01031212,818,618,345,301,2082
E01031213,658,587,169,116,1530
E01031214,652,639,110,76,1477
E01031215,511,517,241,219,1488
E01031216,382,393,127,331,1233
E01031217,387,459,65,95,1006
E01031218,363,348,165,65,941
E01031219,495,362,66,227,1150
E01031220,579,474,54,122,1229
E01031221,471,386,85,309,1251
E01031222,730,612,199,63,1604
E01031223,487,342,95,138,1062
E01031224,379,350,138,52,919
E01031225,502,654,174,14,1344
E01031227,594,695,231,135,1655
E01031228,447,718,176,38,1379
E01031229,367,495,631,108,1601
E01031230,791,451,358,307,1907
E01031231,504,293,436,501,1734
E01031232,721,688,377,121,1907
E01031233,498,464,239,179,1380
E01031234,340,483,496,163,1482
E01031235,394,770,331,92,1587
E01031236,560,408,139,197,1304
E01031237,489,513,103,114,1219
E01031238,311,267,155,392,1125
E01031239,588,463,211,38,1300
E01031240,391,389,111,201,1092
E01031241,491,477,80,112,1160
E01031242,402,407,136,287,1232
E01031243,641,852,114,47,1654
E01031244,545,671,189,114,1519
E01031245,375,430,106,128,1039
E01031246,361,349,110,78,898
E01031247,685,771,248,226,1930
E01031248,630,859,167,142,1798
E01031249,391,218,79,288,976
E01031250,489,578,160,45,1272
E01031251,423,534,34,28,1019
E01031252,353,308,167,144,972
E01031253,451,357,123,293,1224
E01031254,560,535,121,42,1258
E01031255,512,583,86,12,1193
E01031256,424,737,204,48,1413
E01031257,478,277,236,159,1150
E01031258,387,491,304,95,1277
E01031259,639,344,65,26,1074
E01031260,401,329,76,157,963
E01031261,292,162,432,410,1296
E01031262,361,176,364,289,1190
E01031263,316,287,846,180,1629
E01031264,374,217,277,436,1304
E01031265,329,192,330,294,1145
E01031266,241,153,1006,287,1687
E01031267,658,707,101,33,1499
E01031268,1142,509,242,173,2066
E01031269,523,534,218,108,1383
E01031271,381,431,399,322,1533
E01031272,483,400,575,77,1535
E01031273,241,130,82,610,1063
E01031274,396,275,123,336,1130
E01031275,406,511,56,81,1054
E01031276,438,219,122,437,1216
E01031277,548,532,120,69,1269
E01031278,507,515,130,11,1163
E01031279,406,547,80,114,1147
E01031280,459,455,96,74,1084
E01031281,510,510,149,58,1227
E01031282,462,485,147,136,1230
E01031283,434,412,173,37,1056
E01031284,391,494,86,38,1009
E01031285,526,597,559,100,1782
E01031286,379,264,196,361,1200
E01031287,609,510,79,28,1226
E01031288,542,555,170,63,1330
E01031289,584,413,105,53,1155
E01031290,489,358,509,66,1422
E01031291,266,254,671,187,1378
E01031292,558,418,223,19,1218
E01031293,472,294,285,195,1246
E01031294,433,321,310,131,1195
E01031295,360,548,64,21,993
E01031296,669,443,189,15,1316
E01031297,634,455,251,206,1546
E01031298,618,580,168,32,1398
E01031299,502,599,46,13,1160
E01031300,703,544,106,22,1375
E01031301,432,578,164,12,1186
E01031302,407,261,74,105,847
E01031303,418,399,185,216,1218
E01031304,534,525,32,98,1189
E01031305,499,734,30,6,1269
E01031306,471,451,109,159,1190
E01031307,459,655,110,15,1239
E01031308,559,537,308,140,1544
E01031309,507,339,206,314,1366
E01031310,440,459,118,95,1112
E01031311,412,296,93,260,1061
E01031312,339,246,106,266,957
E01031313,555,528,69,21,1173
E01031314,518,478,119,17,1132
E01031315,849,372,190,228,1639
E01031316,404,459,188,181,1232
E01031317,411,580,215,31,1237
E01031318,871,377,149,7,1404
E01031319,692,521,243,110,1566
E01031320,430,348,225,187,1190
E01031321,291,107,73,506,977
E01031322,626,414,269,209,1518
E01031323,456,422,313,163,1354
E01031324,530,370,686,241,1827
E01031325,407,256,120,329,1112
E01031327,406,368,143,291,1208
E01031328,897,651,170,76,1794
E01031329,928,571,300,161,1960
E01031330,576,406,125,60,1167
E01031331,750,510,161,45,1466
E01031332,334,243,216,264,1057
E01031333,301,400,285,95,1081
E01031334,585,287,210,145,1227
E01031335,417,231,517,63,1228
E01031336,338,198,1276,150,1962
E01031337,434,270,439,138,1281
E01031338,499,397,73,8,977
E01031339,516,328,102,15,961
E01031340,562,642,47,6,1257
E01031341,358,255,182,295,1090
E01031342,447,686,169,103,1405
E01031343,575,447,123,18,1163
E01031344,422,340,80,278,1120
E01031345,624,502,78,52,1256
E01031346,536,497,105,31,1169
E01031347,467,287,150,384,1288
E01031348,453,169,151,460,1233
E01031349,538,469,66,51,1124
E01031350,439,218,79,231,967
E01031351,596,542,80,69,1287
E01031352,498,496,90,124,1208
E01031353,377,412,126,2,917
E01031354,479,448,83,26,1036
E01031355,635,415,130,120,1300
E01031356,939,613,299,43,1894
E01031357,728,599,430,59,1816
E01031358,466,231,111,416,1224
E01031359,617,345,98,26,1086
E01031360,433,436,110,278,1257
E01031361,417,265,114,394,1190
E01031362,503,332,135,38,1008
E01031363,501,622,95,150,1368
E01031364,341,318,393,201,1253
E01031365,530,441,119,108,1198
E01031366,387,187,99,353,1026
E01031367,477,557,43,9,1086
E01031368,465,415,58,92,1030
E01031369,392,473,162,33,1060
E01031370,447,347,79,264,1137
E01031371,345,182,88,389,1004
E01031372,280,341,66,330,1017
E01031373,515,316,145,176,1152
E01031374,587,443,167,29,1226
E01031375,433,446,222,122,1223
E01031376,425,533,128,29,1115
E01031377,464,354,299,154,1271
E01031378,529,458,130,58,1175
E01031379,553,639,121,28,1341
E01031380,431,824,123,9,1387
E01031381,383,795,176,10,1364
E01031382,500,876,118,7,1501
E01031383,417,892,75,14,1398
E01031384,542,820,130,3,1495
E01031385,407,499,117,293,1316
E01031386,464,392,150,174,1180
E01031387,481,499,169,103,1252
E01031388,971,664,280,147,2062
E01031389,694,864,152,56,1766
E01031390,388,421,128,188,1125
E01031391,442,532,220,47,1241
E01031392,338,470,376,76,1260
E01031393,647,676,121,22,1466
E01031394,606,352,160,210,1328
E01031395,559,524,116,41,1240
E01031396,727,486,146,174,1533
E01031397,644,549,150,43,1386
E01031398,587,491,90,47,1215
E01031399,497,792,69,90,1448
E01031400,371,385,500,68,1324
E01031401,584,460,156,62,1262
E01031402,592,597,154,27,1370
E01031403,491,362,164,143,1160
E01031404,287,111,136,370,904
E01031405,519,451,160,19,1149
E01031406,510,323,147,58,1038
E01031407,678,303,121,109,1211
E01031408,798,417,237,70,1522
E01031409,446,296,112,220,1074
E01031410,497,325,160,86,1068
E01031411,315,746,41,111,1213
E01031412,378,776,54,6,1214
E01031413,355,562,149,12,1078
E01031414,521,475,84,147,1227
E01031415,349,613,104,248,1314
E01031416,573,706,65,15,1359
E01031417,568,509,162,36,1275
E01031418,585,737,98,32,1452
E01031419,478,620,250,5,1353
E01031420,541,714,122,8,1385
E01031421,516,733,107,28,1384
E01031422,358,880,104,5,1347
E01031423,501,737,138,49,1425
E01031424,325,772,101,4,1202
E01031425,460,569,129,6,1164
E01031426,362,361,155,140,1018
E01031427,295,260,141,383,1079
E01031428,441,307,416,77,1241
E01031429,286,137,144,473,1040
E01031430,461,354,182,150,1147
E01031431,154,243,288,54,739
E01031432,271,332,868,120,1591
E01031433,360,460,167,213,1200
E01031434,475,277,374,172,1298
E01031435,418,463,391,22,1294
E01031436,187,265,955,141,1548
E01031437,343,323,825,43,1534
E01031438,555,383,199,159,1296
E01031439,537,958,115,82,1692
E01031440,477,758,137,10,1382
E01031441,458,342,253,283,1336
E01031442,518,301,348,72,1239
E01031443,435,251,120,241,1047
E01031444,425,259,427,160,1271
E01031445,339,845,135,47,1366
E01031446,478,570,84,11,1143
E01031447,491,735,100,16,1342
E01031448,480,735,136,18,1369
E01031449,610,435,118,128,1291
E01031450,337,87,132,406,962
E01031451,418,216,154,357,1145
E01031452,508,340,189,80,1117
E01031453,338,364,463,136,1301
E01031454,414,346,794,145,1699
E01031455,388,474,154,141,1157
E01031456,269,329,764,78,1440
E01031457,382,786,207,58,1433
E01031458,495,1055,74,8,1632
E01031459,545,327,194,358,1424
E01031460,348,929,256,10,1543
E01031461,577,826,124,15,1542
E01031462,560,368,149,90,1167
E01031463,594,565,80,28,1267
E01031464,399,675,232,41,1347
E01031465,362,469,211,80,1122
E01031466,462,532,88,76,1158
E01031467,582,510,166,121,1379
E01031468,978,449,199,191,1817
E01031469,581,553,154,126,1414
E01031470,523,430,100,123,1176
E01031471,558,390,90,9,1047
E01031472,550,455,119,126,1250
E01031473,331,256,106,258,951
E01031474,448,421,154,152,1175
E01031475,382,491,99,38,1010
E01031476,330,645,232,44,1251
E01031477,392,591,517,302,1802
E01031478,231,386,230,30,877
E01031479,234,381,143,90,848
E01031480,375,202,330,189,1096
E01031481,329,333,416,196,1274
E01031482,286,171,336,464,1257
E01031483,429,187,458,836,1910
E01031484,279,458,471,356,1564
E01031485,409,752,128,5,1294
E01031486,261,535,470,90,1356
E01031487,294,756,163,105,1318
E01031488,330,282,607,314,1533
E01031489,459,442,215,128,1244
E01031490,266,621,477,126,1490
E01031491,422,473,453,211,1559
E01031492,244,176,211,560,1191
E01031493,418,687,184,133,1422
E01031494,270,251,183,622,1326
E01031495,370,523,370,112,1375
E01031496,790,734,218,62,1804
E01031497,366,374,138,196,1074
E01031498,235,328,295,60,918
E01031499,529,467,242,230,1468
E01031500,571,721,171,49,1512
E01031501,338,530,234,93,1195
E01031502,608,436,86,51,1181
E01031503,543,368,92,112,1115
E01031504,569,634,174,301,1678
E01031505,750,812,210,108,1880
E01031506,337,532,73,97,1039
E01031507,253,500,338,55,1146
E01031508,530,665,269,213,1677
E01031509,669,569,264,412,1914
E01031511,404,627,169,78,1278
E01031512,454,389,164,567,1574
E01031513,552,649,275,304,1780
E01031514,364,464,392,121,1341
E01031515,333,313,168,465,1279
E01031516,378,469,263,111,1221
E01031517,633,630,96,100,1459
E01031518,560,544,84,58,1246
E01031519,345,368,173,195,1081
E01031520,332,421,132,174,1059
E01031521,342,400,124,47,913
E01031522,551,473,204,374,1602
E01031523,497,621,165,17,1300
E01031524,394,733,113,39,1279
E01031525,489,520,114,54,1177
E01031526,302,535,95,140,1072
E01031527,486,670,107,38,1301
E01031528,408,529,244,17,1198
E01031529,324,460,119,73,976
E01031530,414,274,96,225,1009
E01031531,421,560,61,31,1073
E01031532,165,206,452,43,866
E01031533,378,306,58,227,969
E01031534,355,715,245,147,1462
E01031535,438,560,186,97,1281
E01031536,275,403,145,120,943
E01031538,475,297,87,361,1220
E01031539,347,192,197,122,858
E01031540,281,657,150,96,1184
E01031541,327,693,141,35,1196
E01031542,521,735,165,91,1512
E01031543,717,693,171,267,1848
E01031544,321,408,165,135,1029
E01031545,358,450,105,95,1008
E01031546,589,112,200,207,1108
E01031547,431,83,130,391,1035
E01031548,440,117,172,502,1231
E01031549,551,80,146,331,1108
E01031550,540,82,113,385,1120
E01031551,563,126,228,252,1169
E01031552,486,218,297,488,1489
E01031553,404,117,120,474,1115
E01031554,672,163,248,256,1339
E01031555,402,189,186,373,1150
E01031556,440,100,141,537,1218
E01031557,791,183,353,109,1436
E01031558,133,45,112,892,1182
E01031559,473,109,153,369,1104
E01031560,530,493,87,130,1240
E01031561,524,478,101,113,1216
E01031562,315,185,191,374,1065
E01031563,517,397,102,44,1060
E01031564,575,372,104,171,1222
E01031565,698,344,212,434,1688
E01031566,610,419,96,213,1338
E01031567,497,336,116,126,1075
E01031568,583,148,217,158,1106
E01031569,480,160,103,468,1211
E01031570,470,288,96,211,1065
E01031571,485,292,151,368,1296
E01031572,389,307,143,330,1169
E01031573,445,227,179,417,1268
E01031574,673,297,197,257,1424
E01031575,432,251,238,387,1308
E01031576,385,279,219,342,1225
E01031577,384,320,225,155,1084
E01031578,780,288,297,24,1389
E01031579,630,101,299,220,1250
E01031580,1060,278,250,97,1685
E01031581,855,252,161,12,1280
E01031582,799,149,383,51,1382
E01031583,448,207,551,442,1648
E01031584,492,334,248,275,1349
E01031585,510,275,358,255,1398
E01031586,628,281,224,214,1347
E01031587,721,502,135,42,1400
E01031588,574,462,139,50,1225
E01031589,604,515,271,45,1435
E01031590,719,436,149,10,1314
E01031591,532,268,346,300,1446
E01031592,813,551,206,41,1611
E01031593,629,357,155,26,1167
E01031594,418,267,101,312,1098
E01031595,470,264,212,379,1325
E01031596,481,228,302,447,1458
E01031597,548,450,194,43,1235
E01031598,360,257,353,344,1314
E01031599,534,345,409,142,1430
E01031600,399,286,212,242,1139
E01031601,358,295,144,211,1008
E01031603,477,319,254,162,1212
E01031604,541,240,169,327,1277
E01031605,538,243,106,327,1214
E01031606,498,289,78,310,1175
E01031607,476,311,85,236,1108
E01031608,506,256,364,289,1415
E01031609,431,199,117,505,1252
E01031610,443,241,407,365,1456
E01031611,487,523,263,66,1339
E01031612,913,484,108,147,1652
E01031613,733,552,221,100,1606
E01031614,554,339,182,435,1510
E01031615,470,570,140,116,1296
E01031616,562,431,174,123,1290
E01031617,795,884,193,89,1961
E01031618,471,453,139,51,1114
E01031619,712,317,173,21,1223
E01031620,585,316,137,231,1269
E01031621,517,970,42,4,1533
E01031622,666,392,217,30,1305
E01031623,538,736,136,83,1493
E01031624,572,391,147,109,1219
E01031625,636,390,86,35,1147
E01031626,382,535,184,127,1228
E01031627,691,800,120,35,1646
E01031628,338,359,150,176,1023
E01031629,467,593,104,71,1235
E01031630,455,656,164,167,1442
E01031631,315,363,143,486,1307
E01031632,506,480,216,21,1223
E01031633,435,447,97,79,1058
E01031634,491,238,133,116,978
E01031635,626,360,97,58,1141
E01031636,426,539,573,256,1794
E01031637,538,446,118,430,1532
E01031638,747,443,187,85,1462
E01031639,606,620,210,79,1515
E01031640,610,814,69,13,1506
E01031641,388,689,214,51,1342
E01031642,595,656,167,103,1521
E01031643,437,355,109,386,1287
E01031644,602,415,104,10,1131
E01031645,639,321,137,19,1116
E01031646,655,314,129,84,1182
E01031647,422,240,78,212,952
E01031648,509,491,254,145,1399
E01031649,532,304,74,7,917
E01031650,590,354,78,10,1032
E01031651,575,277,143,263,1258
E01031652,421,219,113,550,1303
E01031653,527,367,334,133,1361
E01031654,537,524,105,106,1272
E01031655,591,298,231,49,1169
E01031656,512,181,304,400,1397
E01031657,543,528,196,236,1503
E01031658,582,630,242,205,1659
E01031659,605,427,90,51,1173
E01031660,433,473,91,19,1016
E01031661,503,535,160,104,1302
E01031662,481,423,228,138,1270
E01031663,536,365,110,422,1433
E01031664,473,703,140,42,1358
E01031665,401,410,125,96,1032
E01031666,581,654,59,12,1306
E01031667,523,430,118,200,1271
E01031668,491,623,75,82,1271
E01031669,470,324,180,281,1255
E01031670,553,405,251,70,1279
E01031671,515,308,133,391,1347
E01031672,538,443,401,23,1405
E01031673,511,351,123,221,1206
E01031674,392,463,130,52,1037
E01031675,518,422,86,71,1097
E01031676,878,715,420,124,2137
E01031677,536,374,72,211,1193
E01031678,761,391,58,44,1254
E01031679,365,270,311,42,988
E01031680,692,308,65,8,1073
E01031681,642,288,88,124,1142
E01031682,616,182,88,24,910
E01031683,689,283,103,106,1181
E01031684,541,563,100,11,1215
E01031685,505,640,212,63,1420
E01031686,408,683,100,17,1208
E01031687,414,355,187,350,1306
E01031688,417,342,63,278,1100
E01031689,562,418,244,30,1254
E01031690,552,618,70,8,1248
E01031691,578,491,194,106,1369
E01031692,732,375,329,244,1680
E01031693,488,442,345,185,1460
E01031694,484,474,225,172,1355
E01031695,595,432,129,9,1165
E01031696,495,382,117,86,1080
E01031697,413,328,149,68,958
E01031698,573,464,165,92,1294
E01031699,831,291,163,28,1313
E01031700,844,299,107,20,1270
E01031701,761,333,147,186,1427
E01031702,558,571,54,11,1194
E01031703,516,765,68,16,1365
E01031704,693,490,151,47,1381
E01031705,555,193,134,357,1239
E01031706,636,600,89,73,1398
E01031707,547,569,81,103,1300
E01031708,498,267,460,119,1344
E01031709,510,358,205,269,1342
E01031710,587,534,63,3,1187
E01031711,746,464,87,110,1407
E01031712,528,275,115,246,1164
E01031713,559,539,43,15,1156
E01031714,588,364,72,127,1151
E01031715,736,310,134,3,1183
E01031716,325,185,91,301,902
E01031717,594,281,173,40,1088
E01031718,743,536,142,30,1451
E01031719,656,481,181,103,1421
E01031720,548,472,114,9,1143
E01031721,472,643,54,109,1278
E01031722,325,203,279,104,911
E01031723,567,501,86,22,1176
E01031724,670,378,48,11,1107
E01031725,557,491,84,63,1195
E01031726,496,309,107,207,1119
E01031727,515,510,238,44,1307
E01031728,556,657,278,89,1580
E01031729,774,610,106,15,1505
E01031730,865,245,282,36,1428
E01031731,524,350,115,589,1578
E01031732,547,321,172,356,1396
E01031733,648,359,230,135,1372
E01031734,707,527,96,37,1367
E01031735,741,535,133,6,1415
E01031736,577,573,128,19,1297
E01031737,633,338,112,117,1200
E01031738,471,515,41,5,1032
E01031739,693,584,164,21,1462
E01031740,536,444,93,25,1098
E01031741,543,445,350,77,1415
E01031742,538,493,442,122,1595
E01031743,442,221,305,365,1333
E01031744,549,572,60,23,1204
E01031745,592,635,133,91,1451
E01031746,469,350,163,330,1312
E01031747,442,666,86,26,1220
E01031748,438,540,80,9,1067
E01031749,603,429,118,26,1176
E01031750,489,293,96,307,1185
E01031751,893,461,595,143,2092
E01031752,289,141,55,561,1046
E01031753,485,337,121,156,1099
E01031754,603,376,166,126,1271
E01031755,522,314,123,81,1040
E01031756,575,494,202,224,1495
E01031757,424,260,99,437,1220
E01031758,566,475,68,3,1112
E01031759,527,459,271,90,1347
E01031760,642,484,197,31,1354
E01031761,434,369,830,108,1741
E01031763,578,696,114,25,1413
E01031764,422,463,122,138,1145
E01031765,448,548,147,111,1254
E01031766,646,723,233,92,1694
E01031767,466,458,120,44,1088
E01031768,434,672,104,39,1249
E01031769,608,323,152,231,1314
E01031770,556,422,287,69,1334
E01031771,466,269,90,363,1188
E01031772,487,464,149,214,1314
E01031773,665,723,135,31,1554
E01031774,562,663,61,16,1302
E01031775,495,728,165,25,1413
E01031776,695,288,221,23,1227
E01031777,680,375,207,59,1321
E01031778,578,442,207,12,1239
E01031779,309,186,101,385,981
E01031780,700,365,105,18,1188
E01031781,725,347,131,71,1274
E01031782,537,748,69,100,1454
E01031783,427,200,78,481,1186
E01031784,595,529,210,147,1481
E01031785,543,379,138,119,1179
E01031786,527,318,146,225,1216
E01031787,324,295,881,108,1608
E01031788,548,327,595,212,1682
E01031789,415,375,757,75,1622
E01031790,293,266,568,292,1419
E01031791,530,211,499,365,1605
E01031792,490,416,98,106,1110
E01031793,492,579,69,4,1144
E01031794,412,476,109,167,1164
E01031795,540,224,175,212,1151
E01031796,567,265,286,81,1199
E01031797,540,429,67,14,1050
E01031798,603,292,269,80,1244
E01031799,563,295,209,161,1228
E01031800,610,472,113,1,1196
E01031801,563,325,466,55,1409
E01031802,380,889,138,5,1412
E01031803,512,715,58,7,1292
E01031804,535,737,86,9,1367
E01031805,453,841,109,9,1412
E01031806,525,366,204,218,1313
E01031807,377,442,357,152,1328
E01031808,236,185,662,107,1190
E01031809,383,409,526,24,1342
E01031810,502,274,465,46,1287
E01031811,287,255,420,74,1036
E01031812,394,598,320,29,1341
E01031813,557,473,300,83,1413
E01031814,526,568,207,10,1311
E01031815,467,640,223,8,1338
E01031816,662,375,179,6,1222
E01031817,602,203,182,251,1238
E01031818,718,397,197,277,1589
E01031819,207,69,76,574,926
E01031820,552,879,74,6,1511
E01031821,668,529,113,63,1373
E01031822,584,582,101,10,1277
E01031823,606,472,52,7,1137
E01031824,568,441,58,1,1068
E01031825,531,652,130,112,1425
E01031826,525,364,100,127,1116
E01031827,433,399,178,144,1154
E01031828,500,550,38,4,1092
E01031829,610,597,67,8,1282
E01031830,411,391,134,300,1236
E01031831,598,322,259,51,1230
E01031832,497,498,232,194,1421
E01031833,467,253,326,165,1211
E01031834,576,360,157,168,1261
E01031835,436,341,720,51,1548
E01031836,590,283,155,292,1320
E01031837,783,327,362,35,1507
E01031838,591,443,163,48,1245
E01031839,645,387,189,125,1346
E01031840,660,527,169,47,1403
E01031841,494,573,201,190,1458
E01031842,563,571,220,189,1543
E01031843,456,479,238,248,1421
E01031844,629,425,240,239,1533
E01031845,486,558,127,138,1309
E01031846,527,388,165,274,1354
E01031847,590,491,174,174,1429
E01031848,567,587,139,177,1470
E01031849,520,370,237,194,1321
E01031850,612,470,191,307,1580
E01031851,386,234,107,451,1178
E01031852,663,596,260,108,1627
E01031853,388,420,86,303,1197
E01031854,282,397,314,559,1552
E01031855,512,562,82,88,1244
E01031856,300,416,137,449,1302
E01031857,503,307,119,298,1227
E01031858,609,496,231,71,1407
E01031859,390,247,254,445,1336
E01031860,451,303,176,274,1204
E01031861,638,718,220,365,1941
E01031862,315,230,171,539,1255
E01031863,212,315,331,120,978
E01031864,387,471,155,52,1065
E01031865,264,412,176,172,1024
E01031866,437,478,257,139,1311
E01031867,586,381,212,312,1491
E01031868,480,466,366,109,1421
E01031869,447,364,145,542,1498
E01031870,581,605,225,50,1461
E01031871,463,508,210,158,1339
E01031872,401,476,108,316,1301
E01031873,511,451,283,174,1419
E01031874,417,497,134,208,1256
E01031876,419,519,130,167,1235
E01031877,469,584,283,123,1459
E01031878,662,201,440,185,1488
E01031879,102,18,858,209,1187
E01031880,269,79,800,101,1249
E01031882,491,474,446,215,1626
E01031883,495,719,127,168,1509
E01031884,364,545,262,144,1315
E01031885,473,471,182,126,1252
E01031886,494,515,129,28,1166
E01031887,607,579,95,120,1401
E01031888,386,500,128,57,1071
E01031889,551,275,362,239,1427
E01031890,475,511,120,84,1190
E01031891,704,776,257,105,1842
E01031892,430,508,111,80,1129
E01031893,555,529,118,62,1264
E01031894,453,537,176,61,1227
E01031895,470,352,120,288,1230
E01031896,263,149,119,415,946
E01031897,890,378,198,164,1630
E01031898,527,279,221,182,1209
E01031900,831,716,174,150,1871
E01031901,452,259,171,269,1151
E01031902,488,246,95,96,925
E01031903,963,698,205,64,1930
E01031904,675,574,281,121,1651
E01031905,711,310,67,18,1106
E01031906,640,221,280,25,1166
E01031907,1125,442,297,22,1886
E01031908,552,292,169,270,1283
E01031909,452,446,56,99,1053
E01031910,562,333,116,130,1141
E01031911,350,170,97,422,1039
E01031912,292,230,332,298,1152
E01031913,494,404,129,41,1068
E01031914,240,155,76,464,935
E01031915,529,376,129,66,1100
E01031916,438,343,57,222,1060
E01031917,369,205,246,321,1141
E01031918,690,982,168,182,2022
E01031919,549,499,67,96,1211
E01031920,498,280,180,32,990
E01031921,710,245,105,42,1102
E01031922,559,215,244,27,1045
E01031923,631,262,153,36,1082
E01031924,781,226,195,68,1270
E01031925,303,272,61,271,907
E01031926,563,338,134,153,1188
E01031927,540,464,53,13,1070
E01031928,307,158,89,508,1062
E01031929,405,483,98,73,1059
E01031930,332,146,444,56,978
E01031931,493,629,168,55,1345
E01031932,503,528,92,112,1235
E01031933,465,311,114,307,1197
E01031934,662,628,113,30,1433
E01031935,622,506,213,62,1403
E01031936,431,304,114,318,1167
E01031937,334,331,147,86,898
E01031938,548,372,141,41,1102
E01031939,784,623,165,131,1703
E01031940,662,730,244,145,1781
E01031941,519,400,210,98,1227
E01031942,297,392,220,182,1091
E01031944,393,242,203,53,891
E01031946,149,38,736,93,1016
E01031947,441,334,106,424,1305
E01031948,816,445,238,102,1601
E01031949,538,512,328,98,1476
E01031950,483,430,165,34,1112
E01031951,337,318,180,110,945
E01031952,532,368,443,557,1900
E01031953,1138,594,257,235,2224
E01031954,513,432,101,28,1074
E01031955,589,535,99,49,1272
E01031956,293,284,110,265,952
E01031957,466,394,177,131,1168
E01031958,396,494,185,34,1109
E01031959,448,585,163,87,1283
E01031960,311,300,308,130,1049
E01031961,484,448,108,43,1083
E01031962,516,487,55,37,1095
E01031963,381,304,116,614,1415
E01031964,626,608,206,24,1464
E01031965,552,453,87,84,1176
E01031966,568,556,124,18,1266
E01031967,615,410,250,271,1546
E01031968,609,523,164,42,1338
E01031969,649,379,134,23,1185
E01031970,563,563,169,21,1316
E01031971,388,329,131,127,975
E01031972,427,543,125,113,1208
E01031973,551,735,162,30,1478
E01031974,373,510,116,107,1106
E01031975,252,205,55,509,1021
E01031976,380,90,336,165,971
E01031977,1094,440,426,205,2165
E01031978,646,174,199,306,1325
E01031979,671,415,292,280,1658
E01031980,460,185,156,394,1195
E01031981,335,189,84,629,1237
E01031982,424,330,98,313,1165
E01031983,267,169,131,730,1297
E01031984,660,376,115,59,1210
E01031985,386,234,121,235,976
E01031986,286,294,118,339,1037
E01031988,94,26,919,92,1131
E01031989,343,207,294,313,1157
E01031990,444,573,361,218,1596
E01031991,406,656,334,173,1569
E01031992,442,627,154,23,1246
E01031993,427,478,111,173,1189
E01031994,369,417,89,163,1038
E01031995,478,483,307,62,1330
E01031996,430,253,80,371,1134
E01031997,621,346,145,54,1166
E01031998,90,41,1197,147,1475
E01031999,597,488,130,72,1287
E01032000,527,618,486,168,1799
E01032001,521,419,230,46,1216
E01032002,473,265,251,103,1092
E01032003,403,300,393,131,1227
E01032004,521,676,420,251,1868
E01032005,410,402,135,76,1023
E01032006,372,383,206,30,991
E01032007,458,181,159,230,1028
E01032008,371,397,81,373,1222
E01032009,504,767,169,93,1533
E01032010,534,732,300,162,1728
E01032011,816,490,286,343,1935
E01032012,519,812,103,31,1465
E01032013,412,556,409,231,1608
E01032014,275,373,597,148,1393
E01032015,365,258,270,227,1120
E01032016,419,338,321,63,1141
E01032017,488,588,84,38,1198
E01032018,563,585,96,69,1313
E01032019,369,259,84,414,1126
E01032020,459,478,138,126,1201
E01032021,435,360,393,28,1216
E01032022,233,427,571,217,1448
E01032023,256,255,257,602,1370
E01032024,661,381,731,189,1962
E01032025,523,425,137,161,1246
E01032026,595,466,172,84,1317
E01032027,339,456,255,102,1152
E01032029,320,530,218,69,1137
E01032030,301,404,179,377,1261
E01032031,289,427,125,90,931
E01032032,542,608,134,54,1338
E01032033,457,438,181,97,1173
E01032034,371,475,187,103,1136
E01032035,402,659,181,45,1287
E01032036,327,415,285,178,1205
E01032037,327,379,172,324,1202
E01032038,355,441,240,127,1163
E01032039,374,264,312,176,1126
E01032040,374,328,168,305,1175
E01032041,659,813,108,30,1610
E01032042,628,530,127,79,1364
E01032043,339,399,141,97,976
E01032044,425,539,73,83,1120
E01032045,482,574,89,35,1180
E01032046,422,501,123,215,1261
E01032047,448,540,67,103,1158
E01032048,421,405,142,407,1375
E01032049,446,594,112,137,1289
E01032050,482,684,285,80,1531
E01032051,408,510,149,47,1114
E01032052,442,523,111,33,1109
E01032053,514,516,81,38,1149
E01032054,314,346,157,190,1007
E01032055,459,521,65,16,1061
E01032056,420,375,108,152,1055
E01032057,395,434,100,47,976
E01032058,457,395,128,136,1116
E01032059,496,695,162,78,1431
E01032060,452,656,99,80,1287
E01032061,369,422,75,97,963
E01032062,356,251,254,388,1249
E01032063,642,522,169,161,1494
E01032064,299,178,91,437,1005
E01032065,555,359,151,163,1228
E01032066,529,268,131,240,1168
E01032067,548,486,145,78,1257
E01032068,408,426,187,131,1152
E01032069,558,359,69,45,1031
E01032070,491,379,111,287,1268
E01032071,951,656,166,75,1848
E01032072,934,341,168,87,1530
E01032073,659,248,147,22,1076
E01032074,374,516,74,30,994
E01032075,406,383,187,138,1114
E01032076,259,339,304,124,1026
E01032077,656,509,135,71,1371
E01032078,1055,440,298,377,2170
E01032079,509,500,93,119,1221
E01032080,779,353,112,14,1258
E01032081,256,352,386,34,1028
E01032082,389,407,160,71,1027
E01032083,736,803,219,66,1824
E01032084,814,953,226,103,2096
E01032085,627,389,278,35,1329
E01032086,491,243,667,516,1917
E01032087,654,641,298,173,1766
E01032088,569,539,104,18,1230
E01032089,581,213,394,18,1206
E01032090,514,306,146,198,1164
E01032091,488,286,138,69,981
E01032092,575,430,152,24,1181
E01032093,456,258,129,510,1353
E01032094,661,340,395,402,1798
E01032095,639,451,182,54,1326
E01032096,318,199,114,753,1384
E01032097,731,680,93,26,1530
E01032098,642,496,102,106,1346
E01032099,1098,622,281,162,2163
E01032100,511,463,194,50,1218
E01032101,464,316,386,193,1359
E01032102,524,609,112,12,1257
E01032103,423,477,433,134,1467
E01032104,238,148,93,470,949
E01032105,493,595,147,16,1251
E01032106,471,577,96,17,1161
E01032107,87,38,808,77,1010
E01032108,341,499,194,49,1083
E01032109,472,348,157,228,1205
E01032110,605,574,124,33,1336
E01032111,393,311,113,224,1041
E01032112,613,273,230,44,1160
E01032113,459,297,109,269,1134
E01032114,351,333,264,141,1089
E01032115,525,319,251,306,1401
E01032116,987,663,237,146,2033
E01032117,1032,417,248,280,1977
E01032118,343,184,106,497,1130
E01032119,608,331,479,94,1512
E01032121,655,458,149,28,1290
E01032122,720,621,149,90,1580
E01032123,485,704,113,31,1333
E01032124,520,395,144,159,1218
E01032125,534,488,82,88,1192
E01032126,742,782,59,140,1723
E01032127,644,456,117,96,1313
E01032128,514,417,105,144,1180
E01032129,461,281,53,291,1086
E01032130,1078,393,306,295,2072
E01032131,414,214,92,548,1268
E01032132,570,389,158,609,1726
E01032133,471,438,69,355,1333
E01032134,647,526,75,21,1269
E01032135,672,568,95,15,1350
E01032136,454,465,91,7,1017
E01032137,503,443,154,111,1211
E01032138,443,580,65,15,1103
E01032139,573,565,107,11,1256
E01032140,559,620,107,39,1325
E01032141,510,517,127,29,1183
E01032142,657,503,87,10,1257
E01032143,516,547,62,6,1131
E01032144,554,729,152,4,1439
E01032145,542,636,36,11,1225
E01032146,676,621,72,20,1389
E01032147,336,555,51,120,1062
E01032148,407,379,75,7,868
E01032149,509,447,39,3,998
E01032150,572,615,55,13,1255
E01032151,567,501,71,5,1144
E01032152,406,351,80,242,1079
E01032153,568,379,109,118,1174
E01032154,848,372,126,18,1364
E01032155,756,526,61,8,1351
E01032156,367,314,311,159,1151
E01032157,296,574,209,393,1472
E01032158,509,696,66,4,1275
E01032159,543,539,134,227,1443
E01032160,570,564,189,109,1432
E01032161,394,257,117,380,1148
E01032162,734,626,86,61,1507
E01032166,656,734,211,170,1771
E01032168,330,410,61,108,909
E01032169,348,476,84,29,937
E01032170,645,369,96,37,1147
E01032171,588,631,44,31,1294
E01032172,510,491,160,61,1222
E01032173,722,510,61,56,1349
E01032174,539,350,110,233,1232
E01032175,637,533,43,144,1357
E01032176,735,849,199,65,1848
E01032177,467,385,66,13,931
E01032178,454,587,62,10,1113
E01032179,506,603,170,118,1397
E01032180,598,674,151,111,1534
E01032181,571,817,234,95,1717
E01032182,722,755,126,43,1646
E01032183,490,522,97,37,1146
E01032184,412,747,112,97,1368
E01032185,383,695,76,64,1218
E01032186,304,349,199,76,928
E01032187,418,393,109,433,1353
E01032188,671,395,152,313,1531
E01032189,607,728,109,177,1621
E01032190,537,710,116,168,1531
E01032191,792,838,198,98,1926
E01032192,498,516,88,195,1297
E01032193,621,826,204,174,1825
E01032194,309,388,87,416,1200
E01032195,488,542,216,98,1344
E01032196,435,577,202,126,1340
E01032197,451,461,211,122,1245
E01032198,541,772,251,92,1656
E01032199,484,585,184,174,1427
E01032200,572,827,143,138,1680
E01032201,387,363,79,383,1212
E01032202,339,279,115,596,1329
E01032203,436,391,79,338,1244
E01032204,186,121,53,790,1150
E01032205,254,394,183,72,903
E01032206,339,485,131,69,1024
E01032207,547,478,103,60,1188
E01032208,309,518,392,13,1232
E01032209,216,366,304,17,903
E01032210,284,402,81,122,889
E01032211,558,730,141,89,1518
E01032212,542,705,219,122,1588
E01032213,382,716,166,47,1311
E01032214,447,609,330,405,1791
E01032215,242,360,60,303,965
E01032216,455,472,269,103,1299
E01032217,373,562,196,98,1229
E01032218,499,543,155,49,1246
E01032219,550,662,161,16,1389
E01032220,558,438,178,57,1231
E01032221,436,458,95,58,1047
E01032222,504,314,123,158,1099
E01032223,661,757,171,80,1669
E01032224,473,254,407,238,1372
E01032225,235,103,108,449,895
E01032226,791,590,102,124,1607
E01032227,411,506,28,8,953
E01032228,512,444,132,30,1118
E01032229,500,319,173,215,1207
E01032230,617,417,92,70,1196
E01032231,641,505,169,101,1416
E01032232,314,155,100,750,1319
E01032233,1513,349,224,159,2245
E01032234,399,157,165,568,1289
E01032235,384,260,110,627,1381
E01032236,506,254,362,319,1441
E01032237,605,400,192,56,1253
E01032238,504,367,218,43,1132
E01032239,492,178,521,207,1398
E01032240,413,148,132,355,1048
E01032241,405,104,130,390,1029
E01032242,571,165,124,233,1093
E01032243,694,498,32,14,1238
E01032244,495,296,84,154,1029
E01032245,280,100,153,575,1108
E01032246,584,480,69,24,1157
E01032247,502,287,181,195,1165
E01032248,741,379,37,27,1184
E01032249,683,349,189,46,1267
E01032250,345,125,130,412,1012
E01032251,609,173,225,348,1355
E01032252,281,94,154,513,1042
E01032253,590,322,86,24,1022
E01032254,493,343,133,283,1252
E01032255,562,367,113,87,1129
E01032256,559,306,98,258,1221
E01032257,664,393,53,68,1178
E01032258,481,435,218,124,1258
E01032259,563,430,119,54,1166
E01032260,322,95,133,556,1106
E01032261,550,557,54,23,1184
E01032262,535,208,358,536,1637
E01032263,667,508,136,152,1463
E01032264,642,329,164,205,1340
E01032265,453,225,150,388,1216
E01032266,668,432,137,100,1337
E01032267,598,247,128,306,1279
E01032268,543,387,51,49,1030
E01032269,586,423,197,175,1381
E01032270,567,405,88,7,1067
E01032271,582,431,38,35,1086
E01032272,469,359,99,109,1036
E01032273,620,450,69,33,1172
E01032274,612,381,75,7,1075
E01032275,551,241,94,236,1122
E01032276,702,410,81,18,1211
E01032277,445,179,107,304,1035
E01032278,367,118,158,595,1238
E01032279,445,314,113,152,1024
E01032280,504,361,401,64,1330
E01032281,465,289,371,25,1150
E01032282,395,199,744,130,1468
E01032283,508,490,173,134,1305
E01032284,654,728,169,31,1582
E01032285,554,413,259,95,1321
E01032286,663,431,177,80,1351
E01032287,579,429,241,9,1258
E01032288,553,426,142,126,1247
E01032289,512,688,47,25,1272
E01032290,508,604,112,38,1262
E01032292,485,244,408,76,1213
E01032294,468,342,234,80,1124
E01032295,848,459,500,219,2026
E01032296,577,389,241,105,1312
E01032297,624,565,93,17,1299
E01032298,683,719,81,14,1497
E01032299,647,396,161,63,1267
E01032300,543,656,79,12,1290
E01032301,470,386,125,195,1176
E01032302,232,162,269,304,967
E01032303,232,154,78,425,889
E01032304,344,209,76,483,1112
E01032305,650,403,184,114,1351
E01032306,527,313,132,221,1193
E01032307,368,274,180,490,1312
E01032308,585,520,104,24,1233
E01032309,491,324,111,262,1188
E01032310,442,305,182,241,1170
E01032311,351,212,135,478,1176
E01032312,489,284,345,84,1202
E01032313,254,115,148,455,972
E01032314,337,273,300,26,936
E01032315,315,366,376,49,1106
E01032316,364,505,96,17,982
E01032317,462,520,199,107,1288
E01032318,240,131,130,621,1122
E01032319,537,573,279,82,1471
E01032320,525,369,504,76,1474
E01032321,383,269,178,347,1177
E01032322,384,264,583,368,1599
E01032323,622,461,85,34,1202
E01032324,628,261,182,26,1097
E01032325,705,259,234,23,1221
E01032326,574,463,106,7,1150
E01032327,551,373,251,134,1309
E01032328,507,317,112,284,1220
E01032329,769,691,169,53,1682
E01032330,522,217,196,78,1013
E01032331,330,191,80,530,1131
E01032332,168,82,85,593,928
E01032333,498,134,100,605,1337
E01032334,1015,289,407,134,1845
E01032335,793,254,128,7,1182
E01032336,744,254,233,10,1241
E01032337,909,389,213,27,1538
E01032338,799,225,387,131,1542
E01032339,808,276,138,19,1241
E01032340,382,420,103,243,1148
E01032341,463,539,70,30,1102
E01032342,516,288,172,214,1190
E01032343,574,380,719,278,1951
E01032344,504,527,120,52,1203
E01032345,459,519,146,43,1167
E01032346,457,507,67,43,1074
E01032347,447,436,104,65,1052
E01032348,433,461,69,38,1001
E01032349,518,458,139,159,1274
E01032350,275,347,116,140,878
E01032351,396,726,179,24,1325
E01032352,497,519,124,142,1282
E01032353,359,468,176,328,1331
E01032354,886,627,181,245,1939
E01032355,395,429,105,126,1055
E01032356,464,385,48,10,907
E01032357,383,303,101,178,965
E01032358,375,313,143,372,1203
E01032359,352,532,303,360,1547
E01032360,587,453,131,366,1537
E01032361,648,602,145,37,1432
E01032362,819,535,85,56,1495
E01032363,726,510,46,10,1292
E01032364,717,563,63,7,1350
E01032365,500,411,76,454,1441
E01032366,566,532,101,138,1337
E01032367,439,552,97,87,1175
E01032368,308,170,74,406,958
E01032369,398,117,174,446,1135
E01032370,435,268,90,205,998
E01032371,465,221,95,318,1099
E01032372,433,546,95,125,1199
E01032373,420,505,119,47,1091
E01032374,411,415,118,130,1074
E01032375,323,450,87,118,978
E01032376,518,555,177,9,1259
E01032377,368,206,410,478,1462
E01032378,384,335,309,346,1374
E01032379,830,477,139,83,1529
E01032380,541,617,109,54,1321
E01032381,623,280,187,460,1550
E01032382,403,419,101,119,1042
E01032383,430,557,155,64,1206
E01032384,341,348,113,270,1072
E01032385,298,590,117,103,1108
E01032386,498,480,113,25,1116
E01032387,436,472,88,156,1152
E01032388,466,467,92,87,1112
E01032389,328,337,93,273,1031
E01032390,469,408,112,119,1108
E01032391,370,267,75,177,889
E01032392,461,714,117,38,1330
E01032393,518,596,101,80,1295
E01032394,408,450,109,33,1000
E01032395,352,450,138,72,1012
E01032396,748,290,224,11,1273
E01032397,465,476,133,358,1432
E01032398,685,226,284,174,1369
E01032399,532,549,139,149,1369
E01032400,780,785,135,71,1771
E01032401,425,611,166,62,1264
E01032402,717,243,99,24,1083
E01032403,547,374,151,87,1159
E01032404,696,929,222,169,2016
E01032405,379,532,94,126,1131
E01032406,217,314,281,398,1210
E01032407,434,453,101,227,1215
E01032408,412,644,84,34,1174
E01032409,363,386,160,338,1247
E01032410,429,563,92,75,1159
E01032411,460,516,121,161,1258
E01032412,257,375,268,133,1033
E01032413,326,394,81,92,893
E01032414,504,467,75,212,1258
E01032415,545,333,86,55,1019
E01032416,395,424,62,28,909
E01032417,412,563,175,97,1247
E01032418,474,431,189,40,1134
E01032419,430,623,57,13,1123
E01032420,603,326,61,50,1040
E01032421,555,391,24,63,1033
E01032422,417,99,212,357,1085
E01032423,375,642,94,182,1293
E01032424,332,299,67,429,1127
E01032425,461,576,69,120,1226
E01032426,486,514,117,124,1241
E01032427,510,612,80,93,1295
E01032428,381,717,329,35,1462
E01032429,474,660,107,51,1292
E01032430,490,614,146,158,1408
E01032431,360,568,200,112,1240
E01032432,355,386,136,199,1076
E01032433,439,463,109,14,1025
E01032434,344,135,208,548,1235
E01032435,416,260,265,215,1156
E01032436,591,525,156,12,1284
E01032437,553,320,214,302,1389
E01032438,664,505,127,2,1298
E01032439,430,541,77,93,1141
E01032440,369,284,81,220,954
E01032441,445,527,87,12,1071
E01032442,612,445,105,17,1179
E01032443,438,620,94,12,1164
E01032444,409,377,123,69,978
E01032445,490,353,109,279,1231
E01032446,496,470,152,40,1158
E01032447,599,282,267,13,1161
E01032448,469,453,65,6,993
E01032449,509,323,411,43,1286
E01032450,590,315,562,330,1797
E01032451,537,685,58,40,1320
E01032452,554,620,56,50,1280
E01032453,367,230,118,621,1336
E01032454,572,501,192,100,1365
E01032455,565,586,60,39,1250
E01032456,365,321,141,126,953
E01032457,446,333,55,170,1004
E01032458,445,648,58,14,1165
E01032459,541,512,78,53,1184
E01032460,578,491,265,161,1495
E01032461,658,438,452,85,1633
E01032462,833,569,229,135,1766
E01032463,562,658,108,82,1410
E01032464,371,274,102,517,1264
E01032465,352,169,99,487,1107
E01032466,423,570,162,38,1193
E01032467,378,498,101,28,1005
E01032468,373,537,50,44,1004
E01032469,451,203,125,549,1328
E01032470,521,391,211,330,1453
E01032471,203,123,64,774,1164
E01032472,384,588,70,8,1050
E01032473,382,448,86,95,1011
E01032474,420,209,537,188,1354
E01032475,665,336,279,47,1327
E01032476,514,420,146,58,1138
E01032477,421,524,72,7,1024
E01032478,458,299,151,295,1203
E01032479,616,790,126,254,1786
E01032480,578,701,164,67,1510
E01032481,342,572,180,339,1433
E01032482,426,542,183,31,1182
E01032483,584,448,182,198,1412
E01032484,463,397,98,117,1075
E01032485,729,563,146,9,1447
E01032486,578,508,70,27,1183
E01032487,284,183,54,295,816
E01032488,749,575,76,67,1467
E01032489,727,348,398,126,1599
E01032490,687,208,121,56,1072
E01032491,597,240,74,45,956
E01032492,526,184,458,426,1594
E01032493,545,389,159,40,1133
E01032494,344,154,171,674,1343
E01032495,1099,195,208,257,1759
E01032496,905,348,213,152,1618
E01032497,356,146,155,420,1077
E01032498,512,587,144,60,1303
E01032499,755,460,171,52,1438
E01032500,282,124,420,133,959
E01032501,441,367,75,65,948
E01032502,450,207,140,613,1410
E01032503,514,546,89,23,1172
E01032504,522,700,61,10,1293
E01032505,408,292,160,225,1085
E01032506,409,314,291,144,1158
E01032507,458,376,437,68,1339
E01032508,322,200,271,615,1408
E01032509,364,271,320,182,1137
E01032510,624,328,281,228,1461
E01032511,463,341,85,255,1144
E01032512,182,103,413,1072,1770
E01032513,138,72,227,563,1000
E01032514,231,136,75,970,1412
E01032515,390,308,105,312,1115
E01032516,619,547,192,193,1551
E01032517,385,287,172,385,1229
E01032518,433,212,140,547,1332
E01032519,390,285,176,69,920
E01032520,382,433,1102,43,1960
E01032522,352,340,1118,66,1876
E01032523,232,96,495,20,843
E01032524,254,222,266,46,788
E01032525,397,387,1118,119,2021
E01032526,495,497,298,78,1368
E01032527,500,291,116,296,1203
E01032528,359,371,112,385,1227
E01032529,400,338,330,18,1086
E01032530,699,493,229,70,1491
E01032531,468,277,265,903,1913
E01032532,465,423,129,59,1076
E01032533,859,414,132,72,1477
E01032534,541,404,201,281,1427
E01032535,453,325,173,10,961
E01032536,722,331,268,199,1520
E01032537,564,612,285,109,1570
E01032538,541,387,523,235,1686
E01032540,419,114,56,218,807
E01032541,605,434,168,530,1737
E01032542,304,28,73,401,806
E01032543,540,181,177,761,1659
E01032544,896,175,167,248,1486
E01032545,487,293,132,91,1003
E01032546,775,563,96,12,1446
E01032548,473,808,73,19,1373
E01032549,597,619,94,29,1339
E01032550,931,576,226,476,2209
E01032551,855,736,197,265,2053
E01032552,642,192,63,327,1224
E01032553,386,462,121,107,1076
E01032554,464,706,489,76,1735
E01032555,334,285,336,519,1474
E01032556,528,414,188,58,1188
E01032557,246,95,95,755,1191
E01032558,260,87,65,646,1058
E01032559,1217,348,220,192,1977
E01032560,375,411,65,60,911
E01032561,396,184,112,477,1169
E01032562,379,241,95,416,1131
E01032563,474,543,109,21,1147
E01032564,337,120,95,383,935
E01032565,337,114,117,485,1053
E01032566,571,390,118,293,1372
E01032567,608,388,138,170,1304
E01032568,452,245,124,346,1167
E01032569,321,95,110,710,1236
E01032570,609,519,104,52,1284
E01032571,690,568,159,99,1516
E01032572,376,226,576,163,1341
E01032573,295,333,709,90,1427
E01032574,471,334,420,251,1476
E01032575,239,80,314,685,1318
E01032576,711,391,190,15,1307
E01032577,692,386,113,119,1310
E01032579,143,65,389,578,1175
E01032580,262,128,333,269,992
E01032581,470,195,369,233,1267
E01032582,246,58,703,651,1658
E01032583,137,75,406,549,1167
E01032584,214,80,293,487,1074
E01032585,557,586,78,17,1238
E01032586,372,456,108,440,1376
E01032587,560,255,171,301,1287
E01032588,532,486,112,1,1131
E01032589,515,402,148,54,1119
E01032590,688,482,208,15,1393
E01032591,578,643,112,6,1339
E01032592,530,579,143,194,1446
E01032593,732,701,95,52,1580
E01032594,434,589,63,82,1168
E01032595,500,348,98,501,1447
E01032596,580,420,154,14,1168
E01032597,331,162,90,508,1091
E01032598,807,708,155,78,1748
E01032599,565,533,129,20,1247
E01032600,745,723,144,3,1615
E01032601,551,574,77,9,1211
E01032602,384,179,113,500,1176
E01032603,484,687,77,7,1255
E01032604,616,446,133,29,1224
E01032605,545,529,55,23,1152
E01032606,765,385,108,362,1620
E01032607,330,132,304,117,883
E01032608,385,208,306,42,941
E01032609,419,323,90,173,1005
E01032610,580,570,98,66,1314
E01032611,602,631,234,22,1489
E01032612,556,322,658,183,1719
E01032613,363,396,58,197,1014
E01032614,692,238,77,16,1023
E01032615,379,496,40,9,924
E01032616,717,519,68,11,1315
E01032617,615,636,65,14,1330
E01032618,556,445,78,146,1225
E01032619,688,454,134,23,1299
E01032620,727,864,182,133,1906
E01032621,493,386,71,335,1285
E01032622,548,467,85,23,1123
E01032623,627,727,62,7,1423
E01032624,718,732,36,4,1490
E01032625,345,487,57,10,899
E01032626,455,451,175,67,1148
E01032627,514,707,260,246,1727
E01032628,639,765,192,69,1665
E01032629,460,435,176,145,1216
E01032630,776,246,113,77,1212
E01032631,438,149,407,12,1006
E01032632,492,345,134,44,1015
E01032633,621,876,290,56,1843
E01032634,443,516,52,11,1022
E01032635,526,556,115,532,1729
E01032636,500,703,349,59,1611
E01032637,300,97,627,5,1029
E01032638,337,178,567,17,1099
E01032639,261,45,623,410,1339
E01032640,305,153,716,8,1182
E01032641,401,357,225,280,1263
E01032642,513,860,267,212,1852
E01032643,482,419,216,129,1246
E01032644,162,291,265,221,939
E01032645,165,289,165,243,862
E01032646,291,110,743,281,1425
E01032647,905,134,224,53,1316
E01032648,467,118,149,411,1145
E01032649,336,76,158,374,944
E01032650,242,105,65,495,907
E01032651,535,276,133,111,1055
E01032652,323,225,142,230,920
E01032653,558,408,224,42,1232
E01032654,950,180,167,80,1377
E01032655,834,137,153,34,1158
E01032656,674,222,105,122,1123
E01032657,171,235,762,190,1358
E01032658,99,117,508,430,1154
E01032659,124,106,358,394,982
E01032660,443,203,345,173,1164
E01032661,257,371,484,36,1148
E01032662,103,152,278,436,969
E01032663,906,493,227,256,1882
E01032664,221,352,293,109,975
E01032665,268,304,394,167,1133
E01032666,465,301,143,38,947
E01032667,488,140,137,38,803
E01032668,585,105,305,73,1068
E01032669,512,75,428,7,1022
E01032670,654,98,304,51,1107
E01032671,475,87,305,58,925
E01032672,630,199,195,11,1035
E01032673,397,213,257,158,1025
E01032674,1125,442,143,112,1822
E01032675,562,195,302,33,1092
E01032676,463,289,357,55,1164
E01032677,632,101,100,151,984
E01032678,788,175,127,7,1097
E01032679,512,128,314,11,965
E01032680,602,830,106,45,1583
E01032681,401,407,129,101,1038
E01032682,415,213,118,32,778
E01032683,775,739,248,119,1881
E01032684,217,60,645,256,1178
E01032685,329,129,945,30,1433
E01032686,140,61,1119,44,1364
E01032687,200,80,845,123,1248
E01032688,508,183,151,117,959
E01032689,437,331,131,135,1034
E01032690,780,132,188,154,1254
E01032691,606,202,151,182,1141
E01032692,461,157,167,129,914
E01032693,448,252,126,212,1038
E01032694,657,153,187,167,1164
E01032695,552,459,120,34,1165
E01032696,494,420,475,299,1688
E01032697,141,32,549,310,1032
E01032698,398,149,294,401,1242
E01032699,593,639,506,162,1900
E01032700,850,112,167,9,1138
E01032701,538,73,313,17,941
E01032702,666,135,223,30,1054
E01032703,751,101,162,50,1064
E01032704,600,63,269,113,1045
E01032705,704,72,229,45,1050
E01032706,599,86,432,80,1197
E01032707,735,553,169,11,1468
E01032708,506,88,757,19,1370
E01032709,636,79,221,56,992
E01032710,675,137,182,6,1000
E01032711,582,68,354,45,1049
E01032712,590,69,277,109,1045
E01032713,915,113,178,19,1225
E01032714,221,125,680,62,1088
E01032715,255,119,402,56,832
E01032716,609,249,259,53,1170
E01032717,524,858,435,307,2124
E01032719,124,63,368,477,1032
E01032720,175,50,483,639,1347
E01032722,206,63,814,741,1824
E01032724,323,87,261,400,1071
E01032725,749,87,116,182,1134
E01032726,534,152,90,306,1082
E01032727,914,1213,236,53,2416
E01032728,480,162,265,252,1159
E01032729,307,115,429,324,1175
E01032730,283,66,591,188,1128
E01032731,491,137,260,192,1080
E01032732,487,191,269,286,1233
E01032733,259,64,209,356,888
E01032734,323,197,366,273,1159
E01032735,720,415,57,52,1244
E01032737,614,267,88,164,1133
E01032738,123,46,900,100,1169
E01032739,132,136,679,18,965
E01032740,167,149,681,23,1020
E01032741,315,119,366,145,945
E01032742,394,304,277,108,1083
E01032743,453,45,554,429,1481
E01032744,352,153,390,139,1034
E01032745,222,36,411,350,1019
E01032746,275,58,695,67,1095
E01032748,295,132,475,130,1032
E01032750,83,59,613,239,994
E01032751,227,97,468,224,1016
E01032753,492,517,907,18,1934
E01032755,34,25,179,529,767
E01032756,254,295,1798,276,2623
E01032758,715,184,162,147,1208
E01032759,648,309,148,64,1169
E01032761,881,1027,119,23,2050
E01032763,759,793,151,127,1830
E01032764,163,39,521,422,1145
E01032765,205,51,423,559,1238
E01032766,217,30,605,286,1138
E01032767,170,88,1135,123,1516
E01032768,310,105,674,92,1181
E01032769,233,104,511,202,1050
E01032770,182,46,563,246,1037
E01032771,144,77,472,230,923
E01032772,135,60,451,324,970
E01032773,296,81,577,340,1294
E01032774,125,56,382,453,1016
E01032775,253,69,585,82,989
E01032776,144,45,685,106,980
E01032777,250,39,353,306,948
E01032778,173,58,620,119,970
E01032779,127,44,595,131,897
E01032780,267,169,748,34,1218
E01032781,302,130,760,186,1378
E01032782,187,55,625,411,1278
E01032783,230,73,616,306,1225
E01032784,257,80,639,315,1291
E01032785,375,57,371,323,1126
E01032786,201,97,288,603,1189
E01032787,314,123,541,926,1904
E01032788,183,115,304,291,893
E01032789,216,79,348,303,946
E01032790,125,144,354,249,872
E01032792,398,191,320,177,1086
E01032794,240,417,283,160,1100
E01032795,338,226,384,254,1202
E01032797,118,240,832,159,1349
E01032798,423,234,874,591,2122
E01032799,258,219,594,168,1239
E01032800,192,164,544,112,1012
E01032802,232,248,431,230,1141
E01032803,299,87,701,127,1214
E01032805,389,142,496,916,1943
E01032807,213,247,829,64,1353
E01032808,257,115,600,263,1235
E01032809,706,834,307,62,1909
E01032810,422,172,231,274,1099
E01032811,610,179,239,147,1175
E01032812,687,407,220,38,1352
E01032813,820,133,345,49,1347
E01032814,706,400,236,102,1444
E01032815,251,65,229,195,740
E01032816,932,206,178,47,1363
E01032817,447,92,256,92,887
E01032818,671,130,267,25,1093
E01032819,773,164,239,100,1276
E01032820,562,220,325,70,1177
E01032821,819,255,170,22,1266
E01032822,559,364,96,132,1151
E01032823,668,247,168,184,1267
E01032824,578,296,216,71,1161
E01032825,627,130,106,215,1078
E01032826,772,173,143,22,1110
E01032827,832,168,59,78,1137
E01032828,553,215,110,8,886
E01032829,492,397,106,111,1106
E01032830,698,308,170,760,1936
E01032831,542,456,295,19,1312
E01032832,280,284,306,355,1225
E01032833,352,278,503,20,1153
E01032834,249,187,591,45,1072
E01032835,588,133,273,221,1215
E01032836,518,349,245,191,1303
E01032837,425,202,199,122,948
E01032838,589,75,226,106,996
E01032839,286,351,322,34,993
E01032840,666,56,176,361,1259
E01032841,755,127,167,213,1262
E01032842,239,57,614,169,1079
E01032843,817,65,137,231,1250
E01032844,534,156,187,352,1229
E01032845,659,263,326,117,1365
E01032846,388,77,538,247,1250
E01032847,246,177,310,373,1106
E01032848,720,79,190,104,1093
E01032849,716,76,115,154,1061
E01032850,711,202,192,31,1136
E01032851,556,259,188,537,1540
E01032852,826,115,162,117,1220
E01032853,814,180,232,13,1239
E01032854,735,126,267,34,1162
E01032855,257,300,227,92,876
E01032856,97,93,671,76,937
E01032857,457,194,170,3,824
E01032858,626,213,253,522,1614
E01032859,791,255,208,50,1304
E01032860,626,92,389,14,1121
E01032862,698,92,444,141,1375
E01032863,667,157,333,100,1257
E01032865,1037,236,254,33,1560
E01032867,106,40,915,189,1250
E01032868,75,11,770,116,972
E01032870,772,429,228,60,1489
E01032871,467,360,149,256,1232
E01032872,90,28,923,121,1162
E01032873,72,32,831,352,1287
E01032875,37,43,636,272,988
E01032876,418,368,308,48,1142
E01032877,692,848,101,148,1789
E01032878,163,109,391,285,948
E01032879,158,249,278,406,1091
E01032880,689,219,63,63,1034
E01032881,820,164,125,108,1217
E01032882,413,115,259,628,1415
E01032883,427,319,108,254,1108
E01032884,662,617,407,61,1747
E01032885,407,119,486,5,1017
E01032886,829,339,325,19,1512
E01032887,553,494,321,658,2026
E01032888,491,324,153,974,1942
E01032889,372,235,119,669,1395
E01032890,517,277,191,598,1583
E01032891,808,118,328,54,1308
E01032892,729,480,174,129,1512
E01032893,913,216,67,72,1268
E01032894,637,90,110,102,939
E01032895,627,350,97,43,1117
E01032896,228,96,455,136,915
E01032897,390,254,246,84,974
E01032898,193,145,401,245,984
E01032899,331,470,220,280,1301
E01032900,736,164,325,248,1473
E01032901,760,152,178,99,1189
E01032902,531,336,185,50,1102
E01032903,554,440,454,437,1885
E01032904,801,489,111,34,1435
E01032905,753,237,107,147,1244
E01032906,106,31,572,418,1127
E01032907,130,35,441,467,1073
E01032909,124,56,1091,24,1295
E01032911,154,51,765,115,1085
E01032912,229,92,312,590,1223
E01032914,188,66,1079,154,1487
E01032915,206,47,343,609,1205
E01032917,152,49,553,216,970
E01032919,285,274,738,437,1734
E01032920,535,396,246,309,1486
E01032921,336,709,259,418,1722
E01032922,763,894,173,235,2065
E01032923,746,353,321,460,1880
E01032924,668,174,262,58,1162
E01032925,394,310,161,196,1061
E01032926,886,191,150,9,1236
E01032927,659,304,168,38,1169
E01032928,779,169,395,125,1468
E01032929,405,362,84,75,926
E01032930,288,182,746,493,1709
E01032931,287,149,506,72,1014
E01032932,295,287,166,195,943
E01032933,607,57,232,168,1064
E01032934,614,321,169,30,1134
E01032935,726,82,198,120,1126
E01032936,520,52,265,375,1212
E01032937,116,53,433,317,919
E01032938,514,257,277,116,1164
E01032939,686,175,245,66,1172
E01032940,652,95,224,50,1021
E01032941,237,176,297,427,1137
E01032942,387,59,477,198,1121
E01032943,597,149,295,135,1176
E01032944,536,225,256,77,1094
E01032945,200,155,2556,168,3079
E01032946,215,161,1228,163,1767
E01032947,760,117,264,169,1310
E01032948,811,333,178,82,1404
E01032949,635,76,285,110,1106
E01032950,858,92,258,77,1285
E01032951,457,175,581,211,1424
E01032952,495,385,190,46,1116
E01032953,344,329,860,139,1672
E01032954,770,765,366,285,2186
E01032955,403,198,302,187,1090
E01032956,840,132,268,9,1249
E01032957,577,134,347,18,1076
E01032958,524,427,158,122,1231
E01032959,590,109,82,372,1153
E01032960,795,711,265,161,1932
E01032961,214,123,374,143,854
E01032962,746,155,276,10,1187
E01032963,785,129,286,25,1225
E01032964,736,130,330,7,1203
E01032965,612,82,268,44,1006
E01032966,786,81,350,34,1251
E01032967,621,76,437,22,1156
E01032968,787,816,98,120,1821
E01032969,638,82,126,72,918
E01032970,602,232,119,130,1083
E01032971,394,165,201,62,822
E01032972,603,422,93,62,1180
E01032973,848,122,116,74,1160
E01032974,515,314,102,81,1012
E01032975,850,190,205,21,1266
E01032976,501,189,162,154,1006
E01032977,705,87,266,168,1226
E01032978,165,26,321,650,1162
E01032979,79,28,265,675,1047
E01032980,272,55,726,148,1201
E01032981,464,193,496,77,1230
E01032982,534,136,201,43,914
E01032983,746,95,155,32,1028
E01032984,835,90,145,16,1086
E01032985,502,473,152,107,1234
E01032986,245,265,335,89,934
E01032987,448,295,254,63,1060
E01032988,462,204,153,280,1099
E01032989,640,124,197,67,1028
E01032990,1094,158,441,34,1727
E01032991,507,483,156,45,1191
E01032992,522,425,125,59,1131
E01032993,554,580,77,17,1228
E01032994,489,366,155,46,1056
E01032995,273,321,475,126,1195
E01032996,460,470,124,61,1115
E01032997,511,153,142,90,896
E01032998,585,84,213,50,932
E01032999,403,360,139,54,956
E01033000,169,54,162,870,1255
E01033002,138,68,581,351,1138
E01033003,64,39,628,798,1529
E01033005,95,74,885,699,1753
E01033006,107,78,1600,289,2074
E01033008,117,49,863,28,1057
E01033010,119,56,787,59,1021
E01033011,144,52,907,50,1153
E01033013,134,60,566,264,1024
E01033015,146,42,889,56,1133
E01033016,195,82,662,55,994
E01033018,41,21,1006,36,1104
E01033019,129,28,1007,17,1181
E01033021,208,48,246,521,1023
E01033022,453,113,440,111,1117
E01033023,487,209,342,195,1233
E01033024,911,165,67,11,1154
E01033025,652,112,133,54,951
E01033026,645,181,236,65,1127
E01033027,681,100,195,146,1122
E01033028,568,297,99,161,1125
E01033029,605,209,159,188,1161
E01033030,472,22,642,188,1324
E01033031,111,54,530,445,1140
E01033032,201,70,746,170,1187
E01033033,47,21,774,297,1139
E01033034,219,49,693,43,1004
E01033035,52,30,112,877,1071
E01033036,528,437,168,99,1232
E01033037,491,203,229,211,1134
E01033038,379,346,387,234,1346
E01033039,259,315,153,109,836
E01033040,334,108,107,202,751
E01033041,431,127,155,75,788
E01033042,521,644,353,159,1677
E01033043,273,260,290,199,1022
E01033044,573,125,206,104,1008
E01033045,477,123,122,56,778
E01033046,221,135,372,240,968
E01033047,333,256,243,83,915
E01033048,309,237,228,268,1042
E01033049,251,350,292,120,1013
E01033050,531,190,197,79,997
E01033051,726,627,330,245,1928
E01033052,504,342,170,226,1242
E01033053,892,110,178,80,1260
E01033054,363,168,60,234,825
E01033055,648,338,94,29,1109
E01033056,380,328,112,239,1059
E01033057,807,729,114,247,1897
E01033058,452,639,597,273,1961
E01033059,746,248,123,31,1148
E01033060,423,362,124,14,923
E01033061,862,428,74,6,1370
E01033062,1119,688,68,83,1958
E01033063,512,196,192,120,1020
E01033064,401,210,233,261,1105
E01033065,300,294,299,59,952
E01033066,222,183,641,81,1127
E01033067,110,106,508,460,1184
E01033068,128,160,696,93,1077
E01033069,217,225,496,88,1026
E01033070,129,133,612,191,1065
E01033071,148,106,705,59,1018
E01033072,866,871,195,49,1981
E01033073,282,313,592,96,1283
E01033074,587,347,97,701,1732
E01033075,312,249,245,813,1619
E01033076,356,140,68,648,1212
E01033077,551,304,73,547,1475
E01033078,474,596,257,34,1361
E01033079,376,369,100,83,928
E01033080,320,302,1094,300,2016
E01033081,249,90,405,301,1045
E01033082,244,219,326,260,1049
E01033083,250,36,919,101,1306
E01033084,354,123,698,171,1346
E01033085,382,62,661,392,1497
E01033086,94,29,142,569,834
E01033087,333,79,492,207,1111
E01033088,605,125,274,53,1057
E01033089,418,161,264,272,1115
E01033090,210,166,381,240,997
E01033091,623,222,416,61,1322
E01033092,251,109,446,232,1038
E01033093,469,288,546,37,1340
E01033094,157,174,439,66,836
E01033095,759,579,88,103,1529
E01033096,925,925,97,72,2019
E01033097,178,210,461,57,906
E01033098,263,125,484,60,932
E01033099,241,107,323,217,888
E01033100,170,90,497,346,1103
E01033101,328,224,546,26,1124
E01033102,747,163,219,104,1233
E01033103,850,383,92,18,1343
E01033104,124,61,755,236,1176
E01033105,842,124,149,24,1139
E01033106,696,59,151,19,925
E01033107,756,134,109,23,1022
E01033108,841,133,114,10,1098
E01033109,149,95,537,360,1141
E01033110,256,167,230,570,1223
E01033111,323,439,281,169,1212
E01033112,203,169,430,213,1015
E01033113,358,125,96,206,785
E01033114,566,136,210,167,1079
E01033115,550,106,174,105,935
E01033116,549,383,155,187,1274
E01033117,523,82,152,132,889
E01033118,556,317,154,94,1121
E01033119,807,138,165,155,1265
E01033120,339,156,226,434,1155
E01033121,442,34,362,344,1182
E01033122,204,64,448,353,1069
E01033123,470,248,589,148,1455
E01033124,61,43,429,72,605
E01033125,110,34,567,204,915
E01033126,209,76,857,92,1234
E01033127,446,95,288,283,1112
E01033128,396,160,180,167,903
E01033129,137,93,421,351,1002
E01033130,192,83,390,234,899
E01033131,330,138,124,480,1072
E01033132,249,91,349,229,918
E01033133,289,116,485,166,1056
E01033135,313,184,389,24,910
E01033137,561,286,253,107,1207
E01033138,529,312,235,149,1225
E01033139,360,155,489,175,1179
E01033140,255,166,476,80,977
E01033141,220,245,374,80,919
E01033142,959,261,124,195,1539
E01033143,728,1261,175,71,2235
E01033144,729,226,112,230,1297
E01033145,439,430,71,199,1139
E01033146,308,58,282,458,1106
E01033148,515,127,225,450,1317
E01033150,452,33,426,240,1151
E01033151,197,131,201,525,1054
E01033153,253,113,380,1088,1834
E01033154,125,79,688,68,960
E01033156,640,321,235,87,1283
E01033158,383,488,154,55,1080
E01033159,152,293,348,63,856
E01033160,756,362,121,392,1631
E01033161,637,375,169,23,1204
E01033163,990,329,165,54,1538
E01033164,97,145,685,40,967
E01033166,102,61,306,371,840
E01033167,129,100,314,420,963
E01033168,550,310,80,45,985
E01033169,802,179,145,40,1166
E01033170,504,296,142,39,981
E01033171,455,282,348,77,1162
E01033172,401,145,474,161,1181
E01033173,873,136,371,44,1424
E01033174,279,83,294,244,900
E01033175,654,124,188,68,1034
E01033176,539,96,330,136,1101
E01033177,553,84,236,139,1012
E01033178,488,37,238,266,1029
E01033179,463,367,107,240,1177
E01033180,469,67,359,203,1098
E01033181,628,116,275,110,1129
E01033182,389,163,391,210,1153
E01033183,53,7,756,84,900
E01033184,379,41,519,86,1025
E01033185,307,423,235,113,1078
E01033186,320,590,172,44,1126
E01033187,357,157,124,974,1612
E01033188,576,406,37,122,1141
E01033189,750,208,146,56,1160
E01033190,693,124,167,79,1063
E01033191,621,116,164,134,1035
E01033192,706,79,215,92,1092
E01033193,705,284,140,74,1203
E01033194,612,469,449,118,1648
E01033195,159,269,417,51,896
E01033197,73,148,771,109,1101
E01033198,419,338,437,74,1268
E01033200,565,553,393,169,1680
E01033202,432,236,119,167,954
E01033203,891,732,368,288,2279
E01033205,575,400,124,116,1215
E01033206,526,271,113,285,1195
E01033207,227,133,354,656,1370
E01033208,418,175,621,284,1498
E01033209,224,329,363,11,927
E01033210,924,727,154,78,1883
E01033211,133,304,374,207,1018
E01033212,106,129,902,146,1283
E01033213,698,194,261,126,1279
E01033214,763,361,137,33,1294
E01033215,101,327,590,73,1091
E01033216,584,619,561,301,2065
E01033217,85,66,347,432,930
E01033218,706,213,230,53,1202
E01033219,698,405,76,26,1205
E01033220,122,116,230,602,1070
E01033221,62,114,595,173,944
E01033223,19,12,449,325,805
E01033224,94,100,354,303,851
E01033226,103,139,211,449,902
E01033228,325,178,93,854,1450
E01033229,409,577,144,49,1179
E01033231,438,857,394,254,1943
E01033232,498,212,293,135,1138
E01033233,581,972,253,116,1922
E01033234,539,317,235,50,1141
E01033235,257,487,278,67,1089
E01033236,196,464,177,64,901
E01033237,263,178,81,497,1019
E01033239,518,1294,183,37,2032
E01033241,189,178,609,22,998
E01033242,143,160,551,44,898
E01033243,508,329,200,22,1059
E01033244,1129,516,195,13,1853
E01033245,414,243,119,31,807
E01033246,279,280,300,155,1014
E01033247,116,53,576,133,878
E01033248,126,106,471,209,912
E01033249,195,141,483,229,1048
E01033250,557,193,243,31,1024
E01033251,442,140,164,114,860
E01033252,432,572,40,24,1068
E01033253,244,192,849,71,1356
E01033254,714,96,210,42,1062
E01033255,627,283,142,227,1279
E01033256,203,146,672,143,1164
E01033257,1015,841,135,76,2067
E01033258,750,653,305,330,2038
E01033259,699,187,299,44,1229
E01033260,600,227,333,65,1225
E01033261,27,46,1313,271,1657
E01033262,111,31,807,159,1108
E01033263,111,28,907,138,1184
E01033264,123,48,1051,41,1263
E01033265,87,48,581,231,947
E01033266,114,51,1044,137,1346
E01033267,66,44,1012,243,1365
E01033268,145,121,752,929,1947
E01033269,132,107,274,756,1269
E01033270,168,43,676,358,1245
E01033271,24,45,285,770,1124
E01033272,79,56,531,358,1024
E01033273,124,97,944,261,1426
E01033274,93,33,864,243,1233
E01033275,663,243,184,136,1226
E01033276,32,53,1236,281,1602
E01033277,441,250,138,898,1727
E01033278,607,424,131,791,1953
E01033279,558,350,128,816,1852
E01033280,720,430,64,27,1241
E01033281,857,644,360,227,2088
E01033282,358,537,1203,198,2296
E01033283,245,265,540,17,1067
E01033285,122,85,662,117,986
E01033286,256,263,413,39,971
E01033288,321,264,317,59,961
E01033289,356,888,320,220,1784
E01033291,442,676,178,31,1327
E01033292,298,194,216,314,1022
E01033294,935,632,235,132,1934
E01033296,575,440,94,63,1172
E01033297,751,106,346,10,1213
E01033299,663,148,618,173,1602
E01033300,120,61,571,202,954
E01033302,458,197,340,266,1261
E01033303,351,209,335,74,969
E01033305,318,157,458,135,1068
E01033306,371,331,393,203,1298
E01033308,262,37,780,235,1314
E01033310,664,237,237,115,1253
E01033311,466,218,218,331,1233
E01033313,588,266,174,102,1130
E01033314,382,50,972,299,1703
E01033316,728,167,181,90,1166
E01033317,630,243,269,42,1184
E01033319,869,281,245,27,1422
E01033320,430,209,341,206,1186
E01033322,334,79,465,166,1044
E01033324,319,152,323,534,1328
E01033325,296,71,758,15,1140
E01033327,317,199,644,131,1291
E01033328,310,191,655,152,1308
E01033329,502,112,661,219,1494
E01033330,96,94,130,896,1216
E01033331,477,76,503,75,1131
E01033333,442,360,265,83,1150
E01033334,488,106,584,11,1189
E01033336,832,229,124,43,1228
E01033338,798,278,95,58,1229
E01033339,493,221,167,211,1092
E01033341,215,90,379,301,985
E01033342,88,68,862,272,1290
E01033344,183,145,758,330,1416
E01033345,191,124,815,169,1299
E01033347,152,31,449,315,947
E01033348,119,41,358,333,851
E01033350,239,188,444,113,984
E01033352,355,52,498,185,1090
E01033353,89,26,562,383,1060
E01033355,162,76,605,111,954
E01033356,133,70,222,626,1051
E01033358,46,26,295,695,1062
E01033359,139,40,643,258,1080
E01033361,163,153,490,368,1174
E01033362,206,132,572,116,1026
E01033364,522,226,488,141,1377
E01033366,103,32,191,618,944
E01033367,106,63,504,381,1054
E01033369,154,85,166,589,994
E01033370,55,29,328,564,976
E01033372,493,219,298,35,1045
E01033373,350,217,208,262,1037
E01033375,652,133,115,4,904
E01033376,540,107,182,5,834
E01033378,556,431,85,33,1105
E01033380,319,282,727,34,1362
E01033381,291,102,473,366,1232
E01033383,170,98,185,602,1055
E01033384,338,487,421,63,1309
E01033386,739,726,164,235,1864
E01033387,301,125,491,59,976
E01033388,392,274,216,222,1104
E01033389,607,156,281,8,1052
E01033390,776,139,209,6,1130
E01033391,444,492,47,15,998
E01033392,612,624,223,323,1782
E01033393,1046,180,330,38,1594
E01033394,471,426,113,39,1049
E01033395,33,43,647,362,1085
E01033396,68,59,391,424,942
E01033397,474,116,348,369,1307
E01033398,226,60,369,300,955
E01033399,81,80,387,387,935
E01033400,145,91,469,357,1062
E01033401,75,66,632,161,934
E01033402,56,14,683,234,987
E01033403,148,50,528,250,976
E01033404,146,180,2951,425,3702
E01033405,47,29,702,211,989
E01033406,97,24,797,113,1031
E01033407,72,51,807,106,1036
E01033408,233,278,2294,195,3000
E01033409,19,10,219,644,892
E01033410,164,231,2013,123,2531
E01033411,146,61,161,484,852
E01033412,946,914,112,53,2025
E01033413,879,664,191,97,1831
E01033414,878,675,212,116,1881
E01033415,224,60,837,116,1237
E01033417,271,99,529,111,1010
E01033418,259,49,585,119,1012
E01033420,166,74,641,108,989
E01033421,284,61,539,572,1456
E01033422,194,77,575,147,993
E01033423,270,102,599,67,1038
E01033424,226,22,446,382,1076
E01033425,895,198,213,73,1379
E01033426,604,202,136,93,1035
E01033427,627,86,115,123,951
E01033428,531,334,230,70,1165
E01033429,788,467,221,111,1587
E01033430,314,249,108,450,1121
E01033431,525,166,50,201,942
E01033432,800,713,159,111,1783
E01033433,628,539,223,161,1551
E01033434,295,148,439,94,976
E01033435,486,121,569,247,1423
E01033436,208,180,203,518,1109
E01033437,153,135,230,640,1158
E01033438,155,284,551,266,1256
E01033439,364,191,622,56,1233
E01033440,146,73,377,374,970
E01033441,224,121,658,140,1143
E01033442,746,138,180,27,1091
E01033443,341,249,402,42,1034
E01033444,680,116,198,24,1018
E01033445,731,240,172,116,1259
E01033446,620,692,305,116,1733
E01033447,541,480,86,22,1129
E01033448,272,399,237,107,1015
E01033449,539,330,342,61,1272
E01033450,712,1090,149,128,2079
E01033451,529,34,373,154,1090
E01033452,466,219,304,83,1072
E01033453,446,267,849,177,1739
E01033454,454,171,268,99,992
E01033455,130,75,484,207,896
E01033456,126,52,137,1254,1569
E01033457,332,255,745,46,1378
E01033458,271,107,627,102,1107
E01033459,513,351,573,73,1510
E01033460,473,245,188,119,1025
E01033461,725,93,200,104,1122
E01033462,372,146,210,87,815
E01033463,806,923,499,109,2337
E01033464,598,816,537,241,2192
E01033465,908,296,129,55,1388
E01033466,340,300,236,647,1523
E01033467,397,165,98,307,967
E01033468,280,281,664,847,2072
E01033469,436,244,224,601,1505
E01033470,396,351,187,495,1429
E01033471,476,133,201,796,1606
E01033472,1002,642,189,171,2004
E01033473,487,398,210,548,1643
E01033474,854,115,181,4,1154
E01033475,1029,94,109,6,1238
E01033476,851,320,89,13,1273
E01033477,443,295,917,337,1992
E01033478,1015,204,93,0,1312
E01033479,910,231,151,4,1296
E01033480,697,611,75,10,1393
E01033481,585,123,282,29,1019
E01033482,776,255,185,15,1231
E01033483,147,50,358,266,821
E01033484,180,149,506,173,1008
E01033485,222,189,618,516,1545
E01033486,146,55,258,385,844
E01033487,269,65,537,192,1063
E01033488,127,38,288,569,1022
E01033489,325,196,571,116,1208
E01033490,139,98,485,343,1065
E01033491,259,121,734,375,1489
E01033492,254,44,673,252,1223
E01033493,235,74,874,53,1236
E01033494,348,268,434,238,1288
E01033495,639,114,271,23,1047
E01033496,792,434,73,8,1307
E01033497,278,243,205,184,910
E01033498,371,154,148,396,1069
E01033499,207,88,636,298,1229
E01033500,312,52,798,91,1253
E01033501,733,73,406,246,1458
E01033503,681,219,183,75,1158
E01033505,733,64,151,50,998
E01033506,804,214,264,185,1467
E01033508,849,91,186,120,1246
E01033509,593,37,332,221,1183
E01033511,519,40,441,144,1144
E01033512,690,270,163,95,1218
E01033514,688,64,133,108,993
E01033515,893,178,155,143,1369
E01033517,829,89,162,30,1110
E01033519,890,130,195,117,1332
E01033520,867,186,173,70,1296
E01033522,688,67,139,106,1000
E01033523,643,41,227,124,1035
E01033525,662,87,220,234,1203
E01033526,141,325,243,194,903
E01033527,198,637,195,70,1100
E01033528,1111,512,240,150,2013
E01033529,279,495,88,14,876
E01033530,481,623,381,151,1636
E01033531,827,116,221,52,1216
E01033532,704,175,174,7,1060
E01033533,739,263,136,51,1189
E01033534,529,71,214,10,824
E01033535,758,220,126,28,1132
E01033536,664,289,235,62,1250
E01033537,584,412,252,73,1321
E01033538,998,128,324,156,1606
E01033539,415,331,275,93,1114
E01033540,471,472,108,202,1253
E01033541,315,441,289,122,1167
E01033542,899,751,389,99,2138
E01033543,107,54,887,124,1172
E01033545,155,64,639,248,1106
E01033547,237,200,157,1003,1597
E01033548,162,110,395,352,1019
E01033550,973,252,195,19,1439
E01033551,660,636,145,22,1463
E01033553,56,43,878,259,1236
E01033554,185,89,660,281,1215
E01033556,258,265,1345,354,2222
E01033557,220,105,899,77,1301
E01033559,177,49,801,168,1195
E01033561,37,28,272,545,882
E01033562,360,407,903,416,2086
E01033564,176,78,811,82,1147
E01033565,228,46,659,61,994
E01033567,135,62,856,74,1127
E01033568,294,95,643,149,1181
E01033569,395,208,561,107,1271
E01033570,383,116,505,204,1208
E01033571,400,357,178,261,1196
E01033572,437,353,453,62,1305
E01033573,302,42,456,176,976
E01033574,200,37,756,26,1019
E01033575,132,14,779,42,967
E01033576,287,77,486,276,1126
E01033577,215,63,641,293,1212
E01033578,137,22,713,214,1086
E01033579,160,29,746,219,1154
E01033580,344,78,868,60,1350
E01033581,273,89,467,544,1373
E01033582,321,41,774,30,1166
E01033583,456,206,1213,691,2566
E01033584,188,56,209,711,1164
E01033585,229,96,695,934,1954
E01033586,199,63,387,476,1125
E01033587,257,39,411,404,1111
E01033588,224,48,299,493,1064
E01033589,177,42,935,127,1281
E01033590,300,74,287,142,803
E01033591,401,233,616,161,1411
E01033592,728,341,283,98,1450
E01033593,118,138,489,175,920
E01033594,118,130,566,333,1147
E01033595,69,75,627,337,1108
E01033596,89,103,424,469,1085
E01033597,91,88,292,399,870
E01033598,85,71,206,583,945
E01033599,131,41,146,787,1105
E01033600,206,215,467,190,1078
E01033601,145,118,176,757,1196
E01033602,104,83,235,775,1197
E01033603,120,120,406,381,1027
E01033604,41,47,629,318,1035
E01033605,201,182,346,811,1540
E01033606,116,118,507,224,965
E01033607,143,187,324,384,1038
E01033608,254,150,622,187,1213
E01033609,811,534,278,218,1841
E01033610,805,59,251,11,1126
E01033611,661,73,463,14,1211
E01033612,789,162,214,28,1193
E01033613,746,131,236,13,1126
E01033614,937,202,165,6,1310
E01033615,108,27,784,49,968
E01033616,60,36,384,485,965
E01033617,41,39,603,131,814
E01033618,209,95,805,22,1131
E01033619,269,77,533,131,1010
E01033620,73,21,814,84,992
E01033621,448,656,460,523,2087
E01033622,228,64,982,173,1447
E01033623,141,46,654,245,1086
E01033624,183,51,311,255,800
E01033625,213,122,1276,26,1637
E01033626,149,46,427,279,901
E01033627,110,99,320,363,892
E01033628,284,459,265,659,1667
E01033629,521,403,233,741,1898
E01033630,262,23,381,267,933
E01033631,601,509,603,97,1810
E01033632,535,417,247,516,1715
E01033633,621,261,127,786,1795
E01033634,53,50,2826,206,3135
E01033635,586,651,607,271,2115
E01033636,637,875,470,328,2310
E01033637,575,426,252,681,1934
E01033638,197,114,171,684,1166
E01033639,136,93,514,646,1389
E01033640,71,37,171,641,920
E01033641,838,651,543,159,2191
E01033642,778,646,424,197,2045
E01033643,509,711,399,443,2062
E01033644,439,672,355,551,2017
E01033645,652,814,590,377,2433
E01033646,285,167,470,335,1257
E01033647,364,185,172,139,860
E01033648,276,705,441,491,1913
E01033649,353,319,203,204,1079
E01033650,406,659,319,340,1724
E01033651,44,38,960,59,1101
E01033652,58,51,474,246,829
E01033653,303,146,997,191,1637
E01033654,135,58,840,79,1112
E01033655,85,38,1009,27,1159
E01033656,71,57,1122,121,1371
E01033657,75,27,487,255,844
E01033658,215,83,718,38,1054
E01033659,251,54,980,15,1300
E01033660,178,35,927,13,1153
E01033661,185,48,746,161,1140
E01033662,239,105,800,171,1315
E01033663,202,39,679,206,1126
E01033664,169,39,790,19,1017
E01033665,110,101,756,182,1149
E01033666,679,459,461,442,2041
E01033667,244,52,547,128,971
E01033668,162,31,567,201,961
E01033669,202,85,248,581,1116
E01033670,372,56,694,10,1132
E01033671,554,204,731,25,1514
E01033672,114,57,352,533,1056
E01033673,183,37,859,10,1089
E01033674,192,44,680,239,1155
E01033675,351,133,556,423,1463
E01033676,159,108,178,794,1239
E01033677,179,111,832,20,1142
E01033678,192,79,213,678,1162
E01033679,117,29,158,729,1033
E01033680,153,45,693,180,1071
E01033681,269,125,934,9,1337
E01033682,296,158,771,16,1241
E01033683,179,59,966,14,1218
E01033684,89,17,1055,19,1180
E01033685,570,168,266,162,1166
E01033686,230,138,393,254,1015
E01033687,279,126,211,585,1201
E01033688,165,108,159,735,1167
E01033689,113,62,650,235,1060
E01033690,62,33,880,61,1036
E01033691,165,261,396,360,1182
E01033692,96,26,529,268,919
E01033693,338,449,489,335,1611
E01033694,339,210,303,32,884
E01033695,858,166,240,144,1408
E01033696,605,327,188,83,1203
E01033697,856,656,380,44,1936
E01033698,76,28,275,658,1037
E01033699,151,81,628,236,1096
E01033700,222,78,763,272,1335
E01033701,101,52,312,996,1461
E01033702,172,38,266,369,845
E01033703,202,48,509,402,1161
E01033704,415,42,668,261,1386
E01033705,140,47,314,529,1030
E01033706,182,70,936,228,1416
E01033707,66,36,587,470,1159
E01033708,171,93,1101,75,1440
E01033709,123,31,511,698,1363
E01033710,121,28,530,189,868
E01033711,149,47,500,178,874
E01033712,198,78,496,511,1283
E01033713,258,75,409,331,1073
E01033714,724,1041,197,27,1989
E01033715,193,224,213,270,900
E01033716,627,530,185,602,1944
E01033717,472,404,142,114,1132
E01033718,577,521,148,484,1730
E01033719,134,36,756,92,1018
E01033720,786,143,356,180,1465
E01033721,838,138,213,50,1239
E01033722,191,184,615,350,1340
E01033723,144,59,1157,297,1657
E01033724,702,500,864,261,2327
E01033725,530,375,703,344,1952
E01033726,549,250,135,859,1793
E01033727,279,58,372,718,1427
E01033728,358,97,534,91,1080
E01033729,327,240,189,691,1447
E01033730,225,26,440,343,1034
E01033731,316,30,246,284,876
E01033732,252,35,349,213,849
E01033733,303,75,554,38,970
E01033734,408,29,347,238,1022
E01033735,60,19,555,262,896
E01033736,284,33,628,63,1008
E01033737,147,55,311,590,1103
E01033738,300,157,476,107,1040
E01033739,305,45,503,197,1050
E01033740,423,80,435,153,1091
E01033741,488,72,383,191,1134
E01033742,363,34,576,128,1101
E01033743,487,40,449,326,1302
E01033744,387,80,389,414,1270
E01033745,560,80,343,237,1220
E01033746,385,197,318,328,1228
E01033747,111,69,153,481,814
E01033748,272,99,788,28,1187
E01033749,58,50,767,243,1118
E01033750,220,123,996,34,1373
E01033751,187,118,424,213,942
E01033752,110,39,997,14,1160
E01033753,88,23,900,12,1023
E01033754,137,86,860,276,1359
E01033755,164,46,818,20,1048
E01033756,129,136,749,84,1098
E01033757,32,23,480,426,961
E01033758,22,20,335,281,658
E01033759,277,143,120,346,886
E01033760,72,26,630,114,842
E01033761,141,30,1072,77,1320
E01033762,45,31,458,170,704
E01033763,85,144,427,688,1344
E01033764,217,206,300,1113,1836
E01033765,208,108,217,547,1080
E01033766,263,194,456,45,958
E01033767,140,211,268,260,879
E01033768,85,38,307,696,1126
S01006506,328,216,138,65,747
S01006507,263,228,42,161,694
S01006508,330,130,64,26,550
S01006509,247,94,46,90,477
S01006510,214,166,42,125,547
S01006511,291,245,41,54,631
S01006512,172,116,63,7,358
S01006513,253,216,54,4,527
S01006514,384,267,140,16,807
S01006515,256,210,82,18,566
S01006516,144,221,74,11,450
S01006517,341,348,70,47,806
S01006518,175,286,50,2,513
S01006519,329,290,46,8,673
S01006520,209,152,142,1,504
S01006521,225,182,96,7,510
S01006522,222,173,37,5,437
S01006523,340,315,98,12,765
S01006524,243,336,172,19,770
S01006525,281,273,64,30,648
S01006526,219,124,142,298,783
S01006527,126,107,95,229,557
S01006528,252,175,206,242,875
S01006529,213,114,312,149,788
S01006530,181,136,116,236,669
S01006531,178,118,159,354,809
S01006532,276,230,127,9,642
S01006533,288,241,61,2,592
S01006534,363,261,93,9,726
S01006535,420,199,270,21,910
S01006536,368,186,337,27,918
S01006537,265,314,43,14,636
S01006538,247,210,15,7,479
S01006539,290,266,51,16,623
S01006540,388,281,141,13,823
S01006541,323,241,47,67,678
S01006542,293,426,143,10,872
S01006543,326,313,27,10,676
S01006544,397,266,243,22,928
S01006545,352,365,172,45,934
S01006546,236,257,32,0,525
S01006547,256,255,83,174,768
S01006548,265,316,33,2,616
S01006549,252,329,96,20,697
S01006550,318,423,76,1,818
S01006551,160,134,58,238,590
S01006552,347,288,106,11,752
S01006553,266,254,51,153,724
S01006554,255,172,55,131,613
S01006555,247,79,98,229,653
S01006556,240,124,59,282,705
S01006557,192,69,43,275,579
S01006558,226,174,155,6,561
S01006559,208,152,136,15,511
S01006560,385,277,141,42,845
S01006561,284,244,70,16,614
S01006562,232,207,50,117,606
S01006563,263,223,150,34,670
S01006564,206,129,262,292,889
S01006565,241,118,411,181,951
S01006566,222,160,276,25,683
S01006567,183,72,320,212,787
S01006568,296,108,448,22,874
S01006569,178,105,173,37,493
S01006570,258,171,215,11,655
S01006571,324,193,198,32,747
S01006572,318,287,103,7,715
S01006573,266,181,113,4,564
S01006574,318,293,181,15,807
S01006575,354,222,182,9,767
S01006576,277,138,152,7,574
S01006577,240,164,261,15,680
S01006578,337,155,468,62,1022
S01006579,262,103,524,23,912
S01006580,240,143,238,20,641
S01006581,333,301,100,9,743
S01006582,169,75,469,102,815
S01006583,190,49,416,21,676
S01006584,187,81,284,19,571
S01006585,120,112,252,248,732
S01006586,179,112,434,265,990
S01006587,85,16,273,128,502
S01006588,88,31,369,62,550
S01006589,108,23,325,173,629
S01006590,187,82,346,39,654
S01006591,202,89,322,38,651
S01006592,261,94,240,10,605
S01006593,278,122,300,5,705
S01006594,126,102,211,67,506
S01006595,249,133,421,48,851
S01006596,236,144,228,30,638
S01006597,168,66,237,24,495
S01006598,333,265,201,4,803
S01006599,213,137,224,175,749
S01006600,384,210,237,145,976
S01006601,356,224,205,113,898
S01006602,325,258,143,9,735
S01006603,218,135,48,302,703
S01006604,237,173,35,140,585
S01006605,205,105,37,309,656
S01006606,284,280,61,104,729
S01006607,333,183,30,221,767
S01006608,270,222,59,45,596
S01006609,328,205,51,300,884
S01006610,110,116,23,136,385
S01006611,274,175,44,277,770
S01006612,403,186,34,116,739
S01006613,336,108,45,2,491
S01006614,394,60,29,6,489
S01006615,437,77,35,12,561
S01006616,471,124,54,15,664
S01006617,315,188,24,45,572
S01006618,264,177,23,2,466
S01006619,416,238,34,54,742
S01006620,409,192,54,81,736
S01006621,268,109,13,36,426
S01006622,408,67,66,6,547
S01006623,263,147,83,175,668
S01006624,236,154,307,192,889
S01006625,201,109,99,136,545
S01006626,136,85,75,316,612
S01006627,187,91,254,239,771
S01006628,221,70,484,200,975
S01006629,118,75,38,417,648
S01006630,147,70,17,253,487
S01006631,201,117,97,388,803
S01006632,91,62,72,431,656
S01006633,101,51,46,329,527
S01006634,48,16,24,375,463
S01006635,139,92,39,249,519
S01006636,43,28,27,541,639
S01006637,150,109,247,191,697
S01006638,187,87,351,167,792
S01006639,157,73,367,301,898
S01006640,180,33,420,50,683
S01006641,225,75,506,172,978
S01006642,317,128,685,200,1330
S01006643,172,71,430,33,706
S01006644,208,47,453,206,914
S01006645,48,52,85,389,574
S01006646,119,58,590,210,977
S01006647,46,77,168,257,548
S01006648,282,117,919,410,1728
S01006649,176,50,399,266,891
S01006650,209,94,409,99,811
S01006651,98,52,296,164,610
S01006652,135,30,276,73,514
S01006653,169,101,213,28,511
S01006654,173,118,154,351,796
S01006655,238,127,209,75,649
S01006656,218,71,390,177,856
S01006657,100,44,205,130,479
S01006658,114,43,363,356,876
S01006659,149,119,293,31,592
S01006660,62,20,176,165,423
S01006661,130,142,279,36,587
S01006662,107,44,193,393,737
S01006663,75,65,358,22,520
S01006664,95,71,265,39,470
S01006665,143,89,392,54,678
S01006666,45,32,49,615,741
S01006667,24,30,113,484,651
S01006668,219,103,388,147,857
S01006669,133,133,423,470,1159
S01006670,192,112,377,219,900
S01006671,374,389,947,643,2353
S01006672,95,52,159,377,683
S01006673,117,69,167,405,758
S01006674,17,62,55,642,776
S01006675,31,5,24,468,528
S01006676,64,51,109,379,603
S01006677,104,78,97,340,619
S01006678,145,88,68,632,933
S01006679,208,220,81,70,579
S01006680,47,41,40,538,666
S01006681,236,92,110,325,763
S01006682,68,32,60,500,660
S01006683,110,39,132,414,695
S01006684,97,51,110,345,603
S01006685,176,56,92,312,636
S01006686,176,86,78,179,519
S01006687,221,141,134,220,716
S01006688,255,275,89,229,848
S01006689,269,138,126,11,544
S01006690,192,126,139,75,532
S01006691,200,104,154,38,496
S01006692,266,216,129,56,667
S01006693,279,124,224,204,831
S01006694,133,83,38,480,734
S01006695,232,176,51,147,606
S01006696,203,97,111,282,693
S01006697,243,143,80,304,770
S01006698,118,60,99,329,606
S01006699,159,123,80,46,408
S01006700,197,205,138,212,752
S01006701,170,70,20,292,552
S01006702,282,158,25,168,633
S01006703,191,71,31,227,520
S01006704,119,54,15,292,480
S01006705,193,147,33,251,624
S01006706,207,59,24,203,493
S01006707,141,87,28,286,542
S01006708,276,136,34,220,666
S01006709,216,97,47,316,676
S01006710,327,170,20,234,751
S01006711,335,122,40,309,806
S01006712,199,116,19,119,453
S01006713,256,150,38,342,786
S01006714,228,132,37,189,586
S01006715,109,45,18,265,437
S01006716,171,68,13,241,493
S01006717,298,148,28,343,817
S01006718,168,98,31,220,517
S01006719,309,100,37,277,723
S01006720,205,66,39,165,475
S01006721,271,128,24,311,734
S01006722,238,119,38,223,618
S01006723,223,107,40,181,551
S01006724,112,23,34,516,685
S01006725,194,68,25,242,529
S01006726,89,31,61,802,983
S01006727,86,37,33,625,781
S01006728,198,96,17,274,585
S01006729,126,53,36,422,637
S01006730,287,103,15,171,576
S01006731,165,94,9,213,481
S01006732,422,233,140,61,856
S01006733,409,172,50,12,643
S01006734,506,140,103,5,754
S01006735,197,217,72,13,499
S01006736,539,130,70,31,770
S01006737,246,194,74,28,542
S01006738,297,120,154,142,713
S01006739,281,101,134,11,527
S01006740,280,152,31,171,634
S01006741,196,203,36,159,594
S01006742,162,95,20,109,386
S01006743,194,137,62,86,479
S01006744,246,129,49,99,523
S01006745,237,152,55,261,705
S01006746,271,177,37,226,711
S01006747,260,379,67,20,726
S01006748,354,265,74,78,771
S01006749,374,193,51,153,771
S01006750,294,190,30,111,625
S01006751,166,101,38,130,435
S01006752,237,179,29,149,594
S01006753,337,322,51,67,777
S01006754,341,384,54,28,807
S01006755,305,134,97,36,572
S01006756,402,67,137,8,614
S01006757,477,191,73,7,748
S01006758,350,214,33,0,597
S01006759,254,191,30,14,489
S01006760,264,111,44,0,419
S01006761,342,240,39,5,626
S01006762,230,302,95,90,717
S01006763,474,101,87,3,665
S01006764,434,159,67,4,664
S01006765,319,133,44,2,498
S01006766,305,166,23,9,503
S01006767,312,187,35,55,589
S01006768,319,179,5,2,505
S01006769,466,225,33,67,791
S01006770,298,246,17,4,565
S01006771,243,104,26,2,375
S01006772,398,273,46,9,726
S01006773,367,195,31,9,602
S01006774,302,216,14,5,537
S01006775,278,104,41,124,547
S01006776,136,102,36,170,444
S01006777,261,264,20,6,551
S01006778,282,226,16,40,564
S01006779,211,119,32,163,525
S01006780,232,159,30,75,496
S01006781,255,293,38,19,605
S01006782,328,171,80,43,622
S01006783,202,278,19,84,583
S01006784,247,206,92,0,545
S01006785,324,131,31,7,493
S01006786,402,204,40,25,671
S01006787,271,196,57,42,566
S01006788,433,138,83,6,660
S01006789,171,230,125,25,551
S01006790,211,264,90,199,764
S01006791,85,128,204,26,443
S01006792,53,115,239,6,413
S01006793,105,164,153,54,476
S01006794,194,177,27,99,497
S01006795,220,239,73,53,585
S01006796,171,133,81,50,435
S01006797,150,127,208,13,498
S01006798,136,172,175,7,490
S01006799,317,194,63,169,743
S01006800,269,298,111,6,684
S01006801,386,255,149,4,794
S01006802,163,132,199,60,554
S01006803,221,134,61,153,569
S01006804,333,110,45,88,576
S01006805,379,255,146,112,892
S01006806,398,256,157,37,848
S01006807,260,110,102,10,482
S01006808,264,183,45,14,506
S01006809,248,154,62,190,654
S01006810,311,187,70,134,702
S01006811,403,217,126,93,839
S01006812,310,127,80,81,598
S01006813,334,121,46,124,625
S01006814,395,187,30,11,623
S01006815,178,105,18,182,483
S01006816,320,157,30,76,583
S01006817,221,124,79,92,516
S01006818,297,188,58,35,578
S01006819,322,205,107,20,654
S01006820,222,122,28,9,381
S01006821,189,186,99,8,482
S01006822,272,203,124,8,607
S01006823,264,258,77,11,610
S01006824,232,99,32,287,650
S01006825,368,211,35,62,676
S01006826,413,232,55,83,783
S01006827,295,161,59,218,733
S01006828,305,227,137,129,798
S01006829,236,42,10,0,288
S01006830,278,186,22,139,625
S01006831,215,197,35,3,450
S01006832,360,342,83,74,859
S01006833,161,166,36,7,370
S01006834,241,64,38,31,374
S01006835,211,211,173,147,742
S01006836,240,41,44,44,369
S01006837,255,141,19,49,464
S01006838,355,89,20,44,508
S01006839,392,284,74,112,862
S01006840,517,242,23,9,791
S01006841,492,161,48,26,727
S01006842,407,240,21,10,678
S01006843,483,153,24,7,667
S01006844,371,173,36,5,585
S01006845,540,185,46,6,777
S01006846,289,127,19,36,471
S01006847,414,132,36,0,582
S01006848,343,260,161,21,785
S01006849,485,59,46,108,698
S01006850,464,135,38,128,765
S01006851,362,110,23,154,649
S01006852,252,186,42,9,489
S01006853,302,203,155,4,664
S01006854,291,240,54,120,705
S01006855,259,221,122,18,620
S01006856,191,143,180,2,516
S01006857,279,219,282,28,808
S01006858,230,215,67,4,516
S01006859,431,355,73,0,859
S01006860,147,110,54,151,462
S01006861,287,61,59,4,411
S01006862,251,183,45,94,573
S01006863,268,158,54,77,557
S01006864,126,33,36,114,309
S01006865,311,293,174,23,801
S01006866,188,217,40,9,454
S01006867,223,312,52,25,612
S01006868,289,199,54,166,708
S01006869,145,97,134,27,403
S01006870,175,153,42,24,394
S01006871,280,173,27,89,569
S01006872,214,188,133,1,536
S01006873,253,354,201,23,831
S01006874,158,173,144,13,488
S01006875,183,177,70,137,567
S01006876,351,270,91,81,793
S01006877,326,264,173,15,778
S01006878,195,180,147,63,585
S01006879,165,208,274,10,657
S01006880,258,134,59,17,468
S01006881,186,187,80,6,459
S01006882,118,80,23,113,334
S01006883,170,114,52,43,379
S01006884,352,261,50,62,725
S01006885,206,188,38,13,445
S01006886,205,227,143,40,615
S01006887,226,124,44,37,431
S01006888,317,208,60,38,623
S01006889,233,126,23,274,656
S01006890,296,166,17,39,518
S01006891,378,219,42,156,795
S01006892,207,66,13,205,491
S01006893,159,98,13,145,415
S01006894,359,284,32,143,818
S01006895,168,102,63,115,448
S01006896,255,266,72,86,679
S01006897,354,180,33,34,601
S01006898,262,207,39,103,611
S01006899,323,126,28,11,488
S01006900,322,123,49,8,502
S01006901,208,93,34,179,514
S01006902,221,95,50,172,538
S01006903,279,126,39,227,671
S01006904,191,174,132,106,603
S01006905,317,284,42,119,762
S01006906,204,168,46,311,729
S01006907,176,128,153,75,532
S01006908,208,219,129,155,711
S01006909,395,137,38,6,576
S01006910,349,236,101,13,699
S01006911,336,34,16,63,449
S01006912,125,168,76,6,375
S01006913,262,76,43,3,384
S01006914,236,221,120,11,588
S01006915,311,235,58,34,638
S01006916,209,62,34,90,395
S01006917,511,58,23,49,641
S01006918,195,108,27,44,374
S01006919,173,180,31,32,416
S01006920,175,109,36,86,406
S01006921,425,91,31,10,557
S01006922,167,167,67,4,405
S01006923,279,303,41,42,665
S01006924,206,166,63,1,436
S01006925,194,159,25,30,408
S01006926,366,110,38,21,535
S01006927,539,43,81,43,706
S01006928,411,220,142,50,823
S01006929,360,236,45,4,645
S01006930,419,318,20,3,760
S01006931,119,81,113,4,317
S01006932,282,55,22,73,432
S01006933,324,138,15,2,479
S01006934,200,178,107,40,525
S01006935,291,271,28,6,596
S01006936,263,188,31,37,519
S01006937,328,220,53,10,611
S01006938,232,131,39,51,453
S01006939,309,176,19,5,509
S01006940,460,243,69,13,785
S01006941,300,143,18,28,489
S01006942,530,239,51,20,840
S01006943,327,78,34,1,440
S01006944,404,56,78,81,619
S01006945,254,147,19,5,425
S01006946,377,205,55,12,649
S01006947,429,67,58,64,618
S01006948,331,272,60,67,730
S01006949,295,171,28,9,503
S01006950,255,13,36,75,379
S01006951,194,147,14,27,382
S01006952,286,300,80,43,709
S01006953,395,193,30,9,627
S01006954,350,269,33,11,663
S01006955,262,59,45,117,483
S01006956,565,124,56,69,814
S01006957,505,231,92,17,845
S01006958,345,372,61,10,788
S01006959,183,184,63,193,623
S01006960,512,93,24,45,674
S01006961,575,52,41,2,670
S01006962,361,342,68,4,775
S01006963,313,206,47,5,571
S01006964,329,198,104,5,636
S01006965,200,170,33,29,432
S01006966,247,78,32,129,486
S01006967,349,137,19,0,505
S01006968,207,124,37,64,432
S01006969,417,262,76,69,824
S01006970,296,197,55,19,567
S01006971,147,122,24,158,451
S01006972,182,180,49,9,420
S01006973,188,199,28,45,460
S01006974,496,200,47,69,812
S01006975,411,245,100,19,775
S01006976,169,150,53,0,372
S01006977,283,139,209,19,650
S01006978,309,219,100,88,716
S01006979,291,232,82,92,697
S01006980,316,232,125,12,685
S01006981,283,211,89,65,648
S01006982,422,120,49,90,681
S01006983,333,147,71,28,579
S01006984,291,162,91,19,563
S01006985,368,277,46,145,836
S01006986,310,96,51,55,512
S01006987,221,171,52,100,544
S01006988,255,76,45,77,453
S01006989,405,306,61,20,792
S01006990,421,107,96,31,655
S01006991,105,134,35,96,370
S01006992,252,184,60,3,499
S01006993,198,157,67,9,431
S01006994,212,173,90,18,493
S01006995,313,201,127,30,671
S01006996,341,129,23,108,601
S01006997,387,146,42,26,601
S01006998,444,297,107,49,897
S01006999,311,248,150,13,722
S01007000,404,179,33,148,764
S01007001,366,241,70,95,772
S01007002,169,112,84,84,449
S01007003,141,177,85,20,423
S01007004,221,248,97,21,587
S01007005,323,267,112,25,727
S01007006,278,217,128,110,733
S01007007,244,248,126,53,671
S01007008,313,207,67,281,868
S01007009,305,312,95,159,871
S01007010,218,305,101,94,718
S01007011,191,184,97,255,727
S01007012,122,136,40,271,569
S01007013,173,225,51,7,456
S01007014,437,227,123,16,803
S01007015,196,134,138,35,503
S01007016,232,138,86,20,476
S01007017,339,188,63,237,827
S01007018,394,258,48,92,792
S01007019,196,190,85,100,571
S01007020,249,195,118,110,672
S01007021,322,254,70,126,772
S01007022,131,125,21,112,389
S01007023,122,116,103,51,392
S01007024,288,376,133,78,875
S01007025,192,195,52,267,706
S01007026,275,354,44,99,772
S01007027,330,315,83,150,878
S01007028,204,245,115,47,611
S01007029,192,225,26,13,456
S01007030,201,236,47,177,661
S01007031,170,145,68,132,515
S01007032,256,223,156,197,832
S01007033,215,166,32,188,601
S01007034,183,132,47,130,492
S01007035,160,160,37,284,641
S01007036,297,309,58,134,798
S01007037,330,213,38,248,829
S01007038,246,172,68,125,611
S01007039,284,183,23,193,683
S01007040,156,177,31,171,535
S01007041,247,208,29,142,626
S01007042,258,191,60,87,596
S01007043,246,370,198,19,833
S01007044,216,241,78,44,579
S01007045,268,320,83,10,681
S01007046,214,223,48,22,507
S01007047,230,258,42,18,548
S01007048,326,333,74,41,774
S01007049,261,217,57,230,765
S01007050,234,204,50,57,545
S01007051,284,178,52,98,612
S01007052,225,171,42,33,471
S01007053,202,156,42,0,400
S01007054,304,276,89,131,800
S01007055,181,181,54,4,420
S01007056,208,233,69,16,526
S01007057,168,230,16,43,457
S01007058,182,175,13,131,501
S01007059,353,241,76,141,811
S01007060,177,92,16,199,484
S01007061,390,237,103,7,737
S01007062,263,230,58,12,563
S01007063,273,170,47,57,547
S01007064,208,198,62,58,526
S01007065,200,201,35,36,472
S01007066,268,179,65,23,535
S01007067,250,201,27,9,487
S01007068,241,158,45,180,624
S01007069,282,149,88,123,642
S01007070,191,109,21,106,427
S01007071,344,178,18,146,686
S01007072,284,166,33,28,511
S01007073,459,348,28,66,901
S01007074,213,152,19,163,547
S01007075,221,125,55,182,583
S01007076,293,140,33,131,597
S01007077,236,230,37,89,592
S01007078,214,249,57,195,715
S01007079,298,228,95,235,856
S01007080,214,186,60,208,668
S01007081,236,136,110,250,732
S01007082,164,89,74,111,438
S01007083,118,154,129,390,791
S01007084,216,212,68,59,555
S01007085,223,167,196,96,682
S01007086,121,105,249,440,915
S01007087,161,117,228,245,751
S01007088,102,53,69,211,435
S01007089,215,173,26,7,421
S01007090,264,116,60,8,448
S01007091,279,46,20,240,585
S01007092,187,135,22,191,535
S01007093,430,339,60,23,852
S01007094,318,337,56,46,757
S01007095,238,151,49,7,445
S01007096,405,142,43,53,643
S01007097,234,112,42,6,394
S01007098,331,255,48,4,638
S01007099,416,189,32,55,692
S01007100,250,228,49,72,599
S01007101,226,147,50,281,704
S01007102,237,242,97,12,588
S01007103,243,301,15,117,676
S01007104,154,170,69,3,396
S01007105,184,182,30,49,445
S01007106,238,257,42,77,614
S01007107,272,218,38,13,541
S01007108,200,193,56,17,466
S01007109,185,163,50,268,666
S01007110,247,145,44,171,607
S01007111,203,150,17,62,432
S01007112,204,218,32,20,474
S01007113,175,217,67,27,486
S01007114,344,293,31,75,743
S01007115,286,206,23,67,582
S01007116,462,232,24,13,731
S01007117,159,197,20,20,396
S01007118,147,59,53,270,529
S01007119,187,117,39,312,655
S01007120,270,132,155,347,904
S01007121,130,69,111,155,465
S01007122,166,163,58,117,504
S01007123,205,169,52,137,563
S01007124,306,234,54,153,747
S01007125,164,193,77,240,674
S01007126,113,81,82,446,722
S01007127,142,109,272,309,832
S01007128,219,139,58,278,694
S01007129,421,230,71,16,738
S01007130,264,196,42,26,528
S01007131,352,206,49,46,653
S01007132,302,246,28,11,587
S01007133,289,173,76,14,552
S01007134,294,184,83,48,609
S01007135,234,163,28,9,434
S01007136,231,110,61,0,402
S01007137,423,49,35,10,517
S01007138,259,159,49,7,474
S01007139,307,213,70,35,625
S01007140,374,254,126,70,824
S01007141,292,168,61,18,539
S01007142,360,62,28,2,452
S01007143,356,48,24,5,433
S01007144,213,192,185,21,611
S01007145,330,325,44,72,771
S01007146,282,205,58,59,604
S01007147,323,233,29,20,605
S01007148,254,159,19,10,442
S01007149,228,218,14,10,470
S01007150,233,396,47,18,694
S01007151,425,245,37,5,712
S01007152,242,185,27,20,474
S01007153,275,180,27,43,525
S01007154,278,218,108,107,711
S01007155,264,185,47,43,539
S01007156,293,188,69,57,607
S01007157,246,85,55,115,501
S01007158,467,156,61,55,739
S01007159,287,160,67,172,686
S01007160,272,173,58,171,674
S01007161,251,177,82,64,574
S01007162,105,75,111,129,420
S01007163,302,276,48,117,743
S01007164,208,199,66,28,501
S01007165,337,246,102,20,705
S01007166,248,190,76,46,560
S01007167,344,292,31,11,678
S01007168,415,385,36,4,840
S01007169,332,192,35,75,634
S01007170,219,175,124,21,539
S01007171,247,229,247,17,740
S01007172,275,281,131,12,699
S01007173,448,133,51,36,668
S01007174,391,107,36,146,680
S01007175,206,191,95,55,547
S01007176,184,149,140,83,556
S01007177,166,109,36,195,506
S01007178,178,118,83,456,835
S01007179,376,428,34,31,869
S01007180,240,309,23,60,632
S01007181,324,291,55,32,702
S01007182,343,307,125,130,905
S01007183,376,229,114,218,937
S01007184,336,198,164,215,913
S01007185,170,91,102,326,689
S01007186,107,54,90,240,491
S01007187,160,95,196,254,705
S01007188,153,120,128,112,513
S01007189,195,149,83,281,708
S01007190,301,237,58,113,709
S01007191,180,112,81,136,509
S01007192,163,101,31,204,499
S01007193,286,92,35,193,606
S01007194,92,61,70,239,462
S01007195,115,84,29,205,433
S01007196,208,47,45,237,537
S01007197,60,24,39,332,455
S01007198,105,59,25,210,399
S01007199,141,67,44,347,599
S01007200,329,153,60,171,713
S01007201,222,185,34,182,623
S01007202,193,181,40,202,616
S01007203,288,116,33,80,517
S01007204,307,223,159,134,823
S01007205,222,174,156,29,581
S01007206,104,106,69,50,329
S01007207,298,254,69,131,752
S01007208,226,113,197,270,806
S01007209,175,177,208,108,668
S01007210,193,87,95,250,625
S01007211,221,147,79,356,803
S01007212,170,157,83,44,454
S01007213,271,285,129,103,788
S01007214,158,124,77,295,654
S01007215,214,151,121,162,648
S01007216,270,220,60,64,614
S01007217,275,167,85,258,785
S01007218,331,317,51,21,720
S01007219,288,124,47,214,673
S01007220,271,105,45,134,555
S01007221,279,153,36,55,523
S01007222,196,196,67,179,638
S01007223,237,118,52,7,414
S01007224,194,173,47,75,489
S01007225,308,235,141,36,720
S01007226,256,244,150,18,668
S01007227,371,234,69,104,778
S01007228,181,141,165,29,516
S01007229,318,242,328,24,912
S01007230,151,57,34,343,585
S01007231,159,74,103,238,574
S01007232,112,59,86,342,599
S01007233,243,178,79,145,645
S01007234,177,130,83,113,503
S01007235,197,143,186,131,657
S01007236,242,115,70,92,519
S01007237,290,230,50,37,607
S01007238,335,190,56,196,777
S01007239,316,311,72,44,743
S01007240,127,145,174,15,461
S01007241,213,204,80,7,504
S01007242,395,280,82,74,831
S01007243,249,176,38,38,501
S01007244,200,263,127,28,618
S01007245,203,183,98,96,580
S01007246,181,163,82,46,472
S01007247,177,116,191,43,527
S01007248,303,292,29,17,641
S01007249,119,161,40,50,370
S01007250,267,184,118,145,714
S01007251,158,67,48,147,420
S01007252,260,172,69,139,640
S01007253,308,272,58,48,686
S01007254,210,105,101,261,677
S01007255,146,71,52,342,611
S01007256,193,109,131,212,645
S01007257,123,77,104,180,484
S01007258,250,174,94,213,731
S01007259,230,148,101,241,720
S01007260,242,100,41,335,718
S01007261,297,270,28,85,680
S01007262,262,144,41,137,584
S01007263,242,201,40,168,651
S01007264,284,212,28,137,661
S01007265,385,169,68,277,899
S01007266,209,146,93,119,567
S01007267,106,132,172,27,437
S01007268,126,173,187,8,494
S01007269,195,154,49,39,437
S01007270,106,108,148,20,382
S01007271,360,295,96,82,833
S01007272,171,111,39,349,670
S01007273,206,161,58,121,546
S01007274,239,167,147,162,715
S01007275,200,189,26,83,498
S01007276,295,193,58,130,676
S01007277,307,246,28,53,634
S01007278,251,168,23,6,448
S01007279,121,205,124,14,464
S01007280,105,103,209,25,442
S01007281,313,249,218,23,803
S01007282,113,83,199,39,434
S01007283,301,293,121,150,865
S01007284,171,333,95,101,700
S01007285,232,292,134,63,721
S01007286,243,263,145,134,785
S01007287,133,202,114,72,521
S01007288,133,191,127,34,485
S01007289,306,288,57,21,672
S01007290,169,38,52,254,513
S01007291,201,126,100,154,581
S01007292,323,200,45,63,631
S01007293,204,74,35,262,575
S01007294,361,192,61,129,743
S01007295,74,24,56,276,430
S01007296,112,122,175,108,517
S01007297,312,262,175,32,781
S01007298,171,126,51,87,435
S01007299,255,168,140,169,732
S01007300,144,72,30,163,409
S01007301,222,252,111,38,623
S01007302,224,107,44,135,510
S01007303,296,309,118,54,777
S01007304,143,260,133,46,582
S01007305,231,227,74,75,607
S01007306,231,194,67,118,610
S01007307,267,252,126,16,661
S01007308,185,290,142,67,684
S01007309,157,213,101,78,549
S01007310,176,315,128,65,684
S01007311,217,139,148,147,651
S01007312,220,257,87,60,624
S01007313,279,380,124,40,823
S01007314,248,158,65,54,525
S01007315,377,210,70,121,778
S01007316,223,191,67,250,731
S01007317,233,128,58,109,528
S01007318,183,91,39,159,472
S01007319,214,215,83,118,630
S01007320,171,278,167,22,638
S01007321,143,260,100,23,526
S01007322,178,224,60,170,632
S01007323,146,139,43,63,391
S01007324,49,117,79,43,288
S01007325,149,294,139,100,682
S01007326,141,248,199,69,657
S01007327,179,195,86,194,654
S01007328,207,179,66,259,711
S01007329,121,206,135,105,567
S01007330,163,349,75,100,687
S01007331,290,284,89,151,814
S01007332,134,227,37,35,433
S01007333,276,257,48,105,686
S01007334,90,76,55,368,589
S01007335,180,152,41,293,666
S01007336,115,88,157,96,456
S01007337,169,149,66,177,561
S01007338,216,200,8,179,603
S01007339,174,222,32,96,524
S01007340,99,139,57,107,402
S01007341,215,314,77,47,653
S01007342,270,373,69,9,721
S01007343,115,192,227,33,567
S01007344,132,160,52,49,393
S01007345,90,71,40,251,452
S01007346,53,94,101,237,485
S01007347,139,154,42,206,541
S01007348,135,88,44,222,489
S01007349,78,94,34,131,337
S01007350,116,167,119,102,504
S01007351,123,316,65,86,590
S01007352,92,196,125,27,440
S01007353,177,253,49,56,535
S01007354,263,292,97,53,705
S01007355,253,397,142,60,852
S01007356,212,258,73,80,623
S01007357,179,307,103,90,679
S01007358,370,245,79,69,763
S01007359,230,201,52,183,666
S01007360,181,216,49,34,480
S01007361,330,368,121,63,882
S01007362,269,220,113,55,657
S01007363,200,247,57,102,606
S01007364,202,106,49,327,684
S01007365,142,110,45,93,390
S01007366,95,78,63,160,396
S01007367,179,125,104,63,471
S01007368,128,61,32,180,401
S01007369,263,182,86,95,626
S01007370,233,164,161,80,638
S01007371,286,161,69,44,560
S01007372,310,303,110,35,758
S01007373,239,233,50,12,534
S01007374,237,117,23,55,432
S01007375,176,180,41,7,404
S01007376,242,144,47,253,686
S01007377,334,180,25,11,550
S01007378,700,416,182,67,1365
S01007379,166,92,28,117,403
S01007380,229,76,23,119,447
S01007381,153,183,76,9,421
S01007382,276,165,41,50,532
S01007383,281,223,62,68,634
S01007384,296,139,140,34,609
S01007385,306,290,71,60,727
S01007386,314,323,42,3,682
S01007387,332,285,34,11,662
S01007388,334,190,39,7,570
S01007389,78,16,182,110,386
S01007390,84,22,157,99,362
S01007391,242,208,27,8,485
S01007392,203,182,22,4,411
S01007393,282,248,57,77,664
S01007394,227,245,81,5,558
S01007395,239,146,241,86,712
S01007396,238,177,193,82,690
S01007397,370,263,105,55,793
S01007398,191,55,37,230,513
S01007399,128,54,47,271,500
S01007400,296,218,43,46,603
S01007401,316,180,59,14,569
S01007402,315,169,22,14,520
S01007403,219,39,257,34,549
S01007404,111,94,125,40,370
S01007405,282,196,57,13,548
S01007406,265,222,28,4,519
S01007407,304,217,32,43,596
S01007408,237,108,30,107,482
S01007409,310,181,38,83,612
S01007410,121,61,52,305,539
S01007411,204,81,78,334,697
S01007412,143,104,17,130,394
S01007413,487,139,41,53,720
S01007414,411,69,26,17,523
S01007415,249,111,26,289,675
S01007416,89,39,31,262,421
S01007417,494,176,82,39,791
S01007418,215,98,44,174,531
S01007419,185,80,31,352,648
S01007420,819,240,156,66,1281
S01007421,300,101,44,77,522
S01007422,244,134,45,67,490
S01007423,332,118,61,87,598
S01007424,324,285,46,17,672
S01007425,311,268,35,108,722
S01007426,193,119,89,139,540
S01007427,179,131,39,199,548
S01007428,302,163,107,175,747
S01007429,289,130,84,97,600
S01007430,158,109,62,65,394
S01007431,270,171,11,25,477
S01007432,364,186,51,105,706
S01007433,291,184,61,121,657
S01007434,114,60,39,187,400
S01007435,284,141,55,91,571
S01007436,142,61,57,281,541
S01007437,103,90,46,129,368
S01007438,196,169,40,165,570
S01007439,249,170,54,125,598
S01007440,244,127,16,149,536
S01007441,273,161,14,12,460
S01007442,220,181,13,2,416
S01007443,301,284,76,95,756
S01007444,363,308,45,56,772
S01007445,264,206,16,18,504
S01007446,215,165,36,4,420
S01007447,165,196,32,16,409
S01007448,320,298,53,62,733
S01007449,291,203,61,263,818
S01007450,180,94,47,275,596
S01007451,255,148,35,84,522
S01007452,132,75,45,159,411
S01007453,362,56,27,11,456
S01007454,148,82,34,152,416
S01007455,176,91,56,352,675
S01007456,199,80,87,334,700
S01007457,376,149,67,277,869
S01007458,216,154,20,51,441
S01007459,234,166,39,110,549
S01007460,239,136,47,195,617
S01007461,98,58,63,347,566
S01007462,268,122,111,159,660
S01007463,137,48,36,497,718
S01007464,115,58,34,340,547
S01007465,82,35,58,417,592
S01007466,175,83,166,425,849
S01007467,296,181,142,204,823
S01007468,359,178,39,29,605
S01007469,216,85,26,136,463
S01007470,144,72,67,286,569
S01007471,192,59,35,95,381
S01007472,169,90,40,157,456
S01007473,168,65,10,125,368
S01007474,261,128,20,34,443
S01007475,272,131,42,44,489
S01007476,226,229,35,73,563
S01007477,232,121,47,35,435
S01007478,359,179,103,109,750
S01007479,287,61,59,49,456
S01007480,387,93,64,63,607
S01007481,253,409,62,15,739
S01007482,100,144,49,113,406
S01007483,281,149,59,138,627
S01007484,138,114,96,120,468
S01007485,34,32,32,259,357
S01007486,27,38,29,286,380
S01007487,236,115,177,233,761
S01007488,306,214,181,135,836
S01007489,282,249,83,110,724
S01007490,253,241,66,195,755
S01007491,330,135,103,316,884
S01007492,240,154,43,158,595
S01007493,257,141,71,206,675
S01007494,129,201,64,52,446
S01007495,215,313,120,27,675
S01007496,213,408,190,69,880
S01007497,112,117,146,104,479
S01007498,266,249,121,99,735
S01007499,212,186,124,163,685
S01007500,80,159,200,76,515
S01007501,100,302,123,71,596
S01007502,126,160,101,59,446
S01007503,235,343,164,126,868
S01007504,129,248,148,61,586
S01007505,80,121,75,67,343
S01007506,98,223,89,14,424
S01007507,216,278,117,179,790
S01007508,125,269,120,87,601
S01007509,107,273,104,42,526
S01007510,155,401,140,164,860
S01007511,116,206,99,252,673
S01007512,49,239,91,68,447
S01007513,260,182,98,283,823
S01007514,113,149,130,51,443
S01007515,204,235,60,18,517
S01007516,130,91,103,149,473
S01007517,121,186,65,52,424
S01007518,245,187,67,199,698
S01007519,90,224,69,22,405
S01007520,242,294,158,114,808
S01007521,34,152,176,16,378
S01007522,256,343,96,171,866
S01007523,118,179,127,31,455
S01007524,201,346,207,62,816
S01007525,165,162,69,68,464
S01007526,131,204,118,179,632
S01007527,260,251,75,90,676
S01007528,186,142,130,173,631
S01007529,172,297,57,54,580
S01007530,110,177,152,5,444
S01007531,100,223,186,69,578
S01007532,135,154,127,63,479
S01007533,129,176,147,17,469
S01007534,241,243,84,220,788
S01007535,207,272,48,333,860
S01007536,233,250,176,122,781
S01007537,208,356,168,173,905
S01007538,259,299,176,24,758
S01007539,204,328,48,3,583
S01007540,253,228,81,158,720
S01007541,242,294,85,50,671
S01007542,245,208,69,188,710
S01007543,298,212,119,238,867
S01007544,215,536,166,11,928
S01007545,174,311,152,43,680
S01007546,219,155,65,17,456
S01007547,153,163,118,24,458
S01007548,201,182,105,88,576
S01007549,114,215,92,96,517
S01007550,187,325,162,112,786
S01007551,187,369,181,26,763
S01007552,202,172,77,284,735
S01007553,181,141,28,356,706
S01007554,55,87,13,214,369
S01007555,169,176,54,46,445
S01007556,133,117,32,154,436
S01007557,308,173,70,346,897
S01007558,127,149,66,21,363
S01007559,169,147,252,22,590
S01007560,243,283,129,139,794
S01007561,165,241,95,136,637
S01007562,202,191,199,93,685
S01007563,205,247,205,69,726
S01007564,190,244,158,59,651
S01007565,269,274,160,89,792
S01007566,212,219,109,61,601
S01007567,168,196,101,17,482
S01007568,204,177,141,26,548
S01007569,157,240,224,75,696
S01007570,200,211,55,98,564
S01007571,153,158,140,12,463
S01007572,277,252,69,187,785
S01007573,435,95,98,15,643
S01007574,301,173,64,280,818
S01007575,192,153,44,314,703
S01007576,85,57,22,376,540
S01007577,105,72,17,330,524
S01007578,110,74,55,298,537
S01007579,119,41,43,290,493
S01007580,196,77,52,312,637
S01007581,122,85,45,138,390
S01007582,183,80,37,230,530
S01007583,151,76,65,538,830
S01007584,163,92,47,189,491
S01007585,321,360,59,68,808
S01007586,217,145,64,242,668
S01007587,305,263,108,55,731
S01007588,324,285,58,42,709
S01007589,233,226,191,27,677
S01007590,259,242,35,2,538
S01007591,219,123,81,64,487
S01007592,127,91,129,230,577
S01007593,405,311,88,116,920
S01007594,359,227,62,63,711
S01007595,266,314,228,91,899
S01007596,128,211,136,6,481
S01007597,194,181,131,21,527
S01007598,198,207,123,21,549
S01007599,284,161,118,132,695
S01007600,377,310,165,99,951
S01007601,261,131,102,30,524
S01007602,291,172,56,8,527
S01007603,376,208,48,12,644
S01007604,348,361,31,17,757
S01007605,331,310,68,1,710
S01007606,245,182,88,5,520
S01007607,298,247,43,0,588
S01007608,338,249,39,12,638
S01007609,221,163,81,272,737
S01007610,110,104,112,122,448
S01007611,150,163,202,278,793
S01007612,165,153,370,247,935
S01007613,293,234,118,15,660
S01007614,364,271,47,11,693
S01007615,394,244,157,84,879
S01007616,220,143,116,130,609
S01007617,145,104,50,141,440
S01007618,182,130,34,169,515
S01007619,226,107,42,141,516
S01007620,250,199,55,1,505
S01007621,260,235,56,5,556
S01007622,179,118,118,54,469
S01007623,262,163,52,31,508
S01007624,329,147,57,4,537
S01007625,229,132,57,11,429
S01007626,339,98,57,5,499
S01007627,268,97,51,27,443
S01007628,232,276,91,4,603
S01007629,251,198,83,44,576
S01007630,291,295,99,8,693
S01007631,161,247,93,14,515
S01007632,286,245,99,171,801
S01007633,283,275,75,187,820
S01007634,144,180,125,34,483
S01007635,190,345,89,23,647
S01007636,267,211,76,187,741
S01007637,283,170,70,178,701
S01007638,251,182,78,140,651
S01007639,300,163,75,306,844
S01007640,151,123,288,36,598
S01007641,224,194,110,149,677
S01007642,195,312,122,86,715
S01007643,280,293,74,111,758
S01007644,225,229,57,185,696
S01007645,123,169,125,29,446
S01007646,89,170,244,29,532
S01007647,214,227,110,67,618
S01007648,215,280,193,54,742
S01007649,194,195,121,108,618
S01007650,293,252,211,68,824
S01007651,146,127,168,32,473
S01007652,174,169,82,76,501
S01007653,297,299,67,93,756
S01007654,260,260,158,226,904
S01007655,164,246,219,32,661
S01007656,89,216,398,11,714
S01007657,119,110,109,21,359
S01007658,141,163,115,8,427
S01007659,200,215,124,126,665
S01007660,198,88,87,305,678
S01007661,197,165,107,94,563
S01007662,233,239,134,166,772
S01007663,279,285,67,93,724
S01007664,139,134,70,140,483
S01007665,255,89,69,86,499
S01007666,213,151,32,18,414
S01007667,295,237,41,11,584
S01007668,340,189,60,288,877
S01007669,89,59,29,301,478
S01007670,136,84,59,258,537
S01007671,240,276,78,27,621
S01007672,303,397,52,15,767
S01007673,276,219,67,22,584
S01007674,248,183,60,171,662
S01007675,237,216,44,26,523
S01007676,208,254,81,27,570
S01007677,203,137,52,18,410
S01007678,233,181,70,183,667
S01007679,175,200,57,249,681
S01007680,410,312,55,5,782
S01007681,178,101,30,54,363
S01007682,269,330,157,8,764
S01007683,227,163,182,10,582
S01007684,279,373,31,8,691
S01007685,396,322,74,7,799
S01007686,199,255,126,10,590
S01007687,256,214,285,19,774
S01007688,191,85,547,106,929
S01007689,137,57,302,61,557
S01007690,122,104,493,102,821
S01007691,141,100,1803,773,2817
S01007692,124,55,592,93,864
S01007693,56,41,595,238,930
S01007694,93,36,501,379,1009
S01007695,153,120,361,258,892
S01007696,54,38,435,190,717
S01007697,162,144,357,221,884
S01007698,145,41,594,202,982
S01007699,90,54,383,161,688
S01007700,399,280,123,54,856
S01007701,51,47,185,206,489
S01007702,225,82,594,60,961
S01007703,273,161,163,97,694
S01007704,70,81,188,458,797
S01007705,51,20,603,59,733
S01007706,34,20,641,60,755
S01007707,141,52,518,54,765
S01007708,134,57,165,193,549
S01007709,105,53,194,176,528
S01007710,64,21,393,262,740
S01007711,99,64,393,422,978
S01007712,162,86,298,83,629
S01007713,121,66,111,117,415
S01007714,234,66,147,98,545
S01007715,88,29,137,178,432
S01007716,139,75,393,335,942
S01007717,108,48,297,385,838
S01007718,113,77,246,195,631
S01007719,220,107,225,326,878
S01007720,158,233,74,180,645
S01007721,169,101,155,219,644
S01007722,131,92,142,366,731
S01007723,169,94,188,397,848
S01007724,82,22,277,144,525
S01007725,153,73,260,202,688
S01007726,156,74,257,188,675
S01007727,126,50,366,333,875
S01007728,118,54,349,161,682
S01007729,107,71,371,113,662
S01007730,137,53,419,62,671
S01007731,151,36,259,167,613
S01007732,163,40,259,130,592
S01007733,370,192,114,6,682
S01007734,299,271,109,44,723
S01007735,319,276,78,41,714
S01007736,294,211,78,33,616
S01007737,281,179,217,207,884
S01007738,211,258,65,90,624
S01007739,170,136,37,196,539
S01007740,213,183,66,33,495
S01007741,194,148,76,238,656
S01007742,197,173,70,110,550
S01007743,262,116,110,234,722
S01007744,162,71,59,323,615
S01007745,219,89,69,204,581
S01007746,280,106,36,296,718
S01007747,125,84,63,143,415
S01007748,101,46,30,364,541
S01007749,318,209,41,13,581
S01007750,310,340,56,12,718
S01007751,262,348,65,0,675
S01007752,226,279,93,58,656
S01007753,143,67,38,167,415
S01007754,206,123,32,328,689
S01007755,174,107,63,330,674
S01007756,146,85,50,198,479
S01007757,313,350,47,5,715
S01007758,279,387,109,14,789
S01007759,183,193,360,131,867
S01007760,220,259,35,2,516
S01007761,323,297,100,5,725
S01007762,198,223,277,29,727
S01007763,142,81,44,214,481
S01007764,342,253,31,5,631
S01007765,275,254,35,2,566
S01007766,412,320,34,9,775
S01007767,401,316,43,0,760
S01007768,206,180,126,59,571
S01007769,283,296,38,22,639
S01007770,268,263,73,8,612
S01007771,215,219,15,0,449
S01007772,263,198,160,223,844
S01007773,347,269,18,6,640
S01007774,560,69,42,9,680
S01007775,477,199,75,2,753
S01007776,357,141,60,1,559
S01007777,554,71,43,1,669
S01007778,297,57,13,3,370
S01007779,376,163,39,28,606
S01007780,452,128,51,17,648
S01007781,463,101,49,121,734
S01007782,95,45,117,116,373
S01007783,80,108,22,425,635
S01007784,293,36,56,144,529
S01007785,62,21,23,330,436
S01007786,195,180,75,160,610
S01007787,180,101,74,165,520
S01007788,15,2,5,442,464
S01007789,36,2,30,389,457
S01007790,43,14,17,484,558
S01007791,310,48,29,11,398
S01007792,295,184,42,186,707
S01007793,136,83,64,440,723
S01007794,196,118,33,99,446
S01007795,164,112,65,115,456
S01007796,221,65,62,177,525
S01007797,114,59,30,202,405
S01007798,328,72,78,14,492
S01007799,348,39,22,19,428
S01007800,180,96,71,371,718
S01007801,131,86,72,508,797
S01007802,313,38,34,16,401
S01007803,100,66,43,596,805
S01007804,67,20,33,329,449
S01007805,103,31,46,184,364
S01007806,188,106,28,196,518
S01007807,370,110,29,37,546
S01007808,324,66,58,184,632
S01007809,420,316,32,20,788
S01007810,232,96,43,316,687
S01007811,249,95,23,269,636
S01007812,122,31,35,399,587
S01007813,153,78,51,296,578
S01007814,216,122,39,89,466
S01007815,465,274,39,28,806
S01007816,309,174,50,24,557
S01007817,132,173,31,56,392
S01007818,336,152,57,60,605
S01007819,347,221,43,63,674
S01007820,353,217,53,183,806
S01007821,208,155,40,64,467
S01007822,311,192,33,95,631
S01007823,312,240,40,17,609
S01007824,305,242,70,13,630
S01007825,428,300,69,77,874
S01007826,85,50,29,300,464
S01007827,208,58,157,70,493
S01007828,275,136,172,304,887
S01007829,137,148,62,189,536
S01007830,211,174,137,294,816
S01007831,131,94,153,362,740
S01007832,128,142,91,187,548
S01007833,136,272,87,234,729
S01007834,161,95,163,204,623
S01007835,262,136,88,91,577
S01007836,181,154,75,57,467
S01007837,339,321,24,9,693
S01007838,347,302,55,33,737
S01007839,182,180,90,198,650
S01007840,224,123,118,181,646
S01007841,168,100,63,233,564
S01007842,109,58,81,324,572
S01007843,154,75,126,221,576
S01007844,230,106,136,299,771
S01007845,160,95,51,362,668
S01007846,219,111,65,178,573
S01007847,192,112,83,348,735
S01007848,115,55,66,405,641
S01007849,219,109,54,304,686
S01007850,124,199,42,247,612
S01007851,312,243,45,209,809
S01007852,144,68,48,279,539
S01007853,71,52,82,369,574
S01007854,179,90,71,550,890
S01007855,88,51,123,164,426
S01007856,310,175,71,116,672
S01007857,49,28,11,294,382
S01007858,190,59,61,567,877
S01007859,60,11,21,296,388
S01007860,206,12,24,201,443
S01007861,221,120,30,159,530
S01007862,231,121,49,173,574
S01007863,143,77,38,416,674
S01007864,281,192,62,234,769
S01007865,423,31,19,12,485
S01007866,369,49,29,1,448
S01007867,213,75,90,31,409
S01007868,363,346,23,23,755
S01007869,435,224,108,13,780
S01007870,198,154,80,24,456
S01007871,78,59,10,375,522
S01007872,82,59,14,402,557
S01007873,230,163,72,131,596
S01007874,216,149,47,225,637
S01007875,206,106,15,113,440
S01007876,406,128,53,188,775
S01007877,254,150,25,210,639
S01007878,179,99,18,262,558
S01007879,177,93,41,275,586
S01007880,138,144,27,26,335
S01007881,127,93,34,197,451
S01007882,294,229,68,21,612
S01007883,449,232,73,117,871
S01007884,251,98,43,119,511
S01007885,137,86,36,352,611
S01007886,306,216,55,163,740
S01007887,178,153,133,14,478
S01007888,227,122,38,440,827
S01007889,179,103,17,142,441
S01007890,263,135,24,171,593
S01007891,404,138,34,136,712
S01007892,292,207,69,64,632
S01007893,447,314,70,35,866
S01007894,351,172,78,158,759
S01007895,204,149,65,42,460
S01007896,244,119,80,256,699
S01007897,161,133,52,10,356
S01007898,157,124,66,13,360
S01007899,106,134,57,9,306
S01007900,122,83,20,224,449
S01007901,172,93,50,259,574
S01007902,166,132,39,392,729
S01007903,164,185,54,158,561
S01007904,268,234,161,32,695
S01007905,153,42,29,320,544
S01007906,176,105,37,305,623
S01007907,136,127,27,183,473
S01007908,323,288,71,112,794
S01007909,173,77,31,139,420
S01007910,244,104,76,269,693
S01007911,338,114,39,140,631
S01007912,277,171,58,154,660
S01007913,133,90,87,198,508
S01007914,163,87,34,231,515
S01007915,288,151,21,224,684
S01007916,272,188,45,198,703
S01007917,308,165,50,206,729
S01007918,304,194,70,224,792
S01007919,381,218,27,21,647
S01007920,300,137,28,26,491
S01007921,216,110,24,425,775
S01007922,200,98,48,370,716
S01007923,417,243,71,82,813
S01007924,266,161,73,325,825
S01007925,168,162,45,10,385
S01007926,193,134,51,12,390
S01007927,288,171,37,28,524
S01007928,453,260,34,100,847
S01007929,317,185,63,31,596
S01007930,234,186,35,16,471
S01007931,434,238,44,194,910
S01007932,373,311,20,19,723
S01007933,399,155,71,23,648
S01007934,301,91,38,129,559
S01007935,258,122,150,146,676
S01007936,491,204,85,10,790
S01007937,514,243,78,28,863
S01007938,258,159,54,158,629
S01007939,222,136,53,300,711
S01007940,422,201,62,184,869
S01007941,306,200,25,12,543
S01007942,186,38,76,60,360
S01007943,256,172,73,61,562
S01007944,360,154,75,172,761
S01007945,277,187,79,179,722
S01007946,277,165,62,156,660
S01007947,308,176,39,94,617
S01007948,147,89,46,243,525
S01007949,331,220,47,54,652
S01007950,392,250,47,44,733
S01007951,328,141,44,104,617
S01007952,164,88,78,212,542
S01007953,381,112,68,200,761
S01007954,177,60,37,310,584
S01007955,224,99,36,275,634
S01007956,235,65,38,236,574
S01007957,326,139,57,271,793
S01007958,266,88,33,351,738
S01007959,354,256,26,52,688
S01007960,249,98,24,198,569
S01007961,385,447,218,51,1101
S01007962,208,51,53,129,441
S01007963,64,46,34,557,701
S01007964,190,108,62,281,641
S01007965,161,62,32,199,454
S01007966,180,87,42,423,732
S01007967,109,26,32,295,462
S01007968,358,167,46,169,740
S01007969,289,155,31,223,698
S01007970,286,121,62,237,706
S01007971,295,133,52,315,795
S01007972,346,108,51,197,702
S01007973,403,297,15,7,722
S01007974,226,101,49,321,697
S01007975,228,106,66,159,559
S01007976,182,142,101,218,643
S01007977,301,128,72,54,555
S01007978,205,67,139,92,503
S01007979,393,193,65,53,704
S01007980,286,190,48,85,609
S01007981,198,250,24,14,486
S01007982,210,172,9,46,437
S01007983,169,134,41,303,647
S01007984,333,193,39,114,679
S01007985,255,117,68,302,742
S01007986,244,95,47,87,473
S01007987,351,165,40,64,620
S01007988,321,128,47,168,664
S01007989,234,74,96,145,549
S01007990,401,80,83,117,681
S01007991,520,135,45,18,718
S01007992,381,73,31,7,492
S01007993,414,234,30,23,701
S01007994,475,70,34,25,604
S01007995,529,113,26,13,681
S01007996,212,132,30,15,389
S01007997,265,271,33,9,578
S01007998,211,181,25,32,449
S01007999,197,59,37,249,542
S01008000,180,84,37,430,731
S01008001,134,49,29,442,654
S01008002,131,50,39,390,610
S01008003,264,50,75,143,532
S01008004,288,31,91,54,464
S01008005,201,11,37,146,395
S01008006,79,28,24,312,443
S01008007,89,37,92,116,334
S01008008,110,14,27,305,456
S01008009,126,41,60,361,588
S01008010,288,105,82,270,745
S01008011,95,78,123,314,610
S01008012,252,122,238,86,698
S01008013,267,87,157,107,618
S01008014,272,148,64,58,542
S01008015,238,103,138,182,661
S01008016,250,171,100,166,687
S01008017,379,354,39,13,785
S01008018,222,276,65,8,571
S01008019,376,182,43,16,617
S01008020,266,133,105,19,523
S01008021,245,200,28,6,479
S01008022,314,260,29,0,603
S01008023,428,103,15,1,547
S01008024,386,44,30,21,481
S01008025,371,178,22,9,580
S01008026,395,162,80,214,851
S01008027,177,112,38,146,473
S01008028,301,76,36,53,466
S01008029,323,270,108,83,784
S01008030,462,283,56,109,910
S01008031,290,156,53,229,728
S01008032,345,182,40,165,732
S01008033,400,173,33,17,623
S01008034,440,139,16,2,597
S01008035,293,171,23,43,530
S01008036,300,250,8,7,565
S01008037,335,140,53,303,831
S01008038,289,73,27,201,590
S01008039,378,132,45,159,714
S01008040,307,261,24,60,652
S01008041,245,226,77,50,598
S01008042,216,211,36,16,479
S01008043,397,328,11,29,765
S01008044,369,380,55,9,813
S01008045,305,389,66,66,826
S01008046,231,200,93,229,753
S01008047,276,274,27,2,579
S01008048,219,249,13,5,486
S01008049,356,328,19,3,706
S01008050,240,235,17,14,506
S01008051,407,251,28,2,688
S01008052,419,226,15,6,666
S01008053,257,225,22,1,505
S01008054,303,242,58,56,659
S01008055,451,349,31,3,834
S01008056,306,266,15,33,620
S01008057,399,291,30,36,756
S01008058,417,253,45,1,716
S01008059,310,227,18,3,558
S01008060,469,218,22,14,723
S01008061,460,137,29,0,626
S01008062,401,266,35,10,712
S01008063,448,270,39,5,762
S01008064,192,110,36,228,566
S01008065,469,277,26,1,773
S01008066,401,301,24,0,726
S01008067,268,233,20,1,522
S01008068,424,298,36,17,775
S01008069,465,261,40,9,775
S01008070,458,262,18,1,739
S01008071,375,167,18,19,579
S01008072,385,209,106,4,704
S01008073,213,183,5,0,401
S01008074,458,322,15,12,807
S01008075,223,237,28,2,490
S01008076,199,338,37,6,580
S01008077,367,285,22,3,677
S01008078,346,288,50,13,697
S01008079,363,340,22,8,733
S01008080,318,209,28,3,558
S01008081,245,224,21,0,490
S01008082,322,318,30,14,684
S01008083,339,219,20,7,585
S01008084,344,267,52,46,709
S01008085,486,260,29,17,792
S01008086,477,242,70,71,860
S01008087,389,278,19,6,692
S01008088,366,345,61,6,778
S01008089,301,222,15,2,540
S01008090,342,230,27,21,620
S01008091,168,150,10,3,331
S01008092,371,363,8,23,765
S01008093,338,290,41,0,669
S01008094,280,250,19,4,553
S01008095,322,252,65,4,643
S01008096,331,316,24,3,674
S01008097,248,276,18,0,542
S01008098,345,240,27,6,618
S01008099,269,138,28,6,441
S01008100,416,308,40,34,798
S01008101,369,147,95,16,627
S01008102,411,197,44,40,692
S01008103,219,106,82,115,522
S01008104,339,136,80,161,716
S01008105,391,118,76,269,854
S01008106,271,123,69,175,638
S01008107,460,107,55,2,624
S01008108,322,192,20,4,538
S01008109,411,278,42,23,754
S01008110,488,169,34,4,695
S01008111,333,365,38,13,749
S01008112,365,331,12,4,712
S01008113,396,326,46,8,776
S01008114,305,256,11,4,576
S01008115,494,185,67,14,760
S01008116,440,271,26,14,751
S01008117,337,270,20,48,675
S01008118,403,171,43,71,688
S01008119,205,86,27,222,540
S01008120,234,183,35,64,516
S01008121,278,272,3,2,555
S01008122,348,201,35,6,590
S01008123,368,327,58,8,761
S01008124,401,238,23,3,665
S01008125,360,301,58,7,726
S01008126,390,261,14,0,665
S01008127,230,152,18,10,410
S01008128,394,293,25,36,748
S01008129,318,143,72,214,747
S01008130,329,159,130,195,813
S01008131,219,113,100,207,639
S01008132,408,388,37,16,849
S01008133,177,176,76,109,538
S01008134,252,133,104,29,518
S01008135,507,152,164,91,914
S01008136,361,171,81,141,754
S01008137,111,33,35,486,665
S01008138,156,46,47,394,643
S01008139,287,166,61,198,712
S01008140,133,61,28,183,405
S01008141,412,273,9,16,710
S01008142,447,195,8,12,662
S01008143,301,183,65,204,753
S01008144,299,176,27,2,504
S01008145,251,87,31,275,644
S01008146,111,83,21,197,412
S01008147,344,143,20,155,662
S01008148,363,174,33,76,646
S01008149,303,107,35,121,566
S01008150,358,154,44,206,762
S01008151,304,103,38,142,587
S01008152,338,193,71,287,889
S01008153,484,242,28,13,767
S01008154,324,299,30,55,708
S01008155,332,168,24,50,574
S01008156,340,216,47,166,769
S01008157,354,153,22,61,590
S01008158,423,174,19,9,625
S01008159,247,90,92,349,778
S01008160,320,122,27,300,769
S01008161,543,177,49,44,813
S01008162,420,193,56,160,829
S01008163,204,96,93,206,599
S01008164,598,166,123,429,1316
S01008165,458,58,48,14,578
S01008166,177,91,25,148,441
S01008167,137,100,48,274,559
S01008168,266,63,24,314,667
S01008169,263,79,56,183,581
S01008170,315,124,20,30,489
S01008171,220,128,86,180,614
S01008172,223,123,31,78,455
S01008173,320,120,24,56,520
S01008174,250,142,17,37,446
S01008175,312,102,77,122,613
S01008176,300,200,76,32,608
S01008177,241,153,63,177,634
S01008178,224,238,30,66,558
S01008179,311,61,12,4,388
S01008180,248,111,20,0,379
S01008181,286,237,29,25,577
S01008182,311,170,203,146,830
S01008183,246,124,100,49,519
S01008184,254,182,154,143,733
S01008185,314,187,176,208,885
S01008186,246,201,201,73,721
S01008187,188,82,43,185,498
S01008188,227,125,156,259,767
S01008189,205,169,40,75,489
S01008190,220,120,36,331,707
S01008191,126,88,17,154,385
S01008192,279,119,133,146,677
S01008193,320,182,46,128,676
S01008194,198,123,58,128,507
S01008195,259,53,52,258,622
S01008196,225,50,67,252,594
S01008197,486,53,80,119,738
S01008198,185,155,21,213,574
S01008199,148,43,32,384,607
S01008200,131,79,20,279,509
S01008201,198,83,32,317,630
S01008202,251,81,28,125,485
S01008203,118,46,74,220,458
S01008204,266,193,54,261,774
S01008205,225,103,33,202,563
S01008206,179,101,39,207,526
S01008207,132,35,17,266,450
S01008208,376,72,58,114,620
S01008209,335,30,35,9,409
S01008210,294,215,50,191,750
S01008211,322,187,62,171,742
S01008212,296,98,29,22,445
S01008213,512,166,38,58,774
S01008214,213,179,56,161,609
S01008215,328,152,47,91,618
S01008216,269,126,14,8,417
S01008217,274,171,22,3,470
S01008218,606,155,31,27,819
S01008219,386,153,126,190,855
S01008220,138,52,14,253,457
S01008221,111,59,42,326,538
S01008222,173,75,28,228,504
S01008223,191,90,32,195,508
S01008224,463,225,66,27,781
S01008225,267,160,26,138,591
S01008226,214,76,51,294,635
S01008227,214,109,36,320,679
S01008228,261,168,32,76,537
S01008229,181,93,14,261,549
S01008230,459,62,48,43,612
S01008231,455,33,21,13,522
S01008232,314,29,44,97,484
S01008233,208,38,29,73,348
S01008234,106,93,5,135,339
S01008235,237,164,34,253,688
S01008236,282,188,49,171,690
S01008237,267,145,69,212,693
S01008238,209,153,24,243,629
S01008239,314,123,57,134,628
S01008240,335,322,54,19,730
S01008241,252,276,18,9,555
S01008242,246,243,129,167,785
S01008243,372,142,96,94,704
S01008244,189,157,66,56,468
S01008245,412,226,50,101,789
S01008246,364,247,102,71,784
S01008247,269,204,82,85,640
S01008248,214,217,118,191,740
S01008249,279,256,141,70,746
S01008250,295,318,194,26,833
S01008251,348,155,27,12,542
S01008252,323,270,62,32,687
S01008253,242,157,32,214,645
S01008254,322,199,78,218,817
S01008255,302,112,34,126,574
S01008256,185,104,87,287,663
S01008257,176,168,72,163,579
S01008258,366,213,114,15,708
S01008259,261,149,130,95,635
S01008260,201,119,65,263,648
S01008261,269,103,43,291,706
S01008262,169,136,104,82,491
S01008263,223,150,95,53,521
S01008264,225,113,32,203,573
S01008265,245,252,55,9,561
S01008266,211,288,41,35,575
S01008267,269,178,107,112,666
S01008268,311,330,67,14,722
S01008269,305,347,41,59,752
S01008270,266,328,89,19,702
S01008271,161,148,196,79,584
S01008272,350,272,125,68,815
S01008273,314,260,56,41,671
S01008274,191,176,39,185,591
S01008275,177,158,42,84,461
S01008276,240,129,29,23,421
S01008277,142,132,117,15,406
S01008278,272,241,109,13,635
S01008279,253,173,32,146,604
S01008280,299,216,135,126,776
S01008281,200,148,172,63,583
S01008282,243,205,83,55,586
S01008283,220,99,46,28,393
S01008284,374,125,64,106,669
S01008285,161,118,64,283,626
S01008286,253,104,41,220,618
S01008287,257,129,46,183,615
S01008288,293,233,81,144,751
S01008289,159,121,91,153,524
S01008290,308,174,133,119,734
S01008291,233,316,70,24,643
S01008292,252,82,27,228,589
S01008293,317,81,23,5,426
S01008294,449,122,45,65,681
S01008295,512,220,37,24,793
S01008296,252,129,26,158,565
S01008297,373,130,17,63,583
S01008298,368,177,44,17,606
S01008299,159,115,51,290,615
S01008300,271,178,51,208,708
S01008301,451,205,22,7,685
S01008302,293,256,46,20,615
S01008303,247,106,54,63,470
S01008304,187,150,31,41,409
S01008305,366,281,22,6,675
S01008306,336,173,19,8,536
S01008307,338,107,20,26,491
S01008308,245,223,23,8,499
S01008309,182,103,74,242,601
S01008310,396,192,64,164,816
S01008311,178,44,11,79,312
S01008312,190,43,23,71,327
S01008313,262,150,49,285,746
S01008314,70,30,66,302,468
S01008315,139,61,87,328,615
S01008316,95,14,30,280,419
S01008317,279,67,46,166,558
S01008318,490,222,50,35,797
S01008319,267,169,43,141,620
S01008320,212,249,25,87,573
S01008321,304,107,11,12,434
S01008322,371,194,66,206,837
S01008323,239,64,57,248,608
S01008324,217,85,52,140,494
S01008325,226,73,60,193,552
S01008326,273,97,75,306,751
S01008327,348,163,46,153,710
S01008328,368,94,31,6,499
S01008329,459,187,26,4,676
S01008330,432,213,32,7,684
S01008331,310,95,66,4,475
S01008332,406,320,74,11,811
S01008333,396,332,92,37,857
S01008334,317,246,34,3,600
S01008335,299,138,39,112,588
S01008336,278,106,26,96,506
S01008337,454,105,40,62,661
S01008338,518,65,28,7,618
S01008339,337,126,25,3,491
S01008340,441,150,48,2,641
S01008341,353,122,4,2,481
S01008342,357,210,18,107,692
S01008343,398,293,9,0,700
S01008344,341,325,39,4,709
S01008345,341,396,25,0,762
S01008346,481,267,19,4,771
S01008347,385,361,79,5,830
S01008348,306,272,34,4,616
S01008349,424,241,27,2,694
S01008350,246,231,20,5,502
S01008351,420,275,27,3,725
S01008352,259,237,32,0,528
S01008353,254,138,12,0,404
S01008354,287,186,37,27,537
S01008355,250,154,50,84,538
S01008356,313,112,26,4,455
S01008357,336,186,35,7,564
S01008358,252,156,81,91,580
S01008359,283,172,30,6,491
S01008360,406,253,19,7,685
S01008361,262,140,14,5,421
S01008362,463,167,87,2,719
S01008363,300,240,58,1,599
S01008364,331,233,51,11,626
S01008365,282,259,21,3,565
S01008366,348,217,36,143,744
S01008367,288,104,55,168,615
S01008368,325,158,41,16,540
S01008369,235,113,27,44,419
S01008370,316,172,41,22,551
S01008371,365,235,12,4,616
S01008372,393,193,22,3,611
S01008373,416,189,7,0,612
S01008374,330,190,33,3,556
S01008375,394,227,9,1,631
S01008376,268,119,19,7,413
S01008377,357,184,41,0,582
S01008378,461,277,49,23,810
S01008379,242,181,9,0,432
S01008380,345,158,7,0,510
S01008381,364,124,0,0,488
S01008382,322,169,7,2,500
S01008383,256,112,6,2,376
S01008384,498,260,16,4,778
S01008385,322,202,8,8,540
S01008386,420,210,19,10,659
S01008387,324,125,21,5,475
S01008388,357,98,29,2,486
S01008389,201,313,17,38,569
S01008390,254,252,4,2,512
S01008391,305,239,52,29,625
S01008392,467,217,14,7,705
S01008393,301,332,31,3,667
S01008394,394,191,13,0,598
S01008395,262,139,11,0,412
S01008396,233,306,10,3,552
S01008397,438,296,26,0,760
S01008398,226,209,21,22,478
S01008399,204,223,33,0,460
S01008400,302,201,31,0,534
S01008401,431,347,25,2,805
S01008402,419,446,28,4,897
S01008403,265,201,4,1,471
S01008404,442,312,38,4,796
S01008405,337,226,10,9,582
S01008406,358,230,97,103,788
S01008407,180,181,59,34,454
S01008408,323,138,34,15,510
S01008409,334,203,98,82,717
S01008410,238,213,40,2,493
S01008411,275,175,30,18,498
S01008412,321,174,24,41,560
S01008413,208,145,27,60,440
S01008414,193,143,20,3,359
S01008415,375,205,46,51,677
S01008416,356,163,76,184,779
S01008417,297,213,63,10,583
S01008418,270,237,67,9,583
S01008419,228,81,27,35,371
S01008420,205,167,17,5,394
S01008421,353,149,88,94,684
S01008422,252,212,22,2,488
S01008423,435,287,90,12,824
S01008424,304,373,17,2,696
S01008425,1196,901,108,101,2306
S01008426,185,154,54,86,479
S01008427,570,252,39,5,866
S01008428,275,154,36,94,559
S01008429,365,299,17,24,705
S01008430,279,201,40,33,553
S01008431,336,293,13,54,696
S01008432,278,276,15,19,588
S01008433,375,273,23,12,683
S01008434,346,265,22,26,659
S01008435,331,274,33,11,649
S01008436,381,274,51,15,721
S01008437,232,219,89,64,604
S01008438,190,100,63,9,362
S01008439,440,352,54,1,847
S01008440,364,387,38,17,806
S01008441,215,144,11,2,372
S01008442,344,145,60,3,552
S01008443,212,232,27,14,485
S01008444,220,135,143,13,511
S01008445,138,103,270,177,688
S01008446,450,313,40,6,809
S01008447,288,222,42,3,555
S01008448,317,254,37,27,635
S01008449,106,28,65,394,593
S01008450,75,17,62,273,427
S01008451,52,10,23,419,504
S01008452,26,8,53,353,440
S01008453,74,11,61,232,378
S01008454,76,25,49,536,686
S01008455,147,88,169,400,804
S01008456,140,81,78,474,773
S01008457,117,103,97,216,533
S01008458,289,152,152,184,777
S01008459,124,61,64,355,604
S01008460,59,37,42,426,564
S01008461,122,71,48,466,707
S01008462,6,38,21,418,483
S01008463,112,49,64,325,550
S01008464,345,170,156,22,693
S01008465,263,138,177,30,608
S01008466,270,125,176,23,594
S01008467,320,173,122,21,636
S01008468,208,80,94,145,527
S01008469,227,66,131,54,478
S01008470,145,79,91,268,583
S01008471,86,38,81,418,623
S01008472,175,74,130,160,539
S01008473,141,64,104,239,548
S01008474,156,73,139,296,664
S01008475,148,91,135,124,498
S01008476,182,126,130,173,611
S01008477,206,153,138,181,678
S01008478,193,121,168,222,704
S01008479,210,145,173,129,657
S01008480,124,51,142,184,501
S01008481,518,327,128,432,1405
S01008482,188,123,90,119,520
S01008483,205,88,90,146,529
S01008484,309,188,59,69,625
S01008485,290,185,272,49,796
S01008486,302,239,100,135,776
S01008487,321,91,182,83,677
S01008488,264,146,172,91,673
S01008489,198,151,94,99,542
S01008490,308,195,211,79,793
S01008491,236,142,340,105,823
S01008492,204,40,316,252,812
S01008493,204,158,173,157,692
S01008494,188,64,258,86,596
S01008495,216,74,497,62,849
S01008496,250,66,572,39,927
S01008497,228,76,399,49,752
S01008498,213,65,328,124,730
S01008499,214,68,531,120,933
S01008500,32,7,119,192,350
S01008501,105,34,370,45,554
S01008502,180,50,367,5,602
S01008503,338,95,291,26,750
S01008504,491,183,267,6,947
S01008505,307,178,108,4,597
S01008506,287,260,184,27,758
S01008507,369,136,254,40,799
S01008508,351,252,72,4,679
S01008509,390,340,110,20,860
S01008510,385,282,80,6,753
S01008511,365,282,53,8,708
S01008512,203,195,10,0,408
S01008513,312,234,11,8,565
S01008514,340,312,91,12,755
S01008515,339,177,43,3,562
S01008516,268,151,371,34,824
S01008517,222,204,347,13,786
S01008518,341,243,137,9,730
S01008519,330,236,52,5,623
S01008520,402,413,44,8,867
S01008521,356,319,25,4,704
S01008522,206,172,55,0,433
S01008523,409,236,101,7,753
S01008524,192,97,96,326,711
S01008525,125,79,95,301,600
S01008526,325,189,120,101,735
S01008527,298,134,138,23,593
S01008528,266,117,142,13,538
S01008529,289,175,65,92,621
S01008530,185,92,63,227,567
S01008531,192,126,95,203,616
S01008532,144,86,37,100,367
S01008533,50,24,220,75,369
S01008534,248,147,153,26,574
S01008535,331,240,19,5,595
S01008536,209,242,22,9,482
S01008537,246,296,27,0,569
S01008538,201,254,11,0,466
S01008539,336,304,49,0,689
S01008540,320,359,44,3,726
S01008541,387,246,40,1,674
S01008542,457,231,30,0,718
S01008543,379,152,27,3,561
S01008544,326,129,19,4,478
S01008545,369,269,46,4,688
S01008546,346,340,14,0,700
S01008547,535,168,84,29,816
S01008548,441,69,89,51,650
S01008549,463,168,106,61,798
S01008550,357,213,72,16,658
S01008551,436,339,61,36,872
S01008552,403,229,73,38,743
S01008553,198,131,26,103,458
S01008554,159,70,69,465,763
S01008555,169,49,82,494,794
S01008556,196,75,83,234,588
S01008557,171,67,123,318,679
S01008558,235,134,99,242,710
S01008559,245,100,52,154,551
S01008560,243,83,68,154,548
S01008561,220,77,73,156,526
S01008562,95,6,22,364,487
S01008563,256,92,97,204,649
S01008564,225,129,78,94,526
S01008565,236,129,73,282,720
S01008566,341,113,109,251,814
S01008567,224,92,68,188,572
S01008568,351,112,132,31,626
S01008569,29,32,48,406,515
S01008570,155,75,77,410,717
S01008571,217,161,60,125,563
S01008572,342,186,119,86,733
S01008573,427,178,61,32,698
S01008574,397,173,43,9,622
S01008575,376,198,57,12,643
S01008576,338,280,83,22,723
S01008577,344,366,58,16,784
S01008578,313,297,37,10,657
S01008579,274,329,62,10,675
S01008580,203,134,88,39,464
S01008581,284,150,128,207,769
S01008582,342,178,111,204,835
S01008583,220,107,148,118,593
S01008584,204,139,183,156,682
S01008585,188,86,95,98,467
S01008586,257,141,95,171,664
S01008587,347,323,112,18,800
S01008588,307,208,96,8,619
S01008589,166,88,15,42,311
S01008590,240,232,158,15,645
S01008591,334,166,153,21,674
S01008592,239,161,144,67,611
S01008593,306,268,33,12,619
S01008594,353,328,172,26,879
S01008595,218,168,166,265,817
S01008596,177,142,246,178,743
S01008597,334,302,93,9,738
S01008598,190,121,374,59,744
S01008599,298,221,273,12,804
S01008600,231,161,232,40,664
S01008601,377,384,1590,118,2469
S01008602,146,109,314,38,607
S01008603,207,105,677,78,1067
S01008604,241,188,387,12,828
S01008605,187,143,287,10,627
S01008606,264,199,135,7,605
S01008607,180,248,42,41,511
S01008608,233,304,99,0,636
S01008609,355,312,96,35,798
S01008610,226,302,192,12,732
S01008611,316,236,752,22,1326
S01008612,101,67,485,70,723
S01008613,177,210,285,19,691
S01008614,89,80,437,35,641
S01008615,183,138,447,12,780
S01008616,144,77,453,0,674
S01008617,150,104,493,4,751
S01008618,132,70,477,0,679
S01008619,94,95,301,0,490
S01008620,145,89,515,15,764
S01008621,136,90,476,6,708
S01008622,92,133,241,0,466
S01008623,235,218,396,6,855
S01008624,223,330,63,51,667
S01008625,194,222,35,12,463
S01008626,332,257,146,7,742
S01008627,308,218,50,3,579
S01008628,170,150,220,9,549
S01008629,130,157,173,30,490
S01008630,133,104,262,2,501
S01008631,223,134,338,14,709
S01008632,289,192,369,13,863
S01008633,276,340,146,21,783
S01008634,231,204,164,11,610
S01008635,282,224,229,9,744
S01008636,234,234,275,5,748
S01008637,194,187,208,17,606
S01008638,151,102,392,128,773
S01008639,287,135,367,4,793
S01008640,218,117,361,1,697
S01008641,166,136,475,5,782
S01008642,301,146,380,1,828
S01008643,246,116,233,10,605
S01008644,198,104,326,76,704
S01008645,250,135,327,16,728
S01008646,244,133,327,32,736
S01008647,214,73,253,5,545
S01008648,144,42,329,56,571
S01008649,278,89,447,52,866
S01008650,224,74,360,44,702
S01008651,239,92,442,170,943
S01008652,119,26,225,176,546
S01008653,105,44,312,176,637
S01008654,204,70,465,146,885
S01008655,133,68,474,77,752
S01008656,111,54,282,158,605
S01008657,131,77,282,197,687
S01008658,193,90,555,227,1065
S01008659,113,51,505,114,783
S01008660,106,90,597,81,874
S01008661,90,65,442,349,946
S01008662,70,32,496,126,724
S01008663,152,64,475,125,816
S01008664,151,79,374,65,669
S01008665,227,132,591,162,1112
S01008666,205,106,611,18,940
S01008667,194,175,423,128,920
S01008668,126,78,352,35,591
S01008669,37,32,456,17,542
S01008670,99,72,655,16,842
S01008671,94,76,531,35,736
S01008672,87,99,441,25,652
S01008673,108,148,570,161,987
S01008674,84,79,637,127,927
S01008675,87,59,403,140,689
S01008676,137,98,416,86,737
S01008677,113,87,523,66,789
S01008678,132,62,804,162,1160
S01008679,82,59,604,385,1130
S01008680,61,27,379,131,598
S01008681,110,74,549,197,930
S01008682,117,86,377,135,715
S01008683,176,86,437,669,1368
S01008684,116,84,286,374,860
S01008685,127,159,434,253,973
S01008686,158,33,316,370,877
S01008687,198,68,326,27,619
S01008688,268,102,354,85,809
S01008689,258,89,380,75,802
S01008690,318,156,405,29,908
S01008691,332,116,458,81,987
S01008692,221,81,210,142,654
S01008693,218,151,40,11,420
S01008694,365,180,320,31,896
S01008695,295,133,128,21,577
S01008696,317,171,54,6,548
S01008697,448,349,99,8,904
S01008698,188,186,30,14,418
S01008699,267,211,131,151,760
S01008700,206,171,78,12,467
S01008701,47,6,22,228,303
S01008702,85,56,278,74,493
S01008703,122,25,90,518,755
S01008704,129,33,71,300,533
S01008705,92,20,67,214,393
S01008706,55,4,39,304,402
S01008707,106,23,77,396,602
S01008708,62,7,61,601,731
S01008709,166,60,93,225,544
S01008710,121,10,50,182,363
S01008711,129,86,78,276,569
S01008712,150,102,109,565,926
S01008713,99,26,43,299,467
S01008714,189,114,68,112,483
S01008715,244,157,60,185,646
S01008716,186,93,50,137,466
S01008717,208,61,59,9,337
S01008718,259,107,42,20,428
S01008719,416,146,188,31,781
S01008720,189,117,93,42,441
S01008721,460,134,34,11,639
S01008722,426,333,55,87,901
S01008723,342,176,29,32,579
S01008724,405,248,59,65,777
S01008725,324,197,48,43,612
S01008726,273,140,34,3,450
S01008727,439,305,97,67,908
S01008728,160,81,68,89,398
S01008729,335,138,57,20,550
S01008730,299,102,188,58,647
S01008731,150,124,59,51,384
S01008732,183,83,141,94,501
S01008733,353,129,204,28,714
S01008734,196,158,72,39,465
S01008735,427,309,64,4,804
S01008736,296,246,20,42,604
S01008737,326,295,42,10,673
S01008738,334,287,22,3,646
S01008739,234,184,33,18,469
S01008740,237,192,21,13,463
S01008741,394,350,24,22,790
S01008742,138,181,73,52,444
S01008743,262,147,186,175,770
S01008744,413,222,139,104,878
S01008745,160,148,83,9,400
S01008746,208,108,225,352,893
S01008747,203,165,43,8,419
S01008748,243,266,34,22,565
S01008749,412,350,47,30,839
S01008750,284,287,19,19,609
S01008751,214,129,71,88,502
S01008752,147,100,153,262,662
S01008753,140,82,101,133,456
S01008754,171,68,121,182,542
S01008755,247,74,233,258,812
S01008756,192,107,99,224,622
S01008757,116,63,85,273,537
S01008758,226,111,75,279,691
S01008759,138,74,65,185,462
S01008760,181,71,103,406,761
S01008761,217,53,282,46,598
S01008762,278,169,61,18,526
S01008763,422,187,128,27,764
S01008764,311,152,65,56,584
S01008765,404,136,127,18,685
S01008766,453,303,70,35,861
S01008767,249,115,48,47,459
S01008768,173,73,99,105,450
S01008769,243,85,279,12,619
S01008770,215,57,427,24,723
S01008771,229,65,182,167,643
S01008772,295,189,111,72,667
S01008773,310,137,275,184,906
S01008774,236,101,260,190,787
S01008775,216,91,86,16,409
S01008776,196,81,231,245,753
S01008777,200,101,210,436,947
S01008778,263,90,493,151,997
S01008779,264,67,312,17,660
S01008780,185,39,244,60,528
S01008781,206,23,276,280,785
S01008782,221,56,326,92,695
S01008783,109,17,167,71,364
S01008784,106,13,196,78,393
S01008785,119,75,213,323,730
S01008786,287,93,392,83,855
S01008787,2,9,28,238,277
S01008788,199,47,266,100,612
S01008789,153,80,132,215,580
S01008790,169,35,221,149,574
S01008791,201,87,429,61,778
S01008792,250,145,194,94,683
S01008793,92,28,142,124,386
S01008794,208,99,203,261,771
S01008795,341,137,483,38,999
S01008796,202,61,422,263,948
S01008797,273,120,417,75,885
S01008798,213,107,282,120,722
S01008799,123,34,342,64,563
S01008800,339,96,491,43,969
S01008801,285,84,427,72,868
S01008802,256,106,410,119,891
S01008803,183,80,354,242,859
S01008804,142,37,277,151,607
S01008805,122,61,390,14,587
S01008806,253,82,468,114,917
S01008807,279,100,314,47,740
S01008808,220,95,218,79,612
S01008809,128,156,259,25,568
S01008810,248,90,309,5,652
S01008811,249,125,404,14,792
S01008812,140,84,208,2,434
S01008813,208,119,246,253,826
S01008814,241,147,281,61,730
S01008815,266,70,332,136,804
S01008816,160,82,146,83,471
S01008817,217,59,192,188,656
S01008818,334,104,140,61,639
S01008819,294,147,157,46,644
S01008820,281,127,263,289,960
S01008821,317,142,67,23,549
S01008822,342,186,41,13,582
S01008823,285,178,87,4,554
S01008824,404,251,137,39,831
S01008825,252,175,72,11,510
S01008826,243,139,119,86,587
S01008827,288,244,34,3,569
S01008828,320,269,126,35,750
S01008829,269,172,72,48,561
S01008830,266,214,71,8,559
S01008831,270,311,45,29,655
S01008832,250,280,119,3,652
S01008833,348,282,167,63,860
S01008834,407,362,190,16,975
S01008835,321,265,71,35,692
S01008836,207,108,166,123,604
S01008837,353,114,416,54,937
S01008838,318,218,374,22,932
S01008839,349,209,308,50,916
S01008840,386,224,309,13,932
S01008841,190,109,173,29,501
S01008842,262,58,443,25,788
S01008843,288,139,454,28,909
S01008844,193,67,301,54,615
S01008845,169,136,474,14,793
S01008846,193,168,345,33,739
S01008847,145,99,287,4,535
S01008848,209,170,289,41,709
S01008849,157,130,372,2,661
S01008850,168,203,359,8,738
S01008851,196,202,405,147,950
S01008852,201,308,374,0,883
S01008853,174,108,316,7,605
S01008854,198,187,452,7,844
S01008855,304,198,469,13,984
S01008856,153,95,248,9,505
S01008857,214,200,273,3,690
S01008858,154,172,169,2,497
S01008859,229,161,530,119,1039
S01008860,263,188,308,45,804
S01008861,243,266,125,3,637
S01008862,218,150,412,47,827
S01008863,209,181,230,19,639
S01008864,264,246,362,6,878
S01008865,206,221,302,13,742
S01008866,251,174,283,1,709
S01008867,273,243,175,3,694
S01008868,175,106,433,13,727
S01008869,222,275,368,71,936
S01008870,185,222,277,11,695
S01008871,291,271,409,0,971
S01008872,238,145,373,9,765
S01008873,256,198,129,3,586
S01008874,236,197,269,71,773
S01008875,212,152,341,49,754
S01008876,234,212,46,3,495
S01008877,240,121,71,10,442
S01008878,315,257,99,105,776
S01008879,292,233,118,51,694
S01008880,268,177,66,20,531
S01008881,190,237,83,6,516
S01008882,462,320,68,0,850
S01008883,280,434,69,5,788
S01008884,241,304,43,0,588
S01008885,347,274,50,6,677
S01008886,276,254,171,9,710
S01008887,297,256,73,15,641
S01008888,194,130,210,6,540
S01008889,249,143,57,7,456
S01008890,304,248,24,21,597
S01008891,290,315,22,0,627
S01008892,312,284,161,78,835
S01008893,409,272,35,5,721
S01008894,348,298,26,14,686
S01008895,325,252,46,7,630
S01008896,236,120,52,0,408
S01008897,276,226,38,9,549
S01008898,354,298,34,2,688
S01008899,188,121,71,288,668
S01008900,302,188,129,168,787
S01008901,282,140,97,164,683
S01008902,281,119,161,268,829
S01008903,339,220,64,186,809
S01008904,235,95,276,202,808
S01008905,181,60,197,403,841
S01008906,99,30,155,331,615
S01008907,29,18,44,343,434
S01008908,189,108,147,271,715
S01008909,318,120,169,31,638
S01008910,175,69,120,7,371
S01008911,288,73,409,15,785
S01008912,357,182,76,22,637
S01008913,293,72,143,4,512
S01008914,345,205,81,106,737
S01008915,227,156,49,30,462
S01008916,209,148,131,416,904
S01008917,117,33,63,347,560
S01008918,23,10,36,352,421
S01008919,39,17,44,302,402
S01008920,373,66,365,142,946
S01008921,75,47,58,407,587
S01008922,227,104,141,175,647
S01008923,146,91,124,249,610
S01008924,101,29,90,482,702
S01008925,221,53,180,45,499
S01008926,220,72,68,113,473
S01008927,266,18,231,140,655
S01008928,190,70,122,244,626
S01008929,35,18,34,542,629
S01008930,61,33,30,557,681
S01008931,82,54,39,417,592
S01008932,258,51,258,125,692
S01008933,126,16,47,313,502
S01008934,228,66,112,186,592
S01008935,335,326,52,18,731
S01008936,182,106,9,0,297
S01008937,327,227,115,23,692
S01008938,331,205,38,6,580
S01008939,327,272,49,9,657
S01008940,195,263,48,0,506
S01008941,336,227,71,23,657
S01008942,299,203,75,1,578
S01008943,311,331,23,4,669
S01008944,382,364,55,7,808
S01008945,333,261,31,3,628
S01008946,327,362,64,14,767
S01008947,417,406,35,10,868
S01008948,331,187,37,15,570
S01008949,373,179,75,122,749
S01008950,416,188,70,100,774
S01008951,257,136,110,203,706
S01008952,232,104,140,186,662
S01008953,329,168,93,160,750
S01008954,303,158,103,181,745
S01008955,275,162,51,38,526
S01008956,414,163,88,60,725
S01008957,297,208,109,193,807
S01008958,261,90,60,192,603
S01008959,371,190,66,89,716
S01008960,441,152,60,17,670
S01008961,356,163,69,10,598
S01008962,276,207,36,9,528
S01008963,320,284,47,16,667
S01008964,239,173,24,0,436
S01008965,308,284,16,18,626
S01008966,240,214,27,0,481
S01008967,457,357,23,8,845
S01008968,460,314,21,27,822
S01008969,439,350,71,35,895
S01008970,450,303,63,20,836
S01008971,347,189,27,3,566
S01008972,316,259,56,1,632
S01008973,319,261,105,40,725
S01008974,250,217,157,25,649
S01008975,183,191,114,167,655
S01008976,227,174,16,8,425
S01008977,237,236,33,6,512
S01008978,239,116,105,11,471
S01008979,326,74,158,13,571
S01008980,312,98,182,26,618
S01008981,279,284,22,15,600
S01008982,294,124,193,16,627
S01008983,292,62,152,21,527
S01008984,179,76,127,6,388
S01008985,302,180,96,5,583
S01008986,343,259,56,0,658
S01008987,362,317,28,0,707
S01008988,308,307,230,80,925
S01008989,341,74,133,7,555
S01008990,361,123,155,2,641
S01008991,497,163,84,12,756
S01008992,207,149,79,50,485
S01008993,366,281,219,12,878
S01008994,257,138,47,183,625
S01008995,379,231,64,22,696
S01008996,186,151,44,100,481
S01008997,443,137,122,77,779
S01008998,141,54,51,215,461
S01008999,306,216,85,99,706
S01009000,393,274,73,15,755
S01009001,393,182,40,37,652
S01009002,223,129,249,55,656
S01009003,409,244,68,28,749
S01009004,321,138,45,28,532
S01009005,362,152,63,11,588
S01009006,296,155,66,84,601
S01009007,271,155,47,77,550
S01009008,316,303,86,73,778
S01009009,120,65,66,128,379
S01009010,466,187,87,77,817
S01009011,478,161,39,11,689
S01009012,374,187,39,7,607
S01009013,474,186,50,27,737
S01009014,186,168,48,93,495
S01009015,136,234,46,93,509
S01009016,113,222,39,60,434
S01009017,164,162,57,114,497
S01009018,163,270,58,109,600
S01009019,152,168,20,79,419
S01009020,226,169,104,133,632
S01009021,201,320,55,57,633
S01009022,240,375,64,106,785
S01009023,172,480,51,105,808
S01009024,199,393,87,163,842
S01009025,239,387,67,65,758
S01009026,261,385,65,56,767
S01009027,189,379,48,52,668
S01009028,140,234,18,37,429
S01009029,167,249,41,71,528
S01009030,163,326,28,92,609
S01009031,191,327,68,68,654
S01009032,159,314,54,30,557
S01009033,211,364,52,28,655
S01009034,206,258,59,34,557
S01009035,323,317,49,69,758
S01009036,338,262,69,143,812
S01009037,287,235,34,147,703
S01009038,326,296,83,161,866
S01009039,122,134,35,242,533
S01009040,161,157,85,155,558
S01009041,225,216,145,178,764
S01009042,249,215,68,190,722
S01009043,151,169,41,185,546
S01009044,217,267,61,201,746
S01009045,186,194,53,121,554
S01009046,307,277,66,58,708
S01009047,281,263,50,52,646
S01009048,297,315,28,44,684
S01009049,208,222,26,44,500
S01009050,343,197,37,97,674
S01009051,319,77,28,138,562
S01009052,255,172,41,70,538
S01009053,92,39,9,282,422
S01009054,205,95,27,150,477
S01009055,354,212,30,94,690
S01009056,156,48,27,199,430
S01009057,142,55,43,219,459
S01009058,303,95,56,218,672
S01009059,447,100,51,100,698
S01009060,321,65,21,2,409
S01009061,356,117,19,157,649
S01009062,197,113,14,212,536
S01009063,335,196,30,51,612
S01009064,227,92,19,133,471
S01009065,169,89,46,237,541
S01009066,240,123,36,192,591
S01009067,533,69,21,25,648
S01009068,327,168,66,170,731
S01009069,351,163,4,5,523
S01009070,302,154,36,32,524
S01009071,189,113,8,100,410
S01009072,225,99,35,53,412
S01009073,181,76,8,272,537
S01009074,163,100,27,289,579
S01009075,171,122,23,135,451
S01009076,514,184,47,20,765
S01009077,219,163,24,113,519
S01009078,470,52,22,24,568
S01009079,253,122,43,337,755
S01009080,272,191,32,278,773
S01009081,297,153,12,101,563
S01009082,370,122,35,303,830
S01009083,271,121,54,177,623
S01009084,212,72,34,65,383
S01009085,468,53,37,16,574
S01009086,303,85,22,151,561
S01009087,166,78,23,205,472
S01009088,457,251,56,72,836
S01009089,531,117,38,4,690
S01009090,471,66,95,10,642
S01009091,397,58,18,2,475
S01009092,396,236,74,164,870
S01009093,232,86,72,208,598
S01009094,247,288,14,25,574
S01009095,311,172,66,113,662
S01009096,499,103,77,98,777
S01009097,494,149,39,14,696
S01009098,236,156,20,12,424
S01009099,306,149,75,130,660
S01009100,196,93,63,297,649
S01009101,270,119,17,354,760
S01009102,148,49,9,392,598
S01009103,252,189,8,36,485
S01009104,256,150,46,196,648
S01009105,334,139,50,113,636
S01009106,222,96,55,82,455
S01009107,398,155,48,69,670
S01009108,321,244,32,13,610
S01009109,338,202,19,9,568
S01009110,268,112,10,107,497
S01009111,423,167,65,41,696
S01009112,248,198,17,5,468
S01009113,494,252,36,7,789
S01009114,395,97,18,102,612
S01009115,269,88,38,77,472
S01009116,223,160,18,2,403
S01009117,394,85,50,140,669
S01009118,359,78,10,23,470
S01009119,203,118,27,250,598
S01009120,189,91,24,139,443
S01009121,315,183,46,143,687
S01009122,322,203,76,176,777
S01009123,297,79,20,48,444
S01009124,257,32,29,87,405
S01009125,267,154,25,159,605
S01009126,94,37,31,296,458
S01009127,75,40,31,315,461
S01009128,152,72,77,384,685
S01009129,108,49,19,208,384
S01009130,276,54,16,157,503
S01009131,130,109,57,115,411
S01009132,388,120,86,38,632
S01009133,156,76,65,182,479
S01009134,361,214,63,125,763
S01009135,291,49,90,15,445
S01009136,421,57,121,19,618
S01009137,363,45,17,10,435
S01009138,391,195,106,17,709
S01009139,76,40,72,160,348
S01009140,222,105,79,208,614
S01009141,209,58,115,335,717
S01009142,171,138,140,96,545
S01009143,160,52,44,243,499
S01009144,345,60,127,8,540
S01009145,379,224,54,224,881
S01009146,253,119,166,218,756
S01009147,185,120,45,295,645
S01009148,193,113,13,228,547
S01009149,295,204,121,60,680
S01009150,12,133,14,583,742
S01009151,273,175,115,201,764
S01009152,120,85,214,204,623
S01009153,165,96,142,16,419
S01009154,360,302,160,29,851
S01009155,225,155,54,14,448
S01009156,222,181,35,21,459
S01009157,341,213,48,80,682
S01009158,216,104,42,100,462
S01009159,82,43,21,251,397
S01009160,195,99,75,213,582
S01009161,128,70,76,267,541
S01009162,215,93,126,207,641
S01009163,171,156,57,54,438
S01009164,251,127,35,183,596
S01009165,156,96,72,265,589
S01009166,215,70,39,347,671
S01009167,157,44,4,203,408
S01009168,247,276,35,2,560
S01009169,194,154,28,311,687
S01009170,220,82,64,162,528
S01009171,254,82,35,156,527
S01009172,309,203,40,2,554
S01009173,354,219,26,26,625
S01009174,278,41,17,8,344
S01009175,482,126,15,12,635
S01009176,415,332,42,10,799
S01009177,258,115,44,229,646
S01009178,211,77,23,256,567
S01009179,283,88,47,119,537
S01009180,339,173,49,242,803
S01009181,232,159,32,266,689
S01009182,487,194,39,86,806
S01009183,443,127,19,8,597
S01009184,222,132,36,301,691
S01009185,257,101,37,299,694
S01009186,296,135,34,190,655
S01009187,203,137,35,40,415
S01009188,287,134,29,261,711
S01009189,201,101,8,298,608
S01009190,446,122,35,35,638
S01009191,414,54,14,15,497
S01009192,599,270,55,68,992
S01009193,191,32,3,11,237
S01009194,345,292,27,7,671
S01009195,459,122,75,22,678
S01009196,263,162,39,117,581
S01009197,514,182,52,44,792
S01009198,340,193,20,57,610
S01009199,317,90,19,57,483
S01009200,525,263,22,81,891
S01009201,248,91,52,121,512
S01009202,290,74,16,19,399
S01009203,148,71,24,240,483
S01009204,309,114,27,234,684
S01009205,393,174,34,6,607
S01009206,418,214,38,17,687
S01009207,347,302,32,3,684
S01009208,223,207,40,69,539
S01009209,275,249,44,23,591
S01009210,245,142,45,38,470
S01009211,236,106,51,107,500
S01009212,235,178,35,233,681
S01009213,317,117,37,273,744
S01009214,488,213,23,100,824
S01009215,295,179,30,254,758
S01009216,311,181,49,213,754
S01009217,142,46,22,276,486
S01009218,305,229,39,142,715
S01009219,204,151,35,156,546
S01009220,130,134,31,149,444
S01009221,201,115,16,126,458
S01009222,141,70,38,163,412
S01009223,196,109,33,124,462
S01009224,209,77,28,203,517
S01009225,175,111,48,123,457
S01009226,271,179,51,293,794
S01009227,196,122,64,145,527
S01009228,144,102,49,202,497
S01009229,167,167,41,109,484
S01009230,271,100,83,36,490
S01009231,418,260,64,66,808
S01009232,90,64,20,290,464
S01009233,219,136,24,107,486
S01009234,155,89,60,475,779
S01009235,248,141,42,327,758
S01009236,155,183,11,69,418
S01009237,387,287,52,22,748
S01009238,280,188,27,133,628
S01009239,265,107,35,293,700
S01009240,115,43,23,358,539
S01009241,207,122,25,365,719
S01009242,298,238,10,85,631
S01009243,415,133,86,134,768
S01009244,342,298,39,13,692
S01009245,362,237,49,61,709
S01009246,284,159,47,195,685
S01009247,370,137,61,252,820
S01009248,281,202,20,83,586
S01009249,239,101,55,257,652
S01009250,219,129,31,141,520
S01009251,200,128,13,119,460
S01009252,280,65,5,7,357
S01009253,117,103,20,156,396
S01009254,160,79,25,390,654
S01009255,160,59,147,181,547
S01009256,163,156,24,68,411
S01009257,216,160,109,111,596
S01009258,232,214,44,47,537
S01009259,431,238,30,62,761
S01009260,468,181,112,202,963
S01009261,150,88,49,338,625
S01009262,86,53,34,284,457
S01009263,446,88,88,24,646
S01009264,209,195,53,6,463
S01009265,272,188,51,158,669
S01009266,294,243,58,114,709
S01009267,328,214,101,70,713
S01009268,358,169,72,173,772
S01009269,209,72,26,362,669
S01009270,145,104,42,207,498
S01009271,490,215,31,6,742
S01009272,203,97,26,225,551
S01009273,191,200,11,11,413
S01009274,254,184,21,52,511
S01009275,282,154,114,10,560
S01009276,352,277,28,96,753
S01009277,200,208,31,5,444
S01009278,272,105,32,26,435
S01009279,237,144,48,69,498
S01009280,153,112,42,389,696
S01009281,189,128,41,308,666
S01009282,256,201,92,74,623
S01009283,209,71,30,44,354
S01009284,417,191,27,13,648
S01009285,468,167,53,15,703
S01009286,333,263,42,14,652
S01009287,263,298,47,17,625
S01009288,294,238,146,20,698
S01009289,390,303,41,26,760
S01009290,258,268,8,2,536
S01009291,441,302,51,15,809
S01009292,184,79,43,118,424
S01009293,327,138,41,66,572
S01009294,248,133,16,2,399
S01009295,311,189,21,6,527
S01009296,305,84,10,26,425
S01009297,420,201,40,13,674
S01009298,262,142,132,307,843
S01009299,372,173,134,131,810
S01009300,195,71,70,106,442
S01009301,242,99,134,357,832
S01009302,190,62,111,325,688
S01009303,347,224,66,26,663
S01009304,399,190,31,148,768
S01009305,284,147,102,117,650
S01009306,394,142,185,174,895
S01009307,357,209,255,77,898
S01009308,133,113,131,57,434
S01009309,242,129,185,66,622
S01009310,377,321,86,18,802
S01009311,206,79,37,246,568
S01009312,249,104,158,64,575
S01009313,155,94,53,157,459
S01009314,295,181,34,29,539
S01009315,239,109,36,156,540
S01009316,345,196,58,20,619
S01009317,409,274,22,4,709
S01009318,292,180,21,5,498
S01009319,374,325,53,22,774
S01009320,315,121,29,131,596
S01009321,297,233,25,9,564
S01009322,345,210,51,65,671
S01009323,242,185,46,82,555
S01009324,213,98,49,86,446
S01009325,408,129,63,16,616
S01009326,277,45,39,85,446
S01009327,210,206,16,52,484
S01009328,386,25,65,0,476
S01009329,234,28,39,33,334
S01009330,143,33,41,134,351
S01009331,330,43,25,0,398
S01009332,480,224,30,15,749
S01009333,280,106,110,91,587
S01009334,179,81,44,204,508
S01009335,245,133,54,200,632
S01009336,118,77,54,267,516
S01009337,193,65,34,270,562
S01009338,196,78,46,303,623
S01009339,172,69,56,339,636
S01009340,163,94,42,182,481
S01009341,202,101,51,139,493
S01009342,287,122,52,146,607
S01009343,273,91,48,40,452
S01009344,172,111,45,200,528
S01009345,399,146,105,90,740
S01009346,409,46,17,4,476
S01009347,375,78,8,0,461
S01009348,313,21,16,0,350
S01009349,451,50,55,5,561
S01009350,238,21,92,93,444
S01009351,251,41,91,5,388
S01009352,460,46,53,2,561
S01009353,223,40,29,0,292
S01009354,527,48,56,2,633
S01009355,400,266,50,16,732
S01009356,469,302,44,11,826
S01009357,227,53,80,2,362
S01009358,410,138,6,0,554
S01009359,415,77,67,16,575
S01009360,355,236,80,32,703
S01009361,333,214,47,55,649
S01009362,501,302,54,9,866
S01009363,302,189,56,137,684
S01009364,449,108,71,64,692
S01009365,229,147,49,52,477
S01009366,280,164,65,118,627
S01009367,208,110,67,126,511
S01009368,168,68,26,181,443
S01009369,236,107,47,94,484
S01009370,332,224,48,130,734
S01009371,219,95,52,69,435
S01009372,205,81,41,100,427
S01009373,264,98,72,209,643
S01009374,280,184,49,229,742
S01009375,270,123,47,189,629
S01009376,205,90,30,152,477
S01009377,581,76,254,103,1014
S01009378,304,59,68,307,738
S01009379,469,39,51,126,685
S01009380,273,56,122,17,468
S01009381,286,114,87,50,537
S01009382,273,125,63,215,676
S01009383,254,110,137,183,684
S01009384,221,173,44,27,465
S01009385,202,121,33,54,410
S01009386,227,145,30,131,533
S01009387,170,86,44,179,479
S01009388,138,53,90,399,680
S01009389,316,263,132,94,805
S01009390,439,91,24,2,556
S01009391,401,58,53,0,512
S01009392,303,49,25,0,377
S01009393,344,178,31,8,561
S01009394,361,206,215,8,790
S01009395,296,266,15,3,580
S01009396,278,290,34,9,611
S01009397,330,202,61,2,595
S01009398,339,128,88,4,559
S01009399,298,213,56,27,594
S01009400,235,125,34,31,425
S01009401,264,269,31,11,575
S01009402,447,289,38,4,778
S01009403,279,87,20,32,418
S01009404,158,78,48,160,444
S01009405,154,135,25,15,329
S01009406,377,207,91,145,820
S01009407,227,105,28,66,426
S01009408,353,130,64,50,597
S01009409,231,149,41,134,555
S01009410,221,97,55,323,696
S01009411,261,133,51,246,691
S01009412,266,137,26,281,710
S01009413,400,207,65,174,846
S01009414,278,136,31,112,557
S01009415,291,134,128,131,684
S01009416,261,123,15,39,438
S01009417,140,35,30,22,227
S01009418,371,183,112,267,933
S01009419,194,69,23,170,456
S01009420,106,47,21,301,475
S01009421,147,107,23,274,551
S01009422,302,170,43,158,673
S01009423,540,85,53,24,702
S01009424,263,114,40,91,508
S01009425,257,209,52,129,647
S01009426,186,94,63,310,653
S01009427,164,89,40,209,502
S01009428,213,96,31,180,520
S01009429,155,119,45,270,589
S01009430,200,116,68,218,602
S01009431,160,167,69,154,550
S01009432,164,77,36,347,624
S01009433,206,77,44,303,630
S01009434,145,89,20,188,442
S01009435,110,62,24,387,583
S01009436,199,88,45,208,540
S01009437,278,101,33,154,566
S01009438,232,128,28,331,719
S01009439,229,105,31,366,731
S01009440,170,102,40,252,564
S01009441,116,65,46,405,632
S01009442,226,98,82,26,432
S01009443,274,150,67,75,566
S01009444,418,170,46,36,670
S01009445,289,142,27,182,640
S01009446,226,124,78,321,749
S01009447,158,97,36,128,419
S01009448,341,143,42,139,665
S01009449,159,113,33,119,424
S01009450,106,54,46,271,477
S01009451,220,145,66,342,773
S01009452,123,84,54,166,427
S01009453,346,180,79,269,874
S01009454,347,231,93,43,714
S01009455,278,336,82,18,714
S01009456,240,130,70,139,579
S01009457,208,184,92,36,520
S01009458,241,155,79,91,566
S01009459,283,160,103,171,717
S01009460,149,47,57,395,648
S01009461,319,72,7,13,411
S01009462,245,161,34,113,553
S01009463,239,175,29,115,558
S01009464,357,230,50,51,688
S01009465,221,138,21,106,486
S01009466,243,225,21,2,491
S01009467,321,253,44,37,655
S01009468,270,133,52,182,637
S01009469,307,247,65,70,689
S01009470,173,139,25,60,397
S01009471,94,84,86,328,592
S01009472,180,148,74,327,729
S01009473,139,91,281,226,737
S01009474,243,101,67,271,682
S01009475,297,104,37,6,444
S01009476,235,63,51,4,353
S01009477,294,195,79,59,627
S01009478,247,130,225,132,734
S01009479,260,191,184,113,748
S01009480,310,274,73,62,719
S01009481,332,186,220,61,799
S01009482,218,118,201,28,565
S01009483,299,150,152,11,612
S01009484,205,230,104,143,682
S01009485,199,173,83,198,653
S01009486,216,228,44,79,567
S01009487,259,173,63,171,666
S01009488,263,128,27,116,534
S01009489,217,139,75,240,671
S01009490,169,96,46,342,653
S01009491,208,161,33,190,592
S01009492,260,121,39,191,611
S01009493,292,407,25,11,735
S01009494,425,196,107,14,742
S01009495,459,192,69,5,725
S01009496,258,161,73,166,658
S01009497,435,185,65,121,806
S01009498,260,264,18,10,552
S01009499,269,219,32,142,662
S01009500,206,94,44,288,632
S01009501,201,105,37,225,568
S01009502,202,118,43,303,666
S01009503,282,94,47,165,588
S01009504,163,69,29,263,524
S01009505,123,68,49,353,593
S01009506,187,61,46,274,568
S01009507,306,116,41,199,662
S01009508,173,82,51,368,674
S01009509,278,133,73,312,796
S01009510,303,264,13,19,599
S01009511,245,236,28,15,524
S01009512,364,227,31,7,629
S01009513,264,190,27,5,486
S01009514,327,222,24,9,582
S01009515,218,141,28,226,613
S01009516,312,207,71,166,756
S01009517,516,85,73,26,700
S01009518,519,57,64,19,659
S01009519,184,125,22,69,400
S01009520,397,144,56,60,657
S01009521,166,189,41,303,699
S01009522,270,87,133,265,755
S01009523,146,72,38,225,481
S01009524,135,73,105,216,529
S01009525,147,91,95,111,444
S01009526,179,109,265,20,573
S01009527,162,113,177,119,571
S01009528,105,139,75,169,488
S01009529,234,185,40,45,504
S01009530,261,207,17,10,495
S01009531,212,132,83,251,678
S01009532,177,155,63,309,704
S01009533,195,89,132,235,651
S01009534,92,60,79,418,649
S01009535,91,31,34,328,484
S01009536,174,54,31,155,414
S01009537,174,104,42,129,449
S01009538,180,86,101,303,670
S01009539,336,191,42,167,736
S01009540,224,128,73,289,714
S01009541,319,141,133,44,637
S01009542,146,70,42,326,584
S01009543,156,163,57,102,478
S01009544,242,119,171,191,723
S01009545,217,180,77,170,644
S01009546,436,123,26,205,790
S01009547,166,142,93,196,597
S01009548,219,145,70,136,570
S01009549,300,186,74,87,647
S01009550,226,124,26,37,413
S01009551,204,93,90,33,420
S01009552,334,214,55,171,774
S01009553,208,120,57,315,700
S01009554,179,128,62,182,551
S01009555,267,177,99,87,630
S01009556,227,93,63,219,602
S01009557,156,86,88,194,524
S01009558,159,83,83,186,511
S01009559,253,124,84,219,680
S01009560,194,103,122,173,592
S01009561,142,74,82,123,421
S01009562,267,172,79,92,610
S01009563,243,179,115,104,641
S01009564,249,186,54,75,564
S01009565,172,108,74,101,455
S01009566,445,154,95,120,814
S01009567,291,175,135,112,713
S01009568,279,129,60,115,583
S01009569,287,187,83,107,664
S01009570,198,92,65,92,447
S01009571,153,70,109,206,538
S01009572,258,126,150,306,840
S01009573,173,104,96,210,583
S01009574,336,211,133,178,858
S01009575,196,86,41,104,427
S01009576,222,193,38,4,457
S01009577,331,173,29,63,596
S01009578,312,117,92,90,611
S01009579,363,138,38,301,840
S01009580,528,149,44,25,746
S01009581,200,133,51,87,471
S01009582,202,83,62,64,411
S01009583,297,93,84,147,621
S01009584,213,132,67,18,430
S01009585,389,148,88,147,772
S01009586,222,196,48,121,587
S01009587,254,196,57,111,618
S01009588,415,248,64,168,895
S01009589,367,147,62,166,742
S01009590,396,161,14,9,580
S01009591,305,206,48,7,566
S01009592,245,210,24,12,491
S01009593,313,137,26,14,490
S01009594,386,133,19,3,541
S01009595,287,70,20,19,396
S01009596,277,89,67,205,638
S01009597,207,37,76,311,631
S01009598,93,33,14,376,516
S01009599,349,106,78,188,721
S01009600,145,29,57,278,509
S01009601,220,69,87,157,533
S01009602,456,111,27,18,612
S01009603,254,122,21,73,470
S01009604,384,94,74,150,702
S01009605,174,93,56,319,642
S01009606,345,77,30,15,467
S01009607,245,157,26,15,443
S01009608,227,108,45,107,487
S01009609,353,179,73,59,664
S01009610,352,260,93,129,834
S01009611,175,171,90,10,446
S01009612,222,132,31,120,505
S01009613,212,132,28,6,378
S01009614,177,152,84,19,432
S01009615,157,140,12,33,342
S01009616,289,157,54,109,609
S01009617,371,178,37,9,595
S01009618,228,120,89,130,567
S01009619,191,123,52,152,518
S01009620,186,138,68,269,661
S01009621,227,171,94,161,653
S01009622,114,95,68,309,586
S01009623,135,105,42,127,409
S01009624,259,176,51,246,732
S01009625,262,117,64,240,683
S01009626,85,89,17,259,450
S01009627,240,155,32,228,655
S01009628,124,108,26,213,471
S01009629,328,167,82,248,825
S01009630,172,100,59,300,631
S01009631,116,77,107,286,586
S01009632,89,62,76,222,449
S01009633,120,71,52,303,546
S01009634,115,122,28,203,468
S01009635,285,180,65,175,705
S01009636,182,129,191,248,750
S01009637,270,122,66,155,613
S01009638,124,74,68,287,553
S01009639,307,316,43,26,692
S01009640,130,116,72,193,511
S01009641,179,178,127,198,682
S01009642,333,183,147,117,780
S01009643,315,52,15,53,435
S01009644,289,153,40,177,659
S01009645,203,128,52,147,530
S01009646,196,116,15,142,469
S01009647,120,142,42,206,510
S01009648,298,175,50,193,716
S01009649,365,192,33,254,844
S01009650,295,364,20,11,690
S01009651,255,313,136,84,788
S01009652,257,365,63,12,697
S01009653,238,177,15,12,442
S01009654,178,189,51,56,474
S01009655,228,144,33,279,684
S01009656,152,135,56,268,611
S01009657,291,192,31,141,655
S01009658,238,101,34,192,565
S01009659,196,98,19,101,414
S01009660,349,156,56,282,843
S01009661,302,289,107,8,706
S01009662,285,182,42,77,586
S01009663,222,171,63,73,529
S01009664,328,227,124,53,732
S01009665,231,164,45,94,534
S01009666,292,180,86,81,639
S01009667,200,181,33,21,435
S01009668,274,130,37,19,460
S01009669,164,184,51,37,436
S01009670,309,184,48,108,649
S01009671,246,120,116,39,521
S01009672,263,134,60,191,648
S01009673,325,186,68,94,673
S01009674,312,257,102,55,726
S01009675,351,256,77,62,746
S01009676,281,195,103,78,657
S01009677,187,180,95,20,482
S01009678,201,182,55,69,507
S01009679,269,194,110,177,750
S01009680,280,174,72,138,664
S01009681,312,122,54,102,590
S01009682,245,157,80,22,504
S01009683,335,277,82,63,757
S01009684,424,239,137,39,839
S01009685,201,107,68,145,521
S01009686,337,137,218,229,921
S01009687,266,117,117,70,570
S01009688,133,74,80,417,704
S01009689,163,101,155,99,518
S01009690,273,115,100,103,591
S01009691,214,208,71,7,500
S01009692,351,416,91,58,916
S01009693,242,210,44,23,519
S01009694,367,397,85,23,872
S01009695,207,206,76,30,519
S01009696,354,272,109,55,790
S01009697,252,209,80,46,587
S01009698,161,193,124,7,485
S01009699,100,205,61,44,410
S01009700,174,163,137,75,549
S01009701,78,211,44,70,403
S01009702,169,181,112,55,517
S01009703,160,167,30,126,483
S01009704,262,344,88,88,782
S01009705,197,172,58,189,616
S01009706,176,151,80,100,507
S01009707,190,128,80,4,402
S01009708,200,190,49,78,517
S01009709,257,250,93,91,691
S01009710,226,103,51,60,440
S01009711,250,171,67,169,657
S01009712,167,193,103,38,501
S01009713,234,312,117,110,773
S01009714,271,354,98,77,800
S01009715,129,211,171,52,563
S01009716,190,255,157,47,649
S01009717,158,166,287,291,902
S01009718,140,153,125,206,624
S01009719,169,165,110,202,646
S01009720,175,155,198,181,709
S01009721,41,49,469,2,561
S01009722,80,191,730,75,1076
S01009723,53,88,530,82,753
S01009724,105,103,401,280,889
S01009725,56,106,462,33,657
S01009726,93,138,751,42,1024
S01009727,197,200,165,112,674
S01009728,271,274,74,19,638
S01009729,197,298,51,6,552
S01009730,106,157,167,79,509
S01009731,136,284,104,4,528
S01009732,96,238,368,42,744
S01009733,138,212,60,8,418
S01009734,276,257,166,33,732
S01009735,391,584,149,7,1131
S01009736,155,597,1729,152,2633
S01009737,117,108,271,139,635
S01009738,174,57,105,33,369
S01009739,174,48,260,87,569
S01009740,130,112,79,124,445
S01009741,51,36,526,89,702
S01009742,118,171,119,8,416
S01009743,340,301,110,42,793
S01009744,289,213,77,13,592
S01009745,438,290,96,46,870
S01009746,149,156,137,13,455
S01009747,212,129,136,79,556
S01009748,300,189,50,47,586
S01009749,381,290,59,82,812
S01009750,244,127,71,117,559
S01009751,275,133,73,197,678
S01009752,234,209,37,14,494
S01009753,274,189,67,69,599
S01009754,274,257,89,98,718
S01009755,280,177,54,33,544
S01009756,307,218,49,46,620
S01009757,256,213,31,37,537
S01009758,327,107,56,22,512
S01009759,43,15,23,600,681
S01009760,126,90,51,412,679
S01009761,438,180,70,51,739
S01009762,66,12,33,621,732
S01009763,413,130,26,15,584
S01009764,220,22,35,220,497
S01009765,463,64,68,170,765
S01009766,333,66,43,14,456
S01009767,118,42,39,269,468
S01009768,195,9,47,211,462
S01009769,399,41,89,36,565
S01009770,391,79,83,7,560
S01009771,484,118,56,11,669
S01009772,369,85,42,4,500
S01009773,331,36,42,10,419
S01009774,304,29,12,8,353
S01009775,166,72,67,374,679
S01009776,38,34,14,441,527
S01009777,149,15,130,92,386
S01009778,126,88,41,454,709
S01009779,71,30,25,321,447
S01009780,16,12,19,396,443
S01009781,72,46,13,293,424
S01009782,215,14,40,125,394
S01009783,179,19,36,329,563
S01009784,59,26,21,484,590
S01009785,97,88,30,434,649
S01009786,157,89,41,458,745
S01009787,168,104,34,391,697
S01009788,289,192,58,176,715
S01009789,279,163,54,250,746
S01009790,245,108,38,126,517
S01009791,157,78,57,236,528
S01009792,558,56,81,21,716
S01009793,385,251,84,39,759
S01009794,326,49,19,3,397
S01009795,470,118,40,15,643
S01009796,421,158,30,12,621
S01009797,425,138,52,12,627
S01009798,415,103,30,6,554
S01009799,103,72,24,475,674
S01009800,340,114,87,303,844
S01009801,220,106,31,340,697
S01009802,345,63,35,327,770
S01009803,197,72,56,309,634
S01009804,270,48,80,56,454
S01009805,277,87,88,289,741
S01009806,322,183,129,150,784
S01009807,321,138,122,212,793
S01009808,194,65,77,356,692
S01009809,225,119,111,105,560
S01009810,161,76,63,369,669
S01009811,308,153,107,338,906
S01009812,275,124,66,160,625
S01009813,37,18,45,461,561
S01009814,358,187,42,107,694
S01009815,279,146,105,59,589
S01009816,365,112,85,23,585
S01009817,264,139,33,146,582
S01009818,367,426,37,20,850
S01009819,259,178,45,82,564
S01009820,372,214,57,145,788
S01009821,318,153,33,27,531
S01009822,212,51,35,60,358
S01009823,230,108,89,172,599
S01009824,355,79,45,177,656
S01009825,317,116,52,319,804
S01009826,163,71,28,192,454
S01009827,253,129,62,249,693
S01009828,153,83,43,377,656
S01009829,334,130,159,168,791
S01009830,306,102,131,77,616
S01009831,308,131,139,13,591
S01009832,375,233,144,71,823
S01009833,282,60,67,51,460
S01009834,270,21,44,293,628
S01009835,101,39,19,256,415
S01009836,447,172,71,123,813
S01009837,196,94,32,286,608
S01009838,193,110,89,240,632
S01009839,99,41,94,581,815
S01009840,270,174,119,283,846
S01009841,44,37,63,549,693
S01009842,89,37,50,346,522
S01009843,90,20,28,355,493
S01009844,8,8,24,436,476
S01009845,28,5,80,496,609
S01009846,159,64,87,401,711
S01009847,58,24,66,319,467
S01009848,240,144,72,281,737
S01009849,216,154,100,191,661
S01009850,343,170,95,154,762
S01009851,242,160,63,272,737
S01009852,237,104,51,101,493
S01009853,314,156,82,154,706
S01009854,303,49,93,243,688
S01009855,268,93,29,98,488
S01009856,212,182,68,85,547
S01009857,353,152,52,173,730
S01009858,323,140,44,124,631
S01009859,170,86,107,519,882
S01009860,62,54,137,538,791
S01009861,130,44,196,524,894
S01009862,157,73,310,419,959
S01009863,124,77,294,190,685
S01009864,129,56,165,160,510
S01009865,146,66,107,74,393
S01009866,312,154,189,125,780
S01009867,339,99,373,135,946
S01009868,207,102,287,24,620
S01009869,168,42,236,16,462
S01009870,170,46,177,103,496
S01009871,208,150,149,343,850
S01009872,216,97,274,16,603
S01009873,333,210,113,130,786
S01009874,258,237,69,301,865
S01009875,78,21,199,217,515
S01009876,52,29,74,369,524
S01009877,331,276,107,45,759
S01009878,192,113,149,87,541
S01009879,391,256,67,18,732
S01009880,289,186,116,19,610
S01009881,135,87,149,28,399
S01009882,286,49,497,102,934
S01009883,225,97,264,15,601
S01009884,303,104,185,41,633
S01009885,326,154,166,15,661
S01009886,214,160,160,90,624
S01009887,137,57,334,244,772
S01009888,179,59,236,52,526
S01009889,202,73,206,169,650
S01009890,49,15,77,297,438
S01009891,155,99,242,137,633
S01009892,77,34,143,452,706
S01009893,194,102,329,45,670
S01009894,83,59,110,435,687
S01009895,117,25,132,345,619
S01009896,184,57,111,415,767
S01009897,317,185,150,156,808
S01009898,105,88,76,219,488
S01009899,308,95,215,65,683
S01009900,381,115,229,14,739
S01009901,368,101,254,16,739
S01009902,267,194,141,200,802
S01009903,343,149,142,16,650
S01009904,294,89,218,93,694
S01009905,219,63,298,40,620
S01009906,188,91,232,44,555
S01009907,192,47,358,131,728
S01009908,425,149,242,39,855
S01009909,326,103,312,25,766
S01009910,186,51,211,5,453
S01009911,431,265,119,24,839
S01009912,399,268,76,45,788
S01009913,261,230,86,12,589
S01009914,387,342,77,11,817
S01009915,390,271,78,11,750
S01009916,401,280,76,17,774
S01009917,279,202,100,10,591
S01009918,330,184,46,17,577
S01009919,217,161,408,161,947
S01009920,315,135,303,28,781
S01009921,275,69,228,18,590
S01009922,344,187,401,6,938
S01009923,322,151,282,32,787
S01009924,330,107,364,93,894
S01009925,238,77,279,5,599
S01009926,291,107,224,35,657
S01009927,208,95,101,38,442
S01009928,420,179,156,5,760
S01009929,212,125,67,16,420
S01009930,354,88,264,49,755
S01009931,370,118,192,10,690
S01009932,242,94,191,46,573
S01009933,106,24,180,451,761
S01009934,335,147,214,55,751
S01009935,71,73,46,310,500
S01009936,161,38,84,283,566
S01009937,21,23,45,311,400
S01009938,227,116,110,362,815
S01009939,28,16,34,608,686
S01009940,128,90,45,413,676
S01009941,500,105,113,34,752
S01009942,215,124,79,416,834
S01009943,146,75,28,419,668
S01009944,275,140,99,141,655
S01009945,258,115,113,302,788
S01009946,314,137,66,152,669
S01009947,167,121,67,114,469
S01009948,176,85,28,380,669
S01009949,284,146,91,144,665
S01009950,344,194,44,10,592
S01009951,334,222,42,15,613
S01009952,317,224,38,17,596
S01009953,381,261,44,46,732
S01009954,309,140,45,15,509
S01009955,411,265,110,65,851
S01009956,251,170,113,81,615
S01009957,330,233,38,8,609
S01009958,451,252,31,11,745
S01009959,297,214,38,5,554
S01009960,366,292,69,29,756
S01009961,252,201,40,86,579
S01009962,312,192,284,98,886
S01009963,371,257,35,0,663
S01009964,396,231,96,18,741
S01009965,345,212,21,33,611
S01009966,390,223,24,5,642
S01009967,347,290,52,9,698
S01009968,301,190,16,13,520
S01009969,373,229,45,51,698
S01009970,103,48,49,530,730
S01009971,249,62,43,504,858
S01009972,334,126,45,172,677
S01009973,289,36,28,210,563
S01009974,19,14,14,420,467
S01009975,43,19,39,526,627
S01009976,99,22,18,244,383
S01009977,78,35,13,685,811
S01009978,156,27,40,549,772
S01009979,41,25,23,424,513
S01009980,64,25,33,416,538
S01009981,68,11,32,420,531
S01009982,323,41,54,347,765
S01009983,2,2,19,401,424
S01009984,245,40,44,250,579
S01009985,45,7,9,404,465
S01009986,37,33,18,356,444
S01009987,200,57,39,449,745
S01009988,48,42,19,336,445
S01009989,327,129,111,100,667
S01009990,313,114,118,6,551
S01009991,382,99,139,2,622
S01009992,115,41,32,384,572
S01009993,383,124,148,2,657
S01009994,304,94,126,6,530
S01009995,297,104,129,4,534
S01009996,300,89,153,28,570
S01009997,260,109,91,8,468
S01009998,249,204,52,16,521
S01009999,324,208,60,4,596
S01010000,279,83,119,7,488
S01010001,334,99,150,32,615
S01010002,346,158,128,10,642
S01010003,329,184,36,20,569
S01010004,333,250,26,6,615
S01010005,241,119,174,146,680
S01010006,303,158,215,132,808
S01010007,449,240,99,15,803
S01010008,189,77,201,99,566
S01010009,230,42,193,61,526
S01010010,503,250,88,14,855
S01010011,220,99,160,222,701
S01010012,357,234,78,15,684
S01010013,311,100,239,45,695
S01010014,481,189,122,79,871
S01010015,336,96,232,45,709
S01010016,278,146,28,157,609
S01010017,149,71,55,330,605
S01010018,267,91,85,353,796
S01010019,44,38,29,472,583
S01010020,242,132,43,207,624
S01010021,44,25,64,489,622
S01010022,172,44,148,407,771
S01010023,20,40,25,450,535
S01010024,70,23,130,400,623
S01010025,56,15,40,358,469
S01010026,163,40,111,442,756
S01010027,207,63,165,324,759
S01010028,98,29,77,341,545
S01010029,86,105,25,355,571
S01010030,257,83,203,158,701
S01010031,226,68,407,27,728
S01010032,206,43,471,82,802
S01010033,108,45,231,383,767
S01010034,156,112,111,501,880
S01010035,57,26,66,421,570
S01010036,80,41,608,36,765
S01010037,95,75,64,329,563
S01010038,164,84,189,428,865
S01010039,230,51,592,57,930
S01010040,245,81,245,93,664
S01010041,141,56,230,198,625
S01010042,219,46,571,136,972
S01010043,144,53,152,304,653
S01010044,282,98,290,321,991
S01010045,37,23,19,337,416
S01010046,99,96,109,341,645
S01010047,73,29,44,546,692
S01010048,91,67,88,562,808
S01010049,26,14,67,495,602
S01010050,63,26,104,612,805
S01010051,57,41,102,404,604
S01010052,76,39,146,293,554
S01010053,101,51,208,338,698
S01010054,22,2,12,372,408
S01010055,206,97,266,390,959
S01010056,13,12,23,309,357
S01010057,86,30,82,134,332
S01010058,134,30,161,286,611
S01010059,151,81,176,137,545
S01010060,163,89,96,418,766
S01010061,219,51,83,64,417
S01010062,138,97,64,293,592
S01010063,143,57,161,492,853
S01010064,144,56,72,168,440
S01010065,190,102,64,352,708
S01010066,135,74,67,330,606
S01010067,40,12,50,364,466
S01010068,134,22,197,169,522
S01010069,457,159,47,32,695
S01010070,407,110,27,10,554
S01010071,362,158,39,119,678
S01010072,364,175,33,119,691
S01010073,314,273,28,54,669
S01010074,355,287,33,17,692
S01010075,223,135,35,146,539
S01010076,285,96,50,120,551
S01010077,193,62,34,220,509
S01010078,314,144,16,34,508
S01010079,454,286,33,18,791
S01010080,275,269,22,9,575
S01010081,296,265,29,24,614
S01010082,351,242,138,9,740
S01010083,295,127,48,137,607
S01010084,324,134,64,225,747
S01010085,373,239,24,19,655
S01010086,295,142,48,290,775
S01010087,233,248,15,9,505
S01010088,509,29,48,24,610
S01010089,272,122,101,122,617
S01010090,518,166,121,69,874
S01010091,368,60,82,162,672
S01010092,269,151,90,310,820
S01010093,412,171,87,59,729
S01010094,281,206,27,47,561
S01010095,369,209,15,0,593
S01010096,374,209,22,10,615
S01010097,322,183,54,42,601
S01010098,360,221,13,4,598
S01010099,324,232,28,6,590
S01010100,455,229,38,41,763
S01010101,362,204,51,25,642
S01010102,577,125,29,16,747
S01010103,620,118,30,4,772
S01010104,471,41,30,9,551
S01010105,69,19,56,168,312
S01010106,77,56,20,202,355
S01010107,201,37,163,244,645
S01010108,330,67,38,186,621
S01010109,252,65,182,158,657
S01010110,89,63,33,497,682
S01010111,44,29,62,617,752
S01010112,36,8,23,660,727
S01010113,77,25,54,238,394
S01010114,26,18,15,554,613
S01010115,299,72,45,68,484
S01010116,520,58,123,91,792
S01010117,353,36,42,69,500
S01010118,12,17,17,430,476
S01010119,57,0,15,315,387
S01010120,85,10,26,649,770
S01010121,33,7,17,473,530
S01010122,12,23,10,333,378
S01010123,54,16,19,444,533
S01010124,296,47,108,53,504
S01010125,121,30,23,225,399
S01010126,305,59,64,164,592
S01010127,136,73,15,300,524
S01010128,18,2,16,306,342
S01010129,60,16,37,435,548
S01010130,67,14,9,249,339
S01010131,515,284,31,8,838
S01010132,151,142,89,424,806
S01010133,135,93,40,337,605
S01010134,269,171,94,304,838
S01010135,178,158,53,248,637
S01010136,335,167,88,88,678
S01010137,285,194,138,230,847
S01010138,84,93,35,626,838
S01010139,255,170,102,367,894
S01010140,311,56,197,30,594
S01010141,68,32,96,464,660
S01010142,135,72,85,197,489
S01010143,226,117,42,245,630
S01010144,143,49,108,273,573
S01010145,193,111,216,128,648
S01010146,143,29,80,373,625
S01010147,71,18,126,529,744
S01010148,75,64,85,374,598
S01010149,289,41,101,63,494
S01010150,96,117,74,252,539
S01010151,117,102,22,308,549
S01010152,292,179,102,160,733
S01010153,302,139,83,298,822
S01010154,224,233,85,239,781
S01010155,238,174,43,207,662
S01010156,115,82,21,256,474
S01010157,27,37,9,412,485
S01010158,287,186,105,211,789
S01010159,201,165,42,218,626
S01010160,29,12,20,410,471
S01010161,236,19,6,221,482
S01010162,42,14,10,570,636
S01010163,83,66,44,270,463
S01010164,227,78,38,283,626
S01010165,36,83,11,357,487
S01010166,246,81,43,234,604
S01010167,165,123,73,330,691
S01010168,156,43,58,139,396
S01010169,192,54,83,336,665
S01010170,125,48,49,211,433
S01010171,88,35,42,616,781
S01010172,137,125,73,287,622
S01010173,305,155,25,153,638
S01010174,745,285,105,172,1307
S01010175,164,67,58,93,382
S01010176,209,131,51,197,588
S01010177,80,21,25,443,569
S01010178,57,20,45,616,738
S01010179,151,75,39,422,687
S01010180,181,26,58,132,397
S01010181,113,62,24,287,486
S01010182,353,147,50,27,577
S01010183,97,76,23,192,388
S01010184,91,96,29,298,514
S01010185,116,64,20,285,485
S01010186,342,128,43,8,521
S01010187,353,132,46,15,546
S01010188,412,120,60,17,609
S01010189,605,84,40,9,738
S01010190,451,78,32,18,579
S01010191,421,49,46,13,529
S01010192,499,76,39,15,629
S01010193,441,145,74,24,684
S01010194,278,127,12,130,547
S01010195,221,71,42,95,429
S01010196,142,116,34,339,631
S01010197,106,82,28,331,547
S01010198,270,175,60,343,848
S01010199,86,55,14,255,410
S01010200,250,133,21,174,578
S01010201,280,122,32,75,509
S01010202,12,24,20,477,533
S01010203,356,41,99,19,515
S01010204,95,65,44,422,626
S01010205,168,98,53,247,566
S01010206,8,3,152,176,339
S01010207,20,31,154,269,474
S01010208,298,53,204,236,791
S01010209,233,102,74,409,818
S01010210,303,210,73,165,751
S01010211,148,100,58,405,711
S01010212,107,54,69,645,875
S01010213,252,161,87,293,793
S01010214,397,229,97,76,799
S01010215,65,38,28,572,703
S01010216,69,12,42,402,525
S01010217,79,22,92,426,619
S01010218,222,65,90,460,837
S01010219,15,19,27,338,399
S01010220,185,52,168,27,432
S01010221,22,20,36,391,469
S01010222,90,32,96,216,434
S01010223,105,41,87,260,493
S01010224,74,9,33,681,797
S01010225,160,44,84,375,663
S01010226,23,28,22,515,588
S01010227,13,12,29,410,464
S01010228,103,97,31,382,613
S01010229,265,43,40,477,825
S01010230,32,19,40,741,832
S01010231,14,11,30,725,780
S01010232,128,16,37,622,803
S01010233,52,56,36,592,736
S01010234,249,173,340,104,866
S01010235,277,48,499,11,835
S01010236,259,126,210,54,649
S01010237,208,100,170,95,573
S01010238,224,125,290,104,743
S01010239,120,76,139,337,672
S01010240,141,81,175,217,614
S01010241,249,152,280,253,934
S01010242,86,43,175,350,654
S01010243,100,38,252,456,846
S01010244,61,41,92,438,632
S01010245,39,17,44,682,782
S01010246,44,41,119,473,677
S01010247,353,136,28,127,644
S01010248,317,137,286,37,777
S01010249,186,117,308,20,631
S01010250,223,94,364,18,699
S01010251,148,45,357,15,565
S01010252,226,73,183,59,541
S01010253,89,32,81,324,526
S01010254,149,55,237,490,931
S01010255,51,27,80,398,556
S01010256,47,38,57,577,719
S01010257,49,35,494,213,791
S01010258,288,90,1025,64,1467
S01010259,60,95,185,821,1161
S01010260,371,214,832,407,1824
S01010261,158,283,900,1126,2467
S01010262,67,114,191,438,810
S01010263,147,76,447,49,719
S01010264,143,71,439,160,813
S01010265,260,98,656,3,1017
S01010266,102,67,237,81,487
S01010267,93,23,429,37,582
S01010268,155,119,321,176,771
S01010269,88,45,298,73,504
S01010270,96,110,307,607,1120
S01010271,109,64,451,95,719
S01010272,125,54,290,458,927
S01010273,108,41,475,17,641
S01010274,125,48,351,26,550
S01010275,121,42,400,14,577
S01010276,265,90,548,21,924
S01010277,28,25,118,348,519
S01010278,60,23,59,364,506
S01010279,73,44,204,214,535
S01010280,130,71,400,126,727
S01010281,168,62,418,80,728
S01010282,170,84,306,340,900
S01010283,91,37,259,107,494
S01010284,354,104,695,199,1352
S01010285,137,43,348,206,734
S01010286,389,90,715,258,1452
S01010287,186,94,502,43,825
S01010288,190,83,429,50,752
S01010289,350,109,205,23,687
S01010290,92,50,236,113,491
S01010291,161,85,529,220,995
S01010292,228,135,465,14,842
S01010293,112,57,424,161,754
S01010294,119,113,363,46,641
S01010295,187,120,522,60,889
S01010296,108,60,223,182,573
S01010297,148,132,264,443,987
S01010298,140,73,242,363,818
S01010299,60,52,54,288,454
S01010300,125,76,334,301,836
S01010301,101,39,283,41,464
S01010302,46,47,66,397,556
S01010303,28,21,32,316,397
S01010304,71,36,127,245,479
S01010305,184,75,185,320,764
S01010306,171,77,294,149,691
S01010307,267,116,309,60,752
S01010308,274,109,397,95,875
S01010309,79,55,33,219,386
S01010310,87,12,147,308,554
S01010311,61,33,48,437,579
S01010312,6,2,7,659,674
S01010313,28,20,30,468,546
S01010314,168,22,131,789,1110
S01010315,267,60,162,212,701
S01010316,28,11,62,318,419
S01010317,222,91,319,56,688
S01010318,119,44,338,1009,1510
S01010319,242,73,194,135,644
S01010320,118,27,200,277,622
S01010321,191,66,239,286,782
S01010322,318,209,388,36,951
S01010323,11,6,7,485,509
S01010324,136,139,45,341,661
S01010325,146,222,70,384,822
S01010326,78,27,34,601,740
S01010327,271,40,83,373,767
S01010328,345,157,88,219,809
S01010329,152,103,51,186,492
S01010330,87,42,30,344,503
S01010331,193,146,66,369,774
S01010332,208,62,48,257,575
S01010333,241,143,110,297,791
S01010334,335,89,77,234,735
S01010335,214,148,43,288,693
S01010336,25,32,10,433,500
S01010337,170,88,32,237,527
S01010338,94,59,19,396,568
S01010339,168,128,42,212,550
S01010340,158,59,24,352,593
S01010341,226,105,27,108,466
S01010342,347,135,31,16,529
S01010343,568,133,40,14,755
S01010344,76,35,14,457,582
S01010345,264,50,25,8,347
S01010346,509,246,53,66,874
S01010347,185,98,120,534,937
S01010348,287,185,69,263,804
S01010349,275,140,36,292,743
S01010350,116,82,31,498,727
S01010351,242,74,114,258,688
S01010352,122,92,46,192,452
S01010353,59,13,26,664,762
S01010354,134,72,112,293,611
S01010355,132,76,73,338,619
S01010356,251,40,110,147,548
S01010357,98,58,28,317,501
S01010358,146,100,63,403,712
S01010359,38,44,41,523,646
S01010360,86,25,47,285,443
S01010361,14,18,24,460,516
S01010362,72,75,60,533,740
S01010363,279,160,179,35,653
S01010364,430,270,26,34,760
S01010365,414,294,150,9,867
S01010366,440,282,157,28,907
S01010367,670,486,287,43,1486
S01010368,281,233,114,9,637
S01010369,199,116,205,149,669
S01010370,259,119,221,28,627
S01010371,374,183,338,10,905
S01010372,206,110,121,14,451
S01010373,246,146,245,48,685
S01010374,293,187,319,28,827
S01010375,85,53,343,17,498
S01010376,174,60,387,45,666
S01010377,199,123,470,62,854
S01010378,171,52,432,32,687
S01010379,228,143,556,146,1073
S01010380,260,206,323,97,886
S01010381,91,45,384,47,567
S01010382,201,97,339,153,790
S01010383,73,29,199,292,593
S01010384,199,125,383,62,769
S01010385,155,83,292,251,781
S01010386,147,57,219,397,820
S01010387,200,68,483,220,971
S01010388,170,92,223,437,922
S01010389,289,67,537,78,971
S01010390,349,94,390,167,1000
S01010391,221,77,307,131,736
S01010392,157,49,404,22,632
S01010393,273,184,401,91,949
S01010394,102,58,96,473,729
S01010395,300,133,280,202,915
S01010396,182,111,382,268,943
S01010397,154,85,194,64,497
S01010398,382,215,387,14,998
S01010399,344,176,450,6,976
S01010400,405,294,216,31,946
S01010401,188,160,239,80,667
S01010402,359,259,263,38,919
S01010403,407,276,237,8,928
S01010404,285,225,137,42,689
S01010405,306,195,174,12,687
S01010406,276,150,319,11,756
S01010407,179,163,489,11,842
S01010408,185,109,44,95,433
S01010409,332,173,20,14,539
S01010410,252,159,45,11,467
S01010411,429,297,51,19,796
S01010412,260,186,300,15,761
S01010413,234,280,81,15,610
S01010414,417,255,119,79,870
S01010415,270,167,89,358,884
S01010416,245,215,106,18,584
S01010417,255,130,86,15,486
S01010418,432,229,244,31,936
S01010419,404,275,128,27,834
S01010420,291,231,30,24,576
S01010421,394,237,50,22,703
S01010422,435,293,65,100,893
S01010423,123,42,131,404,700
S01010424,170,98,110,328,706
S01010425,161,39,130,543,873
S01010426,174,75,86,266,601
S01010427,206,115,51,428,800
S01010428,315,159,30,71,575
S01010429,459,229,51,32,771
S01010430,143,64,64,424,695
S01010431,334,160,29,23,546
S01010432,148,47,102,428,725
S01010433,34,10,26,475,545
S01010434,72,22,81,316,491
S01010435,220,112,39,154,525
S01010436,115,33,97,413,658
S01010437,183,74,36,172,465
S01010438,203,15,31,359,608
S01010439,186,38,147,425,796
S01010440,136,99,20,277,532
S01010441,328,53,177,134,692
S01010442,149,26,80,338,593
S01010443,202,90,68,75,435
S01010444,232,123,54,148,557
S01010445,346,91,47,299,783
S01010446,376,173,30,119,698
S01010447,261,68,72,413,814
S01010448,405,154,47,102,708
S01010449,245,159,86,162,652
S01010450,295,135,56,202,688
S01010451,184,95,37,384,700
S01010452,274,170,82,173,699
S01010453,116,41,31,349,537
S01010454,356,166,62,148,732
S01010455,123,88,53,567,831
S01010456,189,113,48,135,485
S01010457,184,89,20,239,532
S01010458,196,139,40,274,649
S01010459,230,109,48,86,473
S01010460,329,139,91,32,591
S01010461,197,113,69,234,613
S01010462,11,8,28,577,624
S01010463,334,163,43,122,662
S01010464,226,100,25,95,446
S01010465,486,155,118,37,796
S01010466,425,151,188,15,779
S01010467,271,315,178,20,784
S01010468,364,226,188,2,780
S01010469,141,66,165,146,518
S01010470,303,138,63,168,672
S01010471,197,85,74,178,534
S01010472,227,46,124,63,460
S01010473,288,144,159,75,666
S01010474,238,85,243,146,712
S01010475,323,113,141,12,589
S01010476,374,205,187,160,926
S01010477,296,156,65,109,626
S01010478,279,106,85,392,862
S01010479,349,139,79,270,837
S01010480,259,113,33,98,503
S01010481,97,37,41,298,473
S01010482,315,125,47,165,652
S01010483,417,145,68,226,856
S01010484,168,72,34,184,458
S01010485,414,180,43,155,792
S01010486,488,258,14,21,781
S01010487,429,171,62,152,814
S01010488,95,43,67,375,580
S01010489,284,106,19,466,875
S01010490,92,20,30,382,524
S01010491,50,18,33,531,632
S01010492,18,3,16,386,423
S01010493,10,4,12,459,485
S01010494,215,34,26,189,464
S01010495,62,16,32,532,642
S01010496,46,24,56,522,648
S01010497,167,9,19,355,550
S01010498,47,18,38,537,640
S01010499,20,20,18,631,689
S01010500,143,16,28,558,745
S01010501,223,43,48,411,725
S01010502,269,19,35,287,610
S01010503,72,41,28,404,545
S01010504,88,191,114,38,431
S01010505,115,194,83,59,451
S01010506,225,286,69,107,687
S01010507,221,179,90,157,647
S01010508,225,295,161,136,817
S01010509,265,299,167,60,791
S01010510,315,225,43,111,694
S01010511,187,79,60,340,666
S01010512,206,129,33,131,499
S01010513,304,204,58,49,615
S01010514,247,110,47,151,555
S01010515,246,152,60,202,660
S01010516,163,157,106,87,513
S01010517,226,150,87,219,682
S01010518,211,130,106,94,541
S01010519,159,108,64,235,566
S01010520,331,216,109,97,753
S01010521,190,145,71,201,607
S01010522,129,53,144,186,512
S01010523,61,51,32,310,454
S01010524,165,190,62,43,460
S01010525,221,215,72,34,542
S01010526,248,192,108,126,674
S01010527,204,190,80,267,741
S01010528,160,152,107,82,501
S01010529,254,188,61,80,583
S01010530,198,223,95,29,545
S01010531,332,352,134,109,927
S01010532,96,179,157,27,459
S01010533,168,219,50,79,516
S01010534,232,227,73,172,704
S01010535,171,188,166,45,570
S01010536,230,158,117,197,702
S01010537,230,169,129,142,670
S01010538,180,78,124,216,598
S01010539,316,262,268,113,959
S01010540,153,230,124,31,538
S01010541,257,247,137,63,704
S01010542,244,282,134,93,753
S01010543,207,162,115,22,506
S01010544,254,216,83,137,690
S01010545,231,182,95,75,583
S01010546,232,233,147,96,708
S01010547,182,249,142,47,620
S01010548,184,245,133,9,571
S01010549,388,178,108,34,708
S01010550,169,143,43,90,445
S01010551,223,143,88,56,510
S01010552,243,168,163,54,628
S01010553,146,166,189,11,512
S01010554,239,164,188,44,635
S01010555,288,178,226,77,769
S01010556,268,108,45,387,808
S01010557,186,148,31,142,507
S01010558,215,255,59,137,666
S01010559,238,328,53,52,671
S01010560,241,253,50,18,562
S01010561,214,287,81,20,602
S01010562,298,242,47,34,621
S01010563,180,86,39,108,413
S01010564,113,74,26,228,441
S01010565,237,154,34,117,542
S01010566,351,250,211,62,874
S01010567,490,311,78,4,883
S01010568,380,194,88,125,787
S01010569,273,246,183,18,720
S01010570,283,178,67,330,858
S01010571,371,162,102,18,653
S01010572,277,71,137,126,611
S01010573,226,80,21,97,424
S01010574,305,128,30,8,471
S01010575,258,256,40,21,575
S01010576,338,285,32,23,678
S01010577,254,110,32,293,689
S01010578,272,60,36,91,459
S01010579,354,216,49,11,630
S01010580,162,68,186,46,462
S01010581,258,66,77,20,421
S01010582,210,131,60,7,408
S01010583,468,218,115,7,808
S01010584,299,110,85,100,594
S01010585,425,42,99,31,597
S01010586,388,182,41,8,619
S01010587,292,224,54,16,586
S01010588,260,163,50,34,507
S01010589,204,64,112,123,503
S01010590,410,155,54,7,626
S01010591,318,40,99,80,537
S01010592,179,100,136,12,427
S01010593,297,150,55,8,510
S01010594,241,81,142,41,505
S01010595,313,40,140,66,559
S01010596,320,146,151,9,626
S01010597,303,42,78,60,483
S01010598,438,68,161,71,738
S01010599,261,128,78,4,471
S01010600,396,297,74,39,806
S01010601,199,298,66,37,600
S01010602,237,131,75,4,447
S01010603,286,305,81,23,695
S01010604,227,140,19,4,390
S01010605,345,328,69,21,763
S01010606,235,157,97,167,656
S01010607,370,240,71,12,693
S01010608,112,76,59,254,501
S01010609,178,81,36,155,450
S01010610,214,299,78,23,614
S01010611,362,135,111,169,777
S01010612,319,157,61,82,619
S01010613,160,183,72,185,600
S01010614,164,57,56,165,442
S01010615,332,106,170,47,655
S01010616,347,290,78,14,729
S01010617,398,262,61,13,734
S01010618,354,214,53,10,631
S01010619,134,67,186,129,516
S01010620,69,43,284,162,558
S01010621,291,205,238,67,801
S01010622,147,87,84,200,518
S01010623,71,47,327,107,552
S01010624,226,113,98,114,551
S01010625,255,352,67,10,684
S01010626,294,399,57,42,792
S01010627,232,220,217,59,728
S01010628,349,240,271,33,893
S01010629,294,258,153,104,809
S01010630,142,90,74,178,484
S01010631,142,115,191,108,556
S01010632,260,209,109,225,803
S01010633,223,142,68,379,812
S01010634,172,132,59,170,533
S01010635,211,133,69,226,639
S01010636,316,197,120,56,689
S01010637,101,81,175,150,507
S01010638,226,221,133,159,739
S01010639,247,163,227,313,950
S01010640,214,120,313,78,725
S01010641,111,70,171,428,780
S01010642,155,78,62,439,734
S01010643,79,39,9,392,519
S01010644,61,41,20,391,513
S01010645,232,128,106,8,474
S01010646,258,224,77,16,575
S01010647,315,222,73,20,630
S01010648,271,146,62,80,559
S01010649,226,216,65,10,517
S01010650,168,51,137,58,414
S01010651,256,110,51,148,565
S01010652,311,153,81,67,612
S01010653,268,192,56,15,531
S01010654,326,125,61,124,636
S01010655,314,245,128,40,727
S01010656,156,114,30,62,362
S01010657,226,242,53,11,532
S01010658,232,270,86,12,600
S01010659,195,238,99,10,542
S01010660,207,152,62,88,509
S01010661,171,145,80,121,517
S01010662,332,173,51,57,613
S01010663,345,304,99,26,774
S01010664,275,316,76,9,676
S01010665,292,288,147,44,771
S01010666,312,223,121,110,766
S01010667,223,232,87,27,569
S01010668,314,347,134,151,946
S01010669,172,198,76,42,488
S01010670,222,218,75,59,574
S01010671,204,275,63,85,627
S01010672,151,133,49,197,530
S01010673,231,278,80,181,770
S01010674,281,250,110,115,756
S01010675,182,261,47,42,532
S01010676,229,304,121,115,769
S01010677,142,201,50,26,419
S01010678,227,216,48,38,529
S01010679,144,191,70,101,506
S01010680,165,116,44,205,530
S01010681,262,130,93,344,829
S01010682,327,313,89,46,775
S01010683,288,385,66,92,831
S01010684,189,357,85,52,683
S01010685,150,276,55,50,531
S01010686,189,243,89,62,583
S01010687,231,294,77,95,697
S01010688,152,307,87,70,616
S01010689,140,351,118,58,667
S01010690,181,179,99,105,564
S01010691,164,298,144,14,620
S01010692,253,130,64,149,596
S01010693,123,198,51,23,395
S01010694,134,260,59,65,518
S01010695,221,279,106,6,612
S01010696,389,250,82,114,835
S01010697,357,353,139,70,919
S01010698,170,199,149,90,608
S01010699,198,157,108,26,489
S01010700,227,184,57,33,501
S01010701,358,204,99,178,839
S01010702,382,373,106,13,874
S01010703,257,325,106,18,706
S01010704,230,137,33,134,534
S01010705,432,232,80,151,895
S01010706,219,110,47,175,551
S01010707,198,278,108,7,591
S01010708,231,131,33,67,462
S01010709,332,174,36,47,589
S01010710,160,139,13,296,608
S01010711,304,237,30,45,616
S01010712,191,119,43,201,554
S01010713,259,137,79,156,631
S01010714,158,127,68,258,611
S01010715,222,156,62,146,586
S01010716,255,169,225,130,779
S01010717,249,246,33,8,536
S01010718,322,236,86,109,753
S01010719,225,185,67,85,562
S01010720,228,292,46,61,627
S01010721,204,253,78,10,545
S01010722,277,236,67,128,708
S01010723,319,263,108,18,708
S01010724,281,220,118,85,704
S01010725,236,276,85,1,598
S01010726,301,343,60,87,791
S01010727,215,239,50,22,526
S01010728,205,166,40,6,417
S01010729,259,254,62,13,588
S01010730,300,301,81,14,696
S01010731,267,235,100,148,750
S01010732,213,112,37,287,649
S01010733,109,43,22,261,435
S01010734,218,88,34,380,720
S01010735,86,26,11,330,453
S01010736,200,176,27,14,417
S01010737,320,253,116,197,886
S01010738,126,142,23,165,456
S01010739,278,131,102,182,693
S01010740,48,35,16,286,385
S01010741,173,212,31,95,511
S01010742,226,134,49,161,570
S01010743,132,65,18,314,529
S01010744,333,315,60,191,899
S01010745,172,157,83,114,526
S01010746,344,256,147,93,840
S01010747,229,156,56,217,658
S01010748,195,198,85,46,524
S01010749,174,210,91,27,502
S01010750,143,277,99,20,539
S01010751,114,105,66,296,581
S01010752,175,109,112,189,585
S01010753,281,183,50,283,797
S01010754,195,161,71,143,570
S01010755,193,141,77,129,540
S01010756,237,212,63,29,541
S01010757,182,287,127,61,657
S01010758,173,283,97,49,602
S01010759,198,133,44,118,493
S01010760,143,237,54,104,538
S01010761,143,186,105,7,441
S01010762,179,205,68,45,497
S01010763,136,227,53,132,548
S01010764,136,238,86,35,495
S01010765,216,369,128,141,854
S01010766,211,232,87,122,652
S01010767,141,197,42,200,580
S01010768,119,200,41,128,488
S01010769,107,233,75,7,422
S01010770,263,197,104,153,717
S01010771,167,317,101,162,747
S01010772,149,359,107,80,695
S01010773,234,305,55,55,649
S01010774,193,211,67,117,588
S01010775,242,221,40,22,525
S01010776,176,143,37,97,453
S01010777,137,106,38,167,448
S01010778,82,52,15,220,369
S01010779,147,147,50,267,611
S01010780,183,177,28,89,477
S01010781,286,219,67,73,645
S01010782,196,145,49,121,511
S01010783,153,124,55,129,461
S01010784,193,95,39,253,580
S01010785,251,248,22,56,577
S01010786,311,146,25,50,532
S01010787,272,280,77,101,730
S01010788,201,186,65,52,504
S01010789,237,223,37,91,588
S01010790,177,304,52,35,568
S01010791,263,359,56,41,719
S01010792,162,128,25,174,489
S01010793,215,222,59,31,527
S01010794,186,134,77,36,433
S01010795,326,334,80,79,819
S01010796,250,323,80,26,679
S01010797,273,256,63,39,631
S01010798,203,279,54,41,577
S01010799,229,271,133,182,815
S01010800,201,163,38,204,606
S01010801,204,204,33,160,601
S01010802,188,126,39,120,473
S01010803,129,109,51,208,497
S01010804,152,185,49,109,495
S01010805,247,264,46,146,703
S01010806,196,177,46,320,739
S01010807,138,135,30,146,449
S01010808,143,130,24,123,420
S01010809,297,255,61,60,673
S01010810,98,226,40,64,428
S01010811,170,336,150,87,743
S01010812,117,203,54,58,432
S01010813,125,168,56,103,452
S01010814,163,255,64,51,533
S01010815,67,162,81,65,375
S01010816,234,210,49,28,521
S01010817,357,263,76,14,710
S01010818,415,285,101,22,823
S01010819,321,231,64,57,673
S01010820,207,166,56,0,429
S01010821,227,208,44,18,497
S01010822,333,194,102,10,639
S01010823,197,36,87,45,365
S01010824,429,59,26,19,533
S01010825,196,42,18,0,256
S01010826,323,202,82,11,618
S01010827,340,135,10,4,489
S01010828,694,218,17,29,958
S01010829,370,278,108,51,807
S01010830,277,118,51,28,474
S01010831,374,35,13,11,433
S01010832,400,127,65,19,611
S01010833,496,215,23,3,737
S01010834,378,362,45,7,792
S01010835,274,287,14,0,575
S01010836,335,259,89,10,693
S01010837,279,211,30,39,559
S01010838,376,175,35,75,661
S01010839,325,183,28,56,592
S01010840,196,146,87,17,446
S01010841,306,202,129,18,655
S01010842,209,162,236,199,806
S01010843,169,143,148,121,581
S01010844,302,241,15,11,569
S01010845,257,206,26,37,526
S01010846,341,122,37,119,619
S01010847,366,109,25,16,516
S01010848,180,81,41,215,517
S01010849,265,117,45,303,730
S01010850,260,99,40,309,708
S01010851,241,79,61,225,606
S01010852,341,131,21,117,610
S01010853,394,172,37,122,725
S01010854,249,84,36,331,700
S01010855,205,90,41,111,447
S01010856,288,175,49,241,753
S01010857,379,78,48,137,642
S01010858,249,121,48,171,589
S01010859,266,71,49,198,584
S01010860,256,120,30,120,526
S01010861,181,82,64,204,531
S01010862,67,20,33,317,437
S01010863,324,235,76,40,675
S01010864,226,227,30,2,485
S01010865,252,327,43,20,642
S01010866,304,262,54,48,668
S01010867,276,216,43,54,589
S01010868,350,290,34,67,741
S01010869,331,259,33,7,630
S01010870,271,215,141,38,665
S01010871,361,192,186,18,757
S01010872,295,108,155,64,622
S01010873,70,49,94,282,495
S01010874,354,166,98,12,630
S01010875,198,83,101,42,424
S01010876,135,96,148,227,606
S01010877,292,186,109,203,790
S01010878,418,304,156,168,1046
S01010879,353,189,57,103,702
S01010880,125,100,32,186,443
S01010881,281,193,20,46,540
S01010882,288,99,14,54,455
S01010883,471,162,13,89,735
S01010884,124,100,49,306,579
S01010885,193,74,92,418,777
S01010886,141,68,83,105,397
S01010887,175,90,55,384,704
S01010888,199,175,105,200,679
S01010889,110,35,71,254,470
S01010890,166,149,114,282,711
S01010891,47,33,110,199,389
S01010892,203,118,123,312,756
S01010893,85,58,55,265,463
S01010894,228,55,98,197,578
S01010895,84,92,20,160,356
S01010896,166,121,44,235,566
S01010897,114,79,12,464,669
S01010898,169,68,22,244,503
S01010899,294,89,34,59,476
S01010900,191,67,121,128,507
S01010901,56,49,13,231,349
S01010902,343,192,38,250,823
S01010903,105,69,38,452,664
S01010904,175,18,25,226,444
S01010905,160,45,97,198,500
S01010906,318,61,43,322,744
S01010907,316,36,32,8,392
S01010908,220,104,34,152,510
S01010909,337,220,31,26,614
S01010910,92,49,95,167,403
S01010911,132,95,86,180,493
S01010912,129,68,100,294,591
S01010913,286,136,83,30,535
S01010914,357,133,19,27,536
S01010915,351,130,64,45,590
S01010916,118,91,140,135,484
S01010917,270,168,68,111,617
S01010918,277,140,41,153,611
S01010919,272,146,40,198,656
S01010920,87,25,35,304,451
S01010921,216,71,43,188,518
S01010922,231,125,41,322,719
S01010923,329,146,43,209,727
S01010924,262,91,37,120,510
S01010925,225,118,40,293,676
S01010926,221,138,52,235,646
S01010927,219,93,27,119,458
S01010928,195,83,73,208,559
S01010929,161,77,32,245,515
S01010930,389,169,138,15,711
S01010931,90,97,147,36,370
S01010932,155,75,34,203,467
S01010933,344,138,53,39,574
S01010934,470,259,89,15,833
S01010935,207,265,28,73,573
S01010936,219,156,91,159,625
S01010937,330,177,35,83,625
S01010938,163,90,60,321,634
S01010939,220,123,22,54,419
S01010940,329,243,13,0,585
S01010941,426,262,19,7,714
S01010942,301,245,13,2,561
S01010943,205,75,36,167,483
S01010944,150,74,58,241,523
S01010945,202,95,20,122,439
S01010946,301,100,39,240,680
S01010947,155,82,42,159,438
S01010948,258,94,27,171,550
S01010949,519,271,26,15,831
S01010950,276,207,41,170,694
S01010951,273,112,34,86,505
S01010952,264,50,29,66,409
S01010953,259,115,21,69,464
S01010954,286,181,35,24,526
S01010955,192,149,274,102,717
S01010956,238,141,139,54,572
S01010957,250,184,21,15,470
S01010958,168,150,29,75,422
S01010959,194,126,60,104,484
S01010960,362,167,99,246,874
S01010961,170,107,24,170,471
S01010962,81,384,36,5,506
S01010963,432,180,62,90,764
S01010964,214,150,22,56,442
S01010965,112,68,36,200,416
S01010966,260,126,55,139,580
S01010967,175,95,41,239,550
S01010968,258,217,64,62,601
S01010969,232,231,33,46,542
S01010970,351,210,78,148,787
S01010971,439,218,81,85,823
S01010972,181,91,38,331,641
S01010973,179,159,24,55,417
S01010974,218,107,17,248,590
S01010975,115,39,31,193,378
S01010976,211,88,34,142,475
S01010977,324,106,41,131,602
S01010978,198,79,72,248,597
S01010979,258,104,47,240,649
S01010980,257,133,54,155,599
S01010981,226,139,57,188,610
S01010982,507,370,98,73,1048
S01010983,280,196,64,123,663
S01010984,236,252,17,71,576
S01010985,234,96,45,126,501
S01010986,323,59,12,2,396
S01010987,347,85,13,6,451
S01010988,361,72,7,8,448
S01010989,591,43,46,10,690
S01010990,298,142,76,118,634
S01010991,237,111,35,49,432
S01010992,329,45,17,8,399
S01010993,314,114,17,61,506
S01010994,528,284,62,20,894
S01010995,326,235,26,19,606
S01010996,321,145,33,13,512
S01010997,237,282,21,19,559
S01010998,279,178,31,5,493
S01010999,323,267,74,80,744
S01011000,288,190,84,116,678
S01011001,244,110,34,144,532
S01011002,223,117,45,207,592
S01011003,228,106,32,185,551
S01011004,311,96,19,58,484
S01011005,179,108,71,196,554
S01011006,409,131,80,182,802
S01011007,171,78,42,249,540
S01011008,242,142,24,243,651
S01011009,163,47,19,185,414
S01011010,125,94,130,159,508
S01011011,154,74,77,356,661
S01011012,89,44,23,382,538
S01011013,255,142,40,229,666
S01011014,322,171,43,154,690
S01011015,140,96,12,130,378
S01011016,470,53,32,76,631
S01011017,262,241,132,55,690
S01011018,274,136,70,227,707
S01011019,265,186,161,180,792
S01011020,225,91,34,26,376
S01011021,264,155,48,251,718
S01011022,137,63,23,226,449
S01011023,336,127,49,151,663
S01011024,168,64,38,314,584
S01011025,166,45,29,313,553
S01011026,143,51,11,249,454
S01011027,187,61,34,421,703
S01011028,177,107,24,429,737
S01011029,222,77,25,182,506
S01011030,499,162,41,94,796
S01011031,152,101,32,289,574
S01011032,218,143,72,217,650
S01011033,288,117,24,93,522
S01011034,230,101,56,173,560
S01011035,197,41,25,252,515
S01011036,252,117,41,128,538
S01011037,247,94,62,338,741
S01011038,137,63,23,438,661
S01011039,302,89,89,194,674
S01011040,167,112,29,252,560
S01011041,144,70,20,393,627
S01011042,411,103,51,75,640
S01011043,216,112,21,210,559
S01011044,221,85,34,225,565
S01011045,151,201,196,94,642
S01011046,225,251,199,40,715
S01011047,273,310,154,49,786
S01011048,305,255,74,170,804
S01011049,224,186,57,112,579
S01011050,276,207,135,31,649
S01011051,269,283,122,104,778
S01011052,219,288,110,93,710
S01011053,176,145,49,163,533
S01011054,185,130,45,80,440
S01011055,136,136,142,38,452
S01011056,184,290,48,31,553
S01011057,169,205,46,53,473
S01011058,198,246,65,12,521
S01011059,182,199,94,32,507
S01011060,266,349,66,97,778
S01011061,218,160,64,255,697
S01011062,290,255,89,119,753
S01011063,243,250,41,320,854
S01011064,308,327,86,137,858
S01011065,195,174,110,111,590
S01011066,123,183,44,74,424
S01011067,174,183,42,77,476
S01011068,160,109,33,118,420
S01011069,157,165,34,109,465
S01011070,236,161,35,76,508
S01011071,279,340,45,60,724
S01011072,317,284,56,142,799
S01011073,292,234,48,20,594
S01011074,227,168,36,76,507
S01011075,170,116,36,246,568
S01011076,188,197,46,171,602
S01011077,113,95,15,362,585
S01011078,430,348,52,109,939
S01011079,425,308,117,36,886
S01011080,316,316,80,124,836
S01011081,249,213,26,172,660
S01011082,154,95,17,206,472
S01011083,285,213,56,92,646
S01011084,277,264,79,32,652
S01011085,299,304,72,67,742
S01011086,196,236,57,54,543
S01011087,205,137,28,106,476
S01011088,339,261,111,90,801
S01011089,131,149,34,226,540
S01011090,224,257,120,9,610
S01011091,217,191,110,6,524
S01011092,60,19,48,191,318
S01011093,277,168,41,14,500
S01011094,221,137,80,7,445
S01011095,261,253,119,15,648
S01011096,224,98,137,18,477
S01011097,239,170,126,22,557
S01011098,307,171,72,83,633
S01011099,170,107,41,332,650
S01011100,150,149,16,75,390
S01011101,138,69,23,250,480
S01011102,101,89,93,248,531
S01011103,122,83,147,150,502
S01011104,243,176,101,106,626
S01011105,196,183,135,167,681
S01011106,106,43,263,231,643
S01011107,297,33,136,168,634
S01011108,231,58,28,128,445
S01011109,326,219,86,57,688
S01011110,250,128,42,147,567
S01011111,225,120,62,289,696
S01011112,428,94,68,55,645
S01011113,314,289,58,158,819
S01011114,297,220,31,65,613
S01011115,278,147,57,267,749
S01011116,226,180,72,65,543
S01011117,228,247,144,14,633
S01011118,292,259,133,38,722
S01011119,334,295,107,51,787
S01011120,238,338,25,5,606
S01011121,121,78,165,107,471
S01011122,208,147,97,87,539
S01011123,403,225,67,219,914
S01011124,241,89,90,84,504
S01011125,96,31,43,220,390
S01011126,95,62,106,114,377
S01011127,25,0,270,30,325
S01011128,233,128,121,115,597
S01011129,332,187,223,28,770
S01011130,175,127,72,122,496
S01011131,246,157,133,27,563
S01011132,382,256,94,11,743
S01011133,164,98,28,83,373
S01011134,227,224,126,86,663
S01011135,225,179,59,168,631
S01011136,216,176,80,89,561
S01011137,116,81,39,130,366
S01011138,135,50,118,177,480
S01011139,384,171,521,39,1115
S01011140,203,57,43,123,426
S01011141,152,61,28,192,433
S01011142,412,265,234,19,930
S01011143,395,284,77,22,778
S01011144,299,163,72,61,595
S01011145,207,229,89,14,539
S01011146,224,152,40,168,584
S01011147,390,269,88,92,839
S01011148,184,223,192,51,650
S01011149,145,160,368,26,699
S01011150,181,24,74,39,318
S01011151,118,57,213,39,427
S01011152,138,238,162,50,588
S01011153,214,239,170,124,747
S01011154,135,134,82,142,493
S01011155,182,163,63,146,554
S01011156,272,160,46,7,485
S01011157,227,240,21,24,512
S01011158,131,277,29,7,444
S01011159,129,135,48,157,469
S01011160,256,206,146,137,745
S01011161,174,102,88,131,495
S01011162,122,68,51,122,363
S01011163,243,128,56,242,669
S01011164,259,136,50,142,587
S01011165,177,97,51,296,621
S01011166,168,198,32,34,432
S01011167,228,307,83,22,640
S01011168,227,184,271,22,704
S01011169,443,108,85,68,704
S01011170,247,266,196,45,754
S01011171,220,407,99,61,787
S01011172,174,325,75,71,645
S01011173,180,226,68,30,504
S01011174,82,201,96,27,406
S01011175,136,130,56,116,438
S01011176,125,286,66,17,494
S01011177,187,317,122,113,739
S01011178,164,85,111,32,392
S01011179,203,117,31,155,506
S01011180,150,70,46,271,537
S01011181,169,182,36,13,400
S01011182,165,151,28,4,348
S01011183,238,123,21,91,473
S01011184,439,197,6,7,649
S01011185,319,214,31,34,598
S01011186,326,211,59,192,788
S01011187,288,243,25,42,598
S01011188,368,174,68,173,783
S01011189,373,152,104,74,703
S01011190,219,68,48,188,523
S01011191,196,85,27,126,434
S01011192,266,73,57,156,552
S01011193,215,44,82,196,537
S01011194,190,59,60,243,552
S01011195,263,62,76,185,586
S01011196,258,78,60,306,702
S01011197,241,76,79,259,655
S01011198,179,66,60,179,484
S01011199,294,88,67,188,637
S01011200,309,137,55,117,618
S01011201,276,121,17,92,506
S01011202,344,91,57,195,687
S01011203,355,129,46,132,662
S01011204,252,163,37,20,472
S01011205,353,47,24,69,493
S01011206,374,88,53,50,565
S01011207,325,75,16,204,620
S01011208,557,116,27,27,727
S01011209,192,77,23,220,512
S01011210,340,151,11,98,600
S01011211,352,74,50,68,544
S01011212,180,52,48,136,416
S01011213,304,134,127,248,813
S01011214,247,146,114,220,727
S01011215,117,53,40,246,456
S01011216,113,60,39,162,374
S01011217,187,101,85,268,641
S01011218,110,31,57,304,502
S01011219,220,114,55,253,642
S01011220,315,139,52,229,735
S01011221,328,153,81,204,766
S01011222,216,100,30,207,553
S01011223,317,116,56,155,644
S01011224,208,143,42,204,597
S01011225,118,82,78,284,562
S01011226,390,327,58,81,856
S01011227,212,130,115,143,600
S01011228,219,139,114,200,672
S01011229,108,77,57,201,443
S01011230,109,59,33,622,823
S01011231,115,82,39,265,501
S01011232,162,113,100,444,819
S01011233,100,76,43,90,309
S01011234,239,97,51,398,785
S01011235,88,49,28,144,309
S01011236,169,127,50,128,474
S01011237,204,90,40,260,594
S01011238,108,62,64,279,513
S01011239,160,147,107,212,626
S01011240,155,93,158,225,631
S01011241,367,243,168,133,911
S01011242,265,183,75,156,679
S01011243,142,70,160,383,755
S01011244,136,69,115,254,574
S01011245,199,133,42,344,718
S01011246,310,240,125,70,745
S01011247,339,287,53,40,719
S01011248,344,170,40,75,629
S01011249,360,188,40,26,614
S01011250,288,81,67,363,799
S01011251,245,120,70,262,697
S01011252,180,58,48,345,631
S01011253,203,62,42,383,690
S01011254,512,239,24,14,789
S01011255,465,86,12,11,574
S01011256,262,35,22,14,333
S01011257,125,217,15,12,369
S01011258,275,137,18,48,478
S01011259,249,195,62,155,661
S01011260,291,263,30,46,630
S01011261,172,90,35,315,612
S01011262,153,97,38,113,401
S01011263,492,114,94,215,915
S01011264,180,60,60,209,509
S01011265,200,62,62,474,798
S01011266,351,167,51,174,743
S01011267,198,200,35,64,497
S01011268,105,131,46,49,331
S01011269,146,107,44,142,439
S01011270,138,93,106,230,567
S01011271,248,184,64,216,712
S01011272,206,110,78,232,626
S01011273,253,84,38,271,646
S01011274,250,85,128,211,674
S01011275,109,51,28,324,512
S01011276,308,135,53,272,768
S01011277,355,170,38,14,577
S01011278,268,87,48,12,415
S01011279,320,162,55,23,560
S01011280,253,225,9,28,515
S01011281,358,106,35,19,518
S01011282,477,114,24,77,692
S01011283,459,58,22,8,547
S01011284,346,36,18,8,408
S01011285,165,66,42,274,547
S01011286,172,71,30,275,548
S01011287,211,104,46,271,632
S01011288,249,102,51,191,593
S01011289,270,153,53,274,750
S01011290,340,210,81,365,996
S01011291,229,151,39,252,671
S01011292,169,54,24,323,570
S01011293,209,89,36,255,589
S01011294,189,135,89,333,746
S01011295,378,282,62,97,819
S01011296,182,154,23,130,489
S01011297,223,95,40,290,648
S01011298,140,47,31,260,478
S01011299,168,181,60,5,414
S01011300,230,147,31,357,765
S01011301,314,208,55,15,592
S01011302,221,180,75,287,763
S01011303,488,258,80,20,846
S01011304,170,81,25,262,538
S01011305,305,86,38,210,639
S01011306,118,138,53,163,472
S01011307,145,164,65,7,381
S01011308,137,157,73,5,372
S01011309,291,299,19,6,615
S01011310,228,207,87,67,589
S01011311,256,298,38,12,604
S01011312,402,490,47,13,952
S01011313,307,189,70,46,612
S01011314,459,258,106,51,874
S01011315,138,48,32,99,317
S01011316,213,122,36,201,572
S01011317,304,379,55,3,741
S01011318,307,400,145,17,869
S01011319,320,383,50,3,756
S01011320,188,179,45,52,464
S01011321,294,110,33,48,485
S01011322,285,112,29,66,492
S01011323,351,122,81,181,735
S01011324,167,129,26,39,361
S01011325,201,169,172,107,649
S01011326,174,202,243,65,684
S01011327,157,277,110,78,622
S01011328,198,248,72,75,593
S01011329,302,303,131,58,794
S01011330,304,262,28,20,614
S01011331,304,302,23,5,634
S01011332,362,373,48,6,789
S01011333,220,385,55,9,669
S01011334,222,248,77,41,588
S01011335,339,386,88,11,824
S01011336,238,109,59,74,480
S01011337,292,244,31,19,586
S01011338,248,98,35,128,509
S01011339,169,86,16,181,452
S01011340,143,100,20,288,551
S01011341,223,103,84,182,592
S01011342,301,139,89,52,581
S01011343,257,125,43,272,697
S01011344,218,96,22,359,695
S01011345,159,57,21,358,595
S01011346,254,118,43,152,567
S01011347,345,280,62,197,884
S01011348,249,122,36,330,737
S01011349,508,181,36,15,740
S01011350,293,236,19,21,569
S01011351,180,82,41,271,574
S01011352,255,119,65,112,551
S01011353,234,135,22,163,554
S01011354,304,191,22,89,606
S01011355,334,204,46,219,803
S01011356,397,283,58,50,788
S01011357,330,205,30,144,709
S01011358,345,47,33,7,432
S01011359,246,179,50,169,644
S01011360,87,29,29,426,571
S01011361,20,10,7,425,462
S01011362,312,85,8,21,426
S01011363,292,191,61,218,762
S01011364,318,96,34,71,519
S01011365,361,45,18,22,446
S01011366,185,112,40,115,452
S01011367,267,131,36,252,686
S01011368,467,58,87,14,626
S01011369,289,142,14,230,675
S01011370,414,55,53,107,629
S01011371,158,45,37,521,761
S01011372,43,27,12,490,572
S01011373,113,43,21,375,552
S01011374,320,34,96,85,535
S01011375,218,123,9,183,533
S01011376,22,13,7,387,429
S01011377,266,185,19,34,504
S01011378,323,213,33,105,674
S01011379,490,185,41,22,738
S01011380,226,117,66,172,581
S01011381,253,134,66,73,526
S01011382,128,33,108,166,435
S01011383,111,52,35,367,565
S01011384,73,27,9,411,520
S01011385,192,104,35,437,768
S01011386,101,26,24,315,466
S01011387,206,43,67,339,655
S01011388,544,69,87,114,814
S01011389,214,63,135,252,664
S01011390,211,121,22,309,663
S01011391,175,65,22,245,507
S01011392,169,54,23,293,539
S01011393,314,168,35,194,711
S01011394,343,26,12,36,417
S01011395,186,105,78,276,645
S01011396,219,122,53,267,661
S01011397,250,103,44,289,686
S01011398,189,67,35,298,589
S01011399,132,49,19,222,422
S01011400,245,105,108,121,579
S01011401,273,108,44,124,549
S01011402,317,316,63,142,838
S01011403,219,64,37,103,423
S01011404,310,152,54,279,795
S01011405,214,160,25,124,523
S01011406,221,137,34,156,548
S01011407,429,273,56,176,934
S01011408,299,127,40,223,689
S01011409,210,53,22,344,629
S01011410,203,140,15,180,538
S01011411,276,104,19,153,552
S01011412,391,317,3,38,749
S01011413,336,80,29,12,457
S01011414,259,126,54,227,666
S01011415,432,152,28,114,726
S01011416,313,181,22,13,529
S01011417,284,200,70,130,684
S01011418,160,77,17,208,462
S01011419,213,93,22,140,468
S01011420,79,61,47,216,403
S01011421,328,34,62,19,443
S01011422,217,98,40,184,539
S01011423,127,46,36,205,414
S01011424,237,85,24,118,464
S01011425,196,121,45,327,689
S01011426,526,188,53,35,802
S01011427,229,100,29,201,559
S01011428,167,113,8,142,430
S01011429,693,264,55,35,1047
S01011430,454,154,71,81,760
S01011431,333,168,49,359,909
S01011432,367,182,31,290,870
S01011433,141,47,32,444,664
S01011434,198,134,20,130,482
S01011435,492,185,53,33,763
S01011436,180,72,56,294,602
S01011437,226,93,45,244,608
S01011438,90,20,15,300,425
S01011439,257,160,43,277,737
S01011440,186,74,25,197,482
S01011441,189,131,41,277,638
S01011442,220,107,51,187,565
S01011443,183,109,20,198,510
S01011444,201,91,15,302,609
S01011445,232,78,30,88,428
S01011446,177,127,28,92,424
S01011447,272,78,34,296,680
S01011448,387,202,72,97,758
S01011449,129,80,53,187,449
S01011450,319,103,22,47,491
S01011451,347,111,39,48,545
S01011452,414,206,49,108,777
S01011453,260,156,47,120,583
S01011454,246,84,41,260,631
S01011455,216,102,32,271,621
S01011456,289,104,22,274,689
S01011457,215,94,38,383,730
S01011458,650,103,32,86,871
S01011459,496,68,67,154,785
S01011460,282,38,18,214,552
S01011461,235,48,89,207,579
S01011462,422,172,48,116,758
S01011463,300,121,43,91,555
S01011464,337,33,29,35,434
S01011465,109,47,17,231,404
S01011466,148,70,44,231,493
S01011467,216,59,32,109,416
S01011468,490,49,68,14,621
S01011469,206,29,75,328,638
S01011470,389,159,67,311,926
S01011471,304,210,58,202,774
S01011472,169,85,49,463,766
S01011473,96,59,49,408,612
S01011474,123,64,116,384,687
S01011475,49,23,28,418,518
S01011476,223,156,20,12,411
S01011477,386,292,13,18,709
S01011478,519,236,77,27,859
S01011479,324,269,73,24,690
S01011480,456,274,99,25,854
S01011481,429,92,34,80,635
S01011482,232,152,79,282,745
S01011483,263,143,22,8,436
S01011484,240,87,26,356,709
S01011485,220,84,73,375,752
S01011486,80,55,16,284,435
S01011487,284,74,54,463,875
S01011488,147,75,29,267,518
S01011489,378,28,34,102,542
S01011490,396,113,82,271,862
S01011491,104,44,21,244,413
S01011492,119,31,254,191,595
S01011493,341,44,6,5,396
S01011494,275,90,26,224,615
S01011495,179,92,50,340,661
S01011496,57,21,24,390,492
S01011497,320,90,56,23,489
S01011498,404,95,18,20,537
S01011499,376,120,53,124,673
S01011500,198,111,24,88,421
S01011501,134,55,41,306,536
S01011502,279,99,15,215,608
S01011503,244,108,26,127,505
S01011504,225,140,27,89,481
S01011505,207,51,67,225,550
S01011506,200,118,13,99,430
S01011507,207,110,22,173,512
S01011508,402,110,99,176,787
S01011509,278,122,22,97,519
S01011510,295,115,69,359,838
S01011511,134,62,9,228,433
S01011512,130,30,32,499,691
S01011513,171,79,27,330,607
S01011514,235,88,15,392,730
S01011515,270,85,72,22,449
S01011516,488,148,58,23,717
S01011517,217,100,23,112,452
S01011518,208,77,26,238,549
S01011519,240,124,27,250,641
S01011520,130,29,13,296,468
S01011521,228,100,84,338,750
S01011522,276,80,76,309,741
S01011523,249,69,99,192,609
S01011524,474,154,40,93,761
S01011525,530,100,39,112,781
S01011526,436,141,71,164,812
S01011527,310,188,35,76,609
S01011528,242,172,65,348,827
S01011529,104,44,30,242,420
S01011530,309,120,40,339,808
S01011531,514,177,86,131,908
S01011532,354,55,32,32,473
S01011533,144,89,23,312,568
S01011534,245,90,35,224,594
S01011535,126,79,20,537,762
S01011536,361,171,22,17,571
S01011537,324,73,41,5,443
S01011538,325,186,37,8,556
S01011539,246,104,23,244,617
S01011540,442,125,42,238,847
S01011541,207,70,26,411,714
S01011542,296,110,24,303,733
S01011543,208,33,15,353,609
S01011544,247,54,12,235,548
S01011545,214,83,12,176,485
S01011546,474,56,11,7,548
S01011547,344,46,32,9,431
S01011548,309,156,52,95,612
S01011549,347,254,16,58,675
S01011550,329,253,7,16,605
S01011551,235,112,27,74,448
S01011552,377,175,24,23,599
S01011553,495,59,44,18,616
S01011554,370,175,29,157,731
S01011555,201,51,26,178,456
S01011556,143,67,26,164,400
S01011557,275,87,36,194,592
S01011558,173,45,16,220,454
S01011559,199,62,23,207,491
S01011560,283,64,32,237,616
S01011561,264,85,30,265,644
S01011562,116,21,26,320,483
S01011563,146,59,26,352,583
S01011564,421,121,51,177,770
S01011565,344,64,67,266,741
S01011566,222,78,44,348,692
S01011567,318,179,31,300,828
S01011568,401,110,46,94,651
S01011569,408,179,43,172,802
S01011570,232,115,79,178,604
S01011571,145,35,51,340,571
S01011572,148,74,69,193,484
S01011573,567,69,53,152,841
S01011574,406,72,40,86,604
S01011575,207,49,51,99,406
S01011576,119,61,21,534,735
S01011577,277,79,84,130,570
S01011578,286,61,24,303,674
S01011579,536,307,43,19,905
S01011580,260,64,42,189,555
S01011581,173,77,58,382,690
S01011582,529,323,87,16,955
S01011583,217,90,81,168,556
S01011584,289,92,38,170,589
S01011585,245,121,69,148,583
S01011586,171,75,60,174,480
S01011587,151,50,34,214,449
S01011588,217,109,39,241,606
S01011589,350,175,21,159,705
S01011590,222,80,18,229,549
S01011591,204,47,26,221,498
S01011592,135,39,75,312,561
S01011593,312,115,31,141,599
S01011594,154,94,36,98,382
S01011595,278,136,89,7,510
S01011596,368,205,181,109,863
S01011597,336,85,93,21,535
S01011598,28,12,18,622,680
S01011599,308,138,76,138,660
S01011600,224,146,107,165,642
S01011601,480,101,56,17,654
S01011602,147,102,18,226,493
S01011603,194,97,57,323,671
S01011604,197,66,19,244,526
S01011605,357,164,47,145,713
S01011606,606,68,23,32,729
S01011607,308,135,25,6,474
S01011608,515,130,69,25,739
S01011609,128,63,62,508,761
S01011610,204,49,48,350,651
S01011611,361,132,44,48,585
S01011612,380,33,31,7,451
S01011613,430,289,54,23,796
S01011614,211,100,15,51,377
S01011615,219,94,43,201,557
S01011616,90,60,42,150,342
S01011617,315,137,33,224,709
S01011618,207,90,58,134,489
S01011619,617,117,45,32,811
S01011620,667,78,33,25,803
S01011621,351,126,45,68,590
S01011622,372,60,35,13,480
S01011623,232,106,50,173,561
S01011624,371,62,44,71,548
S01011625,160,63,46,172,441
S01011626,489,89,34,20,632
S01011627,390,79,38,23,530
S01011628,564,237,44,42,887
S01011629,209,106,28,145,488
S01011630,227,108,28,141,504
S01011631,107,21,13,311,452
S01011632,199,76,36,267,578
S01011633,190,89,37,274,590
S01011634,107,31,63,232,433
S01011635,135,32,65,288,520
S01011636,201,71,40,236,548
S01011637,199,117,48,193,557
S01011638,168,97,55,107,427
S01011639,144,84,37,188,453
S01011640,210,92,26,206,534
S01011641,258,132,7,7,404
S01011642,314,186,16,149,665
S01011643,286,73,53,49,461
S01011644,300,154,48,98,600
S01011645,171,127,38,113,449
S01011646,329,236,18,5,588
S01011647,491,145,51,12,699
S01011648,283,59,27,143,512
S01011649,153,48,42,151,394
S01011650,253,172,42,114,581
S01011651,339,182,128,121,770
S01011652,361,186,59,34,640
S01011653,319,103,52,242,716
S01011654,262,120,146,297,825
S01011655,169,100,109,338,716
S01011656,102,55,34,299,490
S01011657,122,33,70,198,423
S01011658,246,98,47,159,550
S01011659,202,121,39,296,658
S01011660,413,234,44,97,788
S01011661,201,107,31,94,433
S01011662,370,77,31,7,485
S01011663,234,44,82,391,751
S01011664,341,98,35,358,832
S01011665,229,67,78,342,716
S01011666,181,120,46,387,734
S01011667,246,118,77,238,679
S01011668,222,69,65,424,780
S01011669,255,183,60,60,558
S01011670,154,40,36,174,404
S01011671,271,176,58,83,588
S01011672,164,117,47,169,497
S01011673,200,96,44,194,534
S01011674,439,145,73,166,823
S01011675,337,127,43,241,748
S01011676,219,77,29,240,565
S01011677,270,34,101,55,460
S01011678,95,88,22,173,378
S01011679,312,53,36,14,415
S01011680,232,135,32,463,862
S01011681,296,108,30,230,664
S01011682,231,151,37,7,426
S01011683,273,139,52,147,611
S01011684,226,113,22,74,435
S01011685,454,87,33,26,600
S01011686,414,224,47,16,701
S01011687,314,107,43,236,700
S01011688,380,106,39,105,630
S01011689,354,143,15,25,537
S01011690,495,104,33,113,745
S01011691,297,62,53,43,455
S01011692,310,129,41,377,857
S01011693,383,137,78,64,662
S01011694,291,35,25,31,382
S01011695,516,103,42,25,686
S01011696,584,101,31,10,726
S01011697,489,112,47,107,755
S01011698,274,119,19,123,535
S01011699,447,242,49,24,762
S01011700,314,214,29,102,659
S01011701,440,261,65,54,820
S01011702,285,193,33,114,625
S01011703,259,172,41,28,500
S01011704,403,102,26,22,553
S01011705,310,66,31,192,599
S01011706,415,271,67,128,881
S01011707,328,204,14,36,582
S01011708,330,209,63,193,795
S01011709,438,175,24,143,780
S01011710,121,39,15,300,475
S01011711,153,59,41,296,549
S01011712,190,78,38,153,459
S01011713,388,232,31,106,757
S01011714,347,36,2,9,394
S01011715,197,66,55,172,490
S01011716,522,103,47,28,700
S01011717,334,250,19,11,614
S01011718,468,54,37,16,575
S01011719,416,78,29,5,528
S01011720,237,188,28,11,464
S01011721,347,143,21,73,584
S01011722,273,162,62,90,587
S01011723,438,163,64,100,765
S01011724,305,45,39,135,524
S01011725,439,29,23,5,496
S01011726,360,50,8,4,422
S01011727,444,63,42,7,556
S01011728,399,174,82,110,765
S01011729,230,77,42,211,560
S01011730,393,306,39,41,779
S01011731,373,216,42,86,717
S01011732,403,251,12,12,678
S01011733,380,202,39,82,703
S01011734,341,188,42,73,644
S01011735,355,233,18,13,619
S01011736,298,121,108,49,576
S01011737,242,109,126,73,550
S01011738,365,158,160,166,849
S01011739,205,116,29,78,428
S01011740,184,84,69,263,600
S01011741,219,122,54,139,534
S01011742,298,139,48,127,612
S01011743,276,166,95,118,655
S01011744,232,167,126,188,713
S01011745,215,143,53,220,631
S01011746,153,64,73,120,410
S01011747,240,103,138,271,752
S01011748,257,73,151,165,646
S01011749,128,32,158,240,558
S01011750,301,160,103,144,708
S01011751,251,72,188,267,778
S01011752,381,127,118,122,748
S01011753,366,202,69,21,658
S01011754,310,136,75,96,617
S01011755,364,128,124,143,759
S01011756,427,130,109,114,780
S01011757,270,112,58,131,571
S01011758,309,78,43,66,496
S01011759,359,182,50,76,667
S01011760,373,162,75,117,727
S01011761,265,47,57,135,504
S01011762,227,79,98,127,531
S01011763,396,119,26,111,652
S01011764,201,80,13,37,331
S01011765,592,156,52,17,817
S01011766,264,106,18,26,414
S01011767,294,163,100,186,743
S01011768,224,71,77,217,589
S01011769,224,163,76,89,552
S01011770,283,154,89,152,678
S01011771,409,88,19,13,529
S01011772,608,234,16,25,883
S01011773,384,43,11,7,445
S01011774,436,52,38,164,690
S01011775,390,66,16,6,478
S01011776,647,87,38,15,787
S01011777,340,62,32,40,474
S01011778,345,40,68,38,491
S01011779,443,163,25,7,638
S01011780,520,177,24,6,727
S01011781,353,94,3,7,457
S01011782,392,167,8,13,580
S01011783,310,151,15,9,485
S01011784,255,84,51,268,658
S01011785,379,118,66,145,708
S01011786,242,26,19,8,295
S01011787,276,137,32,375,820
S01011788,349,131,20,11,511
S01011789,242,202,35,69,548
S01011790,318,169,29,261,777
S01011791,230,101,65,212,608
S01011792,271,192,84,234,781
S01011793,274,193,64,77,608
S01011794,276,137,70,223,706
S01011795,159,100,69,185,513
S01011796,191,65,51,291,598
S01011797,541,285,24,12,862
S01011798,211,61,46,132,450
S01011799,383,245,19,108,755
S01011800,185,93,33,113,424
S01011801,177,62,32,183,454
S01011802,231,122,37,190,580
S01011803,206,84,37,136,463
S01011804,156,166,98,209,629
S01011805,108,181,109,68,466
S01011806,224,256,55,90,625
S01011807,300,445,125,42,912
S01011808,166,194,79,81,520
S01011809,207,277,81,29,594
S01011810,263,389,76,55,783
S01011811,316,413,106,14,849
S01011812,234,243,56,10,543
S01011813,243,270,59,50,622
S01011814,242,271,44,16,573
S01011815,250,210,91,61,612
S01011816,223,242,53,10,528
S01011817,242,274,66,8,590
S01011818,334,303,105,150,892
S01011819,288,199,101,139,727
S01011820,250,161,123,104,638
S01011821,74,52,83,143,352
S01011822,110,156,198,149,613
S01011823,182,153,50,119,504
S01011824,187,119,72,173,551
S01011825,164,149,89,57,459
S01011826,176,165,107,101,549
S01011827,58,269,62,81,470
S01011828,241,403,88,29,761
S01011829,142,151,35,27,355
S01011830,128,249,46,56,479
S01011831,159,446,103,43,751
S01011832,124,381,134,78,717
S01011833,417,295,70,21,803
S01011834,221,109,31,14,375
S01011835,281,205,52,9,547
S01011836,285,312,26,35,658
S01011837,282,204,65,13,564
S01011838,355,291,35,10,691
S01011839,414,302,90,17,823
S01011840,381,236,73,95,785
S01011841,325,180,96,142,743
S01011842,329,184,72,204,789
S01011843,318,368,82,43,811
S01011844,306,218,61,24,609
S01011845,293,167,89,123,672
S01011846,286,274,99,63,722
S01011847,173,131,34,3,341
S01011848,224,213,96,54,587
S01011849,303,166,107,71,647
S01011850,202,213,159,7,581
S01011851,259,194,161,119,733
S01011852,349,181,137,177,844
S01011853,251,165,119,34,569
S01011854,214,293,114,89,710
S01011855,303,141,59,202,705
S01011856,269,283,38,6,596
S01011857,167,180,158,65,570
S01011858,234,363,90,63,750
S01011859,195,285,69,201,750
S01011860,102,145,271,9,527
S01011861,172,255,190,17,634
S01011862,305,406,78,36,825
S01011863,273,267,105,75,720
S01011864,279,297,27,7,610
S01011865,204,179,71,60,514
S01011866,240,213,58,123,634
S01011867,285,98,96,286,765
S01011868,251,233,126,105,715
S01011869,210,200,217,50,677
S01011870,179,169,66,148,562
S01011871,286,236,233,109,864
S01011872,302,253,154,12,721
S01011873,253,176,207,8,644
S01011874,259,146,83,51,539
S01011875,226,169,79,96,570
S01011876,255,260,203,50,768
S01011877,166,176,91,35,468
S01011878,291,328,309,46,974
S01011879,228,181,26,8,443
S01011880,203,181,63,34,481
S01011881,256,155,147,105,663
S01011882,342,219,47,200,808
S01011883,449,286,107,73,915
S01011884,129,132,80,5,346
S01011885,313,146,52,13,524
S01011886,345,216,50,89,700
S01011887,212,133,37,84,466
S01011888,270,129,52,216,667
S01011889,361,274,69,73,777
S01011890,284,180,72,33,569
S01011891,313,184,264,358,1119
S01011892,417,164,225,9,815
S01011893,248,207,236,106,797
S01011894,191,142,102,94,529
S01011895,230,285,54,7,576
S01011896,325,260,94,46,725
S01011897,380,304,77,63,824
S01011898,315,161,43,0,519
S01011899,305,302,51,1,659
S01011900,343,230,25,1,599
S01011901,350,253,102,23,728
S01011902,450,385,46,24,905
S01011903,313,327,33,3,676
S01011904,357,274,58,7,696
S01011905,377,217,38,6,638
S01011906,199,135,30,4,368
S01011907,358,159,78,35,630
S01011908,173,67,42,10,292
S01011909,551,53,152,24,780
S01011910,171,77,53,416,717
S01011911,236,120,27,153,536
S01011912,219,85,54,219,577
S01011913,187,67,29,295,578
S01011914,167,43,55,354,619
S01011915,252,111,43,234,640
S01011916,135,66,45,210,456
S01011917,169,104,34,112,419
S01011918,91,46,40,403,580
S01011919,171,106,182,297,756
S01011920,202,100,45,172,519
S01011921,136,64,36,227,463
S01011922,212,78,53,276,619
S01011923,184,68,74,402,728
S01011924,135,65,33,119,352
S01011925,413,58,41,37,549
S01011926,232,90,64,135,521
S01011927,211,80,41,168,500
S01011928,220,132,76,174,602
S01011929,254,110,45,176,585
S01011930,179,90,78,158,505
S01011931,92,23,54,303,472
S01011932,211,41,145,113,510
S01011933,160,85,160,155,560
S01011934,294,258,298,88,938
S01011935,133,125,368,123,749
S01011936,205,144,234,99,682
S01011937,118,46,271,177,612
S01011938,175,134,217,83,609
S01011939,149,78,248,189,664
S01011940,54,25,190,110,379
S01011941,114,51,413,70,648
S01011942,117,124,330,211,782
S01011943,157,90,431,375,1053
S01011944,129,192,53,8,382
S01011945,287,372,26,11,696
S01011946,216,210,64,179,669
S01011947,44,24,270,75,413
S01011948,317,359,140,178,994
S01011949,221,435,41,14,711
S01011950,228,269,53,117,667
S01011951,243,177,88,53,561
S01011952,231,138,22,0,391
S01011953,301,226,73,8,608
S01011954,178,81,35,106,400
S01011955,323,260,111,140,834
S01011956,462,226,59,34,781
S01011957,249,198,255,60,762
S01011958,271,312,258,59,900
S01011959,288,259,159,42,748
S01011960,336,160,132,7,635
S01011961,308,122,59,82,571
S01011962,309,159,66,4,538
S01011963,252,79,11,70,412
S01011964,356,250,180,38,824
S01011965,286,263,46,80,675
S01011966,337,229,59,48,673
S01011967,396,323,189,54,962
S01011968,357,248,159,66,830
S01011969,319,248,106,197,870
S01011970,227,132,102,299,760
S01011971,222,150,53,18,443
S01011972,296,327,310,43,976
S01011973,227,177,70,72,546
S01011974,313,231,84,20,648
S01011975,153,129,73,35,390
S01011976,264,211,104,64,643
S01011977,304,281,163,215,963
S01011978,187,188,66,145,586
S01011979,402,275,119,37,833
S01011980,82,147,102,9,340
S01011981,177,233,328,49,787
S01011982,193,229,342,20,784
S01011983,147,254,167,87,655
S01011984,132,88,39,278,537
S01011985,275,216,101,29,621
S01011986,119,67,63,280,529
S01011987,294,196,73,207,770
S01011988,253,286,47,14,600
S01011989,290,229,132,66,717
S01011990,231,334,63,23,651
S01011991,261,186,46,99,592
S01011992,322,385,132,15,854
S01011993,178,113,220,203,714
S01011994,203,411,29,10,653
S01011995,274,229,144,15,662
S01011996,163,111,52,134,460
S01011997,297,184,95,167,743
S01011998,219,151,39,14,423
S01011999,171,115,208,31,525
S01012000,188,125,45,15,373
S01012001,241,136,52,91,520
S01012002,209,158,28,87,482
S01012003,168,161,75,51,455
S01012004,309,286,65,93,753
S01012005,393,200,25,56,674
S01012006,224,202,294,22,742
S01012007,227,254,134,87,702
S01012008,229,240,198,135,802
S01012009,155,175,176,110,616
S01012010,342,445,205,87,1079
S01012011,229,309,150,271,959
S01012012,168,213,114,92,587
S01012013,160,227,202,58,647
S01012014,224,177,139,173,713
S01012015,256,241,104,177,778
S01012016,218,247,182,92,739
S01012017,105,177,123,25,430
S01012018,228,231,199,65,723
S01012019,385,167,78,30,660
S01012020,251,141,52,141,585
S01012021,240,148,5,76,469
S01012022,290,133,32,72,527
S01012023,224,175,35,13,447
S01012024,441,158,33,55,687
S01012025,338,119,22,81,560
S01012026,373,57,21,12,463
S01012027,540,206,51,42,839
S01012028,434,299,35,10,778
S01012029,547,288,183,57,1075
S01012030,214,174,123,21,532
S01012031,210,210,24,15,459
S01012032,119,139,39,2,299
S01012033,335,237,41,80,693
S01012034,314,166,72,104,656
S01012035,381,248,46,95,770
S01012036,358,324,42,9,733
S01012037,315,103,70,272,760
S01012038,110,39,15,464,628
S01012039,354,170,32,242,798
S01012040,346,111,36,63,556
S01012041,321,173,72,153,719
S01012042,382,138,54,179,753
S01012043,220,83,79,303,685
S01012044,231,120,50,353,754
S01012045,313,126,183,279,901
S01012046,168,75,44,281,568
S01012047,239,131,77,356,803
S01012048,157,63,93,301,614
S01012049,290,128,52,104,574
S01012050,526,88,49,135,798
S01012051,200,109,36,80,425
S01012052,356,179,78,148,761
S01012053,251,123,38,336,748
S01012054,146,53,87,363,649
S01012055,266,125,92,250,733
S01012056,361,179,12,117,669
S01012057,359,270,28,10,667
S01012058,275,256,51,49,631
S01012059,301,132,73,198,704
S01012060,292,136,59,223,710
S01012061,443,237,98,50,828
S01012062,476,139,61,14,690
S01012063,273,56,61,14,404
S01012064,99,13,40,319,471
S01012065,28,10,5,371,414
S01012066,269,40,56,268,633
S01012067,46,18,14,340,418
S01012068,26,4,15,386,431
S01012069,84,29,31,257,401
S01012070,85,53,87,388,613
S01012071,169,72,314,358,913
S01012072,223,96,261,389,969
S01012073,340,71,90,62,563
S01012074,366,104,103,13,586
S01012075,484,78,5,12,579
S01012076,329,111,73,100,613
S01012077,240,50,76,218,584
S01012078,507,94,36,143,780
S01012079,284,143,48,286,761
S01012080,138,18,20,386,562
S01012081,175,48,31,324,578
S01012082,185,54,44,227,510
S01012083,198,91,19,333,641
S01012084,307,129,21,28,485
S01012085,309,178,26,74,587
S01012086,289,134,58,267,748
S01012087,308,147,37,113,605
S01012088,353,88,27,85,553
S01012089,453,201,32,4,690
S01012090,405,324,30,9,768
S01012091,271,160,21,12,464
S01012092,258,143,21,9,431
S01012093,230,179,56,11,476
S01012094,385,264,22,10,681
S01012095,494,141,28,209,872
S01012096,334,163,36,189,722
S01012097,263,89,31,152,535
S01012098,268,77,29,133,507
S01012099,290,82,60,303,735
S01012100,367,170,32,304,873
S01012101,368,236,25,32,661
S01012102,163,60,34,242,499
S01012103,474,134,69,84,761
S01012104,456,94,103,45,698
S01012105,536,243,93,54,926
S01012106,550,179,142,24,895
S01012107,278,235,29,43,585
S01012108,220,150,67,413,850
S01012109,171,82,229,282,764
S01012110,227,145,107,154,633
S01012111,150,51,47,212,460
S01012112,271,207,57,129,664
S01012113,450,213,50,151,864
S01012114,452,286,81,13,832
S01012115,216,95,37,79,427
S01012116,278,124,17,77,496
S01012117,488,49,22,15,574
S01012118,366,90,23,12,491
S01012119,409,297,17,17,740
S01012120,166,99,39,162,466
S01012121,316,136,47,286,785
S01012122,340,154,27,148,669
S01012123,209,107,63,47,426
S01012124,239,111,76,19,445
S01012125,130,51,111,371,663
S01012126,422,82,136,31,671
S01012127,196,80,301,165,742
S01012128,137,23,180,78,418
S01012129,208,105,146,146,605
S01012130,305,168,159,347,979
S01012131,267,139,276,312,994
S01012132,127,86,238,140,591
S01012133,359,96,194,137,786
S01012134,464,319,187,87,1057
S01012135,105,44,107,486,742
S01012136,137,24,246,305,712
S01012137,125,127,108,245,605
S01012138,388,237,82,77,784
S01012139,399,213,69,100,781
S01012140,232,186,13,8,439
S01012141,463,309,35,21,828
S01012142,419,348,22,9,798
S01012143,361,377,9,17,764
S01012144,464,320,57,31,872
S01012145,492,299,27,16,834
S01012146,190,104,174,348,816
S01012147,175,94,71,280,620
S01012148,158,74,66,274,572
S01012149,356,114,84,137,691
S01012150,251,102,32,236,621
S01012151,242,111,35,236,624
S01012152,146,67,30,356,599
S01012153,74,35,92,244,445
S01012154,147,63,140,335,685
S01012155,127,70,98,201,496
S01012156,144,73,44,266,527
S01012157,352,97,118,233,800
S01012158,550,132,127,67,876
S01012159,231,205,10,5,451
S01012160,311,228,26,2,567
S01012161,103,25,61,152,341
S01012162,278,53,101,296,728
S01012163,219,56,125,184,584
S01012164,669,61,57,15,802
S01012165,201,95,66,348,710
S01012166,206,77,77,128,488
S01012167,326,130,70,162,688
S01012168,385,270,22,35,712
S01012169,349,195,45,134,723
S01012170,377,221,60,188,846
S01012171,448,197,59,126,830
S01012172,248,169,85,106,608
S01012173,318,297,8,7,630
S01012174,497,120,34,11,662
S01012175,429,200,46,10,685
S01012176,451,220,50,5,726
S01012177,269,215,31,6,521
S01012178,230,202,13,5,450
S01012179,221,154,60,83,518
S01012180,198,178,30,72,478
S01012181,317,167,65,96,645
S01012182,587,128,108,27,850
S01012183,269,100,95,149,613
S01012184,227,41,165,11,444
S01012185,185,67,201,170,623
S01012186,254,162,45,130,591
S01012187,202,112,82,186,582
S01012188,221,211,29,42,503
S01012189,297,100,25,45,467
S01012190,326,50,20,3,399
S01012191,468,201,37,10,716
S01012192,258,141,9,16,424
S01012193,352,63,3,7,425
S01012194,358,63,2,2,425
S01012195,644,173,33,46,896
S01012196,323,68,25,21,437
S01012197,340,102,20,114,576
S01012198,432,133,27,176,768
S01012199,324,131,59,87,601
S01012200,286,116,32,80,514
S01012201,339,122,34,114,609
S01012202,291,108,30,41,470
S01012203,446,212,8,7,673
S01012204,443,195,19,3,660
S01012205,377,161,25,7,570
S01012206,446,165,24,45,680
S01012207,372,163,65,121,721
S01012208,416,197,64,151,828
S01012209,319,116,50,102,587
S01012210,296,144,42,163,645
S01012211,420,176,44,97,737
S01012212,350,292,8,13,663
S01012213,373,308,20,5,706
S01012214,297,252,16,0,565
S01012215,435,256,16,13,720
S01012216,333,213,23,16,585
S01012217,139,54,40,206,439
S01012218,86,36,29,202,353
S01012219,253,144,52,270,719
S01012220,127,65,85,265,542
S01012221,210,109,79,146,544
S01012222,311,149,65,158,683
S01012223,217,77,31,257,582
S01012224,295,90,50,152,587
S01012225,344,123,80,268,815
S01012226,357,138,28,55,578
S01012227,314,122,37,52,525
S01012228,328,115,31,66,540
S01012229,367,137,69,5,578
S01012230,496,192,43,2,733
S01012231,406,208,27,2,643
S01012232,462,189,21,0,672
S01012233,461,257,28,5,751
S01012234,575,208,31,27,841
S01012235,190,197,12,6,405
S01012236,265,124,69,40,498
S01012237,354,252,18,10,634
S01012238,235,117,69,86,507
S01012239,181,104,57,141,483
S01012240,297,216,73,114,700
S01012241,218,180,28,17,443
S01012242,359,252,16,10,637
S01012243,262,149,58,15,484
S01012244,372,231,125,19,747
S01012245,240,215,54,75,584
S01012246,303,180,57,38,578
S01012247,279,216,89,27,611
S01012248,271,183,150,50,654
S01012249,259,209,143,82,693
S01012250,177,220,150,15,562
S01012251,274,186,89,229,778
S01012252,227,113,63,161,564
S01012253,220,240,131,197,788
S01012254,303,204,115,76,698
S01012255,244,321,171,76,812
S01012256,347,195,37,90,669
S01012257,299,251,49,163,762
S01012258,312,231,30,10,583
S01012259,200,264,37,14,515
S01012260,351,178,45,138,712
S01012261,385,124,37,83,629
S01012262,216,179,227,28,650
S01012263,196,155,87,156,594
S01012264,163,108,41,71,383
S01012265,225,140,22,249,636
S01012266,396,242,68,196,902
S01012267,292,222,62,17,593
S01012268,148,105,241,8,502
S01012269,375,271,73,109,828
S01012270,280,146,61,138,625
S01012271,299,272,194,51,816
S01012272,294,153,46,73,566
S01012273,227,211,112,40,590
S01012274,384,182,69,126,761
S01012275,171,103,281,168,723
S01012276,382,165,109,149,805
S01012277,338,169,124,209,840
S01012278,184,131,222,111,648
S01012279,157,113,132,234,636
S01012280,339,151,44,228,762
S01012281,233,160,152,70,615
S01012282,356,322,134,164,976
S01012283,291,221,70,128,710
S01012284,168,143,127,229,667
S01012285,185,201,34,66,486
S01012286,266,220,85,306,877
S01012287,101,79,35,548,763
S01012288,102,102,43,373,620
S01012289,238,394,63,43,738
S01012290,177,128,57,112,474
S01012291,357,163,119,93,732
S01012292,226,258,112,27,623
S01012293,140,125,26,87,378
S01012294,331,165,76,130,702
S01012295,306,58,81,122,567
S01012296,380,100,83,66,629
S01012297,178,196,95,5,474
S01012298,319,196,83,79,677
S01012299,205,141,140,18,504
S01012300,191,138,63,143,535
S01012301,201,225,277,83,786
S01012302,114,132,217,19,482
S01012303,257,265,161,36,719
S01012304,300,276,127,84,787
S01012305,176,224,73,117,590
S01012306,105,108,62,209,484
S01012307,147,151,70,163,531
S01012308,281,179,49,167,676
S01012309,171,147,37,108,463
S01012310,220,320,146,90,776
S01012311,197,207,28,60,492
S01012312,305,318,148,97,868
S01012313,221,201,119,100,641
S01012314,210,137,44,280,671
S01012315,163,224,93,181,661
S01012316,127,131,43,214,515
S01012317,185,97,45,77,404
S01012318,217,138,30,258,643
S01012319,148,204,258,30,640
S01012320,187,114,54,197,552
S01012321,255,176,70,121,622
S01012322,248,305,231,47,831
S01012323,243,334,149,35,761
S01012324,124,231,321,14,690
S01012325,122,230,55,124,531
S01012326,129,121,88,149,487
S01012327,187,184,69,218,658
S01012328,116,198,49,124,487
S01012329,140,187,323,42,692
S01012330,164,202,62,78,506
S01012331,298,117,48,27,490
S01012332,204,271,317,36,828
S01012333,185,264,349,17,815
S01012334,233,219,47,209,708
S01012335,403,180,84,129,796
S01012336,200,160,44,106,510
S01012337,185,179,77,306,747
S01012338,176,197,139,117,629
S01012339,98,111,177,138,524
S01012340,234,259,61,273,827
S01012341,267,265,228,34,794
S01012342,241,238,207,98,784
S01012343,190,223,356,50,819
S01012344,149,108,53,171,481
S01012345,273,162,41,107,583
S01012346,171,201,311,23,706
S01012347,262,181,52,142,637
S01012348,240,198,71,76,585
S01012349,286,161,61,236,744
S01012350,194,182,51,196,623
S01012351,297,122,49,204,672
S01012352,265,158,87,118,628
S01012353,168,136,131,233,668
S01012354,184,272,101,109,666
S01012355,180,285,282,19,766
S01012356,203,220,44,85,552
S01012357,247,323,165,2,737
S01012358,153,331,152,43,679
S01012359,128,110,52,327,617
S01012360,105,72,46,366,589
S01012361,112,48,19,306,485
S01012362,70,31,33,442,576
S01012363,227,197,180,238,842
S01012364,213,183,146,51,593
S01012365,359,313,84,34,790
S01012366,266,272,188,55,781
S01012367,299,287,73,126,785
S01012368,208,254,12,55,529
S01012369,314,243,70,96,723
S01012370,290,191,61,274,816
S01012371,298,205,114,193,810
S01012372,175,165,99,216,655
S01012373,339,288,60,159,846
S01012374,348,193,24,175,740
S01012375,270,151,43,288,752
S01012376,301,304,139,44,788
S01012377,174,249,121,62,606
S01012378,116,142,199,34,491
S01012379,103,133,138,50,424
S01012380,258,182,41,247,728
S01012381,229,188,81,213,711
S01012382,359,346,31,72,808
S01012383,255,258,84,135,732
S01012384,171,129,65,66,431
S01012385,256,194,88,56,594
S01012386,170,126,75,433,804
S01012387,237,254,112,150,753
S01012388,271,253,36,17,577
S01012389,316,188,42,113,659
S01012390,254,249,45,70,618
S01012391,362,244,86,91,783
S01012392,191,162,58,193,604
S01012393,295,242,55,134,726
S01012394,126,96,23,284,529
S01012395,159,171,68,114,512
S01012396,152,165,91,123,531
S01012397,208,261,84,176,729
S01012398,232,183,176,175,766
S01012399,129,134,50,191,504
S01012400,117,102,97,169,485
S01012401,151,175,58,276,660
S01012402,166,136,38,10,350
S01012403,344,330,93,90,857
S01012404,241,243,125,215,824
S01012405,300,197,45,10,552
S01012406,213,186,38,60,497
S01012407,235,213,40,149,637
S01012408,194,226,61,20,501
S01012409,178,222,76,85,561
S01012410,325,247,63,206,841
S01012411,234,205,52,270,761
S01012412,143,220,54,120,537
S01012413,252,361,98,81,792
S01012414,142,244,49,152,587
S01012415,137,240,23,48,448
S01012416,159,218,29,48,454
S01012417,109,184,132,117,542
S01012418,178,288,139,72,677
S01012419,174,321,112,68,675
S01012420,205,184,96,207,692
S01012421,194,185,121,127,627
S01012422,199,259,168,96,722
S01012423,306,245,71,72,694
S01012424,324,174,45,208,751
S01012425,115,92,42,246,495
S01012426,108,73,33,167,381
S01012427,156,91,34,239,520
S01012428,197,182,48,111,538
S01012429,169,168,69,58,464
S01012430,203,181,65,24,473
S01012431,274,308,116,90,788
S01012432,218,227,25,151,621
S01012433,158,138,55,86,437
S01012434,224,119,84,149,576
S01012435,175,95,47,208,525
S01012436,163,132,70,228,593
S01012437,232,174,41,167,614
S01012438,260,108,31,133,532
S01012439,223,171,83,166,643
S01012440,244,160,27,12,443
S01012441,296,277,72,117,762
S01012442,372,225,107,103,807
S01012443,284,174,87,69,614
S01012444,302,307,47,55,711
S01012445,255,90,20,36,401
S01012446,157,104,49,118,428
S01012447,407,262,38,16,723
S01012448,410,192,46,62,710
S01012449,262,140,38,39,479
S01012450,301,281,81,34,697
S01012451,309,415,50,11,785
S01012452,264,193,33,12,502
S01012453,352,309,31,5,697
S01012454,264,293,14,5,576
S01012455,196,261,39,0,496
S01012456,280,306,53,8,647
S01012457,279,438,24,14,755
S01012458,293,311,48,15,667
S01012459,325,185,55,17,582
S01012460,194,246,30,2,472
S01012461,222,108,51,68,449
S01012462,251,134,100,166,651
S01012463,213,80,53,132,478
S01012464,220,42,34,193,489
S01012465,261,88,67,148,564
S01012466,277,224,79,92,672
S01012467,238,169,77,76,560
S01012468,308,184,42,82,616
S01012469,346,302,24,2,674
S01012470,318,267,98,141,824
S01012471,300,371,53,5,729
S01012472,270,298,32,11,611
S01012473,239,181,41,7,468
S01012474,243,199,56,130,628
S01012475,215,250,69,22,556
S01012476,342,207,95,124,768
S01012477,306,228,25,10,569
S01012478,315,167,88,118,688
S01012479,352,161,29,9,551
S01012480,117,71,193,96,477
S01012481,259,152,260,40,711
S01012482,232,328,172,7,739
S01012483,158,203,257,191,809
S01012484,338,208,89,37,672
S01012485,287,311,142,1,741
S01012486,219,324,37,5,585
S01012487,219,127,72,109,527
S01012488,336,235,102,132,805
S01012489,163,76,167,436,842
S01012490,183,88,286,300,857
S01012491,73,32,64,188,357
S01012492,120,78,178,321,697
S01012493,165,131,29,279,604
S01012494,390,168,100,142,800
S01012495,313,161,128,258,860
S01012496,208,127,39,263,637
S01012497,132,88,32,173,425
S01012498,125,57,28,425,635
S01012499,189,58,77,264,588
S01012500,112,65,45,153,375
S01012501,63,29,44,311,447
S01012502,102,48,30,420,600
S01012503,165,96,32,228,521
S01012504,133,90,36,229,488
S01012505,305,208,69,286,868
S01012506,180,157,48,48,433
S01012507,365,206,108,134,813
S01012508,328,151,59,113,651
S01012509,229,171,39,18,457
S01012510,407,206,41,55,709
S01012511,257,159,67,67,550
S01012512,206,123,26,158,513
S01012513,284,111,35,14,444
S01012514,523,89,91,32,735
S01012515,150,108,64,205,527
S01012516,235,125,61,112,533
S01012517,325,142,91,133,691
S01012518,230,170,62,24,486
S01012519,179,170,92,17,458
S01012520,316,340,40,17,713
S01012521,195,139,91,11,436
S01012522,349,315,58,13,735
S01012523,373,276,54,45,748
S01012524,328,360,72,22,782
S01012525,342,224,53,11,630
S01012526,339,284,34,6,663
S01012527,231,212,38,56,537
S01012528,343,113,58,145,659
S01012529,252,186,84,97,619
S01012530,339,358,34,26,757
S01012531,329,145,88,56,618
S01012532,314,176,105,63,658
S01012533,174,157,95,39,465
S01012534,238,142,56,99,535
S01012535,350,166,37,130,683
S01012536,269,153,39,159,620
S01012537,261,156,92,163,672
S01012538,368,234,76,229,907
S01012539,214,204,61,103,582
S01012540,209,99,26,232,566
S01012541,292,285,128,153,858
S01012542,363,281,69,82,795
S01012543,305,152,50,40,547
S01012544,316,178,40,134,668
S01012545,130,70,15,160,375
S01012546,305,169,67,105,646
S01012547,252,254,31,89,626
S01012548,339,271,58,42,710
S01012549,185,61,49,140,435
S01012550,313,167,60,128,668
S01012551,373,268,26,8,675
S01012552,441,265,39,14,759
S01012553,470,128,43,10,651
S01012554,205,145,32,3,385
S01012555,256,134,42,4,436
S01012556,253,196,23,13,485
S01012557,214,258,46,14,532
S01012558,212,94,60,122,488
S01012559,167,148,110,235,660
S01012560,188,125,38,92,443
S01012561,307,140,67,109,623
S01012562,240,121,152,126,639
S01012563,225,308,24,1,558
S01012564,328,316,29,28,701
S01012565,301,224,61,75,661
S01012566,220,159,197,64,640
S01012567,311,222,202,159,894
S01012568,259,199,39,21,518
S01012569,329,324,41,13,707
S01012570,162,112,65,51,390
S01012571,225,209,150,86,670
S01012572,171,130,67,65,433
S01012573,317,239,102,17,675
S01012574,363,245,57,49,714
S01012575,209,188,86,57,540
S01012576,267,252,92,33,644
S01012577,271,197,71,77,616
S01012578,329,280,86,154,849
S01012579,223,131,67,124,545
S01012580,252,205,93,68,618
S01012581,178,108,28,261,575
S01012582,365,217,66,82,730
S01012583,223,151,33,175,582
S01012584,298,189,37,95,619
S01012585,232,132,55,255,674
S01012586,510,194,71,13,788
S01012587,356,262,71,17,706
S01012588,283,178,32,25,518
S01012589,202,110,31,220,563
S01012590,276,108,38,229,651
S01012591,176,171,18,286,651
S01012592,298,132,16,8,454
S01012593,453,176,26,19,674
S01012594,222,119,11,41,393
S01012595,240,162,37,90,529
S01012596,284,84,34,211,613
S01012597,249,53,16,31,349
S01012598,295,208,58,22,583
S01012599,271,184,55,53,563
S01012600,337,213,37,6,593
S01012601,467,205,21,30,723
S01012602,188,91,63,193,535
S01012603,229,134,47,175,585
S01012604,228,155,24,152,559
S01012605,137,160,19,118,434
S01012606,478,56,6,7,547
S01012607,342,155,26,99,622
S01012608,300,124,28,220,672
S01012609,260,101,27,291,679
S01012610,249,74,39,384,746
S01012611,339,225,25,106,695
S01012612,266,122,32,183,603
S01012613,249,126,20,152,547
S01012614,405,253,67,158,883
S01012615,279,190,28,73,570
S01012616,359,266,37,125,787
S01012617,188,127,30,7,352
S01012618,216,114,34,77,441
S01012619,150,121,55,162,488
S01012620,323,271,30,20,644
S01012621,225,211,30,44,510
S01012622,278,183,22,114,597
S01012623,190,129,41,192,552
S01012624,253,126,76,131,586
S01012625,192,103,16,142,453
S01012626,204,162,20,24,410
S01012627,126,105,28,170,429
S01012628,500,205,64,24,793
S01012629,220,133,37,9,399
S01012630,222,236,136,173,767
S01012631,281,112,43,288,724
S01012632,260,244,65,19,588
S01012633,231,216,47,71,565
S01012634,201,181,38,152,572
S01012635,436,271,48,122,877
S01012636,269,144,44,44,501
S01012637,198,88,40,335,661
S01012638,274,192,96,159,721
S01012639,302,140,29,210,681
S01012640,185,124,45,420,774
S01012641,308,248,140,245,941
S01012642,145,100,50,356,651
S01012643,144,87,39,103,373
S01012644,213,97,40,184,534
S01012645,310,169,85,119,683
S01012646,451,186,57,68,762
S01012647,417,43,57,10,527
S01012648,156,75,33,172,436
S01012649,217,164,21,145,547
S01012650,268,144,38,44,494
S01012651,154,74,29,264,521
S01012652,523,293,49,16,881
S01012653,279,136,46,241,702
S01012654,337,163,84,28,612
S01012655,453,239,42,228,962
S01012656,287,134,39,211,671
S01012657,188,115,70,81,454
S01012658,417,336,42,20,815
S01012659,610,117,28,13,768
S01012660,267,111,25,185,588
S01012661,347,188,68,40,643
S01012662,222,168,67,174,631
S01012663,285,246,53,12,596
S01012664,397,230,105,81,813
S01012665,170,88,38,267,563
S01012666,189,112,40,210,551
S01012667,122,114,16,228,480
S01012668,246,122,61,166,595
S01012669,353,244,11,7,615
S01012670,316,268,20,7,611
S01012671,350,168,45,197,760
S01012672,157,59,33,337,586
S01012673,139,56,37,243,475
S01012674,147,53,34,204,438
S01012675,254,76,45,265,640
S01012676,329,108,73,122,632
S01012677,174,88,42,169,473
S01012678,384,155,30,4,573
S01012679,332,140,21,173,666
S01012680,297,103,25,10,435
S01012681,252,183,82,49,566
S01012682,335,211,64,52,662
S01012683,253,133,31,186,603
S01012684,284,101,40,15,440
S01012685,335,90,23,174,622
S01012686,419,246,109,18,792
S01012687,197,247,8,2,454
S01012688,272,211,160,47,690
S01012689,204,144,24,18,390
S01012690,247,117,27,32,423
S01012691,361,194,34,3,592
S01012692,309,167,34,112,622
S01012693,436,239,13,12,700
S01012694,210,74,28,49,361
S01012695,305,218,68,58,649
S01012696,343,308,74,7,732
S01012697,191,155,42,15,403
S01012698,348,217,44,42,651
S01012699,450,243,61,91,845
S01012700,319,235,59,56,669
S01012701,206,223,25,11,465
S01012702,260,115,76,30,481
S01012703,344,52,19,47,462
S01012704,308,73,29,185,595
S01012705,457,103,15,7,582
S01012706,288,82,30,154,554
S01012707,439,244,34,8,725
S01012708,266,97,49,181,593
S01012709,173,112,19,124,428
S01012710,237,110,51,205,603
S01012711,209,131,78,296,714
S01012712,375,274,30,14,693
S01012713,282,259,36,36,613
S01012714,240,252,12,9,513
S01012715,242,148,100,132,622
S01012716,291,342,70,35,738
S01012717,248,248,179,193,868
S01012718,364,266,171,65,866
S01012719,235,145,224,90,694
S01012720,195,68,175,24,462
S01012721,274,147,55,60,536
S01012722,249,98,65,217,629
S01012723,202,102,50,216,570
S01012724,257,172,107,93,629
S01012725,334,181,151,100,766
S01012726,229,146,34,108,517
S01012727,194,67,19,285,565
S01012728,114,35,42,379,570
S01012729,412,137,33,87,669
S01012730,197,67,23,162,449
S01012731,296,107,32,189,624
S01012732,283,108,34,123,548
S01012733,619,71,53,19,762
S01012734,373,28,15,7,423
S01012735,183,95,36,85,399
S01012736,443,120,59,115,737
S01012737,435,97,57,42,631
S01012738,246,106,21,131,504
S01012739,507,58,40,8,613
S01012740,429,66,29,98,622
S01012741,332,122,21,13,488
S01012742,327,220,23,22,592
S01012743,245,230,26,2,503
S01012744,408,131,28,6,573
S01012745,337,234,15,14,600
S01012746,402,120,53,53,628
S01012747,318,164,26,174,682
S01012748,157,65,39,386,647
S01012749,206,57,54,365,682
S01012750,215,61,87,250,613
S01012751,275,198,37,194,704
S01012752,285,112,37,233,667
S01012753,119,49,28,188,384
S01012754,180,114,20,161,475
S01012755,130,61,28,222,441
S01012756,175,141,22,120,458
S01012757,160,80,23,135,398
S01012758,251,96,30,121,498
S01012759,225,101,37,221,584
S01012760,282,95,90,315,782
S01012761,314,137,50,151,652
S01012762,307,194,45,61,607
S01012763,165,65,12,105,347
S01012764,259,119,47,196,621
S01012765,277,125,11,171,584
S01012766,354,62,39,236,691
S01012767,283,176,11,12,482
S01012768,353,237,16,7,613
S01012769,268,74,13,1,356
S01012770,359,134,72,131,696
S01012771,311,129,42,117,599
S01012772,226,84,25,208,543
S01012773,359,181,41,147,728
S01012774,359,141,65,178,743
S01012775,160,99,42,66,367
S01012776,297,100,39,198,634
S01012777,537,60,50,61,708
S01012778,273,34,22,212,541
S01012779,154,16,23,145,338
S01012780,164,59,35,307,565
S01012781,296,138,53,64,551
S01012782,140,84,45,238,507
S01012783,215,72,43,227,557
S01012784,270,97,46,215,628
S01012785,153,83,50,329,615
S01012786,117,42,109,319,587
S01012787,296,35,47,67,445
S01012788,200,57,31,206,494
S01012789,342,150,24,101,617
S01012790,308,72,83,42,505
S01012791,262,268,46,30,606
S01012792,393,193,123,161,870
S01012793,172,116,119,281,688
S01012794,204,147,159,39,549
S01012795,293,90,64,419,866
S01012796,333,57,65,155,610
S01012797,210,62,50,224,546
S01012798,300,220,46,25,591
S01012799,315,246,66,36,663
S01012800,410,235,74,13,732
S01012801,112,193,73,10,388
S01012802,254,195,32,3,484
S01012803,342,206,18,5,571
S01012804,276,118,59,169,622
S01012805,332,157,61,189,739
S01012806,319,115,39,107,580
S01012807,268,174,25,4,471
S01012808,459,259,84,70,872
S01012809,222,130,150,27,529
S01012810,229,140,72,344,785
S01012811,289,234,36,103,662
S01012812,328,127,39,61,555
S01012813,405,332,23,6,766
S01012814,497,94,37,9,637
S01012815,467,55,75,27,624
S01012816,304,43,64,20,431
S01012817,325,32,10,13,380
S01012818,462,111,32,20,625
S01012819,235,109,56,203,603
S01012820,587,97,41,50,775
S01012821,448,27,54,22,551
S01012822,83,39,62,179,363
S01012823,530,62,36,5,633
S01012824,354,79,29,57,519
S01012825,158,65,53,142,418
S01012826,91,10,17,318,436
S01012827,389,29,39,19,476
S01012828,358,61,38,3,460
S01012829,243,70,52,286,651
S01012830,275,104,29,155,563
S01012831,198,144,37,179,558
S01012832,212,76,20,127,435
S01012833,139,94,40,298,571
S01012834,215,136,28,180,559
S01012835,364,185,78,142,769
S01012836,440,50,18,16,524
S01012837,66,17,20,474,577
S01012838,52,12,33,609,706
S01012839,394,157,8,16,575
S01012840,459,80,28,15,582
S01012841,286,161,24,24,495
S01012842,251,121,21,12,405
S01012843,449,274,27,22,772
S01012844,323,205,15,16,559
S01012845,305,179,38,30,552
S01012846,217,142,122,324,805
S01012847,261,107,24,62,454
S01012848,371,119,68,21,579
S01012849,185,88,180,109,562
S01012850,293,159,18,150,620
S01012851,360,215,13,108,696
S01012852,291,256,30,13,590
S01012853,312,330,33,10,685
S01012854,449,190,48,5,692
S01012855,335,109,78,15,537
S01012856,242,140,76,148,606
S01012857,250,208,64,241,763
S01012858,221,67,57,273,618
S01012859,444,119,155,124,842
S01012860,491,314,98,43,946
S01012861,325,207,43,15,590
S01012862,154,59,65,240,518
S01012863,131,45,91,287,554
S01012864,163,63,99,333,658
S01012865,307,173,48,140,668
S01012866,350,112,63,110,635
S01012867,203,122,43,275,643
S01012868,154,115,69,160,498
S01012869,75,33,23,292,423
S01012870,415,248,42,99,804
S01012871,360,228,87,23,698
S01012872,316,131,118,10,575
S01012873,376,139,115,24,654
S01012874,279,107,41,208,635
S01012875,184,87,50,164,485
S01012876,297,119,31,216,663
S01012877,332,158,19,120,629
S01012878,472,239,43,18,772
S01012879,334,192,57,25,608
S01012880,404,302,29,22,757
S01012881,344,339,37,53,773
S01012882,129,122,19,222,492
S01012883,131,76,13,307,527
S01012884,173,73,28,176,450
S01012885,91,66,59,173,389
S01012886,364,209,44,32,649
S01012887,342,248,18,22,630
S01012888,366,272,26,28,692
S01012889,466,84,39,71,660
S01012890,211,62,34,241,548
S01012891,230,94,15,115,454
S01012892,269,183,54,422,928
S01012893,179,122,21,274,596
S01012894,361,87,26,131,605
S01012895,272,85,28,25,410
S01012896,223,147,29,359,758
S01012897,288,119,49,15,471
S01012898,339,28,24,8,399
S01012899,151,58,21,245,475
S01012900,294,199,91,32,616
S01012901,299,137,77,53,566
S01012902,327,135,67,99,628
S01012903,356,154,73,99,682
S01012904,314,127,76,114,631
S01012905,135,66,46,241,488
S01012906,435,156,100,90,781
S01012907,362,177,67,127,733
S01012908,265,157,56,123,601
S01012909,226,99,84,100,509
S01012910,260,145,53,313,771
S01012911,303,207,66,53,629
S01012912,228,189,53,108,578
S01012913,345,212,64,109,730
S01012914,319,150,127,113,709
S01012915,495,112,87,114,808
S01012916,253,174,50,93,570
S01012917,342,194,28,21,585
S01012918,183,118,66,48,415
S01012919,176,140,31,48,395
S01012920,249,238,16,1,504
S01012921,299,140,74,78,591
S01012922,462,150,72,98,782
S01012923,319,145,68,44,576
S01012924,235,86,65,34,420
S01012925,247,122,28,14,411
S01012926,285,173,77,57,592
S01012927,331,166,69,60,626
S01012928,388,206,45,34,673
S01012929,332,231,42,34,639
S01012930,264,219,143,151,777
S01012931,331,147,109,141,728
S01012932,233,130,20,38,421
S01012933,358,158,51,105,672
S01012934,252,155,80,116,603
S01012935,362,198,43,111,714
S01012936,289,134,73,121,617
S01012937,317,117,62,83,579
S01012938,329,205,24,40,598
S01012939,350,126,17,4,497
S01012940,403,144,25,4,576
S01012941,397,183,12,6,598
S01012942,270,91,91,171,623
S01012943,389,120,41,22,572
S01012944,284,115,17,0,416
S01012945,416,126,14,10,566
S01012946,457,145,82,5,689
S01012947,261,100,4,4,369
S01012948,374,178,5,14,571
S01012949,353,199,29,12,593
S01012950,529,106,30,10,675
S01012951,533,88,22,4,647
S01012952,258,239,17,9,523
S01012953,358,168,35,5,566
S01012954,265,100,20,6,391
S01012955,472,158,113,17,760
S01012956,414,212,78,146,850
S01012957,269,131,36,102,538
S01012958,266,77,28,62,433
S01012959,348,62,27,26,463
S01012960,256,83,4,158,501
S01012961,281,113,16,3,413
S01012962,342,177,30,3,552
S01012963,492,88,24,10,614
S01012964,373,39,33,2,447
S01012965,346,72,22,121,561
S01012966,401,85,38,67,591
S01012967,236,74,23,62,395
S01012968,259,90,78,88,515
S01012969,276,105,63,124,568
S01012970,260,68,16,143,487
S01012971,259,77,52,248,636
S01012972,259,65,74,212,610
S01012973,377,126,52,90,645
S01012974,429,192,65,197,883
S01012975,226,58,50,155,489
S01012976,188,86,41,109,424
S01012977,299,86,52,121,558
S01012978,323,93,43,186,645
S01012979,324,80,30,79,513
S01012980,273,82,68,102,525
S01012981,343,111,63,103,620
S01012982,354,125,81,100,660
S01012983,381,194,41,15,631
S01012984,329,113,36,50,528
S01012985,390,188,32,47,657
S01012986,311,125,68,120,624
S01012987,298,139,68,125,630
S01012988,318,207,88,129,742
S01012989,434,211,63,99,807
S01012990,227,107,53,127,514
S01012991,344,154,88,81,667
S01012992,347,152,71,88,658
S01012993,236,153,89,106,584
S01012994,253,174,123,209,759
S01012995,415,106,42,97,660
S01012996,320,71,25,132,548
S01012997,210,67,31,82,390
S01012998,509,120,94,111,834
S01012999,230,67,25,73,395
S01013000,267,134,55,91,547
S01013001,116,114,71,18,319
S01013002,158,153,69,24,404
S01013003,285,225,5,5,520
S01013004,292,186,20,33,531
S01013005,231,243,77,22,573
S01013006,206,192,86,17,501
S01013007,378,335,59,23,795
S01013008,263,221,60,71,615
S01013009,179,178,62,106,525
S01013010,200,211,60,8,479
S01013011,293,106,38,73,510
S01013012,223,132,80,102,537
S01013013,258,185,73,48,564
S01013014,209,209,100,87,605
S01013015,268,256,67,16,607
S01013016,173,229,76,17,495
S01013017,305,155,35,162,657
S01013018,374,256,61,77,768
S01013019,383,172,116,15,686
S01013020,168,86,43,106,403
S01013021,195,77,24,78,374
S01013022,119,50,34,119,322
S01013023,327,327,37,16,707
S01013024,219,158,33,10,420
S01013025,167,202,80,27,476
S01013026,445,129,41,194,809
S01013027,219,115,47,410,791
S01013028,171,110,51,60,392
S01013029,171,104,28,185,488
S01013030,126,90,30,233,479
S01013031,173,72,32,226,503
S01013032,408,50,44,67,569
S01013033,320,48,71,71,510
S01013034,251,116,23,184,574
S01013035,189,85,22,249,545
S01013036,188,66,19,329,602
S01013037,358,192,54,48,652
S01013038,315,183,81,230,809
S01013039,299,98,21,7,425
S01013040,213,159,52,117,541
S01013041,233,108,49,93,483
S01013042,370,104,44,129,647
S01013043,149,97,35,275,556
S01013044,235,124,58,230,647
S01013045,286,92,45,116,539
S01013046,162,68,35,154,419
S01013047,535,125,27,15,702
S01013048,396,152,123,12,683
S01013049,371,238,60,15,684
S01013050,213,164,64,205,646
S01013051,338,153,51,219,761
S01013052,258,166,55,156,635
S01013053,126,86,85,227,524
S01013054,253,165,56,101,575
S01013055,224,130,72,153,579
S01013056,273,184,57,258,772
S01013057,148,69,39,383,639
S01013058,290,50,35,43,418
S01013059,239,310,103,16,668
S01013060,203,179,50,16,448
S01013061,288,349,45,0,682
S01013062,283,316,139,6,744
S01013063,282,250,97,48,677
S01013064,329,175,54,154,712
S01013065,252,134,137,207,730
S01013066,274,121,101,115,611
S01013067,85,32,565,91,773
S01013068,94,56,253,254,657
S01013069,97,93,368,110,668
S01013070,81,41,246,192,560
S01013071,130,49,664,80,923
S01013072,53,35,10,334,432
S01013073,152,31,80,374,637
S01013074,56,48,43,377,524
S01013075,120,105,72,451,748
S01013076,302,128,167,53,650
S01013077,161,101,49,231,542
S01013078,83,42,24,285,434
S01013079,680,184,105,115,1084
S01013080,290,185,175,86,736
S01013081,249,251,34,11,545
S01013082,353,327,47,7,734
S01013083,1176,790,192,47,2205
S01013084,307,264,44,7,622
S01013085,214,125,66,188,593
S01013086,221,226,244,66,757
S01013087,239,318,121,9,687
S01013088,323,363,75,10,771
S01013089,225,182,103,121,631
S01013090,201,150,286,48,685
S01013091,88,69,260,44,461
S01013092,248,141,210,140,739
S01013093,124,211,57,15,407
S01013094,260,205,11,0,476
S01013095,403,200,27,0,630
S01013096,189,71,103,84,447
S01013097,254,152,78,7,491
S01013098,322,81,13,2,418
S01013099,311,271,169,38,789
S01013100,206,258,26,3,493
S01013101,343,197,83,210,833
S01013102,219,225,44,12,500
S01013103,444,155,12,7,618
S01013104,431,317,29,16,793
S01013105,366,285,60,19,730
S01013106,312,184,99,61,656
S01013107,208,235,101,10,554
S01013108,159,160,36,121,476
S01013109,382,332,133,39,886
S01013110,179,179,94,34,486
S01013111,163,158,30,24,375
S01013112,230,107,50,100,487
S01013113,290,157,20,211,678
S01013114,195,216,173,91,675
S01013115,179,171,107,116,573
S01013116,292,363,20,5,680
S01013117,215,109,55,130,509
S01013118,189,175,49,39,452
S01013119,220,230,118,97,665
S01013120,219,271,174,165,829
S01013121,79,89,58,104,330
S01013122,94,33,35,316,478
S01013123,188,97,76,251,612
S01013124,297,102,29,166,594
S01013125,317,190,49,130,686
S01013126,134,50,10,384,578
S01013127,120,76,24,403,623
S01013128,150,35,132,240,557
S01013129,428,151,90,301,970
S01013130,125,25,54,336,540
S01013131,155,37,20,293,505
S01013132,72,18,41,349,480
S01013133,231,35,54,452,772
S01013134,265,183,58,160,666
S01013135,130,47,28,398,603
S01013136,326,214,18,227,785
S01013137,196,201,5,223,625
S01013138,105,33,30,348,516
S01013139,172,92,25,420,709
S01013140,208,113,29,320,670
S01013141,169,69,72,228,538
S01013142,56,28,28,636,748
S01013143,263,156,60,247,726
S01013144,309,204,36,230,779
S01013145,305,118,23,160,606
S01013146,191,66,5,105,367
S01013147,314,127,20,132,593
S01013148,320,176,55,96,647
S01013149,349,126,81,134,690
S01013150,297,232,49,149,727
S01013151,267,132,44,31,474
S01013152,393,143,38,160,734
S01013153,169,76,15,416,676
S01013154,248,131,32,370,781
S01013155,121,38,60,445,664
S01013156,112,37,9,487,645
S01013157,160,57,24,498,739
S01013158,277,167,29,20,493
S01013159,324,207,31,40,602
S01013160,379,166,31,3,579
S01013161,390,158,36,249,833
S01013162,219,197,50,235,701
S01013163,310,179,18,68,575
S01013164,379,183,39,254,855
S01013165,347,210,31,181,769
S01013166,60,21,32,416,529
S01013167,84,26,14,402,526
S01013168,298,98,63,299,758
S01013169,259,136,34,292,721
S01013170,140,35,39,220,434
S01013171,325,97,21,79,522
S01013172,297,103,33,178,611
S01013173,402,99,56,98,655
S01013174,481,113,11,18,623
S01013175,451,114,32,60,657
S01013176,349,170,72,109,700
S01013177,327,154,29,20,530
S01013178,306,180,58,77,621
S01013179,285,208,61,150,704
S01013180,246,81,30,1,358
S01013181,349,177,21,62,609
S01013182,266,146,44,175,631
S01013183,368,258,11,68,705
S01013184,98,37,29,273,437
S01013185,245,90,28,254,617
S01013186,177,58,16,269,520
S01013187,246,93,29,289,657
S01013188,389,193,32,117,731
S01013189,298,161,13,50,522
S01013190,345,89,34,183,651
S01013191,577,226,21,8,832
S01013192,420,246,69,82,817
S01013193,289,124,107,36,556
S01013194,241,101,117,33,492
S01013195,390,120,214,165,889
S01013196,295,126,116,24,561
S01013197,229,169,50,52,500
S01013198,259,170,57,213,699
S01013199,324,193,77,220,814
S01013200,213,142,30,210,595
S01013201,140,55,5,398,598
S01013202,141,90,18,215,464
S01013203,213,101,24,236,574
S01013204,414,105,51,62,632
S01013205,133,41,15,271,460
S01013206,178,85,33,221,517
S01013207,241,136,50,234,661
S01013208,209,81,67,382,739
S01013209,287,152,100,167,706
S01013210,270,195,32,13,510
S01013211,411,152,44,124,731
S01013212,363,84,16,8,471
S01013213,316,119,16,6,457
S01013214,276,54,13,3,346
S01013215,372,90,75,111,648
S01013216,193,47,35,174,449
S01013217,232,99,58,151,540
S01013218,135,28,47,244,454
S01013219,117,64,26,215,422
S01013220,187,88,40,207,522
S01013221,244,124,40,311,719
S01013222,126,36,24,289,475
S01013223,355,129,115,337,936
S01013224,302,117,24,229,672
S01013225,205,74,20,319,618
S01013226,244,73,28,54,399
S01013227,157,77,29,300,563
S01013228,238,101,149,116,604
S01013229,243,93,51,232,619
S01013230,221,142,43,155,561
S01013231,271,103,40,205,619
S01013232,207,162,48,184,601
S01013233,214,167,43,85,509
S01013234,203,80,8,17,308
S01013235,333,196,61,88,678
S01013236,330,330,22,80,762
S01013237,412,103,46,86,647
S01013238,152,82,37,353,624
S01013239,204,93,30,380,707
S01013240,89,46,19,278,432
S01013241,379,311,20,15,725
S01013242,241,186,45,35,507
S01013243,187,146,52,213,598
S01013244,223,105,68,220,616
S01013245,409,177,74,135,795
S01013246,219,45,28,72,364
S01013247,226,90,81,230,627
S01013248,135,82,52,240,509
S01013249,191,78,24,80,373
S01013250,289,180,84,150,703
S01013251,118,46,55,336,555
S01013252,243,93,30,178,544
S01013253,269,112,68,134,583
S01013254,166,44,25,262,497
S01013255,465,310,48,375,1198
S01013256,319,100,85,98,602
S01013257,239,181,68,207,695
S01013258,326,200,37,73,636
S01013259,274,153,92,158,677
S01013260,209,90,65,311,675
S01013261,230,101,46,243,620
S01013262,200,130,39,159,528
S01013263,227,127,46,4,404
S01013264,301,63,15,0,379
S01013265,401,69,8,5,483
S01013266,323,74,26,0,423
S01013267,180,68,25,186,459
S01013268,409,110,54,83,656
S01013269,467,152,109,18,746
S01013270,484,106,14,5,609
S01013271,272,207,20,0,499
S01013272,414,119,20,10,563
S01013273,553,59,22,5,639
S01013274,426,186,70,1,683
S01013275,349,155,62,1,567
S01013276,346,104,36,13,499
S01013277,372,105,102,138,717
S01013278,287,86,103,226,702
S01013279,163,56,72,257,548
S01013280,272,91,50,42,455
S01013281,330,84,130,196,740
S01013282,215,44,86,282,627
S01013283,152,39,208,134,533
S01013284,351,114,63,9,537
S01013285,349,111,67,13,540
S01013286,357,132,49,16,554
S01013287,465,140,18,8,631
S01013288,243,159,53,88,543
S01013289,307,207,64,14,592
S01013290,441,120,68,61,690
S01013291,415,66,25,18,524
S01013292,372,186,45,16,619
S01013293,408,162,10,0,580
S01013294,381,125,32,59,597
S01013295,378,167,69,11,625
S01013296,186,123,29,258,596
S01013297,269,150,55,99,573
S01013298,248,146,101,84,579
S01013299,425,146,59,190,820
S01013300,190,115,57,121,483
S01013301,172,74,50,111,407
S01013302,269,161,46,36,512
S01013303,405,207,57,90,759
S01013304,246,73,98,327,744
S01013305,308,96,148,236,788
S01013306,106,29,82,536,753
S01013307,196,57,125,435,813
S01013308,93,45,46,523,707
S01013309,288,74,102,27,491
S01013310,243,75,63,123,504
S01013311,248,90,110,169,617
S01013312,309,124,98,300,831
S01013313,195,97,95,148,535
S01013314,174,112,71,178,535
S01013315,300,50,26,4,380
S01013316,249,197,36,64,546
S01013317,262,133,60,1,456
S01013318,339,79,49,10,477
S01013319,267,53,31,76,427
S01013320,532,73,102,25,732
S01013321,159,41,39,127,366
S01013322,369,91,48,132,640
S01013323,321,87,80,280,768
S01013324,165,42,36,255,498
S01013325,100,18,34,509,661
S01013326,157,37,74,160,428
S01013327,174,60,60,245,539
S01013328,158,29,60,231,478
S01013329,166,83,48,136,433
S01013330,501,88,176,53,818
S01013331,291,40,134,14,479
S01013332,264,90,76,104,534
S01013333,408,105,71,57,641
S01013334,222,55,69,222,568
S01013335,161,42,34,332,569
S01013336,155,51,79,373,658
S01013337,448,212,62,59,781
S01013338,307,44,36,0,387
S01013339,277,123,62,8,470
S01013340,410,234,37,12,693
S01013341,387,174,142,21,724
S01013342,201,58,58,197,514
S01013343,279,58,50,136,523
S01013344,173,79,47,354,653
S01013345,255,52,98,169,574
S01013346,437,72,57,52,618
S01013347,370,107,68,28,573
S01013348,256,46,33,5,340
S01013349,228,25,314,47,614
S01013350,223,55,79,192,549
S01013351,335,141,77,76,629
S01013352,382,124,86,121,713
S01013353,224,51,38,194,507
S01013354,335,140,45,68,588
S01013355,251,99,45,124,519
S01013356,192,74,39,276,581
S01013357,321,158,35,142,656
S01013358,301,144,51,179,675
S01013359,151,77,38,235,501
S01013360,220,103,37,211,571
S01013361,148,52,30,250,480
S01013362,153,86,29,119,387
S01013363,144,93,48,324,609
S01013364,373,138,33,173,717
S01013365,346,208,106,6,666
S01013366,450,132,34,81,697
S01013367,319,72,30,47,468
S01013368,348,149,43,97,637
S01013369,202,106,99,303,710
S01013370,144,77,17,260,498
S01013371,162,154,45,195,556
S01013372,191,82,43,526,842
S01013373,272,151,72,261,756
S01013374,125,100,120,400,745
S01013375,170,97,38,160,465
S01013376,176,84,67,151,478
S01013377,232,169,73,177,651
S01013378,332,167,39,248,786
S01013379,335,154,53,161,703
S01013380,29,73,16,7,125
S01013381,154,97,18,131,400
S01013382,271,75,29,68,443
S01013383,195,91,49,244,579
S01013384,268,104,49,196,617
S01013385,179,110,52,64,405
S01013386,427,187,14,59,687
S01013387,170,75,15,209,469
S01013388,253,149,72,163,637
S01013389,322,100,46,153,621
S01013390,178,73,20,109,380
S01013391,170,99,21,64,354
S01013392,426,56,57,7,546
S01013393,236,86,43,196,561
S01013394,196,74,38,224,532
S01013395,80,24,32,380,516
S01013396,428,18,44,9,499
S01013397,363,98,62,180,703
S01013398,359,52,14,19,444
S01013399,640,84,48,65,837
S01013400,208,98,85,144,535
S01013401,445,54,52,64,615
S01013402,600,29,133,6,768
S01013403,439,27,116,38,620
S01013404,243,20,84,73,420
S01013405,218,167,60,124,569
S01013406,169,66,51,217,503
S01013407,152,76,44,162,434
S01013408,152,52,69,245,518
S01013409,374,130,102,226,832
S01013410,58,18,29,380,485
S01013411,241,126,143,91,601
S01013412,318,105,66,170,659
S01013413,333,147,61,93,634
S01013414,181,128,290,166,765
S01013415,128,65,71,300,564
S01013416,156,72,41,219,488
S01013417,240,129,156,204,729
S01013418,212,82,54,160,508
S01013419,255,113,9,8,385
S01013420,264,73,58,71,466
S01013421,454,44,27,38,563
S01013422,245,109,45,190,589
S01013423,372,146,32,116,666
S01013424,254,83,28,19,384
S01013425,201,80,44,30,355
S01013426,243,125,80,221,669
S01013427,234,53,45,13,345
S01013428,254,101,77,305,737
S01013429,278,87,69,112,546
S01013430,320,121,32,77,550
S01013431,206,112,32,211,561
S01013432,255,141,47,147,590
S01013433,327,169,33,69,598
S01013434,230,127,39,23,419
S01013435,308,152,19,6,485
S01013436,334,119,34,174,661
S01013437,260,96,80,123,559
S01013438,153,78,110,126,467
S01013439,376,320,28,11,735
S01013440,438,351,16,21,826
S01013441,295,267,61,13,636
S01013442,348,179,62,42,631
S01013443,240,165,76,25,506
S01013444,275,143,192,202,812
S01013445,303,220,16,39,578
S01013446,279,162,53,81,575
S01013447,305,80,27,7,419
S01013448,284,327,62,13,686
S01013449,311,185,22,4,522
S01013450,299,112,56,0,467
S01013451,460,181,13,11,665
S01013452,336,202,57,10,605
S01013453,124,83,33,358,598
S01013454,327,168,61,43,599
S01013455,161,115,128,60,464
S01013456,306,100,59,182,647
S01013457,285,130,52,258,725
S01013458,276,141,50,119,586
S01013459,301,129,103,188,721
S01013460,284,124,34,209,651
S01013461,436,82,100,209,827
S01013462,470,89,66,54,679
S01013463,167,39,34,162,402
S01013464,269,246,56,47,618
S01013465,272,211,44,57,584
S01013466,126,169,61,43,399
S01013467,515,138,38,28,719
S01013468,243,123,64,154,584
S01013469,340,241,26,35,642
S01013470,192,91,69,223,575
S01013471,305,148,42,246,741
S01013472,371,51,35,10,467
S01013473,376,55,27,10,468
S01013474,335,58,56,14,463
S01013475,285,157,37,30,509
S01013476,234,175,47,80,536
S01013477,167,101,76,166,510
S01013478,361,79,78,151,669
S01013479,213,115,111,243,682
S01013480,204,156,60,143,563
S01013481,177,134,30,50,391
W01000001,222,401,233,120,976
W01000002,346,461,172,73,1052
W01000003,616,697,373,353,2039
W01000004,336,516,109,112,1073
W01000005,382,691,338,253,1664
W01000006,445,580,149,125,1299
W01000007,475,614,226,93,1408
W01000008,458,508,173,69,1208
W01000009,516,588,183,224,1511
W01000010,539,821,216,36,1612
W01000011,257,394,357,86,1094
W01000012,469,562,88,123,1242
W01000013,636,960,171,87,1854
W01000014,599,537,223,290,1649
W01000015,452,581,164,78,1275
W01000016,314,198,363,90,965
W01000017,444,412,165,202,1223
W01000018,347,504,159,129,1139
W01000019,370,684,169,58,1281
W01000020,374,566,143,38,1121
W01000021,589,924,238,150,1901
W01000022,395,643,207,113,1358
W01000023,398,411,182,175,1166
W01000024,301,173,393,87,954
W01000025,677,645,201,152,1675
W01000026,287,532,134,93,1046
W01000027,494,558,246,171,1469
W01000028,493,599,194,296,1582
W01000029,329,342,232,288,1191
W01000030,524,460,305,475,1764
W01000031,444,549,169,125,1287
W01000032,280,450,97,76,903
W01000033,271,298,108,522,1199
W01000034,368,380,77,133,958
W01000035,464,685,259,138,1546
W01000036,242,225,167,248,882
W01000037,353,329,125,140,947
W01000038,641,764,237,215,1857
W01000039,253,506,110,28,897
W01000040,295,549,140,6,990
W01000041,300,173,120,553,1146
W01000042,634,660,232,216,1742
W01000043,352,364,92,163,971
W01000044,388,496,66,17,967
W01000047,309,522,138,128,1097
W01000048,278,448,125,253,1104
W01000049,203,296,335,104,938
W01000050,347,394,277,92,1110
W01000051,418,601,244,366,1629
W01000052,416,374,75,65,930
W01000053,401,401,135,37,974
W01000054,306,435,76,93,910
W01000056,451,542,257,263,1513
W01000057,260,690,148,115,1213
W01000059,410,464,170,585,1629
W01000060,265,536,192,105,1098
W01000061,359,694,225,160,1438
W01000062,104,95,991,158,1348
W01000063,525,470,188,284,1467
W01000064,519,359,287,270,1435
W01000065,239,409,167,130,945
W01000066,270,455,169,98,992
W01000067,268,448,199,77,992
W01000068,331,420,132,271,1154
W01000069,325,733,170,100,1328
W01000070,299,524,143,97,1063
W01000071,804,562,272,220,1858
W01000072,450,525,262,231,1468
W01000073,547,602,115,121,1385
W01000074,453,837,264,111,1665
W01000075,262,179,460,345,1246
W01000076,168,249,402,103,922
W01000077,219,207,576,230,1232
W01000078,385,601,172,213,1371
W01000079,200,521,116,85,922
W01000080,278,756,230,273,1537
W01000081,537,587,241,271,1636
W01000082,213,355,204,89,861
W01000083,262,606,159,39,1066
W01000084,255,466,212,79,1012
W01000085,410,917,272,121,1720
W01000086,555,769,172,317,1813
W01000087,600,550,144,178,1472
W01000088,605,712,107,154,1578
W01000089,461,845,202,152,1660
W01000090,293,126,76,530,1025
W01000091,174,141,149,434,898
W01000092,201,235,1502,97,2035
W01000093,627,861,270,85,1843
W01000094,279,521,160,54,1014
W01000095,267,472,147,212,1098
W01000096,375,254,107,226,962
W01000097,311,309,155,149,924
W01000098,399,229,161,894,1683
W01000099,619,554,142,102,1417
W01000100,242,407,113,89,851
W01000101,423,450,164,153,1190
W01000102,332,365,185,45,927
W01000103,396,354,170,87,1007
W01000104,455,521,174,289,1439
W01000105,374,534,270,205,1383
W01000106,349,873,220,54,1496
W01000107,282,457,90,206,1035
W01000108,488,557,407,308,1760
W01000109,373,489,268,400,1530
W01000110,524,393,60,225,1202
W01000111,392,339,282,244,1257
W01000112,571,566,164,220,1521
W01000113,474,709,158,160,1501
W01000114,317,683,138,177,1315
W01000115,720,674,171,210,1775
W01000116,333,841,257,22,1453
W01000117,331,350,256,313,1250
W01000118,497,583,115,138,1333
W01000119,710,608,411,109,1838
W01000121,320,457,129,99,1005
W01000122,595,723,318,131,1767
W01000123,564,484,206,140,1394
W01000124,513,875,187,124,1699
W01000125,461,588,140,84,1273
W01000126,660,471,195,61,1387
W01000127,319,325,112,307,1063
W01000128,508,412,156,143,1219
W01000129,274,279,142,183,878
W01000130,413,576,297,37,1323
W01000131,437,450,107,187,1181
W01000132,387,388,397,34,1206
W01000133,449,932,156,46,1583
W01000134,449,656,265,324,1694
W01000135,540,1087,171,11,1809
W01000136,507,609,217,180,1513
W01000137,395,600,235,43,1273
W01000138,528,519,145,322,1514
W01000139,587,488,160,80,1315
W01000140,381,414,228,169,1192
W01000141,379,809,151,40,1379
W01000142,545,754,80,13,1392
W01000143,482,375,328,49,1234
W01000144,297,202,505,169,1173
W01000145,363,269,125,245,1002
W01000146,406,431,801,69,1707
W01000147,374,577,249,74,1274
W01000148,391,265,122,160,938
W01000149,418,607,208,18,1251
W01000150,596,493,123,22,1234
W01000151,533,280,179,201,1193
W01000152,512,392,226,38,1168
W01000153,547,571,117,73,1308
W01000154,465,538,117,5,1125
W01000155,384,516,265,22,1187
W01000156,372,601,301,73,1347
W01000157,380,273,222,339,1214
W01000158,454,707,110,118,1389
W01000159,339,493,265,54,1151
W01000162,516,683,212,144,1555
W01000163,269,168,67,462,966
W01000164,536,320,141,86,1083
W01000165,658,830,144,6,1638
W01000166,617,531,155,218,1521
W01000167,548,491,202,285,1526
W01000168,537,448,198,229,1412
W01000169,402,365,468,273,1508
W01000170,612,597,163,139,1511
W01000171,496,379,228,188,1291
W01000172,390,292,202,147,1031
W01000173,520,430,211,2,1163
W01000174,635,608,146,7,1396
W01000175,430,884,125,7,1446
W01000176,479,352,278,175,1284
W01000177,418,447,74,81,1020
W01000178,462,426,229,345,1462
W01000179,466,771,151,24,1412
W01000180,604,513,147,10,1274
W01000181,691,360,146,14,1211
W01000182,346,386,645,108,1485
W01000183,400,370,238,48,1056
W01000184,723,826,329,120,1998
W01000185,348,495,103,94,1040
W01000186,280,325,261,504,1370
W01000187,245,129,83,655,1112
W01000188,541,651,140,144,1476
W01000189,354,517,221,157,1249
W01000190,290,502,259,110,1161
W01000191,707,487,310,191,1695
W01000192,256,359,103,126,844
W01000193,316,347,170,243,1076
W01000194,594,428,485,125,1632
W01000195,466,573,105,25,1169
W01000196,608,354,156,39,1157
W01000197,581,454,155,143,1333
W01000198,197,156,88,677,1118
W01000199,443,458,194,294,1389
W01000200,514,404,95,19,1032
W01000201,426,291,239,207,1163
W01000202,587,576,84,79,1326
W01000203,794,849,180,121,1944
W01000204,413,557,166,70,1206
W01000205,288,428,106,127,949
W01000206,627,634,254,165,1680
W01000207,690,755,280,150,1875
W01000208,284,340,300,78,1002
W01000209,399,449,112,291,1251
W01000210,380,544,141,57,1122
W01000211,547,699,181,90,1517
W01000212,771,848,166,27,1812
W01000213,321,243,169,310,1043
W01000214,398,304,171,34,907
W01000215,472,618,79,18,1187
W01000216,460,264,184,198,1106
W01000217,627,580,187,227,1621
W01000218,545,447,195,89,1276
W01000219,842,622,471,27,1962
W01000220,400,911,188,7,1506
W01000221,393,485,228,26,1132
W01000222,561,694,182,4,1441
W01000223,462,445,191,22,1120
W01000224,431,497,104,136,1168
W01000225,424,471,233,126,1254
W01000226,409,532,192,163,1296
W01000227,501,479,248,87,1315
W01000228,267,290,308,65,930
W01000229,408,622,168,173,1371
W01000230,709,765,190,25,1689
W01000231,501,362,202,105,1170
W01000232,625,493,172,12,1302
W01000233,491,405,145,43,1084
W01000234,387,214,146,319,1066
W01000235,579,348,119,20,1066
W01000236,459,203,253,495,1410
W01000237,285,161,138,653,1237
W01000238,598,343,239,134,1314
W01000239,353,186,588,306,1433
W01000240,157,89,520,288,1054
W01000241,371,188,257,148,964
W01000242,511,414,207,386,1518
W01000243,370,533,307,165,1375
W01000244,600,674,109,29,1412
W01000245,531,489,175,166,1361
W01000246,499,410,177,244,1330
W01000247,534,652,233,122,1541
W01000248,494,547,198,104,1343
W01000249,554,412,58,4,1028
W01000250,588,588,101,39,1316
W01000251,505,337,77,262,1181
W01000252,534,758,98,28,1418
W01000253,686,537,169,174,1566
W01000254,626,490,238,368,1722
W01000255,862,521,245,251,1879
W01000256,612,255,142,215,1224
W01000257,936,645,154,38,1773
W01000258,886,708,100,135,1829
W01000259,471,391,196,259,1317
W01000260,737,647,95,15,1494
W01000261,584,512,152,21,1269
W01000262,464,246,188,259,1157
W01000263,370,239,71,483,1163
W01000264,658,318,156,162,1294
W01000265,425,531,120,44,1120
W01000266,418,417,204,74,1113
W01000267,623,480,106,86,1295
W01000268,754,498,79,44,1375
W01000269,474,449,193,199,1315
W01000270,507,425,123,37,1092
W01000271,402,400,162,89,1053
W01000272,643,706,122,101,1572
W01000273,452,447,116,259,1274
W01000274,458,210,256,471,1395
W01000275,490,368,111,51,1020
W01000276,623,166,175,76,1040
W01000277,671,230,155,13,1069
W01000278,386,187,82,465,1120
W01000279,441,535,40,40,1056
W01000280,557,393,95,125,1170
W01000281,502,405,78,27,1012
W01000282,992,194,65,10,1261
W01000283,835,674,273,77,1859
W01000284,779,439,129,11,1358
W01000285,524,597,93,14,1228
W01000286,1033,458,203,13,1707
W01000287,559,575,209,171,1514
W01000288,475,316,185,806,1782
W01000289,622,368,66,34,1090
W01000290,237,215,119,485,1056
W01000291,544,291,115,158,1108
W01000292,428,288,135,254,1105
W01000293,530,378,155,204,1267
W01000294,841,606,91,20,1558
W01000295,602,506,83,70,1261
W01000296,390,318,97,376,1181
W01000297,480,235,92,127,934
W01000298,469,433,156,201,1259
W01000299,678,797,106,68,1649
W01000300,625,614,150,71,1460
W01000301,658,607,136,88,1489
W01000302,554,764,211,25,1554
W01000303,636,581,100,42,1359
W01000304,397,345,227,557,1526
W01000305,640,498,91,200,1429
W01000306,810,639,164,275,1888
W01000307,461,502,85,25,1073
W01000308,456,335,72,139,1002
W01000309,679,573,246,227,1725
W01000310,622,689,110,105,1526
W01000311,534,417,219,301,1471
W01000312,509,536,120,238,1403
W01000313,446,378,138,267,1229
W01000314,285,333,204,133,955
W01000315,540,705,177,210,1632
W01000316,452,497,76,14,1039
W01000317,568,493,32,5,1098
W01000318,221,153,48,435,857
W01000319,448,364,174,241,1227
W01000320,578,405,149,348,1480
W01000321,696,595,77,14,1382
W01000322,461,469,57,104,1091
W01000323,482,575,138,87,1282
W01000324,598,483,94,40,1215
W01000325,585,542,86,69,1282
W01000326,629,593,74,81,1377
W01000327,880,664,178,77,1799
W01000328,634,442,462,213,1751
W01000329,391,239,168,275,1073
W01000330,615,237,226,569,1647
W01000331,678,418,91,143,1330
W01000332,547,327,152,218,1244
W01000333,308,169,115,518,1110
W01000334,679,497,283,153,1612
W01000335,305,175,69,335,884
W01000336,285,150,64,580,1079
W01000337,720,565,347,130,1762
W01000338,629,535,220,164,1548
W01000339,561,555,71,166,1353
W01000340,886,825,155,42,1908
W01000341,521,359,159,250,1289
W01000342,409,267,158,450,1284
W01000343,348,521,36,4,909
W01000344,461,600,57,8,1126
W01000345,486,612,183,43,1324
W01000346,487,556,185,75,1303
W01000347,1032,423,370,131,1956
W01000348,381,179,98,443,1101
W01000349,686,290,220,310,1506
W01000350,239,184,672,212,1307
W01000351,768,537,140,278,1723
W01000352,278,218,65,215,776
W01000353,243,111,57,607,1018
W01000354,629,569,99,139,1436
W01000355,418,331,128,444,1321
W01000356,437,278,61,545,1321
W01000359,451,317,95,99,962
W01000360,319,314,66,292,991
W01000361,557,509,196,369,1631
W01000362,382,234,88,479,1183
W01000363,507,458,96,175,1236
W01000364,586,490,147,105,1328
W01000365,593,658,391,153,1795
W01000366,458,258,105,331,1152
W01000367,554,313,120,64,1051
W01000368,718,838,139,13,1708
W01000369,383,491,88,116,1078
W01000370,444,490,171,30,1135
W01000371,357,301,310,45,1013
W01000372,258,211,360,208,1037
W01000373,535,257,111,506,1409
W01000374,437,327,70,290,1124
W01000375,837,268,200,220,1525
W01000376,523,447,60,97,1127
W01000377,573,386,118,132,1209
W01000378,354,177,109,335,975
W01000379,436,247,82,517,1282
W01000380,585,287,93,20,985
W01000381,279,254,230,192,955
W01000382,145,137,190,412,884
W01000383,1015,510,256,107,1888
W01000384,385,389,93,47,914
W01000385,633,681,94,45,1453
W01000386,484,175,144,393,1196
W01000387,457,485,72,28,1042
W01000388,382,348,49,116,895
W01000389,682,593,138,245,1658
W01000390,627,569,89,69,1354
W01000391,516,472,63,139,1190
W01000392,417,148,93,638,1296
W01000393,565,568,156,323,1612
W01000394,434,388,195,35,1052
W01000395,336,337,82,147,902
W01000396,484,440,69,20,1013
W01000397,405,407,44,5,861
W01000398,424,441,70,153,1088
W01000399,474,386,51,42,953
W01000400,608,325,169,236,1338
W01000401,620,265,161,357,1403
W01000402,549,418,1062,184,2213
W01000403,377,446,213,69,1105
W01000404,606,575,232,176,1589
W01000405,644,370,120,556,1690
W01000406,610,410,101,552,1673
W01000407,465,401,222,33,1121
W01000408,320,311,61,246,938
W01000409,195,84,62,1055,1396
W01000410,475,520,195,140,1330
W01000411,356,272,178,460,1266
W01000412,526,442,230,111,1309
W01000413,78,48,38,761,925
W01000414,221,95,84,501,901
W01000415,520,497,137,118,1272
W01000416,605,361,83,3,1052
W01000417,563,595,116,23,1297
W01000418,471,510,185,192,1358
W01000419,454,177,112,412,1155
W01000420,448,348,185,162,1143
W01000422,560,709,220,250,1739
W01000423,698,173,287,468,1626
W01000424,414,342,150,156,1062
W01000425,274,150,111,1144,1679
W01000426,409,554,93,141,1197
W01000427,220,673,152,118,1163
W01000428,280,525,277,52,1134
W01000429,512,1109,229,45,1895
W01000430,272,500,219,56,1047
W01000431,322,294,240,185,1041
W01000432,341,453,152,49,995
W01000433,571,925,228,235,1959
W01000434,395,658,162,149,1364
W01000438,199,639,104,145,1087
W01000439,615,725,186,75,1601
W01000440,351,573,176,20,1120
W01000441,405,499,164,76,1144
W01000442,452,887,259,93,1691
W01000443,510,1035,297,82,1924
W01000444,599,911,322,87,1919
W01000445,365,617,153,115,1250
W01000446,303,505,280,241,1329
W01000447,493,849,205,137,1684
W01000448,317,492,143,199,1151
W01000449,364,554,268,143,1329
W01000450,284,645,185,24,1138
W01000451,252,472,111,77,912
W01000452,434,884,161,134,1613
W01000453,318,604,206,43,1171
W01000454,213,261,351,185,1010
W01000455,563,551,201,320,1635
W01000456,454,748,362,117,1681
W01000457,713,743,190,107,1753
W01000458,562,643,174,82,1461
W01000459,279,509,138,58,984
W01000460,456,667,193,121,1437
W01000461,335,551,200,147,1233
W01000464,265,584,185,20,1054
W01000465,268,443,89,59,859
W01000466,308,453,128,240,1129
W01000467,296,548,319,140,1303
W01000470,457,685,305,102,1549
W01000471,403,773,229,148,1553
W01000472,274,498,149,51,972
W01000473,493,554,274,474,1795
W01000474,408,722,207,90,1427
W01000475,511,1132,269,93,2005
W01000476,336,415,221,107,1079
W01000477,327,756,115,27,1225
W01000478,413,167,146,528,1254
W01000479,287,237,127,445,1096
W01000480,403,397,351,504,1655
W01000481,592,798,324,196,1910
W01000482,455,659,267,113,1494
W01000483,335,261,144,653,1393
W01000484,288,763,230,39,1320
W01000485,277,809,219,65,1370
W01000486,242,297,142,232,913
W01000487,367,658,367,284,1676
W01000488,611,866,256,63,1796
W01000489,361,366,278,257,1262
W01000492,354,411,413,135,1313
W01000493,286,506,232,137,1161
W01000494,406,566,192,219,1383
W01000496,651,782,117,167,1717
W01000497,459,497,127,42,1125
W01000498,181,229,359,466,1235
W01000499,297,214,264,206,981
W01000500,491,461,171,130,1253
W01000501,515,666,343,281,1805
W01000502,613,823,127,175,1738
W01000503,245,455,170,8,878
W01000504,270,252,48,364,934
W01000505,376,520,132,153,1181
W01000506,259,578,287,98,1222
W01000507,313,548,134,42,1037
W01000508,244,346,213,175,978
W01000509,414,719,115,227,1475
W01000510,209,289,236,274,1008
W01000511,226,230,277,194,927
W01000512,247,322,586,84,1239
W01000513,107,207,1900,150,2364
W01000515,354,261,146,370,1131
W01000516,419,311,209,371,1310
W01000517,118,138,1010,109,1375
W01000518,183,344,422,170,1119
W01000519,394,795,156,61,1406
W01000522,337,596,126,45,1104
W01000523,495,772,229,71,1567
W01000524,540,756,268,69,1633
W01000525,269,538,171,2,980
W01000527,152,273,361,46,832
W01000528,255,436,225,262,1178
W01000529,421,614,186,82,1303
W01000531,472,675,208,125,1480
W01000532,531,904,210,33,1678
W01000533,322,441,177,218,1158
W01000534,397,568,227,38,1230
W01000535,438,904,229,115,1686
W01000536,314,661,224,32,1231
W01000537,345,689,165,49,1248
W01000538,440,605,212,28,1285
W01000539,293,568,153,17,1031
W01000540,320,465,125,56,966
W01000541,447,740,254,69,1510
W01000542,602,922,234,63,1821
W01000543,548,803,223,87,1661
W01000544,218,410,144,114,886
W01000545,518,976,206,78,1778
W01000546,257,481,135,103,976
W01000547,281,553,77,72,983
W01000548,453,625,212,148,1438
W01000549,608,610,191,37,1446
W01000550,276,461,200,57,994
W01000551,345,583,100,70,1098
W01000552,524,754,258,78,1614
W01000553,349,546,137,46,1078
W01000554,594,689,120,68,1471
W01000555,409,611,117,47,1184
W01000556,302,521,106,56,985
W01000557,528,459,165,66,1218
W01000558,547,773,229,84,1633
W01000559,400,683,104,30,1217
W01000560,276,510,131,102,1019
W01000561,356,517,108,32,1013
W01000562,368,800,190,81,1439
W01000563,326,413,166,54,959
W01000564,356,465,121,63,1005
W01000565,360,766,177,238,1541
W01000566,385,541,165,179,1270
W01000567,519,608,316,162,1605
W01000568,506,475,508,430,1919
W01000569,257,247,328,164,996
W01000570,205,90,205,506,1006
W01000571,620,735,216,264,1835
W01000572,486,587,215,157,1445
W01000573,784,735,367,116,2002
W01000574,544,629,259,139,1571
W01000575,699,809,175,260,1943
W01000576,608,895,176,172,1851
W01000577,472,667,143,37,1319
W01000578,482,729,120,91,1422
W01000579,591,833,189,244,1857
W01000580,773,816,115,173,1877
W01000581,420,578,124,117,1239
W01000582,410,773,168,27,1378
W01000583,385,489,153,125,1152
W01000584,547,718,153,262,1680
W01000585,366,516,217,40,1139
W01000586,574,492,147,520,1733
W01000587,487,608,366,236,1697
W01000588,503,505,128,529,1665
W01000589,287,311,113,196,907
W01000590,303,383,57,221,964
W01000591,345,362,80,178,965
W01000592,301,223,72,397,993
W01000593,728,811,165,515,2219
W01000594,527,444,246,532,1749
W01000595,460,581,280,246,1567
W01000596,475,534,151,41,1201
W01000597,209,517,100,149,975
W01000598,627,710,194,300,1831
W01000599,624,637,128,328,1717
W01000600,376,381,368,211,1336
W01000601,266,234,101,542,1143
W01000602,334,424,200,91,1049
W01000603,568,440,306,160,1474
W01000604,393,344,137,296,1170
W01000605,675,498,160,114,1447
W01000606,316,275,80,538,1209
W01000607,401,457,130,520,1508
W01000608,308,452,220,202,1182
W01000609,619,1118,162,149,2048
W01000610,394,669,179,137,1379
W01000611,480,760,169,23,1432
W01000612,361,741,211,183,1496
W01000613,461,1039,260,100,1860
W01000614,349,570,136,121,1176
W01000615,389,683,126,59,1257
W01000616,192,407,246,86,931
W01000617,375,516,138,139,1168
W01000618,311,543,157,219,1230
W01000619,548,727,245,198,1718
W01000620,165,263,359,114,901
W01000621,317,397,242,243,1199
W01000622,362,586,182,79,1209
W01000623,487,738,221,102,1548
W01000624,704,924,193,70,1891
W01000625,292,286,100,254,932
W01000626,349,475,222,143,1189
W01000627,650,672,167,191,1680
W01000628,564,523,117,33,1237
W01000629,488,470,289,153,1400
W01000630,522,432,220,111,1285
W01000631,389,321,118,553,1381
W01000632,447,425,171,120,1163
W01000633,342,418,226,207,1193
W01000634,392,682,107,16,1197
W01000635,990,582,148,84,1804
W01000636,601,391,81,413,1486
W01000637,406,282,133,310,1131
W01000638,224,227,98,338,887
W01000639,318,397,225,181,1121
W01000640,323,534,115,12,984
W01000641,309,511,694,292,1806
W01000642,474,697,167,32,1370
W01000643,445,365,207,255,1272
W01000644,437,291,226,111,1065
W01000645,413,453,320,166,1352
W01000646,504,813,294,151,1762
W01000647,356,701,145,55,1257
W01000648,457,604,114,28,1203
W01000649,429,694,125,59,1307
W01000650,361,772,189,65,1387
W01000651,567,436,186,108,1297
W01000652,397,506,176,382,1461
W01000653,428,516,113,137,1194
W01000654,493,528,317,62,1400
W01000655,498,455,182,417,1552
W01000656,581,674,141,303,1699
W01000657,306,326,90,181,903
W01000658,391,380,126,121,1018
W01000659,273,345,284,280,1182
W01000660,371,368,229,288,1256
W01000662,725,800,127,138,1790
W01000663,785,738,105,271,1899
W01000664,586,650,138,80,1454
W01000665,718,658,70,43,1489
W01000666,475,397,156,123,1151
W01000667,398,558,99,96,1151
W01000670,404,481,164,275,1324
W01000671,570,669,102,161,1502
W01000672,413,587,174,192,1366
W01000673,313,430,132,136,1011
W01000674,599,917,172,43,1731
W01000675,523,847,158,137,1665
W01000676,423,681,153,18,1275
W01000677,332,380,242,165,1119
W01000678,278,536,125,192,1131
W01000679,297,376,228,92,993
W01000680,697,829,87,42,1655
W01000681,531,528,168,322,1549
W01000682,354,593,112,52,1111
W01000683,246,519,101,36,902
W01000684,551,765,132,78,1526
W01000685,388,541,127,220,1276
W01000686,319,580,111,34,1044
W01000687,480,841,159,97,1577
W01000688,454,498,170,329,1451
W01000689,503,700,152,14,1369
W01000690,581,580,102,156,1419
W01000691,481,596,78,180,1335
W01000692,574,399,111,145,1229
W01000693,250,344,62,237,893
W01000694,338,586,130,50,1104
W01000695,458,550,96,171,1275
W01000696,418,577,131,180,1306
W01000697,533,564,210,186,1493
W01000698,545,575,140,245,1505
W01000699,578,595,83,10,1266
W01000700,566,890,171,94,1721
W01000701,398,583,146,101,1228
W01000702,269,342,185,172,968
W01000703,490,469,332,128,1419
W01000704,524,620,100,117,1361
W01000705,429,485,275,324,1513
W01000706,481,441,144,224,1290
W01000707,333,256,98,432,1119
W01000708,310,270,111,371,1062
W01000709,604,1010,174,64,1852
W01000710,797,836,134,19,1786
W01000711,534,627,154,347,1662
W01000712,544,486,126,52,1208
W01000713,503,428,77,116,1124
W01000714,379,399,140,248,1166
W01000715,402,541,91,36,1070
W01000716,424,564,74,40,1102
W01000717,373,441,118,254,1186
W01000718,387,421,92,250,1150
W01000719,446,548,76,155,1225
W01000720,467,549,208,120,1344
W01000721,379,391,113,194,1077
W01000722,338,646,95,28,1107
W01000723,440,540,101,69,1150
W01000724,560,541,106,268,1475
W01000725,650,737,142,208,1737
W01000726,569,637,84,6,1296
W01000727,285,481,59,52,877
W01000728,570,961,159,65,1755
W01000729,344,381,115,198,1038
W01000730,379,453,86,133,1051
W01000731,847,788,213,157,2005
W01000732,358,419,313,56,1146
W01000733,201,183,248,406,1038
W01000734,337,296,325,148,1106
W01000735,644,780,266,173,1863
W01000736,550,803,82,6,1441
W01000737,394,679,160,20,1253
W01000738,340,274,108,647,1369
W01000739,540,261,325,358,1484
W01000740,579,615,70,53,1317
W01000741,420,364,110,378,1272
W01000742,173,186,145,753,1257
W01000744,319,311,426,217,1273
W01000745,308,264,1134,289,1995
W01000746,309,306,656,250,1521
W01000747,278,227,1074,105,1684
W01000749,336,513,655,122,1626
W01000750,441,409,138,284,1272
W01000751,465,619,86,40,1210
W01000752,425,290,116,325,1156
W01000753,477,330,104,210,1121
W01000754,515,458,198,99,1270
W01000755,660,484,205,224,1573
W01000756,368,266,116,521,1271
W01000757,427,530,88,245,1290
W01000758,699,552,143,152,1546
W01000759,548,606,77,21,1252
W01000760,534,411,199,199,1343
W01000761,517,326,194,191,1228
W01000762,348,267,89,549,1253
W01000763,569,401,195,24,1189
W01000764,596,411,254,54,1315
W01000765,563,456,220,133,1372
W01000766,565,490,170,17,1242
W01000767,382,336,159,389,1266
W01000768,430,454,118,154,1156
W01000769,461,556,103,31,1151
W01000770,650,530,68,45,1293
W01000771,391,541,61,104,1097
W01000772,555,536,57,124,1272
W01000773,930,406,283,437,2056
W01000774,535,464,169,152,1320
W01000775,512,759,147,68,1486
W01000776,491,806,90,73,1460
W01000777,667,593,136,85,1481
W01000778,777,471,213,25,1486
W01000779,567,344,85,203,1199
W01000781,571,727,93,11,1402
W01000782,363,495,66,12,936
W01000784,445,444,105,97,1091
W01000785,526,524,37,7,1094
W01000786,551,519,63,9,1142
W01000787,523,392,229,99,1243
W01000788,451,374,233,107,1165
W01000789,402,320,271,147,1140
W01000790,501,410,308,159,1378
W01000791,715,328,116,45,1204
W01000792,683,552,112,6,1353
W01000793,905,357,180,5,1447
W01000794,957,383,297,75,1712
W01000795,718,403,147,16,1284
W01000796,1300,428,260,80,2068
W01000797,563,497,86,110,1256
W01000798,476,567,94,85,1222
W01000799,506,178,231,492,1407
W01000800,620,490,74,16,1200
W01000801,330,256,123,497,1206
W01000802,849,535,128,371,1883
W01000803,611,652,125,141,1529
W01000804,350,729,108,63,1250
W01000805,431,483,62,6,982
W01000806,538,466,108,120,1232
W01000807,621,491,83,21,1216
W01000808,486,528,84,134,1232
W01000809,563,366,199,114,1242
W01000810,275,141,91,568,1075
W01000811,453,288,171,342,1254
W01000812,325,283,282,270,1160
W01000813,587,541,171,33,1332
W01000814,353,271,263,271,1158
W01000815,581,618,96,56,1351
W01000816,674,476,189,44,1383
W01000817,242,192,106,841,1381
W01000818,328,400,97,404,1229
W01000819,510,646,70,34,1260
W01000820,543,390,108,107,1148
W01000821,435,476,89,222,1222
W01000822,350,591,55,102,1098
W01000823,532,832,66,10,1440
W01000824,401,643,198,41,1283
W01000825,393,505,317,42,1257
W01000826,419,609,132,4,1164
W01000827,451,435,247,6,1139
W01000828,556,762,123,17,1458
W01000829,652,615,142,169,1578
W01000830,107,44,83,943,1177
W01000831,406,258,146,587,1397
W01000832,282,145,84,762,1273
W01000833,286,145,94,749,1274
W01000834,306,210,78,538,1132
W01000835,370,254,73,380,1077
W01000836,528,153,239,730,1650
W01000837,626,527,125,10,1288
W01000838,324,252,88,325,989
W01000839,280,456,95,3,834
W01000840,461,826,88,4,1379
W01000841,475,450,101,206,1232
W01000842,502,522,56,76,1156
W01000843,553,412,97,49,1111
W01000844,308,217,63,329,917
W01000845,781,606,128,90,1605
W01000846,579,420,235,144,1378
W01000847,437,442,61,102,1042
W01000848,263,274,59,333,929
W01000849,477,404,275,293,1449
W01000850,487,430,683,355,1955
W01000851,408,412,304,150,1274
W01000852,433,493,217,83,1226
W01000853,541,452,134,67,1194
W01000854,523,408,96,26,1053
W01000855,485,608,105,69,1267
W01000856,347,309,165,641,1462
W01000857,421,447,243,391,1502
W01000858,545,513,312,31,1401
W01000859,347,764,109,55,1275
W01000860,390,751,123,7,1271
W01000861,223,284,263,29,799
W01000862,146,94,128,763,1131
W01000863,179,151,133,727,1190
W01000864,161,148,60,809,1178
W01000865,370,236,88,378,1072
W01000866,221,180,85,431,917
W01000867,185,163,105,562,1015
W01000868,437,397,81,26,941
W01000869,358,325,537,160,1380
W01000870,348,251,665,77,1341
W01000871,240,213,998,189,1640
W01000872,484,479,174,13,1150
W01000873,150,154,1199,131,1634
W01000874,355,339,1179,43,1916
W01000875,169,290,1312,136,1907
W01000876,258,258,1337,59,1912
W01000877,590,575,103,14,1282
W01000878,409,399,78,120,1006
W01000879,592,752,106,26,1476
W01000880,458,711,131,69,1369
W01000881,247,362,142,376,1127
W01000882,432,416,132,421,1401
W01000883,627,513,57,38,1235
W01000884,328,355,228,82,993
W01000885,333,243,141,358,1075
W01000886,327,378,359,147,1211
W01000887,811,563,135,370,1879
W01000888,870,662,133,203,1868
W01000889,667,681,117,66,1531
W01000890,645,681,50,13,1389
W01000891,502,388,107,194,1191
W01000892,642,736,95,113,1586
W01000893,534,664,225,222,1645
W01000894,499,412,115,114,1140
W01000895,429,345,312,201,1287
W01000896,341,237,135,581,1294
W01000897,375,427,125,172,1099
W01000898,479,504,80,142,1205
W01000899,696,513,68,99,1376
W01000900,423,336,138,498,1395
W01000901,515,443,109,306,1373
W01000902,317,477,41,39,874
W01000903,416,529,27,2,974
W01000904,635,467,109,1,1212
W01000905,567,418,98,136,1219
W01000906,309,506,46,71,932
W01000907,448,357,117,457,1379
W01000908,599,614,92,107,1412
W01000909,309,434,71,154,968
W01000910,634,535,83,16,1268
W01000911,536,451,44,14,1045
W01000912,397,366,98,122,983
W01000913,381,342,188,65,976
W01000914,377,301,109,449,1236
W01000915,455,327,93,103,978
W01000916,443,367,95,26,931
W01000917,1082,782,212,102,2178
W01000918,583,661,123,226,1593
W01000919,344,411,65,144,964
W01000920,305,484,73,166,1028
W01000921,241,335,74,573,1223
W01000922,545,386,126,293,1350
W01000923,503,589,95,68,1255
W01000924,243,397,65,198,903
W01000925,356,398,86,386,1226
W01000926,594,744,157,98,1593
W01000927,560,421,112,232,1325
W01000928,443,492,138,226,1299
W01000929,345,361,85,250,1041
W01000930,288,482,133,218,1121
W01000931,407,449,87,127,1070
W01000932,340,311,61,191,903
W01000933,901,464,101,54,1520
W01000934,335,340,282,102,1059
W01000935,378,422,275,318,1393
W01000936,371,271,126,419,1187
W01000937,613,389,316,335,1653
W01000938,431,584,94,46,1155
W01000939,231,263,253,324,1071
W01000940,302,305,82,346,1035
W01000941,410,343,135,300,1188
W01000942,453,329,111,569,1462
W01000943,592,548,71,37,1248
W01000944,295,440,71,182,988
W01000945,374,353,51,167,945
W01000946,476,504,117,148,1245
W01000947,560,421,110,497,1588
W01000948,519,538,244,205,1506
W01000949,482,478,79,100,1139
W01000950,563,408,277,31,1279
W01000951,504,418,289,50,1261
W01000952,425,373,127,40,965
W01000953,436,572,121,277,1406
W01000954,418,588,123,59,1188
W01000955,439,431,53,114,1037
W01000956,377,579,53,8,1017
W01000957,304,426,192,512,1434
W01000958,242,260,99,651,1252
W01000959,601,509,223,167,1500
W01000960,519,385,190,333,1427
W01000961,494,412,65,358,1329
W01000962,324,236,142,506,1208
W01000963,366,399,159,508,1432
W01000964,427,414,112,476,1429
W01000965,541,727,103,327,1698
W01000966,442,504,158,98,1202
W01000967,431,395,183,199,1208
W01000968,639,494,163,263,1559
W01000969,508,498,52,12,1070
W01000970,419,306,57,178,960
W01000971,435,450,106,167,1158
W01000973,396,372,125,303,1196
W01000974,784,574,211,137,1706
W01000975,544,370,117,690,1721
W01000976,348,301,88,146,883
W01000977,421,344,118,257,1140
W01000978,594,513,206,130,1443
W01000979,691,267,240,115,1313
W01000980,522,303,99,210,1134
W01000981,175,106,49,532,862
W01000982,518,459,155,113,1245
W01000983,755,235,213,9,1212
W01000984,876,350,339,143,1708
W01000985,724,288,94,10,1116
W01000986,583,295,152,34,1064
W01000987,723,462,171,416,1772
W01000989,501,485,150,53,1189
W01000990,497,288,109,329,1223
W01000991,226,218,104,342,890
W01000992,403,480,235,72,1190
W01000993,474,416,197,93,1180
W01000994,465,369,140,124,1098
W01000995,506,515,156,16,1193
W01000996,505,449,110,194,1258
W01000997,533,602,119,67,1321
W01000998,487,354,149,14,1004
W01000999,347,378,85,334,1144
W01001000,676,484,139,105,1404
W01001001,451,468,87,163,1169
W01001002,675,229,309,646,1859
W01001003,419,548,120,46,1133
W01001004,317,276,141,179,913
W01001005,729,475,170,14,1388
W01001006,981,844,113,22,1960
W01001007,602,379,174,220,1375
W01001008,776,920,123,12,1831
W01001009,423,355,93,140,1011
W01001010,375,255,58,279,967
W01001011,553,357,103,107,1120
W01001012,712,384,113,22,1231
W01001013,461,471,93,214,1239
W01001014,519,475,227,155,1376
W01001015,437,410,97,231,1175
W01001016,458,800,108,61,1427
W01001017,569,536,61,39,1205
W01001018,487,428,184,62,1161
W01001019,492,424,99,209,1224
W01001020,473,332,93,255,1153
W01001021,452,317,363,208,1340
W01001022,304,321,81,385,1091
W01001023,473,445,207,336,1461
W01001024,354,344,168,73,939
W01001025,468,364,123,34,989
W01001026,611,375,193,421,1600
W01001027,501,610,99,118,1328
W01001028,633,630,266,62,1591
W01001029,590,707,183,7,1487
W01001030,625,687,116,44,1472
W01001031,536,620,82,3,1241
W01001032,557,739,190,5,1491
W01001033,575,552,191,57,1375
W01001034,441,419,161,144,1165
W01001035,432,238,376,273,1319
W01001036,589,553,107,63,1312
W01001037,591,593,120,6,1310
W01001038,709,598,243,171,1721
W01001039,703,424,68,166,1361
W01001040,569,479,123,41,1212
W01001041,965,838,116,12,1931
W01001042,468,337,199,51,1055
W01001043,397,367,132,50,946
W01001044,526,397,163,301,1387
W01001045,590,453,340,39,1422
W01001046,469,514,462,39,1484
W01001047,565,574,157,100,1396
W01001048,630,401,125,12,1168
W01001049,396,301,77,277,1051
W01001050,573,326,159,226,1284
W01001051,552,390,126,307,1375
W01001052,455,258,126,269,1108
W01001053,279,515,70,19,883
W01001054,372,580,68,5,1025
W01001055,372,274,80,251,977
W01001056,490,393,73,101,1057
W01001057,440,269,114,356,1179
W01001058,787,459,182,90,1518
W01001059,468,468,115,76,1127
W01001060,549,590,95,4,1238
W01001061,787,374,370,132,1663
W01001062,572,304,171,19,1066
W01001063,662,347,308,38,1355
W01001064,330,208,110,405,1053
W01001065,557,357,204,108,1226
W01001066,579,277,247,126,1229
W01001067,409,203,80,426,1118
W01001068,711,240,202,209,1362
W01001069,437,274,279,153,1143
W01001070,334,138,278,142,892
W01001071,544,357,158,194,1253
W01001072,1434,446,152,51,2083
W01001073,511,233,456,426,1626
W01001075,446,357,80,74,957
W01001076,520,311,226,92,1149
W01001077,471,398,65,230,1164
W01001078,463,388,56,108,1015
W01001079,535,262,343,77,1217
W01001080,547,307,241,146,1241
W01001081,403,257,115,403,1178
W01001082,329,701,210,77,1317
W01001083,483,744,90,20,1337
W01001084,446,681,139,43,1309
W01001085,553,558,90,15,1216
W01001086,502,610,137,7,1256
W01001087,572,614,86,20,1292
W01001088,457,500,64,484,1505
W01001089,560,538,74,31,1203
W01001090,568,565,61,24,1218
W01001091,663,694,75,10,1442
W01001092,587,339,107,293,1326
W01001093,530,377,124,364,1395
W01001094,359,171,58,414,1002
W01001095,303,120,57,646,1126
W01001096,481,349,107,221,1158
W01001097,393,227,96,508,1224
W01001098,438,442,47,5,932
W01001099,381,186,103,389,1059
W01001100,638,533,29,54,1254
W01001101,514,274,340,42,1170
W01001102,576,279,269,26,1150
W01001103,522,416,77,18,1033
W01001104,714,637,188,104,1643
W01001105,908,984,179,66,2137
W01001106,636,490,65,24,1215
W01001107,449,670,139,92,1350
W01001108,469,338,459,62,1328
W01001109,446,545,84,133,1208
W01001110,388,380,215,26,1009
W01001111,414,324,107,326,1171
W01001112,620,284,200,18,1122
W01001113,734,838,160,71,1803
W01001114,514,710,68,16,1308
W01001115,780,654,114,141,1689
W01001116,586,741,219,4,1550
W01001117,508,489,101,80,1178
W01001118,1000,516,211,161,1888
W01001119,671,539,143,22,1375
W01001120,605,421,124,9,1159
W01001121,433,437,151,198,1219
W01001122,715,241,570,54,1580
W01001123,459,526,368,47,1400
W01001124,510,331,330,29,1200
W01001125,473,420,192,38,1123
W01001126,532,395,680,78,1685
W01001127,405,514,94,5,1018
W01001128,515,562,107,29,1213
W01001129,500,331,56,192,1079
W01001130,449,378,172,13,1012
W01001131,519,269,86,477,1351
W01001132,638,353,105,16,1112
W01001133,652,790,258,18,1718
W01001134,451,421,80,8,960
W01001135,498,568,122,39,1227
W01001136,435,478,55,8,976
W01001137,692,696,325,208,1921
W01001138,371,348,139,229,1087
W01001139,506,473,153,40,1172
W01001140,386,485,177,123,1171
W01001141,386,439,210,217,1252
W01001142,345,540,217,152,1254
W01001143,519,556,160,47,1282
W01001144,401,360,183,289,1233
W01001145,530,459,219,197,1405
W01001146,487,454,173,51,1165
W01001147,604,589,130,141,1464
W01001148,542,478,277,34,1331
W01001149,432,465,128,155,1180
W01001150,442,456,369,70,1337
W01001151,507,704,102,61,1374
W01001152,461,593,91,145,1290
W01001153,419,389,166,186,1160
W01001154,373,422,149,213,1157
W01001155,441,472,253,38,1204
W01001156,783,372,45,6,1206
W01001157,580,408,111,46,1145
W01001158,601,326,120,150,1197
W01001159,632,231,118,23,1004
W01001160,685,551,82,16,1334
W01001161,871,423,157,302,1753
W01001162,509,375,128,330,1342
W01001164,602,437,155,24,1218
W01001165,490,370,82,109,1051
W01001166,330,454,209,65,1058
W01001167,417,489,216,31,1153
W01001168,397,528,110,145,1180
W01001169,441,292,125,480,1338
W01001170,423,530,58,25,1036
W01001171,425,462,142,29,1058
W01001172,455,485,195,55,1190
W01001173,356,374,109,291,1130
W01001174,320,286,117,376,1099
W01001175,419,535,126,85,1165
W01001176,452,488,200,44,1184
W01001177,357,485,163,44,1049
W01001178,548,509,176,134,1367
W01001179,403,391,118,478,1390
W01001180,402,224,93,415,1134
W01001181,547,318,56,235,1156
W01001182,504,358,251,38,1151
W01001183,266,152,298,150,866
W01001184,600,724,200,110,1634
W01001185,498,341,142,358,1339
W01001186,666,420,101,180,1367
W01001187,404,473,129,131,1137
W01001188,243,300,119,213,875
W01001189,510,341,153,258,1262
W01001190,1100,588,266,57,2011
W01001191,1135,480,208,127,1950
W01001192,418,208,85,448,1159
W01001193,479,440,48,47,1014
W01001194,946,593,154,26,1719
W01001195,522,370,171,170,1233
W01001196,743,343,164,13,1263
W01001197,539,447,36,0,1022
W01001198,695,445,124,4,1268
W01001199,734,500,115,19,1368
W01001200,349,316,122,31,818
W01001201,332,300,138,209,979
W01001202,367,657,223,214,1461
W01001203,264,275,91,462,1092
W01001204,375,470,172,36,1053
W01001205,476,481,152,192,1301
W01001206,451,441,124,151,1167
W01001207,328,267,148,366,1109
W01001208,429,553,242,73,1297
W01001209,246,324,122,354,1046
W01001210,356,519,197,111,1183
W01001211,460,439,203,134,1236
W01001212,362,386,174,153,1075
W01001213,377,504,150,69,1100
W01001214,464,501,70,31,1066
W01001215,290,274,201,92,857
W01001216,483,498,183,71,1235
W01001217,311,310,113,204,938
W01001218,513,548,168,23,1252
W01001219,301,318,219,241,1079
W01001220,463,504,143,77,1187
W01001221,335,362,86,349,1132
W01001222,267,238,148,554,1207
W01001223,589,583,142,11,1325
W01001224,1001,430,100,23,1554
W01001225,577,590,97,25,1289
W01001226,633,329,137,230,1329
W01001227,471,508,81,33,1093
W01001228,506,576,140,53,1275
W01001229,498,519,158,12,1187
W01001230,621,495,72,24,1212
W01001231,497,451,230,85,1263
W01001232,376,395,158,216,1145
W01001233,527,613,97,192,1429
W01001234,522,530,151,20,1223
W01001235,526,391,239,105,1261
W01001236,589,492,97,31,1209
W01001237,405,293,114,364,1176
W01001238,254,194,122,655,1225
W01001239,370,156,72,509,1107
W01001240,819,501,153,106,1579
W01001241,661,358,157,242,1418
W01001242,461,481,94,62,1098
W01001243,356,274,168,319,1117
W01001244,385,721,56,34,1196
W01001245,493,557,23,13,1086
W01001246,428,559,77,118,1182
W01001247,512,553,209,99,1373
W01001248,632,640,304,73,1649
W01001249,409,448,154,159,1170
W01001250,498,511,94,59,1162
W01001251,325,228,82,544,1179
W01001252,630,466,105,49,1250
W01001253,513,422,108,98,1141
W01001255,485,316,84,382,1267
W01001256,370,393,185,8,956
W01001257,438,453,91,53,1035
W01001258,405,357,214,78,1054
W01001259,542,494,154,125,1315
W01001260,265,289,154,160,868
W01001261,351,415,264,25,1055
W01001262,285,235,568,85,1173
W01001263,204,282,990,98,1574
W01001264,252,205,792,38,1287
W01001265,441,543,197,66,1247
W01001266,302,331,166,264,1063
W01001267,325,508,152,183,1168
W01001268,368,552,195,51,1166
W01001269,404,571,150,22,1147
W01001270,457,518,156,22,1153
W01001271,462,521,219,89,1291
W01001272,435,476,111,203,1225
W01001273,486,682,156,73,1397
W01001274,183,299,158,356,996
W01001275,456,628,272,76,1432
W01001276,321,429,297,104,1151
W01001277,545,362,32,37,976
W01001278,374,268,99,118,859
W01001279,300,240,85,303,928
W01001280,395,401,287,258,1341
W01001281,562,647,162,16,1387
W01001282,657,547,204,189,1597
W01001283,501,530,76,127,1234
W01001284,599,229,56,13,897
W01001285,441,482,156,58,1137
W01001286,497,513,174,56,1240
W01001287,412,497,155,138,1202
W01001288,360,380,154,266,1160
W01001289,388,548,157,80,1173
W01001290,594,541,144,247,1526
W01001291,641,406,155,188,1390
W01001292,326,303,125,599,1353
W01001293,460,430,130,362,1382
W01001294,617,636,105,21,1379
W01001295,364,321,194,385,1264
W01001296,612,536,129,130,1407
W01001297,595,435,299,193,1522
W01001298,424,311,196,514,1445
W01001299,312,212,123,592,1239
W01001300,261,295,101,662,1319
W01001301,377,372,104,608,1461
W01001302,298,352,155,107,912
W01001303,233,262,110,337,942
W01001304,498,528,105,109,1240
W01001305,387,448,169,71,1075
W01001306,548,534,154,59,1295
W01001307,286,343,241,369,1239
W01001308,245,152,90,479,966
W01001309,256,292,66,381,995
W01001310,562,510,101,161,1334
W01001311,382,293,167,105,947
W01001312,397,387,75,314,1173
W01001313,481,534,189,81,1285
W01001314,674,669,197,180,1720
W01001315,301,451,331,343,1426
W01001316,1218,743,262,78,2301
W01001317,481,500,107,266,1354
W01001318,499,588,136,34,1257
W01001319,725,538,64,40,1367
W01001320,517,472,95,166,1250
W01001321,500,402,147,178,1227
W01001322,540,432,177,137,1286
W01001324,539,746,194,195,1674
W01001325,445,303,89,381,1218
W01001326,582,490,193,382,1647
W01001327,859,529,219,182,1789
W01001328,505,365,119,251,1240
W01001329,490,411,123,229,1253
W01001330,536,328,110,189,1163
W01001331,659,386,211,114,1370
W01001332,588,400,226,286,1500
W01001333,527,296,158,230,1211
W01001334,362,273,95,411,1141
W01001335,457,383,126,71,1037
W01001336,448,455,90,219,1212
W01001337,504,509,183,77,1273
W01001338,588,495,260,66,1409
W01001339,235,228,74,541,1078
W01001340,774,541,66,89,1470
W01001341,508,391,145,435,1479
W01001342,511,297,67,67,942
W01001343,434,404,73,55,966
W01001344,596,486,130,176,1388
W01001345,243,187,54,578,1062
W01001346,519,433,154,118,1224
W01001347,501,479,82,121,1183
W01001348,514,244,151,478,1387
W01001349,872,392,98,98,1460
W01001350,591,549,221,90,1451
W01001351,621,532,70,75,1298
W01001352,563,383,114,415,1475
W01001353,436,474,78,349,1337
W01001354,594,488,178,81,1341
W01001355,434,404,162,390,1390
W01001356,493,440,63,27,1023
W01001357,616,474,92,143,1325
W01001358,407,360,69,400,1236
W01001359,591,465,134,57,1247
W01001360,434,479,114,53,1080
W01001361,335,304,54,304,997
W01001362,664,657,191,204,1716
W01001363,579,297,129,174,1179
W01001364,576,261,147,408,1392
W01001365,784,478,105,293,1660
W01001366,678,504,102,96,1380
W01001367,567,443,165,43,1218
W01001368,521,257,155,292,1225
W01001369,781,700,159,201,1841
W01001370,622,474,127,220,1443
W01001371,404,218,112,415,1149
W01001372,747,506,153,127,1533
W01001373,632,468,212,66,1378
W01001374,417,470,94,207,1188
W01001375,439,365,133,290,1227
W01001376,343,276,48,510,1177
W01001377,516,585,113,84,1298
W01001378,469,404,95,290,1258
W01001379,586,419,80,111,1196
W01001380,658,552,122,144,1476
W01001381,361,269,89,483,1202
W01001382,545,527,131,116,1319
W01001383,415,457,169,164,1205
W01001384,481,556,230,61,1328
W01001385,445,436,174,184,1239
W01001386,377,361,109,485,1332
W01001387,360,298,135,228,1021
W01001388,546,390,129,333,1398
W01001389,377,327,107,82,893
W01001390,779,450,95,59,1383
W01001391,563,435,133,191,1322
W01001392,672,647,97,52,1468
W01001393,392,304,95,280,1071
W01001394,650,361,47,23,1081
W01001395,480,378,92,253,1203
W01001396,457,218,122,420,1217
W01001397,729,392,109,141,1371
W01001398,1229,264,204,164,1861
W01001399,522,392,103,68,1085
W01001400,372,177,52,472,1073
W01001401,545,539,160,373,1617
W01001402,494,335,111,352,1292
W01001403,584,391,186,115,1276
W01001404,481,651,47,33,1212
W01001405,556,425,113,350,1444
W01001406,573,518,134,370,1595
W01001407,610,372,91,110,1183
W01001408,436,260,99,334,1129
W01001409,626,558,82,130,1396
W01001410,627,495,129,293,1544
W01001411,506,507,133,293,1439
W01001412,522,540,290,97,1449
W01001413,597,483,127,292,1499
W01001414,492,326,126,300,1244
W01001415,742,344,172,163,1421
W01001416,578,479,128,80,1265
W01001417,692,389,88,25,1194
W01001418,464,365,118,241,1188
W01001419,570,437,116,143,1266
W01001420,501,385,132,48,1066
W01001421,212,90,82,763,1147
W01001422,273,466,101,399,1239
W01001423,524,576,115,13,1228
W01001424,492,377,192,155,1216
W01001425,630,523,175,17,1345
W01001426,561,472,66,12,1111
W01001427,913,279,157,9,1358
W01001428,228,209,35,516,988
W01001429,339,402,100,121,962
W01001430,774,571,255,242,1842
W01001431,580,451,171,75,1277
W01001432,745,489,313,201,1748
W01001433,440,453,215,55,1163
W01001434,646,390,79,14,1129
W01001435,443,433,267,48,1191
W01001436,309,444,286,87,1126
W01001437,489,564,152,67,1272
W01001438,438,381,65,346,1230
W01001439,602,545,89,187,1423
W01001440,381,404,83,259,1127
W01001441,288,183,56,424,951
W01001442,462,428,87,32,1009
W01001443,350,350,176,266,1142
W01001444,675,385,127,357,1544
W01001445,446,421,174,172,1213
W01001446,398,368,77,130,973
W01001447,352,292,133,428,1205
W01001448,326,369,241,108,1044
W01001449,429,367,151,277,1224
W01001450,350,432,116,198,1096
W01001451,370,455,234,94,1153
W01001452,639,383,161,82,1265
W01001453,359,355,61,457,1232
W01001454,406,412,103,255,1176
W01001455,478,501,180,244,1403
W01001456,323,325,146,259,1053
W01001457,367,174,118,718,1377
W01001458,590,443,141,95,1269
W01001459,254,177,96,322,849
W01001460,516,450,345,69,1380
W01001461,454,355,181,152,1142
W01001462,484,358,105,279,1226
W01001463,633,676,229,40,1578
W01001464,361,392,135,360,1248
W01001465,364,418,110,395,1287
W01001466,453,552,311,128,1444
W01001467,529,371,145,472,1517
W01001468,436,364,91,238,1129
W01001469,270,298,56,388,1012
W01001470,528,524,59,140,1251
W01001471,361,294,83,646,1384
W01001472,545,523,87,77,1232
W01001473,139,252,50,645,1086
W01001474,378,480,47,379,1284
W01001475,447,371,105,78,1001
W01001476,280,277,182,129,868
W01001477,403,569,177,39,1188
W01001478,482,529,173,43,1227
W01001479,218,232,95,658,1203
W01001480,302,344,68,505,1219
W01001481,392,326,250,325,1293
W01001482,354,251,62,296,963
W01001483,344,219,68,418,1049
W01001484,615,560,75,141,1391
W01001485,277,262,53,376,968
W01001486,508,362,139,188,1197
W01001487,451,425,108,270,1254
W01001488,362,292,69,507,1230
W01001489,355,458,150,324,1287
W01001490,453,425,129,50,1057
W01001491,567,401,155,318,1441
W01001492,870,567,86,342,1865
W01001493,652,431,199,342,1624
W01001494,504,560,82,121,1267
W01001495,554,632,151,199,1536
W01001496,384,435,119,226,1164
W01001497,486,288,71,333,1178
W01001498,349,247,62,269,927
W01001499,553,186,78,168,985
W01001500,772,210,64,8,1054
W01001501,415,146,86,364,1011
W01001502,613,321,44,73,1051
W01001503,355,158,120,374,1007
W01001504,639,495,113,385,1632
W01001505,781,549,156,136,1622
W01001506,387,268,153,347,1155
W01001507,652,639,127,241,1659
W01001508,351,540,69,63,1023
W01001509,556,600,59,34,1249
W01001510,431,453,125,220,1229
W01001511,514,458,84,264,1320
W01001512,538,587,42,20,1187
W01001513,596,578,72,30,1276
W01001514,439,404,90,31,964
W01001515,540,358,165,109,1172
W01001516,444,336,67,345,1192
W01001517,852,398,170,114,1534
W01001518,374,455,50,58,937
W01001519,264,172,134,536,1106
W01001520,587,428,165,245,1425
W01001521,489,345,140,202,1176
W01001522,496,291,96,487,1370
W01001523,489,429,159,154,1231
W01001524,553,512,224,226,1515
W01001525,384,364,70,409,1227
W01001526,330,257,67,392,1046
W01001527,314,256,147,327,1044
W01001528,342,290,55,214,901
W01001529,623,482,144,424,1673
W01001530,330,163,67,794,1354
W01001531,532,410,104,336,1382
W01001532,478,292,101,483,1354
W01001533,799,376,68,44,1287
W01001534,560,328,89,241,1218
W01001535,517,327,64,204,1112
W01001536,264,84,69,456,873
W01001537,511,382,65,79,1037
W01001538,370,196,75,392,1033
W01001539,462,291,89,302,1144
W01001540,507,379,97,55,1038
W01001541,358,334,59,167,918
W01001542,693,552,103,119,1467
W01001543,595,469,79,18,1161
W01001545,362,685,120,19,1186
W01001546,353,259,118,443,1173
W01001548,587,837,241,77,1742
W01001549,457,626,103,44,1230
W01001551,370,282,48,211,911
W01001552,503,697,62,38,1300
W01001553,964,654,205,302,2125
W01001554,262,455,343,90,1150
W01001555,351,533,111,6,1001
W01001556,373,390,56,130,949
W01001557,483,465,351,227,1526
W01001558,457,392,89,337,1275
W01001559,413,462,98,127,1100
W01001560,437,481,154,25,1097
W01001561,405,741,78,15,1239
W01001562,477,449,75,161,1162
W01001563,313,337,62,138,850
W01001564,589,833,204,256,1882
W01001565,535,762,148,67,1512
W01001566,264,384,314,36,998
W01001567,186,316,287,65,854
W01001568,474,712,232,32,1450
W01001569,373,598,98,147,1216
W01001571,397,525,99,28,1049
W01001572,622,397,71,148,1238
W01001573,685,412,84,36,1217
W01001574,667,373,149,22,1211
W01001575,352,483,133,59,1027
W01001576,336,262,148,129,875
W01001577,210,279,69,438,996
W01001578,899,656,106,135,1796
W01001579,391,612,187,69,1259
W01001580,483,548,144,281,1456
W01001581,518,790,173,155,1636
W01001582,775,335,89,211,1410
W01001583,557,586,130,73,1346
W01001584,681,444,230,160,1515
W01001585,504,444,75,2,1025
W01001586,1000,626,163,92,1881
W01001587,483,356,411,274,1524
W01001588,657,675,109,26,1467
W01001589,433,408,118,287,1246
W01001590,775,861,128,58,1822
W01001591,759,300,120,16,1195
W01001592,353,167,150,588,1258
W01001593,638,353,183,226,1400
W01001594,447,498,78,91,1114
W01001595,413,578,58,18,1067
W01001596,210,346,121,112,789
W01001597,550,472,140,68,1230
W01001598,518,381,99,313,1311
W01001599,601,712,155,296,1764
W01001600,553,604,103,11,1271
W01001601,293,208,154,472,1127
W01001602,579,476,86,127,1268
W01001603,471,343,220,52,1086
W01001604,514,606,63,23,1206
W01001605,414,253,332,113,1112
W01001606,430,484,80,57,1051
W01001607,216,82,89,584,971
W01001608,530,479,115,123,1247
W01001609,235,160,55,594,1044
W01001610,438,284,76,231,1029
W01001611,445,317,198,53,1013
W01001612,558,389,249,81,1277
W01001613,642,400,164,23,1229
W01001614,338,263,105,517,1223
W01001615,602,327,69,168,1166
W01001616,548,457,121,101,1227
W01001617,247,206,56,485,994
W01001618,305,215,69,323,912
W01001619,369,179,96,429,1073
W01001620,302,189,76,332,899
W01001621,363,219,113,410,1105
W01001622,460,292,73,177,1002
W01001623,511,452,194,27,1184
W01001624,550,314,87,7,958
W01001625,472,428,122,55,1077
W01001626,448,533,82,101,1164
W01001627,627,550,106,17,1300
W01001628,269,224,123,280,896
W01001629,436,503,128,99,1166
W01001630,354,317,96,491,1258
W01001631,599,393,79,77,1148
W01001632,500,275,102,207,1084
W01001633,308,151,98,536,1093
W01001634,473,281,131,285,1170
W01001635,534,395,84,70,1083
W01001636,912,342,145,10,1409
W01001637,599,488,125,126,1338
W01001638,500,413,39,10,962
W01001639,894,435,82,53,1464
W01001640,352,513,82,45,992
W01001641,474,539,77,11,1101
W01001642,550,308,275,187,1320
W01001643,337,172,177,349,1035
W01001644,942,377,558,185,2062
W01001645,464,257,95,205,1021
W01001646,234,330,42,549,1155
W01001647,585,558,94,42,1279
W01001648,523,463,122,108,1216
W01001649,471,515,89,145,1220
W01001650,523,276,125,255,1179
W01001651,583,589,72,49,1293
W01001652,321,186,156,677,1340
W01001653,510,603,58,26,1197
W01001654,625,505,115,66,1311
W01001655,629,563,101,22,1315
W01001657,671,366,102,12,1151
W01001658,794,428,100,98,1420
W01001659,328,146,355,484,1313
W01001660,432,348,275,132,1187
W01001661,407,203,965,487,2062
W01001662,198,130,191,528,1047
W01001663,413,324,84,426,1247
W01001664,300,253,59,524,1136
W01001665,450,383,155,337,1325
W01001666,353,260,92,418,1123
W01001667,281,204,51,444,980
W01001668,289,240,45,309,883
W01001669,519,548,54,6,1127
W01001670,1047,545,150,15,1757
W01001671,576,317,219,305,1417
W01001672,629,488,112,119,1348
W01001673,551,597,50,52,1250
W01001674,532,392,94,187,1205
W01001675,520,366,297,34,1217
W01001676,500,309,406,71,1286
W01001677,504,487,164,37,1192
W01001678,524,326,129,312,1291
W01001679,421,388,67,68,944
W01001680,465,299,219,8,991
W01001681,318,175,249,330,1072
W01001682,378,241,123,305,1047
W01001683,410,287,107,86,890
W01001684,570,317,236,37,1160
W01001685,338,200,582,254,1374
W01001686,462,287,220,80,1049
W01001687,274,277,695,216,1462
W01001688,959,246,307,468,1980
W01001689,215,65,53,979,1312
W01001690,632,343,606,135,1716
W01001691,442,298,284,137,1161
W01001692,528,395,576,78,1577
W01001693,419,382,473,80,1354
W01001694,377,202,622,351,1552
W01001695,166,55,612,500,1333
W01001696,262,151,369,434,1216
W01001697,506,255,420,207,1388
W01001698,307,203,895,165,1570
W01001699,265,141,525,736,1667
W01001702,650,284,178,307,1419
W01001703,291,208,78,385,962
W01001704,298,175,98,547,1118
W01001705,578,261,174,290,1303
W01001706,411,353,98,137,999
W01001707,553,227,124,576,1480
W01001708,355,214,152,461,1182
W01001709,706,358,258,143,1465
W01001710,519,386,354,53,1312
W01001711,435,405,192,266,1298
W01001712,478,327,354,39,1198
W01001713,591,333,347,133,1404
W01001714,567,496,113,26,1202
W01001715,531,378,318,101,1328
W01001716,498,345,170,15,1028
W01001717,553,318,274,195,1340
W01001718,229,135,1168,22,1554
W01001719,268,304,824,21,1417
W01001720,138,129,1466,46,1779
W01001721,95,107,1104,156,1462
W01001722,119,126,1192,43,1480
W01001724,67,117,1739,19,1942
W01001725,52,69,1863,108,2092
W01001726,232,135,1167,36,1570
W01001727,481,356,61,15,913
W01001728,605,533,46,2,1186
W01001729,981,469,198,22,1670
W01001730,470,690,93,8,1261
W01001731,541,490,100,4,1135
W01001732,521,588,178,2,1289
W01001733,469,487,123,62,1141
W01001734,569,538,128,1,1236
W01001735,543,486,194,21,1244
W01001736,506,561,85,6,1158
W01001737,331,178,88,566,1163
W01001738,246,118,109,469,942
W01001739,231,110,96,522,959
W01001740,358,195,99,515,1167
W01001741,234,105,100,633,1072
W01001742,294,161,84,525,1064
W01001743,594,473,85,39,1191
W01001744,332,176,120,591,1219
W01001745,547,431,76,28,1082
W01001746,363,194,172,399,1128
W01001747,641,423,251,65,1380
W01001748,519,278,128,279,1204
W01001749,508,335,110,272,1225
W01001750,449,290,152,477,1368
W01001751,435,247,130,482,1294
W01001752,675,502,125,52,1354
W01001753,389,207,111,505,1212
W01001754,625,516,194,106,1441
W01001755,380,214,647,28,1269
W01001756,405,232,432,394,1463
W01001757,311,215,656,56,1238
W01001758,367,275,929,45,1616
W01001759,643,312,228,90,1273
W01001760,521,382,238,188,1329
W01001761,400,295,424,214,1333
W01001762,375,193,393,362,1323
W01001764,366,303,323,268,1260
W01001765,372,310,262,107,1051
W01001766,436,303,356,137,1232
W01001767,443,236,400,195,1274
W01001768,381,272,383,121,1157
W01001769,655,560,67,10,1292
W01001770,310,347,137,73,867
W01001771,616,511,149,51,1327
W01001772,513,549,100,19,1181
W01001773,902,492,447,95,1936
W01001774,543,466,90,11,1110
W01001775,548,449,263,58,1318
W01001776,494,446,139,3,1082
W01001777,485,632,102,15,1234
W01001778,787,684,58,2,1531
W01001779,493,531,183,20,1227
W01001780,511,477,116,63,1167
W01001781,480,506,327,89,1402
W01001782,587,512,70,6,1175
W01001783,566,335,102,11,1014
W01001784,551,436,130,19,1136
W01001785,225,156,67,442,890
W01001786,575,372,139,133,1219
W01001787,481,240,113,335,1169
W01001788,382,205,101,408,1096
W01001789,543,378,254,75,1250
W01001790,373,241,102,219,935
W01001791,460,568,203,89,1320
W01001792,468,324,106,381,1279
W01001793,661,279,147,21,1108
W01001794,587,326,215,5,1133
W01001795,690,349,156,19,1214
W01001796,647,359,146,81,1233
W01001797,611,434,96,59,1200
W01001798,600,450,128,26,1204
W01001799,395,504,65,8,972
W01001800,497,287,95,316,1195
W01001802,588,417,117,220,1342
W01001803,485,327,98,371,1281
W01001804,542,263,108,311,1224
W01001805,459,256,90,353,1158
W01001806,501,597,214,96,1408
W01001807,385,160,105,472,1122
W01001808,346,144,108,553,1151
W01001809,522,351,74,116,1063
W01001810,509,188,124,391,1212
W01001811,322,141,91,455,1009
W01001812,460,284,100,140,984
W01001813,377,242,101,455,1175
W01001814,557,331,188,95,1171
W01001815,570,341,88,73,1072
W01001816,864,239,272,498,1873
W01001817,574,275,89,176,1114
W01001818,602,252,193,117,1164
W01001819,839,785,114,123,1861
W01001820,448,326,54,115,943
W01001821,364,328,186,84,962
W01001822,542,472,222,157,1393
W01001823,528,349,169,13,1059
W01001824,375,245,644,48,1312
W01001825,617,350,315,110,1392
W01001826,467,560,107,14,1148
W01001827,570,584,81,29,1264
W01001828,516,696,90,18,1320
W01001829,228,188,1108,104,1628
W01001830,152,132,1084,121,1489
W01001831,329,238,810,26,1403
W01001832,71,79,1408,87,1645
W01001833,388,283,534,93,1298
W01001834,311,195,794,128,1428
W01001835,177,159,725,339,1400
W01001836,323,193,738,50,1304
W01001837,205,168,756,120,1249
W01001838,382,219,941,17,1559
W01001839,268,215,911,44,1438
W01001840,649,400,162,249,1460
W01001841,958,314,140,133,1545
W01001842,798,208,331,16,1353
W01001843,1015,353,245,33,1646
W01001844,830,256,298,183,1567
W01001846,757,354,127,46,1284
W01001847,555,708,41,5,1309
W01001848,548,515,101,11,1175
W01001849,567,635,99,9,1310
W01001850,652,835,96,7,1590
W01001851,502,546,115,77,1240
W01001852,734,652,79,11,1476
W01001853,433,818,102,5,1358
W01001854,458,796,117,7,1378
W01001855,410,244,386,322,1362
W01001856,273,259,630,331,1493
W01001857,310,226,407,458,1401
W01001858,346,325,614,150,1435
W01001859,391,279,442,93,1205
W01001860,554,338,502,59,1453
W01001861,423,273,608,57,1361
W01001862,274,279,685,140,1378
W01001863,600,430,134,107,1271
W01001864,598,535,105,26,1264
W01001865,566,372,64,73,1075
W01001866,435,343,108,225,1111
W01001867,316,164,97,457,1034
W01001868,432,325,84,309,1150
W01001869,482,270,194,194,1140
W01001870,537,262,172,130,1101
W01001871,317,175,130,553,1175
W01001872,443,312,258,231,1244
W01001873,428,217,359,364,1368
W01001874,201,86,230,584,1101
W01001875,841,221,503,439,2004
W01001876,403,186,138,437,1164
W01001877,840,306,189,56,1391
W01001878,601,270,124,162,1157
W01001879,487,140,185,585,1397
W01001880,235,57,107,623,1022
W01001881,377,221,138,398,1134
W01001882,890,229,215,46,1380
W01001883,409,269,75,475,1228
W01001884,24,5,15,845,889
W01001885,851,241,167,192,1451
W01001886,308,174,81,361,924
W01001887,586,580,93,1,1260
W01001888,648,388,129,154,1319
W01001889,482,543,173,102,1300
W01001890,501,489,158,13,1161
W01001891,527,485,190,177,1379
W01001892,496,662,46,7,1211
W01001893,682,438,124,268,1512
W01001894,571,577,114,28,1290
W01001895,368,321,114,490,1293
W01001896,602,499,121,20,1242
W01001897,469,711,246,119,1545
W01001898,393,477,86,298,1254
W01001899,573,714,119,212,1618
W01001900,413,486,120,210,1229
W01001901,487,700,216,185,1588
W01001902,199,204,58,614,1075
W01001903,513,810,181,248,1752
W01001904,477,624,212,79,1392
W01001905,541,825,289,83,1738
W01001906,488,759,220,145,1612
W01001907,312,544,233,74,1163
W01001908,622,647,111,426,1806
W01001909,726,617,124,667,2134
W01001910,474,201,383,200,1258
W01001911,375,236,239,58,908
W01001912,575,508,126,15,1224
W01001913,640,159,250,80,1129
W01001914,952,249,40,32,1273
W01001915,886,301,68,3,1258
W01001916,721,226,150,14,1111
W01001917,494,475,110,115,1194
W01001918,832,168,80,23,1103
W01001919,683,186,137,34,1040
W01001920,623,187,97,11,918
W01001921,600,162,116,240,1118
W01001922,30,75,1178,61,1344
W01001923,282,226,297,234,1039
W01001924,250,235,201,347,1033
W01001925,645,840,182,222,1889
W01001926,659,839,276,93,1867
W01001927,456,426,119,79,1080
W01001928,232,345,299,113,989
W01001929,239,200,471,195,1105
W01001930,611,757,220,184,1772
W01001931,208,176,430,331,1145
W01001932,494,1168,534,190,2386
W01001933,448,1086,288,159,1981
W01001934,308,559,1086,240,2193
W01001935,244,203,411,69,927
W01001936,249,371,288,77,985
W01001937,531,758,360,78,1727
W01001938,142,197,651,137,1127
W01001939,112,90,721,15,938
W01001940,203,79,654,114,1050
W01001941,116,77,802,23,1018
W01001942,264,148,377,304,1093
W01001943,231,80,587,91,989
W01001944,248,56,587,47,938
W01001945,264,76,894,11,1245
W01001946,252,87,393,377,1109
W01001947,431,106,762,58,1357
W01001948,718,277,190,46,1231
W01001949,475,88,297,185,1045
W01001950,269,133,546,50,998
W01001951,237,73,520,85,915
W01001952,192,66,610,133,1001
W01001953,537,280,137,252,1206
W01001954,526,590,90,35,1241
W01001955,40,57,444,920,1461
W01001956,620,571,217,107,1515
W01001957,135,189,264,110,698
W01001958,249,165,532,275,1221
